PokerStars Zoom Hand #185659997917:  Hold'em No Limit ($0.02/$0.05) - 2018/04/25 23:43:31 CCT [2018/04/25 11:43:31 ET]
Table 'Donati' 6-max Seat #1 is the button
Seat 1: anatnof ($5.37 in chips) 
Seat 2: adyrnicc ($5.72 in chips) 
Seat 3: HubertusB ($5 in chips) 
Seat 4: catalin.snow ($11.10 in chips) 
Seat 5: calinutzuu ($5.47 in chips) 
Seat 6: someep1ck ($8.51 in chips) 
adyrnicc: posts small blind $0.02
HubertusB: posts big blind $0.05
*** HOLE CARDS ***
Dealt to HubertusB [6d 9s]
catalin.snow: folds 
calinutzuu: raises $0.10 to $0.15
someep1ck: raises $0.35 to $0.50
anatnof: folds 
adyrnicc: folds 
HubertusB: folds 
calinutzuu: folds 
Uncalled bet ($0.35) returned to someep1ck
someep1ck collected $0.37 from pot
someep1ck: doesn't show hand 
*** SUMMARY ***
Total pot $0.37 | Rake $0 
Seat 1: anatnof (button) folded before Flop (didn't bet)
Seat 2: adyrnicc (small blind) folded before Flop
Seat 3: HubertusB (big blind) folded before Flop
Seat 4: catalin.snow folded before Flop (didn't bet)
Seat 5: calinutzuu folded before Flop
Seat 6: someep1ck collected ($0.37)



PokerStars Zoom Hand #185660007689:  Hold'em No Limit ($0.02/$0.05) - 2018/04/25 23:43:48 CCT [2018/04/25 11:43:48 ET]
Table 'Donati' 6-max Seat #1 is the button
Seat 1: fulldeepthroat ($4.95 in chips) 
Seat 2: HubertusB ($4.95 in chips) 
Seat 3: naimscorp ($5.66 in chips) 
Seat 4: jwsoldier ($14.36 in chips) 
Seat 5: Mitusha666 ($5 in chips) 
Seat 6: jackpot2104 ($6.30 in chips) 
HubertusB: posts small blind $0.02
naimscorp: posts big blind $0.05
*** HOLE CARDS ***
Dealt to HubertusB [9h 3s]
jwsoldier: folds 
Mitusha666: raises $0.10 to $0.15
jackpot2104: folds 
fulldeepthroat: raises $0.37 to $0.52
HubertusB: folds 
naimscorp: folds 
Mitusha666: folds 
Uncalled bet ($0.37) returned to fulldeepthroat
fulldeepthroat collected $0.37 from pot
fulldeepthroat: doesn't show hand 
*** SUMMARY ***
Total pot $0.37 | Rake $0 
Seat 1: fulldeepthroat (button) collected ($0.37)
Seat 2: HubertusB (small blind) folded before Flop
Seat 3: naimscorp (big blind) folded before Flop
Seat 4: jwsoldier folded before Flop (didn't bet)
Seat 5: Mitusha666 folded before Flop
Seat 6: jackpot2104 folded before Flop (didn't bet)



PokerStars Zoom Hand #185660011093:  Hold'em No Limit ($0.02/$0.05) - 2018/04/25 23:43:54 CCT [2018/04/25 11:43:54 ET]
Table 'Donati' 6-max Seat #1 is the button
Seat 1: HubertusB ($4.93 in chips) 
Seat 2: Alexsny13 ($7.08 in chips) 
Seat 3: SapientiAA ($5.51 in chips) 
Seat 4: Dimas169 ($5.24 in chips) 
Seat 5: JonQveee ($7.20 in chips) 
Seat 6: olivier070 ($5.26 in chips) 
Alexsny13: posts small blind $0.02
SapientiAA: posts big blind $0.05
*** HOLE CARDS ***
Dealt to HubertusB [Tc Td]
Dimas169: folds 
JonQveee: raises $0.10 to $0.15
olivier070: folds 
HubertusB: calls $0.15
Alexsny13: calls $0.13
SapientiAA: calls $0.10
*** FLOP *** [2h Ts Kd]
Alexsny13: checks 
SapientiAA: checks 
JonQveee: checks 
HubertusB: checks 
*** TURN *** [2h Ts Kd] [Qs]
Alexsny13: checks 
SapientiAA: checks 
JonQveee: checks 
HubertusB: bets $0.42
Alexsny13: folds 
SapientiAA: folds 
JonQveee: calls $0.42
*** RIVER *** [2h Ts Kd Qs] [Js]
JonQveee: checks 
HubertusB: checks 
*** SHOW DOWN ***
JonQveee: shows [Ah Th] (a straight, Ten to Ace)
HubertusB: mucks hand 
JonQveee collected $1.38 from pot
*** SUMMARY ***
Total pot $1.44 | Rake $0.06 
Board [2h Ts Kd Qs Js]
Seat 1: HubertusB (button) mucked [Tc Td]
Seat 2: Alexsny13 (small blind) folded on the Turn
Seat 3: SapientiAA (big blind) folded on the Turn
Seat 4: Dimas169 folded before Flop (didn't bet)
Seat 5: JonQveee showed [Ah Th] and won ($1.38) with a straight, Ten to Ace
Seat 6: olivier070 folded before Flop (didn't bet)



PokerStars Zoom Hand #185660044782:  Hold'em No Limit ($0.02/$0.05) - 2018/04/25 23:44:53 CCT [2018/04/25 11:44:53 ET]
Table 'Donati' 6-max Seat #1 is the button
Seat 1: fantazja8 ($11.49 in chips) 
Seat 2: YudinAY ($2.12 in chips) 
Seat 3: HubertusB ($4.36 in chips) 
Seat 4: 7dimafon7 ($5 in chips) 
Seat 5: yz2681 ($42.74 in chips) 
Seat 6: Kam99pro ($3.73 in chips) 
YudinAY: posts small blind $0.02
HubertusB: posts big blind $0.05
*** HOLE CARDS ***
Dealt to HubertusB [Ts 9d]
7dimafon7: folds 
yz2681: raises $0.10 to $0.15
Kam99pro: folds 
fantazja8: folds 
YudinAY: folds 
HubertusB: folds 
Uncalled bet ($0.10) returned to yz2681
yz2681 collected $0.12 from pot
yz2681: doesn't show hand 
*** SUMMARY ***
Total pot $0.12 | Rake $0 
Seat 1: fantazja8 (button) folded before Flop (didn't bet)
Seat 2: YudinAY (small blind) folded before Flop
Seat 3: HubertusB (big blind) folded before Flop
Seat 4: 7dimafon7 folded before Flop (didn't bet)
Seat 5: yz2681 collected ($0.12)
Seat 6: Kam99pro folded before Flop (didn't bet)



PokerStars Zoom Hand #185660038603:  Hold'em No Limit ($0.02/$0.05) - 2018/04/25 23:44:42 CCT [2018/04/25 11:44:42 ET]
Table 'Donati' 6-max Seat #1 is the button
Seat 1: SteN 4 ($5 in chips) 
Seat 2: mrak088 ($8.55 in chips) 
Seat 3: kferte ($5 in chips) 
Seat 4: Timberwol815 ($9.13 in chips) 
Seat 5: xiazhen ($8.57 in chips) 
Seat 6: HubertusB ($4.36 in chips) 
mrak088: posts small blind $0.02
kferte: posts big blind $0.05
*** HOLE CARDS ***
Dealt to HubertusB [4c Jh]
Timberwol815: folds 
xiazhen: folds 
HubertusB: folds 
SteN 4: folds 
mrak088: raises $0.10 to $0.15
kferte: folds 
Uncalled bet ($0.10) returned to mrak088
mrak088 collected $0.10 from pot
mrak088: doesn't show hand 
*** SUMMARY ***
Total pot $0.10 | Rake $0 
Seat 1: SteN 4 (button) folded before Flop (didn't bet)
Seat 2: mrak088 (small blind) collected ($0.10)
Seat 3: kferte (big blind) folded before Flop
Seat 4: Timberwol815 folded before Flop (didn't bet)
Seat 5: xiazhen folded before Flop (didn't bet)
Seat 6: HubertusB folded before Flop (didn't bet)



PokerStars Zoom Hand #185660051601:  Hold'em No Limit ($0.02/$0.05) - 2018/04/25 23:45:05 CCT [2018/04/25 11:45:05 ET]
Table 'Donati' 6-max Seat #1 is the button
Seat 1: infitoha ($5 in chips) 
Seat 2: Guernik ($7.46 in chips) 
Seat 3: SimõesB ($5.80 in chips) 
Seat 4: Tn 939 ($5.07 in chips) 
Seat 5: HubertusB ($4.31 in chips) 
Seat 6: bacchus7110 ($4.06 in chips) 
Guernik: posts small blind $0.02
SimõesB: posts big blind $0.05
*** HOLE CARDS ***
Dealt to HubertusB [Ah Jh]
Tn 939: raises $0.10 to $0.15
HubertusB: calls $0.15
bacchus7110: raises $0.10 to $0.25
infitoha: folds 
Guernik: folds 
SimõesB: folds 
Tn 939: folds 
HubertusB: calls $0.10
*** FLOP *** [Qd Kh 3h]
HubertusB: checks 
bacchus7110: bets $0.45
HubertusB: raises $1.16 to $1.61
bacchus7110: folds 
Uncalled bet ($1.16) returned to HubertusB
HubertusB collected $1.55 from pot
HubertusB: doesn't show hand 
*** SUMMARY ***
Total pot $1.62 | Rake $0.07 
Board [Qd Kh 3h]
Seat 1: infitoha (button) folded before Flop (didn't bet)
Seat 2: Guernik (small blind) folded before Flop
Seat 3: SimõesB (big blind) folded before Flop
Seat 4: Tn 939 folded before Flop
Seat 5: HubertusB collected ($1.55)
Seat 6: bacchus7110 folded on the Flop



PokerStars Zoom Hand #185660077793:  Hold'em No Limit ($0.02/$0.05) - 2018/04/25 23:45:50 CCT [2018/04/25 11:45:50 ET]
Table 'Donati' 6-max Seat #1 is the button
Seat 1: vrooong ($9.29 in chips) 
Seat 2: HubertusB ($5.16 in chips) 
Seat 3: Ko$tyari$ ($2.05 in chips) 
Seat 4: crazysnipa ($6.08 in chips) 
Seat 5: mcmeku ($7.15 in chips) 
Seat 6: 19690728 ($3.73 in chips) 
HubertusB: posts small blind $0.02
Ko$tyari$: posts big blind $0.05
*** HOLE CARDS ***
Dealt to HubertusB [Qh As]
crazysnipa: folds 
mcmeku: folds 
19690728: folds 
vrooong: folds 
HubertusB: raises $0.10 to $0.15
Ko$tyari$: raises $0.30 to $0.45
HubertusB: raises $4.71 to $5.16 and is all-in
Ko$tyari$: calls $1.60 and is all-in
Uncalled bet ($3.11) returned to HubertusB
*** FLOP *** [Th 5c 8s]
*** TURN *** [Th 5c 8s] [3c]
*** RIVER *** [Th 5c 8s 3c] [7h]
*** SHOW DOWN ***
HubertusB: shows [Qh As] (high card Ace)
Ko$tyari$: shows [5d Ac] (a pair of Fives)
Ko$tyari$ collected $3.93 from pot
*** SUMMARY ***
Total pot $4.10 | Rake $0.17 
Board [Th 5c 8s 3c 7h]
Seat 1: vrooong (button) folded before Flop (didn't bet)
Seat 2: HubertusB (small blind) showed [Qh As] and lost with high card Ace
Seat 3: Ko$tyari$ (big blind) showed [5d Ac] and won ($3.93) with a pair of Fives
Seat 4: crazysnipa folded before Flop (didn't bet)
Seat 5: mcmeku folded before Flop (didn't bet)
Seat 6: 19690728 folded before Flop (didn't bet)



PokerStars Zoom Hand #185660074334:  Hold'em No Limit ($0.02/$0.05) - 2018/04/25 23:45:44 CCT [2018/04/25 11:45:44 ET]
Table 'Donati' 6-max Seat #1 is the button
Seat 1: EstebanDLP66 ($4.76 in chips) 
Seat 2: thePauliuss ($6.19 in chips) 
Seat 3: anatnof ($5 in chips) 
Seat 4: Moonknight15 ($4.96 in chips) 
Seat 5: HubertusB ($5.16 in chips) 
Seat 6: SNIPE_nt ($4.93 in chips) 
thePauliuss: posts small blind $0.02
anatnof: posts big blind $0.05
*** HOLE CARDS ***
Dealt to HubertusB [2c Ts]
Moonknight15: folds 
HubertusB: folds 
SNIPE_nt: folds 
EstebanDLP66: raises $0.05 to $0.10
thePauliuss: calls $0.08
anatnof: folds 
*** FLOP *** [8s 7h 3d]
thePauliuss: checks 
EstebanDLP66: checks 
*** TURN *** [8s 7h 3d] [2d]
thePauliuss: bets $0.12
EstebanDLP66: calls $0.12
*** RIVER *** [8s 7h 3d 2d] [5h]
thePauliuss: checks 
EstebanDLP66: bets $0.47
thePauliuss: folds 
Uncalled bet ($0.47) returned to EstebanDLP66
EstebanDLP66 collected $0.47 from pot
EstebanDLP66: doesn't show hand 
*** SUMMARY ***
Total pot $0.49 | Rake $0.02 
Board [8s 7h 3d 2d 5h]
Seat 1: EstebanDLP66 (button) collected ($0.47)
Seat 2: thePauliuss (small blind) folded on the River
Seat 3: anatnof (big blind) folded before Flop
Seat 4: Moonknight15 folded before Flop (didn't bet)
Seat 5: HubertusB folded before Flop (didn't bet)
Seat 6: SNIPE_nt folded before Flop (didn't bet)



PokerStars Zoom Hand #185660093380:  Hold'em No Limit ($0.02/$0.05) - 2018/04/25 23:46:17 CCT [2018/04/25 11:46:17 ET]
Table 'Donati' 6-max Seat #1 is the button
Seat 1: maratos744 ($13.19 in chips) 
Seat 2: infitoha ($5 in chips) 
Seat 3: Baksas333 ($3.26 in chips) 
Seat 4: HubertusB ($3.11 in chips) 
Seat 5: limity ($9.56 in chips) 
Seat 6: maxmoyt ($5.09 in chips) 
infitoha: posts small blind $0.02
Baksas333: posts big blind $0.05
*** HOLE CARDS ***
Dealt to HubertusB [7c 8s]
HubertusB: folds 
limity: folds 
maxmoyt: folds 
maratos744: raises $0.10 to $0.15
infitoha: folds 
Baksas333: folds 
Uncalled bet ($0.10) returned to maratos744
maratos744 collected $0.12 from pot
maratos744: doesn't show hand 
*** SUMMARY ***
Total pot $0.12 | Rake $0 
Seat 1: maratos744 (button) collected ($0.12)
Seat 2: infitoha (small blind) folded before Flop
Seat 3: Baksas333 (big blind) folded before Flop
Seat 4: HubertusB folded before Flop (didn't bet)
Seat 5: limity folded before Flop (didn't bet)
Seat 6: maxmoyt folded before Flop (didn't bet)



PokerStars Zoom Hand #185660104465:  Hold'em No Limit ($0.02/$0.05) - 2018/04/25 23:46:36 CCT [2018/04/25 11:46:36 ET]
Table 'Donati' 6-max Seat #1 is the button
Seat 1: someep1ck ($6.36 in chips) 
Seat 2: Tema220303 ($4.73 in chips) 
Seat 3: thePauliuss ($11.80 in chips) 
Seat 4: speedy_1110 ($4.99 in chips) 
Seat 5: mcmeku ($6.53 in chips) 
Seat 6: HubertusB ($3.11 in chips) 
Tema220303: posts small blind $0.02
thePauliuss: posts big blind $0.05
*** HOLE CARDS ***
Dealt to HubertusB [Ah 9c]
speedy_1110: folds 
mcmeku: folds 
HubertusB: folds 
someep1ck: raises $0.07 to $0.12
Tema220303: folds 
thePauliuss: folds 
Uncalled bet ($0.07) returned to someep1ck
someep1ck collected $0.12 from pot
someep1ck: doesn't show hand 
*** SUMMARY ***
Total pot $0.12 | Rake $0 
Seat 1: someep1ck (button) collected ($0.12)
Seat 2: Tema220303 (small blind) folded before Flop
Seat 3: thePauliuss (big blind) folded before Flop
Seat 4: speedy_1110 folded before Flop (didn't bet)
Seat 5: mcmeku folded before Flop (didn't bet)
Seat 6: HubertusB folded before Flop (didn't bet)



PokerStars Zoom Hand #185660099827:  Hold'em No Limit ($0.02/$0.05) - 2018/04/25 23:46:28 CCT [2018/04/25 11:46:28 ET]
Table 'Donati' 6-max Seat #1 is the button
Seat 1: HubertusB ($3.11 in chips) 
Seat 2: krezifrut ($5.12 in chips) 
Seat 3: Original Flo ($2.72 in chips) 
Seat 4: Teta1410 ($9.74 in chips) 
Seat 5: infitoha ($5.78 in chips) 
Seat 6: RichardxSiph ($5.57 in chips) 
krezifrut: posts small blind $0.02
Original Flo: posts big blind $0.05
*** HOLE CARDS ***
Dealt to HubertusB [8c Th]
Teta1410: folds 
infitoha: folds 
RichardxSiph: folds 
HubertusB: folds 
krezifrut: raises $0.07 to $0.12
Original Flo: calls $0.07
*** FLOP *** [Qd Tc 9s]
krezifrut: checks 
Original Flo: bets $0.10
krezifrut: folds 
Uncalled bet ($0.10) returned to Original Flo
Original Flo collected $0.23 from pot
Original Flo: doesn't show hand 
*** SUMMARY ***
Total pot $0.24 | Rake $0.01 
Board [Qd Tc 9s]
Seat 1: HubertusB (button) folded before Flop (didn't bet)
Seat 2: krezifrut (small blind) folded on the Flop
Seat 3: Original Flo (big blind) collected ($0.23)
Seat 4: Teta1410 folded before Flop (didn't bet)
Seat 5: infitoha folded before Flop (didn't bet)
Seat 6: RichardxSiph folded before Flop (didn't bet)



PokerStars Zoom Hand #185660110886:  Hold'em No Limit ($0.02/$0.05) - 2018/04/25 23:46:47 CCT [2018/04/25 11:46:47 ET]
Table 'Donati' 6-max Seat #1 is the button
Seat 1: OfCouRse72 ($7.96 in chips) 
Seat 2: maxmoyt ($4.80 in chips) 
Seat 3: infitoha ($5.07 in chips) 
Seat 4: HubertusB ($3.11 in chips) 
Seat 5: kamilson66 ($5.24 in chips) 
Seat 6: dem&n777 ($4.23 in chips) 
maxmoyt: posts small blind $0.02
infitoha: posts big blind $0.05
*** HOLE CARDS ***
Dealt to HubertusB [3h 3c]
HubertusB: raises $0.05 to $0.10
kamilson66: folds 
dem&n777: calls $0.10
OfCouRse72: raises $0.44 to $0.54
maxmoyt: folds 
infitoha: folds 
HubertusB: folds 
dem&n777: calls $0.44
*** FLOP *** [Td Qh Js]
dem&n777: bets $0.60
OfCouRse72: raises $1.10 to $1.70
dem&n777: raises $1.99 to $3.69 and is all-in
OfCouRse72: calls $1.99
*** TURN *** [Td Qh Js] [5h]
*** RIVER *** [Td Qh Js 5h] [7h]
*** SHOW DOWN ***
dem&n777: shows [Jd Jh] (three of a kind, Jacks)
OfCouRse72: shows [Kc Ks] (a pair of Kings)
dem&n777 collected $8.27 from pot
*** SUMMARY ***
Total pot $8.63 | Rake $0.36 
Board [Td Qh Js 5h 7h]
Seat 1: OfCouRse72 (button) showed [Kc Ks] and lost with a pair of Kings
Seat 2: maxmoyt (small blind) folded before Flop
Seat 3: infitoha (big blind) folded before Flop
Seat 4: HubertusB folded before Flop
Seat 5: kamilson66 folded before Flop (didn't bet)
Seat 6: dem&n777 showed [Jd Jh] and won ($8.27) with three of a kind, Jacks



PokerStars Zoom Hand #185660129666:  Hold'em No Limit ($0.02/$0.05) - 2018/04/25 23:47:20 CCT [2018/04/25 11:47:20 ET]
Table 'Donati' 6-max Seat #1 is the button
Seat 1: patriotmonte ($6.66 in chips) 
Seat 2: Vahenta ($6.57 in chips) 
Seat 3: HubertusB ($3.01 in chips) 
Seat 4: WildSashka13 ($6.13 in chips) 
Seat 5: Jhefoo ($5.70 in chips) 
Seat 6: fantazja8 ($11.82 in chips) 
Vahenta: posts small blind $0.02
HubertusB: posts big blind $0.05
*** HOLE CARDS ***
Dealt to HubertusB [Ks 8d]
WildSashka13: folds 
Jhefoo: raises $0.10 to $0.15
fantazja8: folds 
patriotmonte: folds 
Vahenta: folds 
HubertusB: folds 
Uncalled bet ($0.10) returned to Jhefoo
Jhefoo collected $0.12 from pot
Jhefoo: doesn't show hand 
*** SUMMARY ***
Total pot $0.12 | Rake $0 
Seat 1: patriotmonte (button) folded before Flop (didn't bet)
Seat 2: Vahenta (small blind) folded before Flop
Seat 3: HubertusB (big blind) folded before Flop
Seat 4: WildSashka13 folded before Flop (didn't bet)
Seat 5: Jhefoo collected ($0.12)
Seat 6: fantazja8 folded before Flop (didn't bet)



PokerStars Zoom Hand #185660134888:  Hold'em No Limit ($0.02/$0.05) - 2018/04/25 23:47:29 CCT [2018/04/25 11:47:29 ET]
Table 'Donati' 6-max Seat #1 is the button
Seat 1: Boba1888 ($5.59 in chips) 
Seat 2: HubertusB ($2.96 in chips) 
Seat 3: yurok_chess ($5.22 in chips) 
Seat 4: ezelpp ($5 in chips) 
Seat 5: krezifrut ($5 in chips) 
Seat 6: Moonknight15 ($5.01 in chips) 
HubertusB: posts small blind $0.02
yurok_chess: posts big blind $0.05
*** HOLE CARDS ***
Dealt to HubertusB [Tc 3c]
ezelpp: folds 
krezifrut: folds 
Moonknight15: folds 
Boba1888: folds 
HubertusB: folds 
Uncalled bet ($0.03) returned to yurok_chess
yurok_chess collected $0.04 from pot
yurok_chess: doesn't show hand 
*** SUMMARY ***
Total pot $0.04 | Rake $0 
Seat 1: Boba1888 (button) folded before Flop (didn't bet)
Seat 2: HubertusB (small blind) folded before Flop
Seat 3: yurok_chess (big blind) collected ($0.04)
Seat 4: ezelpp folded before Flop (didn't bet)
Seat 5: krezifrut folded before Flop (didn't bet)
Seat 6: Moonknight15 folded before Flop (didn't bet)



PokerStars Zoom Hand #185660137814:  Hold'em No Limit ($0.02/$0.05) - 2018/04/25 23:47:34 CCT [2018/04/25 11:47:34 ET]
Table 'Donati' 6-max Seat #1 is the button
Seat 1: HubertusB ($2.94 in chips) 
Seat 2: skystaruk ($6.95 in chips) 
Seat 3: Timberwol815 ($14.88 in chips) 
Seat 4: Vedyschiy_ ($5 in chips) 
Seat 5: YSZ458 ($5.08 in chips) 
Seat 6: baagii1979 ($10.64 in chips) 
skystaruk: posts small blind $0.02
Timberwol815: posts big blind $0.05
*** HOLE CARDS ***
Dealt to HubertusB [5s 6s]
Vedyschiy_: folds 
YSZ458: folds 
baagii1979: raises $0.10 to $0.15
HubertusB: raises $0.30 to $0.45
skystaruk: folds 
Timberwol815: folds 
baagii1979: calls $0.30
*** FLOP *** [Ah Qc 2s]
baagii1979: checks 
HubertusB: bets $0.51
baagii1979: folds 
Uncalled bet ($0.51) returned to HubertusB
HubertusB collected $0.93 from pot
HubertusB: doesn't show hand 
*** SUMMARY ***
Total pot $0.97 | Rake $0.04 
Board [Ah Qc 2s]
Seat 1: HubertusB (button) collected ($0.93)
Seat 2: skystaruk (small blind) folded before Flop
Seat 3: Timberwol815 (big blind) folded before Flop
Seat 4: Vedyschiy_ folded before Flop (didn't bet)
Seat 5: YSZ458 folded before Flop (didn't bet)
Seat 6: baagii1979 folded on the Flop



PokerStars Zoom Hand #185660170676:  Hold'em No Limit ($0.02/$0.05) - 2018/04/25 23:48:31 CCT [2018/04/25 11:48:31 ET]
Table 'Donati' 6-max Seat #1 is the button
Seat 1: OfCouRse72 ($10.29 in chips) 
Seat 2: nAzgulpl ($5 in chips) 
Seat 3: pablo_1958_1 ($4.46 in chips) 
Seat 4: denserk ($5.28 in chips) 
Seat 5: HubertusB ($3.42 in chips) 
Seat 6: VOOOR666 ($4.63 in chips) 
nAzgulpl: posts small blind $0.02
pablo_1958_1: posts big blind $0.05
*** HOLE CARDS ***
Dealt to HubertusB [3c 2c]
denserk: folds 
HubertusB: raises $0.05 to $0.10
VOOOR666: calls $0.10
OfCouRse72: folds 
nAzgulpl: folds 
pablo_1958_1: folds 
*** FLOP *** [3s Kh Ks]
HubertusB: bets $0.14
VOOOR666: calls $0.14
*** TURN *** [3s Kh Ks] [4c]
HubertusB: bets $0.30
VOOOR666: folds 
Uncalled bet ($0.30) returned to HubertusB
HubertusB collected $0.53 from pot
HubertusB: doesn't show hand 
*** SUMMARY ***
Total pot $0.55 | Rake $0.02 
Board [3s Kh Ks 4c]
Seat 1: OfCouRse72 (button) folded before Flop (didn't bet)
Seat 2: nAzgulpl (small blind) folded before Flop
Seat 3: pablo_1958_1 (big blind) folded before Flop
Seat 4: denserk folded before Flop (didn't bet)
Seat 5: HubertusB collected ($0.53)
Seat 6: VOOOR666 folded on the Turn



PokerStars Zoom Hand #185660191235:  Hold'em No Limit ($0.02/$0.05) - 2018/04/25 23:49:07 CCT [2018/04/25 11:49:07 ET]
Table 'Donati' 6-max Seat #1 is the button
Seat 1: yurok_chess ($8.58 in chips) 
Seat 2: BrianLodi ($3.90 in chips) 
Seat 3: Tn 939 ($5.74 in chips) 
Seat 4: nikifffor ($7.25 in chips) 
Seat 5: HubertusB ($3.69 in chips) 
Seat 6: limity ($8.82 in chips) 
BrianLodi: posts small blind $0.02
Tn 939: posts big blind $0.05
*** HOLE CARDS ***
Dealt to HubertusB [9c 5h]
nikifffor: raises $0.10 to $0.15
HubertusB: folds 
limity: folds 
yurok_chess: folds 
BrianLodi: folds 
Tn 939: folds 
Uncalled bet ($0.10) returned to nikifffor
nikifffor collected $0.12 from pot
nikifffor: doesn't show hand 
*** SUMMARY ***
Total pot $0.12 | Rake $0 
Seat 1: yurok_chess (button) folded before Flop (didn't bet)
Seat 2: BrianLodi (small blind) folded before Flop
Seat 3: Tn 939 (big blind) folded before Flop
Seat 4: nikifffor collected ($0.12)
Seat 5: HubertusB folded before Flop (didn't bet)
Seat 6: limity folded before Flop (didn't bet)



PokerStars Zoom Hand #185660187303:  Hold'em No Limit ($0.02/$0.05) - 2018/04/25 23:49:00 CCT [2018/04/25 11:49:00 ET]
Table 'Donati' 6-max Seat #1 is the button
Seat 1: Bashkir_12 ($4.04 in chips) 
Seat 2: HubertusB ($3.71 in chips) 
Seat 3: asteins ($5.07 in chips) 
Seat 4: ezelpp ($5.13 in chips) 
Seat 5: adyrnicc ($16.41 in chips) 
Seat 6: FoundingDadd ($7.12 in chips) 
HubertusB: posts small blind $0.02
asteins: posts big blind $0.05
*** HOLE CARDS ***
Dealt to HubertusB [7h 6s]
ezelpp: folds 
adyrnicc: folds 
FoundingDadd: folds 
Bashkir_12: raises $0.10 to $0.15
HubertusB: folds 
asteins: folds 
Uncalled bet ($0.10) returned to Bashkir_12
Bashkir_12 collected $0.12 from pot
Bashkir_12: doesn't show hand 
*** SUMMARY ***
Total pot $0.12 | Rake $0 
Seat 1: Bashkir_12 (button) collected ($0.12)
Seat 2: HubertusB (small blind) folded before Flop
Seat 3: asteins (big blind) folded before Flop
Seat 4: ezelpp folded before Flop (didn't bet)
Seat 5: adyrnicc folded before Flop (didn't bet)
Seat 6: FoundingDadd folded before Flop (didn't bet)



PokerStars Zoom Hand #185660194620:  Hold'em No Limit ($0.02/$0.05) - 2018/04/25 23:49:13 CCT [2018/04/25 11:49:13 ET]
Table 'Donati' 6-max Seat #1 is the button
Seat 1: burgwart77 ($8.82 in chips) 
Seat 2: SimõesB ($5.21 in chips) 
Seat 3: HubertusB ($3.69 in chips) 
Seat 4: IDex777 ($5.12 in chips) 
Seat 5: fantazja8 ($10.51 in chips) 
Seat 6: infitoha ($9.63 in chips) 
SimõesB: posts small blind $0.02
HubertusB: posts big blind $0.05
*** HOLE CARDS ***
Dealt to HubertusB [7h 9s]
IDex777: folds 
fantazja8: folds 
infitoha: folds 
burgwart77: folds 
SimõesB: raises $0.07 to $0.12
HubertusB: raises $0.28 to $0.40
SimõesB: folds 
Uncalled bet ($0.28) returned to HubertusB
HubertusB collected $0.24 from pot
HubertusB: doesn't show hand 
*** SUMMARY ***
Total pot $0.24 | Rake $0 
Seat 1: burgwart77 (button) folded before Flop (didn't bet)
Seat 2: SimõesB (small blind) folded before Flop
Seat 3: HubertusB (big blind) collected ($0.24)
Seat 4: IDex777 folded before Flop (didn't bet)
Seat 5: fantazja8 folded before Flop (didn't bet)
Seat 6: infitoha folded before Flop (didn't bet)



PokerStars Zoom Hand #185660213522:  Hold'em No Limit ($0.02/$0.05) - 2018/04/25 23:49:46 CCT [2018/04/25 11:49:46 ET]
Table 'Donati' 6-max Seat #1 is the button
Seat 1: mcmeku ($8.17 in chips) 
Seat 2: xiazhen ($5.10 in chips) 
Seat 3: vrooong ($5.23 in chips) 
Seat 4: don_energo2 ($6.06 in chips) 
Seat 5: OfCouRse72 ($5 in chips) 
Seat 6: HubertusB ($3.81 in chips) 
xiazhen: posts small blind $0.02
vrooong: posts big blind $0.05
*** HOLE CARDS ***
Dealt to HubertusB [Tc 7d]
don_energo2: raises $0.07 to $0.12
OfCouRse72: folds 
HubertusB: folds 
mcmeku: folds 
xiazhen: folds 
vrooong: folds 
Uncalled bet ($0.07) returned to don_energo2
don_energo2 collected $0.12 from pot
don_energo2: doesn't show hand 
*** SUMMARY ***
Total pot $0.12 | Rake $0 
Seat 1: mcmeku (button) folded before Flop (didn't bet)
Seat 2: xiazhen (small blind) folded before Flop
Seat 3: vrooong (big blind) folded before Flop
Seat 4: don_energo2 collected ($0.12)
Seat 5: OfCouRse72 folded before Flop (didn't bet)
Seat 6: HubertusB folded before Flop (didn't bet)



PokerStars Zoom Hand #185660216917:  Hold'em No Limit ($0.02/$0.05) - 2018/04/25 23:49:52 CCT [2018/04/25 11:49:52 ET]
Table 'Donati' 6-max Seat #1 is the button
Seat 1: johnnyb07070 ($5.22 in chips) 
Seat 2: chikimambone ($5.36 in chips) 
Seat 3: OfCouRse72 ($5 in chips) 
Seat 4: pochitama ($5.99 in chips) 
Seat 5: jwsoldier ($5.54 in chips) 
Seat 6: HubertusB ($3.81 in chips) 
chikimambone: posts small blind $0.02
OfCouRse72: posts big blind $0.05
*** HOLE CARDS ***
Dealt to HubertusB [6s Jd]
pochitama: folds 
jwsoldier: folds 
HubertusB: folds 
johnnyb07070: raises $0.06 to $0.11
chikimambone: folds 
OfCouRse72: folds 
Uncalled bet ($0.06) returned to johnnyb07070
johnnyb07070 collected $0.12 from pot
johnnyb07070: doesn't show hand 
*** SUMMARY ***
Total pot $0.12 | Rake $0 
Seat 1: johnnyb07070 (button) collected ($0.12)
Seat 2: chikimambone (small blind) folded before Flop
Seat 3: OfCouRse72 (big blind) folded before Flop
Seat 4: pochitama folded before Flop (didn't bet)
Seat 5: jwsoldier folded before Flop (didn't bet)
Seat 6: HubertusB folded before Flop (didn't bet)



PokerStars Zoom Hand #185660220265:  Hold'em No Limit ($0.02/$0.05) - 2018/04/25 23:49:58 CCT [2018/04/25 11:49:58 ET]
Table 'Donati' 6-max Seat #1 is the button
Seat 1: HubertusB ($3.81 in chips) 
Seat 2: Insignificant ($6.56 in chips) 
Seat 3: Tn 939 ($5.72 in chips) 
Seat 4: ezelpp ($5.48 in chips) 
Seat 5: chengyiche ($9.16 in chips) 
Seat 6: nokadrian ($4.91 in chips) 
Insignificant: posts small blind $0.02
Tn 939: posts big blind $0.05
*** HOLE CARDS ***
Dealt to HubertusB [2s Kd]
ezelpp: folds 
chengyiche: raises $0.10 to $0.15
nokadrian: calls $0.15
HubertusB: folds 
Insignificant: raises $0.60 to $0.75
Tn 939: folds 
chengyiche: folds 
nokadrian: folds 
Uncalled bet ($0.60) returned to Insignificant
Insignificant collected $0.50 from pot
Insignificant: doesn't show hand 
*** SUMMARY ***
Total pot $0.50 | Rake $0 
Seat 1: HubertusB (button) folded before Flop (didn't bet)
Seat 2: Insignificant (small blind) collected ($0.50)
Seat 3: Tn 939 (big blind) folded before Flop
Seat 4: ezelpp folded before Flop (didn't bet)
Seat 5: chengyiche folded before Flop
Seat 6: nokadrian folded before Flop



PokerStars Zoom Hand #185660227196:  Hold'em No Limit ($0.02/$0.05) - 2018/04/25 23:50:10 CCT [2018/04/25 11:50:10 ET]
Table 'Donati' 6-max Seat #1 is the button
Seat 1: olbadass ($10.27 in chips) 
Seat 2: SL50AMG ($4.36 in chips) 
Seat 3: Boba1888 ($4.79 in chips) 
Seat 4: HubertusB ($3.81 in chips) 
Seat 5: GiPSrb ($2.33 in chips) 
Seat 6: myosotis438 ($3.61 in chips) 
SL50AMG: posts small blind $0.02
Boba1888: posts big blind $0.05
*** HOLE CARDS ***
Dealt to HubertusB [Qd 6h]
HubertusB: folds 
GiPSrb: folds 
myosotis438: folds 
olbadass: folds 
SL50AMG: folds 
Uncalled bet ($0.03) returned to Boba1888
Boba1888 collected $0.04 from pot
Boba1888: doesn't show hand 
*** SUMMARY ***
Total pot $0.04 | Rake $0 
Seat 1: olbadass (button) folded before Flop (didn't bet)
Seat 2: SL50AMG (small blind) folded before Flop
Seat 3: Boba1888 (big blind) collected ($0.04)
Seat 4: HubertusB folded before Flop (didn't bet)
Seat 5: GiPSrb folded before Flop (didn't bet)
Seat 6: myosotis438 folded before Flop (didn't bet)



PokerStars Zoom Hand #185660223734:  Hold'em No Limit ($0.02/$0.05) - 2018/04/25 23:50:04 CCT [2018/04/25 11:50:04 ET]
Table 'Donati' 6-max Seat #1 is the button
Seat 1: WIKISMOM ($3.63 in chips) 
Seat 2: $tealOff ($2.82 in chips) 
Seat 3: Tema220303 ($5 in chips) 
Seat 4: Dida007007 ($4.95 in chips) 
Seat 5: HubertusB ($3.81 in chips) 
Seat 6: holdmybreath ($5.83 in chips) 
$tealOff: posts small blind $0.02
Tema220303: posts big blind $0.05
*** HOLE CARDS ***
Dealt to HubertusB [5c 7d]
Dida007007: folds 
HubertusB: folds 
holdmybreath: folds 
WIKISMOM: calls $0.05
$tealOff: folds 
Tema220303: checks 
*** FLOP *** [Ks 4s 6d]
Tema220303: checks 
WIKISMOM: bets $0.12
Tema220303: folds 
Uncalled bet ($0.12) returned to WIKISMOM
WIKISMOM collected $0.12 from pot
WIKISMOM: doesn't show hand 
*** SUMMARY ***
Total pot $0.12 | Rake $0 
Board [Ks 4s 6d]
Seat 1: WIKISMOM (button) collected ($0.12)
Seat 2: $tealOff (small blind) folded before Flop
Seat 3: Tema220303 (big blind) folded on the Flop
Seat 4: Dida007007 folded before Flop (didn't bet)
Seat 5: HubertusB folded before Flop (didn't bet)
Seat 6: holdmybreath folded before Flop (didn't bet)



PokerStars Zoom Hand #185660230156:  Hold'em No Limit ($0.02/$0.05) - 2018/04/25 23:50:15 CCT [2018/04/25 11:50:15 ET]
Table 'Donati' 6-max Seat #1 is the button
Seat 1: vitore ($8.20 in chips) 
Seat 2: HubertusB ($3.81 in chips) 
Seat 3: $tealOff ($1.79 in chips) 
Seat 4: peepiceek ($7.84 in chips) 
Seat 5: OfCouRse72 ($11.47 in chips) 
Seat 6: asteins ($5 in chips) 
HubertusB: posts small blind $0.02
$tealOff: posts big blind $0.05
*** HOLE CARDS ***
Dealt to HubertusB [4s Qc]
peepiceek: folds 
OfCouRse72: folds 
asteins: raises $0.07 to $0.12
vitore: calls $0.12
HubertusB: folds 
$tealOff: calls $0.07
*** FLOP *** [7d Qs 8s]
$tealOff: checks 
asteins: bets $0.18
vitore: folds 
$tealOff: folds 
Uncalled bet ($0.18) returned to asteins
asteins collected $0.36 from pot
asteins: doesn't show hand 
*** SUMMARY ***
Total pot $0.38 | Rake $0.02 
Board [7d Qs 8s]
Seat 1: vitore (button) folded on the Flop
Seat 2: HubertusB (small blind) folded before Flop
Seat 3: $tealOff (big blind) folded on the Flop
Seat 4: peepiceek folded before Flop (didn't bet)
Seat 5: OfCouRse72 folded before Flop (didn't bet)
Seat 6: asteins collected ($0.36)



PokerStars Zoom Hand #185660242782:  Hold'em No Limit ($0.02/$0.05) - 2018/04/25 23:50:37 CCT [2018/04/25 11:50:37 ET]
Table 'Donati' 6-max Seat #1 is the button
Seat 1: asteins ($5 in chips) 
Seat 2: calinutzuu ($7.76 in chips) 
Seat 3: Glolight ($5.32 in chips) 
Seat 4: NeverFold27o ($6.20 in chips) 
Seat 5: Cadu_171 ($5.36 in chips) 
Seat 6: HubertusB ($3.74 in chips) 
calinutzuu: posts small blind $0.02
Glolight: posts big blind $0.05
*** HOLE CARDS ***
Dealt to HubertusB [Jd 7s]
NeverFold27o: folds 
Cadu_171: folds 
HubertusB: folds 
asteins: folds 
calinutzuu: folds 
Uncalled bet ($0.03) returned to Glolight
Glolight collected $0.04 from pot
Glolight: doesn't show hand 
*** SUMMARY ***
Total pot $0.04 | Rake $0 
Seat 1: asteins (button) folded before Flop (didn't bet)
Seat 2: calinutzuu (small blind) folded before Flop
Seat 3: Glolight (big blind) collected ($0.04)
Seat 4: NeverFold27o folded before Flop (didn't bet)
Seat 5: Cadu_171 folded before Flop (didn't bet)
Seat 6: HubertusB folded before Flop (didn't bet)



PokerStars Zoom Hand #185660246257:  Hold'em No Limit ($0.02/$0.05) - 2018/04/25 23:50:43 CCT [2018/04/25 11:50:43 ET]
Table 'Donati' 6-max Seat #1 is the button
Seat 1: Draugsvoll ($6.04 in chips) 
Seat 2: Gatil228 ($2.99 in chips) 
Seat 3: Lolczyk92 ($5 in chips) 
Seat 4: jackpot2104 ($9.01 in chips) 
Seat 5: HubertusB ($3.74 in chips) 
Seat 6: xiazhen ($5.74 in chips) 
Gatil228: posts small blind $0.02
Lolczyk92: posts big blind $0.05
*** HOLE CARDS ***
Dealt to HubertusB [9d 3c]
jackpot2104: folds 
HubertusB: folds 
xiazhen: folds 
Draugsvoll: folds 
Gatil228: folds 
Uncalled bet ($0.03) returned to Lolczyk92
Lolczyk92 collected $0.04 from pot
Lolczyk92: doesn't show hand 
*** SUMMARY ***
Total pot $0.04 | Rake $0 
Seat 1: Draugsvoll (button) folded before Flop (didn't bet)
Seat 2: Gatil228 (small blind) folded before Flop
Seat 3: Lolczyk92 (big blind) collected ($0.04)
Seat 4: jackpot2104 folded before Flop (didn't bet)
Seat 5: HubertusB folded before Flop (didn't bet)
Seat 6: xiazhen folded before Flop (didn't bet)



PokerStars Zoom Hand #185660239222:  Hold'em No Limit ($0.02/$0.05) - 2018/04/25 23:50:31 CCT [2018/04/25 11:50:31 ET]
Table 'Donati' 6-max Seat #1 is the button
Seat 1: HubertusB ($3.74 in chips) 
Seat 2: Vahenta ($6.85 in chips) 
Seat 3: dino.moh ($5 in chips) 
Seat 4: maxmoyt ($6.11 in chips) 
Seat 5: DuggieD ($5 in chips) 
Seat 6: GabrielCH88 ($25.07 in chips) 
Vahenta: posts small blind $0.02
dino.moh: posts big blind $0.05
*** HOLE CARDS ***
Dealt to HubertusB [Jc 5h]
maxmoyt: folds 
DuggieD: folds 
GabrielCH88: folds 
HubertusB: folds 
Vahenta: raises $0.07 to $0.12
dino.moh: folds 
Uncalled bet ($0.07) returned to Vahenta
Vahenta collected $0.10 from pot
Vahenta: doesn't show hand 
*** SUMMARY ***
Total pot $0.10 | Rake $0 
Seat 1: HubertusB (button) folded before Flop (didn't bet)
Seat 2: Vahenta (small blind) collected ($0.10)
Seat 3: dino.moh (big blind) folded before Flop
Seat 4: maxmoyt folded before Flop (didn't bet)
Seat 5: DuggieD folded before Flop (didn't bet)
Seat 6: GabrielCH88 folded before Flop (didn't bet)



PokerStars Zoom Hand #185660233031:  Hold'em No Limit ($0.02/$0.05) - 2018/04/25 23:50:20 CCT [2018/04/25 11:50:20 ET]
Table 'Donati' 6-max Seat #1 is the button
Seat 1: Jovani_Silva ($6.34 in chips) 
Seat 2: criminal36 ($4.79 in chips) 
Seat 3: HubertusB ($3.79 in chips) 
Seat 4: TOMOGOCHI ($15.30 in chips) 
Seat 5: holdmybreath ($5.83 in chips) 
Seat 6: AudioLSD ($4.76 in chips) 
criminal36: posts small blind $0.02
HubertusB: posts big blind $0.05
*** HOLE CARDS ***
Dealt to HubertusB [5c 9h]
TOMOGOCHI: folds 
holdmybreath: folds 
AudioLSD: raises $0.07 to $0.12
Jovani_Silva: folds 
criminal36: calls $0.10
HubertusB: folds 
*** FLOP *** [8c Qs 5d]
criminal36: checks 
AudioLSD: checks 
*** TURN *** [8c Qs 5d] [Qd]
criminal36: checks 
AudioLSD: checks 
*** RIVER *** [8c Qs 5d Qd] [4d]
criminal36: bets $0.05
AudioLSD: raises $0.30 to $0.35
criminal36: folds 
Uncalled bet ($0.30) returned to AudioLSD
AudioLSD collected $0.37 from pot
AudioLSD: doesn't show hand 
*** SUMMARY ***
Total pot $0.39 | Rake $0.02 
Board [8c Qs 5d Qd 4d]
Seat 1: Jovani_Silva (button) folded before Flop (didn't bet)
Seat 2: criminal36 (small blind) folded on the River
Seat 3: HubertusB (big blind) folded before Flop
Seat 4: TOMOGOCHI folded before Flop (didn't bet)
Seat 5: holdmybreath folded before Flop (didn't bet)
Seat 6: AudioLSD collected ($0.37)



PokerStars Zoom Hand #185660250321:  Hold'em No Limit ($0.02/$0.05) - 2018/04/25 23:50:50 CCT [2018/04/25 11:50:50 ET]
Table 'Donati' 6-max Seat #1 is the button
Seat 1: Opushtencija ($4.95 in chips) 
Seat 2: ninjalyalin88 ($4.95 in chips) 
Seat 3: maxmoyt ($6.11 in chips) 
Seat 4: HubertusB ($3.74 in chips) 
Seat 5: gjikaban ($11.31 in chips) 
Seat 6: kirill349003 ($5.93 in chips) 
ninjalyalin88: posts small blind $0.02
maxmoyt: posts big blind $0.05
*** HOLE CARDS ***
Dealt to HubertusB [Tc 4s]
HubertusB: folds 
gjikaban: folds 
kirill349003: folds 
Opushtencija: raises $0.10 to $0.15
ninjalyalin88: folds 
maxmoyt: folds 
Uncalled bet ($0.10) returned to Opushtencija
Opushtencija collected $0.12 from pot
Opushtencija: doesn't show hand 
*** SUMMARY ***
Total pot $0.12 | Rake $0 
Seat 1: Opushtencija (button) collected ($0.12)
Seat 2: ninjalyalin88 (small blind) folded before Flop
Seat 3: maxmoyt (big blind) folded before Flop
Seat 4: HubertusB folded before Flop (didn't bet)
Seat 5: gjikaban folded before Flop (didn't bet)
Seat 6: kirill349003 folded before Flop (didn't bet)



PokerStars Zoom Hand #185660254994:  Hold'em No Limit ($0.02/$0.05) - 2018/04/25 23:50:58 CCT [2018/04/25 11:50:58 ET]
Table 'Donati' 6-max Seat #1 is the button
Seat 1: calamari66 ($4.92 in chips) 
Seat 2: fiddlefreddy ($3.67 in chips) 
Seat 3: vougiouks ($14.23 in chips) 
Seat 4: HubertusB ($3.74 in chips) 
Seat 5: denserk ($5.53 in chips) 
Seat 6: calinutzuu ($5 in chips) 
fiddlefreddy: posts small blind $0.02
vougiouks: posts big blind $0.05
*** HOLE CARDS ***
Dealt to HubertusB [Ts Ks]
HubertusB: raises $0.05 to $0.10
denserk: folds 
calinutzuu: folds 
calamari66: calls $0.10
fiddlefreddy: folds 
vougiouks: folds 
*** FLOP *** [Ac 3h 9d]
HubertusB: checks 
calamari66: checks 
*** TURN *** [Ac 3h 9d] [5c]
HubertusB: checks 
calamari66: bets $0.20
HubertusB: folds 
Uncalled bet ($0.20) returned to calamari66
calamari66 collected $0.26 from pot
calamari66: doesn't show hand 
*** SUMMARY ***
Total pot $0.27 | Rake $0.01 
Board [Ac 3h 9d 5c]
Seat 1: calamari66 (button) collected ($0.26)
Seat 2: fiddlefreddy (small blind) folded before Flop
Seat 3: vougiouks (big blind) folded before Flop
Seat 4: HubertusB folded on the Turn
Seat 5: denserk folded before Flop (didn't bet)
Seat 6: calinutzuu folded before Flop (didn't bet)



PokerStars Zoom Hand #185660292273:  Hold'em No Limit ($0.02/$0.05) - 2018/04/25 23:52:03 CCT [2018/04/25 11:52:03 ET]
Table 'Donati' 6-max Seat #1 is the button
Seat 1: andrej_@7995 ($5.01 in chips) 
Seat 2: HubertusB ($3.64 in chips) 
Seat 3: $tealOff ($2.51 in chips) 
Seat 4: face903 ($4.78 in chips) 
Seat 5: Dimas169 ($5 in chips) 
Seat 6: kaver1012 ($5 in chips) 
HubertusB: posts small blind $0.02
$tealOff: posts big blind $0.05
*** HOLE CARDS ***
Dealt to HubertusB [5s 2d]
face903: folds 
Dimas169: folds 
kaver1012: raises $0.12 to $0.17
andrej_@7995: folds 
HubertusB: folds 
$tealOff: raises $0.33 to $0.50
kaver1012: calls $0.33
*** FLOP *** [2h 9s Th]
$tealOff: bets $0.65
kaver1012: calls $0.65
*** TURN *** [2h 9s Th] [7s]
$tealOff: bets $1.36 and is all-in
kaver1012: calls $1.36
*** RIVER *** [2h 9s Th 7s] [Ts]
*** SHOW DOWN ***
$tealOff: shows [Qc Qs] (two pair, Queens and Tens)
kaver1012: shows [Td Jd] (three of a kind, Tens)
kaver1012 collected $4.83 from pot
*** SUMMARY ***
Total pot $5.04 | Rake $0.21 
Board [2h 9s Th 7s Ts]
Seat 1: andrej_@7995 (button) folded before Flop (didn't bet)
Seat 2: HubertusB (small blind) folded before Flop
Seat 3: $tealOff (big blind) showed [Qc Qs] and lost with two pair, Queens and Tens
Seat 4: face903 folded before Flop (didn't bet)
Seat 5: Dimas169 folded before Flop (didn't bet)
Seat 6: kaver1012 showed [Td Jd] and won ($4.83) with three of a kind, Tens



PokerStars Zoom Hand #185660297954:  Hold'em No Limit ($0.02/$0.05) - 2018/04/25 23:52:13 CCT [2018/04/25 11:52:13 ET]
Table 'Donati' 6-max Seat #1 is the button
Seat 1: Ddenis85 ($2.88 in chips) 
Seat 2: someep1ck ($6.56 in chips) 
Seat 3: HubertusB ($3.62 in chips) 
Seat 4: gorechin_alexey ($7.27 in chips) 
Seat 5: Efi Giannis ($3.59 in chips) 
Seat 6: IGOR909 ($5 in chips) 
someep1ck: posts small blind $0.02
HubertusB: posts big blind $0.05
*** HOLE CARDS ***
Dealt to HubertusB [3c Ah]
gorechin_alexey: folds 
Efi Giannis: folds 
IGOR909: folds 
Ddenis85: raises $0.05 to $0.10
someep1ck: folds 
HubertusB: calls $0.05
*** FLOP *** [3h 7c 6s]
HubertusB: bets $0.10
Ddenis85: raises $0.10 to $0.20
HubertusB: calls $0.10
*** TURN *** [3h 7c 6s] [Ad]
HubertusB: checks 
Ddenis85: bets $0.30
HubertusB: calls $0.30
*** RIVER *** [3h 7c 6s Ad] [Kc]
HubertusB: checks 
Ddenis85: bets $1.15
HubertusB: calls $1.15
*** SHOW DOWN ***
Ddenis85: shows [8c 7h] (a pair of Sevens)
HubertusB: shows [3c Ah] (two pair, Aces and Threes)
HubertusB collected $3.37 from pot
*** SUMMARY ***
Total pot $3.52 | Rake $0.15 
Board [3h 7c 6s Ad Kc]
Seat 1: Ddenis85 (button) showed [8c 7h] and lost with a pair of Sevens
Seat 2: someep1ck (small blind) folded before Flop
Seat 3: HubertusB (big blind) showed [3c Ah] and won ($3.37) with two pair, Aces and Threes
Seat 4: gorechin_alexey folded before Flop (didn't bet)
Seat 5: Efi Giannis folded before Flop (didn't bet)
Seat 6: IGOR909 folded before Flop (didn't bet)



PokerStars Zoom Hand #185660324871:  Hold'em No Limit ($0.02/$0.05) - 2018/04/25 23:53:00 CCT [2018/04/25 11:53:00 ET]
Table 'Donati' 6-max Seat #1 is the button
Seat 1: pfouro ($6.20 in chips) 
Seat 2: nik_6181 ($4.76 in chips) 
Seat 3: kad-imos1 ($6.80 in chips) 
Seat 4: nikifffor ($11.56 in chips) 
Seat 5: YSZ458 ($5.05 in chips) 
Seat 6: HubertusB ($5.24 in chips) 
nik_6181: posts small blind $0.02
kad-imos1: posts big blind $0.05
*** HOLE CARDS ***
Dealt to HubertusB [4h Ks]
nikifffor: folds 
YSZ458: raises $0.07 to $0.12
HubertusB: folds 
pfouro: folds 
nik_6181: folds 
kad-imos1: folds 
Uncalled bet ($0.07) returned to YSZ458
YSZ458 collected $0.12 from pot
YSZ458: doesn't show hand 
*** SUMMARY ***
Total pot $0.12 | Rake $0 
Seat 1: pfouro (button) folded before Flop (didn't bet)
Seat 2: nik_6181 (small blind) folded before Flop
Seat 3: kad-imos1 (big blind) folded before Flop
Seat 4: nikifffor folded before Flop (didn't bet)
Seat 5: YSZ458 collected ($0.12)
Seat 6: HubertusB folded before Flop (didn't bet)



PokerStars Zoom Hand #185660328398:  Hold'em No Limit ($0.02/$0.05) - 2018/04/25 23:53:06 CCT [2018/04/25 11:53:06 ET]
Table 'Donati' 6-max Seat #1 is the button
Seat 1: HubertusB ($5.24 in chips) 
Seat 2: alex2-a.a ($3.53 in chips) 
Seat 3: Smith1358 ($5.88 in chips) 
Seat 4: chikimambone ($15.21 in chips) 
Seat 5: Glolight ($6.23 in chips) 
Seat 6: sdbhsfb ($10.09 in chips) 
alex2-a.a: posts small blind $0.02
Smith1358: posts big blind $0.05
*** HOLE CARDS ***
Dealt to HubertusB [6d 9d]
chikimambone: folds 
Glolight: folds 
sdbhsfb: folds 
HubertusB: raises $0.05 to $0.10
alex2-a.a: folds 
Smith1358: calls $0.05
*** FLOP *** [7s 5s 6h]
Smith1358: checks 
HubertusB: bets $0.10
Smith1358: folds 
Uncalled bet ($0.10) returned to HubertusB
HubertusB collected $0.21 from pot
HubertusB: doesn't show hand 
*** SUMMARY ***
Total pot $0.22 | Rake $0.01 
Board [7s 5s 6h]
Seat 1: HubertusB (button) collected ($0.21)
Seat 2: alex2-a.a (small blind) folded before Flop
Seat 3: Smith1358 (big blind) folded on the Flop
Seat 4: chikimambone folded before Flop (didn't bet)
Seat 5: Glolight folded before Flop (didn't bet)
Seat 6: sdbhsfb folded before Flop (didn't bet)



PokerStars Zoom Hand #185660342672:  Hold'em No Limit ($0.02/$0.05) - 2018/04/25 23:53:31 CCT [2018/04/25 11:53:31 ET]
Table 'Donati' 6-max Seat #1 is the button
Seat 1: plaz v ($2.32 in chips) 
Seat 2: HubertusB ($5.35 in chips) 
Seat 3: olivier070 ($7.56 in chips) 
Seat 4: Vedyschiy_ ($5.78 in chips) 
Seat 5: PaTRoN16q ($1.91 in chips) 
Seat 6: asteins ($5.07 in chips) 
HubertusB: posts small blind $0.02
olivier070: posts big blind $0.05
*** HOLE CARDS ***
Dealt to HubertusB [Ts 6c]
Vedyschiy_: folds 
PaTRoN16q: folds 
asteins: folds 
plaz v: folds 
HubertusB: folds 
Uncalled bet ($0.03) returned to olivier070
olivier070 collected $0.04 from pot
olivier070: doesn't show hand 
*** SUMMARY ***
Total pot $0.04 | Rake $0 
Seat 1: plaz v (button) folded before Flop (didn't bet)
Seat 2: HubertusB (small blind) folded before Flop
Seat 3: olivier070 (big blind) collected ($0.04)
Seat 4: Vedyschiy_ folded before Flop (didn't bet)
Seat 5: PaTRoN16q folded before Flop (didn't bet)
Seat 6: asteins folded before Flop (didn't bet)



PokerStars Zoom Hand #185660346099:  Hold'em No Limit ($0.02/$0.05) - 2018/04/25 23:53:37 CCT [2018/04/25 11:53:37 ET]
Table 'Donati' 6-max Seat #1 is the button
Seat 1: Mr.Zhuxx ($6.30 in chips) 
Seat 2: limity ($8.96 in chips) 
Seat 3: HubertusB ($5.33 in chips) 
Seat 4: YoshimotoxD ($6.67 in chips) 
Seat 5: T0QOCR ($8.96 in chips) 
Seat 6: pipirkin ($7.79 in chips) 
limity: posts small blind $0.02
HubertusB: posts big blind $0.05
*** HOLE CARDS ***
Dealt to HubertusB [Qh 8c]
YoshimotoxD: folds 
T0QOCR: folds 
pipirkin: folds 
Mr.Zhuxx: folds 
limity: raises $0.10 to $0.15
HubertusB: folds 
Uncalled bet ($0.10) returned to limity
limity collected $0.10 from pot
limity: doesn't show hand 
*** SUMMARY ***
Total pot $0.10 | Rake $0 
Seat 1: Mr.Zhuxx (button) folded before Flop (didn't bet)
Seat 2: limity (small blind) collected ($0.10)
Seat 3: HubertusB (big blind) folded before Flop
Seat 4: YoshimotoxD folded before Flop (didn't bet)
Seat 5: T0QOCR folded before Flop (didn't bet)
Seat 6: pipirkin folded before Flop (didn't bet)



PokerStars Zoom Hand #185660364638:  Hold'em No Limit ($0.02/$0.05) - 2018/04/25 23:54:09 CCT [2018/04/25 11:54:09 ET]
Table 'Donati' 6-max Seat #1 is the button
Seat 1: ramosd04 ($5 in chips) 
Seat 2: SpeeLy ($5.50 in chips) 
Seat 3: limity ($9.63 in chips) 
Seat 4: kferte ($5.40 in chips) 
Seat 5: pashqadk ($5.27 in chips) 
Seat 6: HubertusB ($5.28 in chips) 
SpeeLy: posts small blind $0.02
limity: posts big blind $0.05
*** HOLE CARDS ***
Dealt to HubertusB [Qd 3d]
kferte: folds 
pashqadk: folds 
HubertusB: folds 
ramosd04: folds 
SpeeLy: raises $0.10 to $0.15
limity: folds 
Uncalled bet ($0.10) returned to SpeeLy
SpeeLy collected $0.10 from pot
SpeeLy: doesn't show hand 
*** SUMMARY ***
Total pot $0.10 | Rake $0 
Seat 1: ramosd04 (button) folded before Flop (didn't bet)
Seat 2: SpeeLy (small blind) collected ($0.10)
Seat 3: limity (big blind) folded before Flop
Seat 4: kferte folded before Flop (didn't bet)
Seat 5: pashqadk folded before Flop (didn't bet)
Seat 6: HubertusB folded before Flop (didn't bet)



PokerStars Zoom Hand #185660361729:  Hold'em No Limit ($0.02/$0.05) - 2018/04/25 23:54:04 CCT [2018/04/25 11:54:04 ET]
Table 'Donati' 6-max Seat #1 is the button
Seat 1: olivier070 ($5.02 in chips) 
Seat 2: zhdam9 ($5.94 in chips) 
Seat 3: Draugsvoll ($5 in chips) 
Seat 4: anatnof ($5.39 in chips) 
Seat 5: HubertusB ($5.28 in chips) 
Seat 6: Lolczyk92 ($10.02 in chips) 
zhdam9: posts small blind $0.02
Draugsvoll: posts big blind $0.05
*** HOLE CARDS ***
Dealt to HubertusB [Kd 2h]
anatnof: raises $0.10 to $0.15
HubertusB: folds 
Lolczyk92: folds 
olivier070: raises $0.35 to $0.50
zhdam9: folds 
Draugsvoll: folds 
anatnof: folds 
Uncalled bet ($0.35) returned to olivier070
olivier070 collected $0.37 from pot
olivier070: doesn't show hand 
*** SUMMARY ***
Total pot $0.37 | Rake $0 
Seat 1: olivier070 (button) collected ($0.37)
Seat 2: zhdam9 (small blind) folded before Flop
Seat 3: Draugsvoll (big blind) folded before Flop
Seat 4: anatnof folded before Flop
Seat 5: HubertusB folded before Flop (didn't bet)
Seat 6: Lolczyk92 folded before Flop (didn't bet)



PokerStars Zoom Hand #185660368131:  Hold'em No Limit ($0.02/$0.05) - 2018/04/25 23:54:15 CCT [2018/04/25 11:54:15 ET]
Table 'Donati' 6-max Seat #1 is the button
Seat 1: zhdam9 ($5.92 in chips) 
Seat 2: Mr.Zhuxx ($6.03 in chips) 
Seat 3: ezelpp ($5 in chips) 
Seat 4: HubertusB ($5.28 in chips) 
Seat 5: russland415 ($6.89 in chips) 
Seat 6: 1989ace1989 ($6.49 in chips) 
Mr.Zhuxx: posts small blind $0.02
ezelpp: posts big blind $0.05
*** HOLE CARDS ***
Dealt to HubertusB [Qc 8s]
HubertusB: folds 
russland415: folds 
1989ace1989: raises $0.10 to $0.15
zhdam9: folds 
Mr.Zhuxx: folds 
ezelpp: folds 
Uncalled bet ($0.10) returned to 1989ace1989
1989ace1989 collected $0.12 from pot
1989ace1989: doesn't show hand 
*** SUMMARY ***
Total pot $0.12 | Rake $0 
Seat 1: zhdam9 (button) folded before Flop (didn't bet)
Seat 2: Mr.Zhuxx (small blind) folded before Flop
Seat 3: ezelpp (big blind) folded before Flop
Seat 4: HubertusB folded before Flop (didn't bet)
Seat 5: russland415 folded before Flop (didn't bet)
Seat 6: 1989ace1989 collected ($0.12)



PokerStars Zoom Hand #185660357551:  Hold'em No Limit ($0.02/$0.05) - 2018/04/25 23:53:57 CCT [2018/04/25 11:53:57 ET]
Table 'Donati' 6-max Seat #1 is the button
Seat 1: HubertusB ($5.28 in chips) 
Seat 2: asleysantos ($5.62 in chips) 
Seat 3: nAzgulpl ($5.81 in chips) 
Seat 4: Alexsny13 ($6.99 in chips) 
Seat 5: timchipking ($3.87 in chips) 
Seat 6: Jovani_Silva ($6.19 in chips) 
asleysantos: posts small blind $0.02
nAzgulpl: posts big blind $0.05
*** HOLE CARDS ***
Dealt to HubertusB [4s 6h]
Alexsny13: raises $0.10 to $0.15
timchipking: calls $0.15
Jovani_Silva: folds 
HubertusB: folds 
asleysantos: calls $0.13
nAzgulpl: calls $0.10
*** FLOP *** [5d 2h Qc]
asleysantos: checks 
nAzgulpl: checks 
Alexsny13: bets $0.30
timchipking: calls $0.30
asleysantos: folds 
nAzgulpl: folds 
*** TURN *** [5d 2h Qc] [8h]
Alexsny13: checks 
timchipking: bets $0.35
Alexsny13: raises $0.55 to $0.90
timchipking: calls $0.55
*** RIVER *** [5d 2h Qc 8h] [Jd]
Alexsny13: checks 
timchipking: checks 
*** SHOW DOWN ***
Alexsny13: shows [Td Th] (a pair of Tens)
timchipking: shows [Ad Ah] (a pair of Aces)
timchipking collected $2.88 from pot
*** SUMMARY ***
Total pot $3 | Rake $0.12 
Board [5d 2h Qc 8h Jd]
Seat 1: HubertusB (button) folded before Flop (didn't bet)
Seat 2: asleysantos (small blind) folded on the Flop
Seat 3: nAzgulpl (big blind) folded on the Flop
Seat 4: Alexsny13 showed [Td Th] and lost with a pair of Tens
Seat 5: timchipking showed [Ad Ah] and won ($2.88) with a pair of Aces
Seat 6: Jovani_Silva folded before Flop (didn't bet)



PokerStars Zoom Hand #185660388903:  Hold'em No Limit ($0.02/$0.05) - 2018/04/25 23:54:51 CCT [2018/04/25 11:54:51 ET]
Table 'Donati' 6-max Seat #1 is the button
Seat 1: ezelpp ($5 in chips) 
Seat 2: chengyiche ($7.89 in chips) 
Seat 3: krezifrut ($5 in chips) 
Seat 4: HubertusB ($5.18 in chips) 
Seat 5: Dairyujin ($5.07 in chips) 
Seat 6: salamandryko ($5 in chips) 
chengyiche: posts small blind $0.02
krezifrut: posts big blind $0.05
*** HOLE CARDS ***
Dealt to HubertusB [Kh 6d]
HubertusB: folds 
Dairyujin: folds 
salamandryko: folds 
ezelpp: folds 
chengyiche: folds 
Uncalled bet ($0.03) returned to krezifrut
krezifrut collected $0.04 from pot
krezifrut: doesn't show hand 
*** SUMMARY ***
Total pot $0.04 | Rake $0 
Seat 1: ezelpp (button) folded before Flop (didn't bet)
Seat 2: chengyiche (small blind) folded before Flop
Seat 3: krezifrut (big blind) collected ($0.04)
Seat 4: HubertusB folded before Flop (didn't bet)
Seat 5: Dairyujin folded before Flop (didn't bet)
Seat 6: salamandryko folded before Flop (didn't bet)



PokerStars Zoom Hand #185660399708:  Hold'em No Limit ($0.02/$0.05) - 2018/04/25 23:55:11 CCT [2018/04/25 11:55:11 ET]
Table 'Donati' 6-max Seat #1 is the button
Seat 1: xiazhen ($5.62 in chips) 
Seat 2: HubertusB ($5.13 in chips) 
Seat 3: offuca ($9.30 in chips) 
Seat 4: pashqadk ($5.27 in chips) 
Seat 5: Glolight ($5.35 in chips) 
Seat 6: yurok_chess ($5.06 in chips) 
HubertusB: posts small blind $0.02
offuca: posts big blind $0.05
*** HOLE CARDS ***
Dealt to HubertusB [6d Jd]
pashqadk: folds 
Glolight: folds 
yurok_chess: folds 
xiazhen: folds 
HubertusB: folds 
Uncalled bet ($0.03) returned to offuca
offuca collected $0.04 from pot
offuca: doesn't show hand 
*** SUMMARY ***
Total pot $0.04 | Rake $0 
Seat 1: xiazhen (button) folded before Flop (didn't bet)
Seat 2: HubertusB (small blind) folded before Flop
Seat 3: offuca (big blind) collected ($0.04)
Seat 4: pashqadk folded before Flop (didn't bet)
Seat 5: Glolight folded before Flop (didn't bet)
Seat 6: yurok_chess folded before Flop (didn't bet)



PokerStars Zoom Hand #185660391794:  Hold'em No Limit ($0.02/$0.05) - 2018/04/25 23:54:56 CCT [2018/04/25 11:54:56 ET]
Table 'Donati' 6-max Seat #1 is the button
Seat 1: FoundingDadd ($5.04 in chips) 
Seat 2: fantazja8 ($10.15 in chips) 
Seat 3: HubertusB ($5.18 in chips) 
Seat 4: yatanasov ($7.79 in chips) 
Seat 5: SpaceOrca ($5.08 in chips) 
Seat 6: adyrnicc ($17.02 in chips) 
fantazja8: posts small blind $0.02
HubertusB: posts big blind $0.05
*** HOLE CARDS ***
Dealt to HubertusB [9d 8h]
yatanasov: raises $0.10 to $0.15
SpaceOrca: calls $0.15
adyrnicc: folds 
FoundingDadd: folds 
fantazja8: folds 
HubertusB: folds 
*** FLOP *** [6c Kd 4h]
yatanasov: bets $0.20
SpaceOrca: calls $0.20
*** TURN *** [6c Kd 4h] [As]
yatanasov: bets $0.20
SpaceOrca: folds 
Uncalled bet ($0.20) returned to yatanasov
yatanasov collected $0.74 from pot
yatanasov: doesn't show hand 
*** SUMMARY ***
Total pot $0.77 | Rake $0.03 
Board [6c Kd 4h As]
Seat 1: FoundingDadd (button) folded before Flop (didn't bet)
Seat 2: fantazja8 (small blind) folded before Flop
Seat 3: HubertusB (big blind) folded before Flop
Seat 4: yatanasov collected ($0.74)
Seat 5: SpaceOrca folded on the Turn
Seat 6: adyrnicc folded before Flop (didn't bet)



PokerStars Zoom Hand #185660402569:  Hold'em No Limit ($0.02/$0.05) - 2018/04/25 23:55:17 CCT [2018/04/25 11:55:17 ET]
Table 'Donati' 6-max Seat #1 is the button
Seat 1: jjtaro ($6.15 in chips) 
Seat 2: sapiosss1 ($11.98 in chips) 
Seat 3: vougiouks ($22.45 in chips) 
Seat 4: lucaskissler ($5.72 in chips) 
Seat 5: sdbhsfb ($10.12 in chips) 
Seat 6: HubertusB ($5.11 in chips) 
sapiosss1: posts small blind $0.02
vougiouks: posts big blind $0.05
*** HOLE CARDS ***
Dealt to HubertusB [Qh 4d]
lucaskissler: folds 
sdbhsfb: folds 
HubertusB: folds 
jjtaro: raises $0.10 to $0.15
sapiosss1: folds 
vougiouks: folds 
Uncalled bet ($0.10) returned to jjtaro
jjtaro collected $0.12 from pot
jjtaro: doesn't show hand 
*** SUMMARY ***
Total pot $0.12 | Rake $0 
Seat 1: jjtaro (button) collected ($0.12)
Seat 2: sapiosss1 (small blind) folded before Flop
Seat 3: vougiouks (big blind) folded before Flop
Seat 4: lucaskissler folded before Flop (didn't bet)
Seat 5: sdbhsfb folded before Flop (didn't bet)
Seat 6: HubertusB folded before Flop (didn't bet)



PokerStars Zoom Hand #185660396758:  Hold'em No Limit ($0.02/$0.05) - 2018/04/25 23:55:05 CCT [2018/04/25 11:55:05 ET]
Table 'Donati' 6-max Seat #1 is the button
Seat 1: RowTheDice ($6.89 in chips) 
Seat 2: FoundingDadd ($5 in chips) 
Seat 3: KingOgiii ($5.16 in chips) 
Seat 4: HubertusB ($5.13 in chips) 
Seat 5: Blackantz ($6.79 in chips) 
Seat 6: Glolight ($5.35 in chips) 
FoundingDadd: posts small blind $0.02
KingOgiii: posts big blind $0.05
*** HOLE CARDS ***
Dealt to HubertusB [Tc 7d]
HubertusB: folds 
Blackantz: folds 
Glolight: folds 
RowTheDice: raises $0.07 to $0.12
FoundingDadd: calls $0.10
KingOgiii: calls $0.07
*** FLOP *** [6d 7c Qd]
FoundingDadd: checks 
KingOgiii: checks 
RowTheDice: checks 
*** TURN *** [6d 7c Qd] [9d]
FoundingDadd: checks 
KingOgiii: checks 
RowTheDice: bets $0.22
FoundingDadd: folds 
KingOgiii: folds 
Uncalled bet ($0.22) returned to RowTheDice
RowTheDice collected $0.35 from pot
RowTheDice: doesn't show hand 
*** SUMMARY ***
Total pot $0.36 | Rake $0.01 
Board [6d 7c Qd 9d]
Seat 1: RowTheDice (button) collected ($0.35)
Seat 2: FoundingDadd (small blind) folded on the Turn
Seat 3: KingOgiii (big blind) folded on the Turn
Seat 4: HubertusB folded before Flop (didn't bet)
Seat 5: Blackantz folded before Flop (didn't bet)
Seat 6: Glolight folded before Flop (didn't bet)



PokerStars Zoom Hand #185660372106:  Hold'em No Limit ($0.02/$0.05) - 2018/04/25 23:54:22 CCT [2018/04/25 11:54:22 ET]
Table 'Donati' 6-max Seat #1 is the button
Seat 1: KingOgiii ($6.36 in chips) 
Seat 2: Dev1lAngel07 ($4.73 in chips) 
Seat 3: pettrowaa ($11.28 in chips) 
Seat 4: DjatlikN ($4.38 in chips) 
Seat 5: HubertusB ($5.28 in chips) 
Seat 6: tofsty ($8.99 in chips) 
Dev1lAngel07: posts small blind $0.02
pettrowaa: posts big blind $0.05
*** HOLE CARDS ***
Dealt to HubertusB [5d 9d]
DjatlikN: folds 
HubertusB: raises $0.05 to $0.10
tofsty: folds 
KingOgiii: folds 
Dev1lAngel07: calls $0.08
pettrowaa: calls $0.05
*** FLOP *** [Ac 5s Js]
Dev1lAngel07: bets $0.15
pettrowaa: calls $0.15
HubertusB: folds 
*** TURN *** [Ac 5s Js] [2d]
Dev1lAngel07: bets $0.29
pettrowaa: calls $0.29
*** RIVER *** [Ac 5s Js 2d] [2c]
Dev1lAngel07: bets $1.13
pettrowaa: calls $1.13
*** SHOW DOWN ***
Dev1lAngel07: shows [Kd 6s] (a pair of Deuces)
pettrowaa: shows [6c Ad] (two pair, Aces and Deuces)
pettrowaa collected $3.30 from pot
*** SUMMARY ***
Total pot $3.44 | Rake $0.14 
Board [Ac 5s Js 2d 2c]
Seat 1: KingOgiii (button) folded before Flop (didn't bet)
Seat 2: Dev1lAngel07 (small blind) showed [Kd 6s] and lost with a pair of Deuces
Seat 3: pettrowaa (big blind) showed [6c Ad] and won ($3.30) with two pair, Aces and Deuces
Seat 4: DjatlikN folded before Flop (didn't bet)
Seat 5: HubertusB folded on the Flop
Seat 6: tofsty folded before Flop (didn't bet)



PokerStars Zoom Hand #185660405500:  Hold'em No Limit ($0.02/$0.05) - 2018/04/25 23:55:23 CCT [2018/04/25 11:55:23 ET]
Table 'Donati' 6-max Seat #1 is the button
Seat 1: abyz777 ($3.33 in chips) 
Seat 2: chikimambone ($14.29 in chips) 
Seat 3: HubertusB ($5.11 in chips) 
Seat 4: maltrine ($5.02 in chips) 
Seat 5: DjatlikN ($5.30 in chips) 
Seat 6: face903 ($4.79 in chips) 
chikimambone: posts small blind $0.02
HubertusB: posts big blind $0.05
*** HOLE CARDS ***
Dealt to HubertusB [Jd 9c]
maltrine: folds 
DjatlikN: folds 
face903: folds 
abyz777: calls $0.05
chikimambone: calls $0.03
HubertusB: checks 
*** FLOP *** [8c 3s Qs]
chikimambone: checks 
HubertusB: checks 
abyz777: bets $0.05
chikimambone: folds 
HubertusB: calls $0.05
*** TURN *** [8c 3s Qs] [8h]
HubertusB: checks 
abyz777: bets $0.10
HubertusB: raises $0.20 to $0.30
abyz777: calls $0.20
*** RIVER *** [8c 3s Qs 8h] [Tc]
HubertusB: bets $0.60
abyz777: folds 
Uncalled bet ($0.60) returned to HubertusB
HubertusB collected $0.81 from pot
HubertusB: doesn't show hand 
*** SUMMARY ***
Total pot $0.85 | Rake $0.04 
Board [8c 3s Qs 8h Tc]
Seat 1: abyz777 (button) folded on the River
Seat 2: chikimambone (small blind) folded on the Flop
Seat 3: HubertusB (big blind) collected ($0.81)
Seat 4: maltrine folded before Flop (didn't bet)
Seat 5: DjatlikN folded before Flop (didn't bet)
Seat 6: face903 folded before Flop (didn't bet)



PokerStars Zoom Hand #185660434435:  Hold'em No Limit ($0.02/$0.05) - 2018/04/25 23:56:22 CCT [2018/04/25 11:56:22 ET]
Table 'Donati' 6-max Seat #1 is the button
Seat 1: infitoha ($5.07 in chips) 
Seat 2: HubertusB ($5.52 in chips) 
Seat 3: BigBadPalm ($5.07 in chips) 
Seat 4: Draugsvoll ($5.67 in chips) 
Seat 5: Chippzin ($6.96 in chips) 
Seat 6: SNIPE_nt ($7.45 in chips) 
HubertusB: posts small blind $0.02
BigBadPalm: posts big blind $0.05
*** HOLE CARDS ***
Dealt to HubertusB [4d 7s]
Draugsvoll: folds 
Chippzin: folds 
SNIPE_nt: raises $0.10 to $0.15
infitoha: folds 
HubertusB: folds 
BigBadPalm: folds 
Uncalled bet ($0.10) returned to SNIPE_nt
SNIPE_nt collected $0.12 from pot
SNIPE_nt: doesn't show hand 
*** SUMMARY ***
Total pot $0.12 | Rake $0 
Seat 1: infitoha (button) folded before Flop (didn't bet)
Seat 2: HubertusB (small blind) folded before Flop
Seat 3: BigBadPalm (big blind) folded before Flop
Seat 4: Draugsvoll folded before Flop (didn't bet)
Seat 5: Chippzin folded before Flop (didn't bet)
Seat 6: SNIPE_nt collected ($0.12)



PokerStars Zoom Hand #185660439369:  Hold'em No Limit ($0.02/$0.05) - 2018/04/25 23:56:32 CCT [2018/04/25 11:56:32 ET]
Table 'Donati' 6-max Seat #1 is the button
Seat 1: HubertusB ($5.50 in chips) 
Seat 2: ellet123 ($8.27 in chips) 
Seat 3: BigBadPalm ($5 in chips) 
Seat 4: Alexsny13 ($5.72 in chips) 
Seat 5: ImpalerPoker ($5 in chips) 
Seat 6: YoshimotoxD ($8.41 in chips) 
ellet123: posts small blind $0.02
BigBadPalm: posts big blind $0.05
*** HOLE CARDS ***
Dealt to HubertusB [Jd Th]
Alexsny13: folds 
ImpalerPoker: raises $0.10 to $0.15
YoshimotoxD: folds 
HubertusB: calls $0.15
ellet123: folds 
BigBadPalm: folds 
*** FLOP *** [2s 2c Qd]
ImpalerPoker: bets $0.12
HubertusB: calls $0.12
*** TURN *** [2s 2c Qd] [Ks]
ImpalerPoker: bets $0.35
HubertusB: folds 
Uncalled bet ($0.35) returned to ImpalerPoker
ImpalerPoker collected $0.58 from pot
ImpalerPoker: doesn't show hand 
*** SUMMARY ***
Total pot $0.61 | Rake $0.03 
Board [2s 2c Qd Ks]
Seat 1: HubertusB (button) folded on the Turn
Seat 2: ellet123 (small blind) folded before Flop
Seat 3: BigBadPalm (big blind) folded before Flop
Seat 4: Alexsny13 folded before Flop (didn't bet)
Seat 5: ImpalerPoker collected ($0.58)
Seat 6: YoshimotoxD folded before Flop (didn't bet)



PokerStars Zoom Hand #185660453484:  Hold'em No Limit ($0.02/$0.05) - 2018/04/25 23:57:01 CCT [2018/04/25 11:57:01 ET]
Table 'Donati' 6-max Seat #1 is the button
Seat 1: Mr.Zhuxx ($6.08 in chips) 
Seat 2: soreron16 ($3.30 in chips) 
Seat 3: Svetlaya737 ($3.96 in chips) 
Seat 4: russland415 ($10.59 in chips) 
Seat 5: abyz777 ($2.78 in chips) 
Seat 6: HubertusB ($5.23 in chips) 
soreron16: posts small blind $0.02
Svetlaya737: posts big blind $0.05
*** HOLE CARDS ***
Dealt to HubertusB [Js Qh]
russland415: folds 
abyz777: folds 
HubertusB: raises $0.10 to $0.15
Mr.Zhuxx: folds 
soreron16: folds 
Svetlaya737: calls $0.10
*** FLOP *** [Ah 4s Qc]
Svetlaya737: bets $0.10
HubertusB: calls $0.10
*** TURN *** [Ah 4s Qc] [Ts]
Svetlaya737: bets $0.05
HubertusB: calls $0.05
*** RIVER *** [Ah 4s Qc Ts] [6d]
Svetlaya737: bets $0.05
HubertusB: calls $0.05
*** SHOW DOWN ***
Svetlaya737: shows [Ks Qd] (a pair of Queens)
HubertusB: mucks hand 
Svetlaya737 collected $0.69 from pot
*** SUMMARY ***
Total pot $0.72 | Rake $0.03 
Board [Ah 4s Qc Ts 6d]
Seat 1: Mr.Zhuxx (button) folded before Flop (didn't bet)
Seat 2: soreron16 (small blind) folded before Flop
Seat 3: Svetlaya737 (big blind) showed [Ks Qd] and won ($0.69) with a pair of Queens
Seat 4: russland415 folded before Flop (didn't bet)
Seat 5: abyz777 folded before Flop (didn't bet)
Seat 6: HubertusB mucked [Js Qh]



PokerStars Zoom Hand #185660477542:  Hold'em No Limit ($0.02/$0.05) - 2018/04/25 23:57:50 CCT [2018/04/25 11:57:50 ET]
Table 'Donati' 6-max Seat #1 is the button
Seat 1: Draugsvoll ($5.50 in chips) 
Seat 2: KingMax14 ($2.25 in chips) 
Seat 3: Glolight ($5.50 in chips) 
Seat 4: pianobeast ($5.63 in chips) 
Seat 5: HubertusB ($4.88 in chips) 
Seat 6: alex2-a.a ($3.81 in chips) 
KingMax14: posts small blind $0.02
Glolight: posts big blind $0.05
*** HOLE CARDS ***
Dealt to HubertusB [Qs Ks]
pianobeast: folds 
HubertusB: raises $0.05 to $0.10
alex2-a.a: folds 
Draugsvoll: folds 
KingMax14: raises $0.25 to $0.35
Glolight: folds 
HubertusB: calls $0.25
*** FLOP *** [Qd 9d 6d]
KingMax14: bets $0.25
HubertusB: raises $0.25 to $0.50
KingMax14: raises $1.40 to $1.90 and is all-in
HubertusB: calls $1.40
*** TURN *** [Qd 9d 6d] [8s]
*** RIVER *** [Qd 9d 6d 8s] [2s]
*** SHOW DOWN ***
KingMax14: shows [Jd Jh] (a pair of Jacks)
HubertusB: shows [Qs Ks] (a pair of Queens)
HubertusB collected $4.36 from pot
*** SUMMARY ***
Total pot $4.55 | Rake $0.19 
Board [Qd 9d 6d 8s 2s]
Seat 1: Draugsvoll (button) folded before Flop (didn't bet)
Seat 2: KingMax14 (small blind) showed [Jd Jh] and lost with a pair of Jacks
Seat 3: Glolight (big blind) folded before Flop
Seat 4: pianobeast folded before Flop (didn't bet)
Seat 5: HubertusB showed [Qs Ks] and won ($4.36) with a pair of Queens
Seat 6: alex2-a.a folded before Flop (didn't bet)



PokerStars Zoom Hand #185660512814:  Hold'em No Limit ($0.02/$0.05) - 2018/04/25 23:59:02 CCT [2018/04/25 11:59:02 ET]
Table 'Donati' 6-max Seat #1 is the button
Seat 1: DjatlikN ($9.90 in chips) 
Seat 2: HubertusB ($6.99 in chips) 
Seat 3: JoSavard 07 ($5.43 in chips) 
Seat 4: Boba1888 ($3.98 in chips) 
Seat 5: mcmeku ($5.96 in chips) 
Seat 6: naimscorp ($5.51 in chips) 
HubertusB: posts small blind $0.02
JoSavard 07: posts big blind $0.05
*** HOLE CARDS ***
Dealt to HubertusB [3c Tc]
Boba1888: folds 
mcmeku: folds 
naimscorp: folds 
DjatlikN: folds 
HubertusB: folds 
Uncalled bet ($0.03) returned to JoSavard 07
JoSavard 07 collected $0.04 from pot
JoSavard 07: doesn't show hand 
*** SUMMARY ***
Total pot $0.04 | Rake $0 
Seat 1: DjatlikN (button) folded before Flop (didn't bet)
Seat 2: HubertusB (small blind) folded before Flop
Seat 3: JoSavard 07 (big blind) collected ($0.04)
Seat 4: Boba1888 folded before Flop (didn't bet)
Seat 5: mcmeku folded before Flop (didn't bet)
Seat 6: naimscorp folded before Flop (didn't bet)



PokerStars Zoom Hand #185660507420:  Hold'em No Limit ($0.02/$0.05) - 2018/04/25 23:58:51 CCT [2018/04/25 11:58:51 ET]
Table 'Donati' 6-max Seat #1 is the button
Seat 1: HubertusB ($6.99 in chips) 
Seat 2: BigBadPalm ($5 in chips) 
Seat 3: c0nscience ($5.11 in chips) 
Seat 4: chengyiche ($7.28 in chips) 
Seat 5: Lady Tanee ($6.73 in chips) 
Seat 6: Draugsvoll ($5.08 in chips) 
BigBadPalm: posts small blind $0.02
c0nscience: posts big blind $0.05
*** HOLE CARDS ***
Dealt to HubertusB [Jc 2s]
chengyiche: folds 
Lady Tanee: folds 
Draugsvoll: folds 
HubertusB: folds 
BigBadPalm: calls $0.03
c0nscience: checks 
*** FLOP *** [Ac 7c Tc]
BigBadPalm: bets $0.06
c0nscience: calls $0.06
*** TURN *** [Ac 7c Tc] [5d]
BigBadPalm: checks 
c0nscience: bets $0.09
BigBadPalm: folds 
Uncalled bet ($0.09) returned to c0nscience
c0nscience collected $0.21 from pot
c0nscience: doesn't show hand 
*** SUMMARY ***
Total pot $0.22 | Rake $0.01 
Board [Ac 7c Tc 5d]
Seat 1: HubertusB (button) folded before Flop (didn't bet)
Seat 2: BigBadPalm (small blind) folded on the Turn
Seat 3: c0nscience (big blind) collected ($0.21)
Seat 4: chengyiche folded before Flop (didn't bet)
Seat 5: Lady Tanee folded before Flop (didn't bet)
Seat 6: Draugsvoll folded before Flop (didn't bet)



PokerStars Zoom Hand #185660516254:  Hold'em No Limit ($0.02/$0.05) - 2018/04/25 23:59:09 CCT [2018/04/25 11:59:09 ET]
Table 'Donati' 6-max Seat #1 is the button
Seat 1: HotToxin ($8.13 in chips) 
Seat 2: here-ftw-AA ($9.92 in chips) 
Seat 3: HubertusB ($6.97 in chips) 
Seat 4: someep1ck ($6.61 in chips) 
Seat 5: holdmybreath ($5.03 in chips) 
Seat 6: maniek160593 ($6.39 in chips) 
here-ftw-AA: posts small blind $0.02
HubertusB: posts big blind $0.05
*** HOLE CARDS ***
Dealt to HubertusB [Qs 7d]
someep1ck: folds 
holdmybreath: folds 
maniek160593: folds 
HotToxin: folds 
here-ftw-AA: calls $0.03
HubertusB: checks 
*** FLOP *** [Ts 6h 4d]
here-ftw-AA: checks 
HubertusB: checks 
*** TURN *** [Ts 6h 4d] [7s]
here-ftw-AA: bets $0.07
HubertusB: calls $0.07
*** RIVER *** [Ts 6h 4d 7s] [8d]
here-ftw-AA: checks 
HubertusB: checks 
*** SHOW DOWN ***
here-ftw-AA: shows [7c Qc] (a pair of Sevens)
HubertusB: shows [Qs 7d] (a pair of Sevens)
here-ftw-AA collected $0.12 from pot
HubertusB collected $0.11 from pot
*** SUMMARY ***
Total pot $0.24 | Rake $0.01 
Board [Ts 6h 4d 7s 8d]
Seat 1: HotToxin (button) folded before Flop (didn't bet)
Seat 2: here-ftw-AA (small blind) showed [7c Qc] and won ($0.12) with a pair of Sevens
Seat 3: HubertusB (big blind) showed [Qs 7d] and won ($0.11) with a pair of Sevens
Seat 4: someep1ck folded before Flop (didn't bet)
Seat 5: holdmybreath folded before Flop (didn't bet)
Seat 6: maniek160593 folded before Flop (didn't bet)



PokerStars Zoom Hand #185660535010:  Hold'em No Limit ($0.02/$0.05) - 2018/04/25 23:59:47 CCT [2018/04/25 11:59:47 ET]
Table 'Donati' 6-max Seat #1 is the button
Seat 1: ellvis82 ($5 in chips) 
Seat 2: 74west74 ($3.85 in chips) 
Seat 3: zhdam9 ($7.50 in chips) 
Seat 4: pashqadk ($5 in chips) 
Seat 5: HubertusB ($6.96 in chips) 
Seat 6: NeverFold27o ($16.45 in chips) 
74west74: posts small blind $0.02
zhdam9: posts big blind $0.05
*** HOLE CARDS ***
Dealt to HubertusB [6h 7s]
pashqadk: folds 
HubertusB: folds 
NeverFold27o: folds 
ellvis82: folds 
74west74: folds 
Uncalled bet ($0.03) returned to zhdam9
zhdam9 collected $0.04 from pot
zhdam9: doesn't show hand 
*** SUMMARY ***
Total pot $0.04 | Rake $0 
Seat 1: ellvis82 (button) folded before Flop (didn't bet)
Seat 2: 74west74 (small blind) folded before Flop
Seat 3: zhdam9 (big blind) collected ($0.04)
Seat 4: pashqadk folded before Flop (didn't bet)
Seat 5: HubertusB folded before Flop (didn't bet)
Seat 6: NeverFold27o folded before Flop (didn't bet)



PokerStars Zoom Hand #185660537945:  Hold'em No Limit ($0.02/$0.05) - 2018/04/25 23:59:53 CCT [2018/04/25 11:59:53 ET]
Table 'Donati' 6-max Seat #1 is the button
Seat 1: Maximus122 ($5 in chips) 
Seat 2: russland415 ($10.57 in chips) 
Seat 3: DuggieD ($5.85 in chips) 
Seat 4: HubertusB ($6.96 in chips) 
Seat 5: SNIPE_nt ($6.94 in chips) 
Seat 6: ellvis82 ($5 in chips) 
russland415: posts small blind $0.02
DuggieD: posts big blind $0.05
*** HOLE CARDS ***
Dealt to HubertusB [6d Ts]
HubertusB: folds 
SNIPE_nt: folds 
ellvis82: folds 
Maximus122: folds 
russland415: raises $0.08 to $0.13
DuggieD: folds 
Uncalled bet ($0.08) returned to russland415
russland415 collected $0.10 from pot
russland415: doesn't show hand 
*** SUMMARY ***
Total pot $0.10 | Rake $0 
Seat 1: Maximus122 (button) folded before Flop (didn't bet)
Seat 2: russland415 (small blind) collected ($0.10)
Seat 3: DuggieD (big blind) folded before Flop
Seat 4: HubertusB folded before Flop (didn't bet)
Seat 5: SNIPE_nt folded before Flop (didn't bet)
Seat 6: ellvis82 folded before Flop (didn't bet)



PokerStars Zoom Hand #185660540976:  Hold'em No Limit ($0.02/$0.05) - 2018/04/25 23:59:59 CCT [2018/04/25 11:59:59 ET]
Table 'Donati' 6-max Seat #1 is the button
Seat 1: KingMax14 ($2.59 in chips) 
Seat 2: M0rfar ($2.50 in chips) 
Seat 3: spIeeNy ($5 in chips) 
Seat 4: kss.gold ($3.91 in chips) 
Seat 5: NakashimaStr ($8.05 in chips) 
Seat 6: HubertusB ($6.96 in chips) 
M0rfar: posts small blind $0.02
spIeeNy: posts big blind $0.05
*** HOLE CARDS ***
Dealt to HubertusB [4s 3d]
kss.gold: raises $0.05 to $0.10
NakashimaStr: folds 
HubertusB: folds 
KingMax14: folds 
M0rfar: raises $0.25 to $0.35
spIeeNy: folds 
kss.gold: calls $0.25
*** FLOP *** [Ah 6d Qc]
M0rfar: bets $0.30
kss.gold: folds 
Uncalled bet ($0.30) returned to M0rfar
M0rfar collected $0.72 from pot
M0rfar: doesn't show hand 
*** SUMMARY ***
Total pot $0.75 | Rake $0.03 
Board [Ah 6d Qc]
Seat 1: KingMax14 (button) folded before Flop (didn't bet)
Seat 2: M0rfar (small blind) collected ($0.72)
Seat 3: spIeeNy (big blind) folded before Flop
Seat 4: kss.gold folded on the Flop
Seat 5: NakashimaStr folded before Flop (didn't bet)
Seat 6: HubertusB folded before Flop (didn't bet)



PokerStars Zoom Hand #185660543985:  Hold'em No Limit ($0.02/$0.05) - 2018/04/26 0:00:05 CCT [2018/04/25 12:00:05 ET]
Table 'Donati' 6-max Seat #1 is the button
Seat 1: salav.udinov ($2.47 in chips) 
Seat 2: jjtaro ($6.49 in chips) 
Seat 3: HubertusB ($6.96 in chips) 
Seat 4: tsegmid farseer ($1.39 in chips) 
Seat 5: necko12 ($3.76 in chips) 
Seat 6: jason1703 ($4.10 in chips) 
jjtaro: posts small blind $0.02
HubertusB: posts big blind $0.05
*** HOLE CARDS ***
Dealt to HubertusB [6c Jh]
tsegmid farseer: calls $0.05
necko12: folds 
jason1703: calls $0.05
salav.udinov: calls $0.05
jjtaro: calls $0.03
HubertusB: checks 
*** FLOP *** [3d Js Ts]
jjtaro: checks 
HubertusB: bets $0.10
tsegmid farseer: folds 
jason1703: calls $0.10
salav.udinov: folds 
jjtaro: folds 
*** TURN *** [3d Js Ts] [8h]
HubertusB: bets $0.20
jason1703: calls $0.20
*** RIVER *** [3d Js Ts 8h] [Qh]
HubertusB: checks 
jason1703: bets $0.50
HubertusB: folds 
Uncalled bet ($0.50) returned to jason1703
jason1703 collected $0.81 from pot
jason1703: doesn't show hand 
*** SUMMARY ***
Total pot $0.85 | Rake $0.04 
Board [3d Js Ts 8h Qh]
Seat 1: salav.udinov (button) folded on the Flop
Seat 2: jjtaro (small blind) folded on the Flop
Seat 3: HubertusB (big blind) folded on the River
Seat 4: tsegmid farseer folded on the Flop
Seat 5: necko12 folded before Flop (didn't bet)
Seat 6: jason1703 collected ($0.81)



PokerStars Zoom Hand #185660567924:  Hold'em No Limit ($0.02/$0.05) - 2018/04/26 0:00:51 CCT [2018/04/25 12:00:51 ET]
Table 'Donati' 6-max Seat #1 is the button
Seat 1: Dariev ($9.35 in chips) 
Seat 2: Kanárek01 ($9.75 in chips) 
Seat 3: Xodrobalubas ($5.84 in chips) 
Seat 4: simonsand999 ($5.25 in chips) 
Seat 5: HubertusB ($6.61 in chips) 
Seat 6: Vedyschiy_ ($8.24 in chips) 
Kanárek01: posts small blind $0.02
Xodrobalubas: posts big blind $0.05
*** HOLE CARDS ***
Dealt to HubertusB [Kh Ac]
simonsand999: folds 
HubertusB: raises $0.10 to $0.15
Vedyschiy_: folds 
Dariev: folds 
Kanárek01: calls $0.13
Xodrobalubas: folds 
*** FLOP *** [Qh Th 2s]
Kanárek01: checks 
HubertusB: bets $0.20
Kanárek01: folds 
Uncalled bet ($0.20) returned to HubertusB
HubertusB collected $0.34 from pot
HubertusB: doesn't show hand 
*** SUMMARY ***
Total pot $0.35 | Rake $0.01 
Board [Qh Th 2s]
Seat 1: Dariev (button) folded before Flop (didn't bet)
Seat 2: Kanárek01 (small blind) folded on the Flop
Seat 3: Xodrobalubas (big blind) folded before Flop
Seat 4: simonsand999 folded before Flop (didn't bet)
Seat 5: HubertusB collected ($0.34)
Seat 6: Vedyschiy_ folded before Flop (didn't bet)



PokerStars Zoom Hand #185660588892:  Hold'em No Limit ($0.02/$0.05) - 2018/04/26 0:01:29 CCT [2018/04/25 12:01:29 ET]
Table 'Donati' 6-max Seat #1 is the button
Seat 1: HubertusB ($6.78 in chips) 
Seat 2: DK1004 ($5.09 in chips) 
Seat 3: steven_stans ($12 in chips) 
Seat 4: lucaskissler ($5.79 in chips) 
Seat 5: Ka4ibuk@ ($5.12 in chips) 
Seat 6: Ddenis85 ($2.09 in chips) 
DK1004: posts small blind $0.02
steven_stans: posts big blind $0.05
*** HOLE CARDS ***
Dealt to HubertusB [7h 8h]
lucaskissler: folds 
Ka4ibuk@: folds 
Ddenis85: folds 
HubertusB: raises $0.05 to $0.10
DK1004: folds 
steven_stans: folds 
Uncalled bet ($0.05) returned to HubertusB
HubertusB collected $0.12 from pot
HubertusB: doesn't show hand 
*** SUMMARY ***
Total pot $0.12 | Rake $0 
Seat 1: HubertusB (button) collected ($0.12)
Seat 2: DK1004 (small blind) folded before Flop
Seat 3: steven_stans (big blind) folded before Flop
Seat 4: lucaskissler folded before Flop (didn't bet)
Seat 5: Ka4ibuk@ folded before Flop (didn't bet)
Seat 6: Ddenis85 folded before Flop (didn't bet)



PokerStars Zoom Hand #185660586070:  Hold'em No Limit ($0.02/$0.05) - 2018/04/26 0:01:24 CCT [2018/04/25 12:01:24 ET]
Table 'Donati' 6-max Seat #1 is the button
Seat 1: cu55lo ($4.80 in chips) 
Seat 2: HubertusB ($6.80 in chips) 
Seat 3: VVinner19 ($5.93 in chips) 
Seat 4: Yrgen500 ($9.28 in chips) 
Seat 5: Alexsny13 ($5.73 in chips) 
Seat 6: J.A.S.W.45 ($11.25 in chips) 
HubertusB: posts small blind $0.02
VVinner19: posts big blind $0.05
*** HOLE CARDS ***
Dealt to HubertusB [Tc 5h]
Yrgen500: folds 
Alexsny13: folds 
J.A.S.W.45: calls $0.05
cu55lo: folds 
HubertusB: folds 
VVinner19: checks 
*** FLOP *** [4s 3s 3h]
VVinner19: checks 
J.A.S.W.45: checks 
*** TURN *** [4s 3s 3h] [8s]
VVinner19: checks 
J.A.S.W.45: bets $0.09
VVinner19: folds 
Uncalled bet ($0.09) returned to J.A.S.W.45
J.A.S.W.45 collected $0.12 from pot
J.A.S.W.45: doesn't show hand 
*** SUMMARY ***
Total pot $0.12 | Rake $0 
Board [4s 3s 3h 8s]
Seat 1: cu55lo (button) folded before Flop (didn't bet)
Seat 2: HubertusB (small blind) folded before Flop
Seat 3: VVinner19 (big blind) folded on the Turn
Seat 4: Yrgen500 folded before Flop (didn't bet)
Seat 5: Alexsny13 folded before Flop (didn't bet)
Seat 6: J.A.S.W.45 collected ($0.12)



PokerStars Zoom Hand #185660597131:  Hold'em No Limit ($0.02/$0.05) - 2018/04/26 0:01:44 CCT [2018/04/25 12:01:44 ET]
Table 'Donati' 6-max Seat #1 is the button
Seat 1: MssMar23 ($2.55 in chips) 
Seat 2: krezifrut ($5.02 in chips) 
Seat 3: mmelo4 ($6.60 in chips) 
Seat 4: OfCouRse72 ($8.93 in chips) 
Seat 5: BOHEMIAN8849 ($5.34 in chips) 
Seat 6: HubertusB ($6.85 in chips) 
krezifrut: posts small blind $0.02
mmelo4: posts big blind $0.05
*** HOLE CARDS ***
Dealt to HubertusB [8d Ad]
OfCouRse72: folds 
BOHEMIAN8849: folds 
HubertusB: raises $0.05 to $0.10
MssMar23: calls $0.10
krezifrut: folds 
mmelo4: folds 
*** FLOP *** [4d 9s Ts]
HubertusB: checks 
MssMar23: checks 
*** TURN *** [4d 9s Ts] [Jd]
HubertusB: checks 
MssMar23: bets $0.15
HubertusB: calls $0.15
*** RIVER *** [4d 9s Ts Jd] [4c]
HubertusB: checks 
MssMar23: checks 
*** SHOW DOWN ***
HubertusB: shows [8d Ad] (a pair of Fours)
MssMar23: mucks hand 
HubertusB collected $0.55 from pot
*** SUMMARY ***
Total pot $0.57 | Rake $0.02 
Board [4d 9s Ts Jd 4c]
Seat 1: MssMar23 (button) mucked [3h Kh]
Seat 2: krezifrut (small blind) folded before Flop
Seat 3: mmelo4 (big blind) folded before Flop
Seat 4: OfCouRse72 folded before Flop (didn't bet)
Seat 5: BOHEMIAN8849 folded before Flop (didn't bet)
Seat 6: HubertusB showed [8d Ad] and won ($0.55) with a pair of Fours



PokerStars Zoom Hand #185660621382:  Hold'em No Limit ($0.02/$0.05) - 2018/04/26 0:02:27 CCT [2018/04/25 12:02:27 ET]
Table 'Donati' 6-max Seat #1 is the button
Seat 1: mcmeku ($6.54 in chips) 
Seat 2: fantazja8 ($14.91 in chips) 
Seat 3: UruGabo ($6.67 in chips) 
Seat 4: HubertusB ($7.15 in chips) 
Seat 5: onebearl4 ($5.36 in chips) 
Seat 6: limity ($7.99 in chips) 
fantazja8: posts small blind $0.02
UruGabo: posts big blind $0.05
*** HOLE CARDS ***
Dealt to HubertusB [8d Jd]
HubertusB: raises $0.05 to $0.10
onebearl4: folds 
limity: folds 
mcmeku: folds 
fantazja8: folds 
UruGabo: folds 
Uncalled bet ($0.05) returned to HubertusB
HubertusB collected $0.12 from pot
HubertusB: doesn't show hand 
*** SUMMARY ***
Total pot $0.12 | Rake $0 
Seat 1: mcmeku (button) folded before Flop (didn't bet)
Seat 2: fantazja8 (small blind) folded before Flop
Seat 3: UruGabo (big blind) folded before Flop
Seat 4: HubertusB collected ($0.12)
Seat 5: onebearl4 folded before Flop (didn't bet)
Seat 6: limity folded before Flop (didn't bet)



PokerStars Zoom Hand #185660629827:  Hold'em No Limit ($0.02/$0.05) - 2018/04/26 0:02:42 CCT [2018/04/25 12:02:42 ET]
Table 'Donati' 6-max Seat #1 is the button
Seat 1: HubertusB ($7.22 in chips) 
Seat 2: actionMoon ($5.32 in chips) 
Seat 3: Tom_FRG ($5.14 in chips) 
Seat 4: xaris5555 ($6.13 in chips) 
Seat 5: offuca ($9.88 in chips) 
Seat 6: poongdeng ($5.85 in chips) 
actionMoon: posts small blind $0.02
Tom_FRG: posts big blind $0.05
*** HOLE CARDS ***
Dealt to HubertusB [4d 7c]
xaris5555: folds 
offuca: folds 
poongdeng: folds 
HubertusB: folds 
actionMoon: folds 
Uncalled bet ($0.03) returned to Tom_FRG
Tom_FRG collected $0.04 from pot
Tom_FRG: doesn't show hand 
*** SUMMARY ***
Total pot $0.04 | Rake $0 
Seat 1: HubertusB (button) folded before Flop (didn't bet)
Seat 2: actionMoon (small blind) folded before Flop
Seat 3: Tom_FRG (big blind) collected ($0.04)
Seat 4: xaris5555 folded before Flop (didn't bet)
Seat 5: offuca folded before Flop (didn't bet)
Seat 6: poongdeng folded before Flop (didn't bet)



PokerStars Zoom Hand #185660633308:  Hold'em No Limit ($0.02/$0.05) - 2018/04/26 0:02:49 CCT [2018/04/25 12:02:49 ET]
Table 'Donati' 6-max Seat #1 is the button
Seat 1: Dariev ($5 in chips) 
Seat 2: chikimambone ($14.36 in chips) 
Seat 3: TOMOGOCHI ($22.82 in chips) 
Seat 4: HubertusB ($7.22 in chips) 
Seat 5: 199920041813 ($10.24 in chips) 
Seat 6: Rodadaganha ($1.35 in chips) 
chikimambone: posts small blind $0.02
TOMOGOCHI: posts big blind $0.05
*** HOLE CARDS ***
Dealt to HubertusB [6c Ah]
HubertusB: folds 
199920041813: raises $0.10 to $0.15
Rodadaganha: folds 
Dariev: folds 
chikimambone: folds 
TOMOGOCHI: folds 
Uncalled bet ($0.10) returned to 199920041813
199920041813 collected $0.12 from pot
199920041813: doesn't show hand 
*** SUMMARY ***
Total pot $0.12 | Rake $0 
Seat 1: Dariev (button) folded before Flop (didn't bet)
Seat 2: chikimambone (small blind) folded before Flop
Seat 3: TOMOGOCHI (big blind) folded before Flop
Seat 4: HubertusB folded before Flop (didn't bet)
Seat 5: 199920041813 collected ($0.12)
Seat 6: Rodadaganha folded before Flop (didn't bet)



PokerStars Zoom Hand #185660637367:  Hold'em No Limit ($0.02/$0.05) - 2018/04/26 0:02:55 CCT [2018/04/25 12:02:55 ET]
Table 'Donati' 6-max Seat #1 is the button
Seat 1: offuca ($9.88 in chips) 
Seat 2: Xodrobalubas ($7.44 in chips) 
Seat 3: HubertusB ($7.22 in chips) 
Seat 4: paxquack ($11.47 in chips) 
Seat 5: BigBadPalm ($5.05 in chips) 
Seat 6: Sun-Green ($5.44 in chips) 
Xodrobalubas: posts small blind $0.02
HubertusB: posts big blind $0.05
*** HOLE CARDS ***
Dealt to HubertusB [7s Tc]
paxquack: raises $0.09 to $0.14
BigBadPalm: folds 
Sun-Green: folds 
offuca: folds 
Xodrobalubas: folds 
HubertusB: folds 
Uncalled bet ($0.09) returned to paxquack
paxquack collected $0.12 from pot
paxquack: doesn't show hand 
*** SUMMARY ***
Total pot $0.12 | Rake $0 
Seat 1: offuca (button) folded before Flop (didn't bet)
Seat 2: Xodrobalubas (small blind) folded before Flop
Seat 3: HubertusB (big blind) folded before Flop
Seat 4: paxquack collected ($0.12)
Seat 5: BigBadPalm folded before Flop (didn't bet)
Seat 6: Sun-Green folded before Flop (didn't bet)



PokerStars Zoom Hand #185660642474:  Hold'em No Limit ($0.02/$0.05) - 2018/04/26 0:03:04 CCT [2018/04/25 12:03:04 ET]
Table 'Donati' 6-max Seat #1 is the button
Seat 1: shen112 ($2.90 in chips) 
Seat 2: HubertusB ($7.17 in chips) 
Seat 3: MarsVBR ($5.69 in chips) 
Seat 4: Willi1604 ($6.81 in chips) 
Seat 5: Amaris99 ($6.55 in chips) 
Seat 6: Lolczyk92 ($5.47 in chips) 
HubertusB: posts small blind $0.02
MarsVBR: posts big blind $0.05
*** HOLE CARDS ***
Dealt to HubertusB [Td 6c]
Willi1604: folds 
Amaris99: folds 
Lolczyk92: folds 
shen112: folds 
HubertusB: folds 
Uncalled bet ($0.03) returned to MarsVBR
MarsVBR collected $0.04 from pot
MarsVBR: doesn't show hand 
*** SUMMARY ***
Total pot $0.04 | Rake $0 
Seat 1: shen112 (button) folded before Flop (didn't bet)
Seat 2: HubertusB (small blind) folded before Flop
Seat 3: MarsVBR (big blind) collected ($0.04)
Seat 4: Willi1604 folded before Flop (didn't bet)
Seat 5: Amaris99 folded before Flop (didn't bet)
Seat 6: Lolczyk92 folded before Flop (didn't bet)



PokerStars Zoom Hand #185660646271:  Hold'em No Limit ($0.02/$0.05) - 2018/04/26 0:03:10 CCT [2018/04/25 12:03:10 ET]
Table 'Donati' 6-max Seat #1 is the button
Seat 1: HubertusB ($7.15 in chips) 
Seat 2: alexkit13 ($5.02 in chips) 
Seat 3: russland415 ($10.76 in chips) 
Seat 4: BrianLodi ($1.17 in chips) 
Seat 5: sashsa90 ($2.38 in chips) 
Seat 6: Rapstar86 ($4.56 in chips) 
alexkit13: posts small blind $0.02
russland415: posts big blind $0.05
*** HOLE CARDS ***
Dealt to HubertusB [3s 4s]
BrianLodi: folds 
sashsa90: raises $0.05 to $0.10
Rapstar86: calls $0.10
HubertusB: raises $0.45 to $0.55
alexkit13: folds 
russland415: folds 
sashsa90: calls $0.45
Rapstar86: calls $0.45
*** FLOP *** [4h 4d 6h]
sashsa90: checks 
Rapstar86: checks 
HubertusB: bets $0.91
sashsa90: folds 
Rapstar86: folds 
Uncalled bet ($0.91) returned to HubertusB
HubertusB collected $1.65 from pot
HubertusB: doesn't show hand 
*** SUMMARY ***
Total pot $1.72 | Rake $0.07 
Board [4h 4d 6h]
Seat 1: HubertusB (button) collected ($1.65)
Seat 2: alexkit13 (small blind) folded before Flop
Seat 3: russland415 (big blind) folded before Flop
Seat 4: BrianLodi folded before Flop (didn't bet)
Seat 5: sashsa90 folded on the Flop
Seat 6: Rapstar86 folded on the Flop



PokerStars Zoom Hand #185660671970:  Hold'em No Limit ($0.02/$0.05) - 2018/04/26 0:03:55 CCT [2018/04/25 12:03:55 ET]
Table 'Donati' 6-max Seat #1 is the button
Seat 1: VOOOR666 ($6.54 in chips) 
Seat 2: limity ($10.36 in chips) 
Seat 3: Jovani_Silva ($5.22 in chips) 
Seat 4: mozart97 ($4.38 in chips) 
Seat 5: HubertusB ($8.25 in chips) 
Seat 6: Maximus122 ($7.40 in chips) 
limity: posts small blind $0.02
Jovani_Silva: posts big blind $0.05
*** HOLE CARDS ***
Dealt to HubertusB [As Ts]
mozart97: folds 
HubertusB: raises $0.10 to $0.15
Maximus122: raises $0.30 to $0.45
VOOOR666: folds 
limity: folds 
Jovani_Silva: folds 
HubertusB: calls $0.30
*** FLOP *** [7h 5h 8c]
HubertusB: checks 
Maximus122: checks 
*** TURN *** [7h 5h 8c] [Kh]
HubertusB: bets $0.40
Maximus122: folds 
Uncalled bet ($0.40) returned to HubertusB
HubertusB collected $0.93 from pot
HubertusB: doesn't show hand 
*** SUMMARY ***
Total pot $0.97 | Rake $0.04 
Board [7h 5h 8c Kh]
Seat 1: VOOOR666 (button) folded before Flop (didn't bet)
Seat 2: limity (small blind) folded before Flop
Seat 3: Jovani_Silva (big blind) folded before Flop
Seat 4: mozart97 folded before Flop (didn't bet)
Seat 5: HubertusB collected ($0.93)
Seat 6: Maximus122 folded on the Turn



PokerStars Zoom Hand #185660719437:  Hold'em No Limit ($0.02/$0.05) - 2018/04/26 0:05:17 CCT [2018/04/25 12:05:17 ET]
Table 'Donati' 6-max Seat #1 is the button
Seat 1: petokrcmar ($1.73 in chips) 
Seat 2: zugy37ru ($4.98 in chips) 
Seat 3: alex2-a.a ($3.85 in chips) 
Seat 4: mcmeku ($7.08 in chips) 
Seat 5: chis94 ($5.07 in chips) 
Seat 6: HubertusB ($8.73 in chips) 
zugy37ru: posts small blind $0.02
alex2-a.a: posts big blind $0.05
*** HOLE CARDS ***
Dealt to HubertusB [Td Qh]
mcmeku: folds 
chis94: folds 
HubertusB: folds 
petokrcmar: raises $0.10 to $0.15
zugy37ru: folds 
alex2-a.a: calls $0.10
*** FLOP *** [4c Kc 7h]
alex2-a.a: checks 
petokrcmar: bets $0.30
alex2-a.a: folds 
Uncalled bet ($0.30) returned to petokrcmar
petokrcmar collected $0.31 from pot
petokrcmar: doesn't show hand 
*** SUMMARY ***
Total pot $0.32 | Rake $0.01 
Board [4c Kc 7h]
Seat 1: petokrcmar (button) collected ($0.31)
Seat 2: zugy37ru (small blind) folded before Flop
Seat 3: alex2-a.a (big blind) folded on the Flop
Seat 4: mcmeku folded before Flop (didn't bet)
Seat 5: chis94 folded before Flop (didn't bet)
Seat 6: HubertusB folded before Flop (didn't bet)



PokerStars Zoom Hand #185660735400:  Hold'em No Limit ($0.02/$0.05) - 2018/04/26 0:05:44 CCT [2018/04/25 12:05:44 ET]
Table 'Donati' 6-max Seat #1 is the button
Seat 1: Glolight ($5.43 in chips) 
Seat 2: LClaudioLP ($6.33 in chips) 
Seat 3: Mammarella56 ($5 in chips) 
Seat 4: Boba1888 ($5.32 in chips) 
Seat 5: HubertusB ($8.63 in chips) 
Seat 6: andychen66 ($14.40 in chips) 
LClaudioLP: posts small blind $0.02
Mammarella56: posts big blind $0.05
*** HOLE CARDS ***
Dealt to HubertusB [Qd 8s]
Boba1888: folds 
HubertusB: folds 
andychen66: folds 
Glolight: folds 
LClaudioLP: raises $0.10 to $0.15
Mammarella56: folds 
Uncalled bet ($0.10) returned to LClaudioLP
LClaudioLP collected $0.10 from pot
LClaudioLP: doesn't show hand 
*** SUMMARY ***
Total pot $0.10 | Rake $0 
Seat 1: Glolight (button) folded before Flop (didn't bet)
Seat 2: LClaudioLP (small blind) collected ($0.10)
Seat 3: Mammarella56 (big blind) folded before Flop
Seat 4: Boba1888 folded before Flop (didn't bet)
Seat 5: HubertusB folded before Flop (didn't bet)
Seat 6: andychen66 folded before Flop (didn't bet)



PokerStars Zoom Hand #185660740604:  Hold'em No Limit ($0.02/$0.05) - 2018/04/26 0:05:53 CCT [2018/04/25 12:05:53 ET]
Table 'Donati' 6-max Seat #1 is the button
Seat 1: usdgbp23 ($5.45 in chips) 
Seat 2: catalin.snow ($5.86 in chips) 
Seat 3: HubertusB ($8.63 in chips) 
Seat 4: Kanárek01 ($10.20 in chips) 
Seat 5: Smith1358 ($3.90 in chips) 
Seat 6: artem1103072 ($4.83 in chips) 
catalin.snow: posts small blind $0.02
HubertusB: posts big blind $0.05
*** HOLE CARDS ***
Dealt to HubertusB [8s 4s]
Kanárek01: raises $0.05 to $0.10
Smith1358: folds 
artem1103072: folds 
usdgbp23: folds 
catalin.snow: folds 
HubertusB: raises $0.30 to $0.40
Kanárek01: calls $0.30
*** FLOP *** [3s 2s Ah]
HubertusB: bets $0.40
Kanárek01: folds 
Uncalled bet ($0.40) returned to HubertusB
HubertusB collected $0.79 from pot
HubertusB: doesn't show hand 
*** SUMMARY ***
Total pot $0.82 | Rake $0.03 
Board [3s 2s Ah]
Seat 1: usdgbp23 (button) folded before Flop (didn't bet)
Seat 2: catalin.snow (small blind) folded before Flop
Seat 3: HubertusB (big blind) collected ($0.79)
Seat 4: Kanárek01 folded on the Flop
Seat 5: Smith1358 folded before Flop (didn't bet)
Seat 6: artem1103072 folded before Flop (didn't bet)



PokerStars Zoom Hand #185660722493:  Hold'em No Limit ($0.02/$0.05) - 2018/04/26 0:05:22 CCT [2018/04/25 12:05:22 ET]
Table 'Donati' 6-max Seat #1 is the button
Seat 1: IGOR 1987600 ($5.86 in chips) 
Seat 2: gjikaban ($18.18 in chips) 
Seat 3: julianna470 ($3.98 in chips) 
Seat 4: andychen66 ($14.38 in chips) 
Seat 5: JohnyeliteM ($5 in chips) 
Seat 6: HubertusB ($8.73 in chips) 
gjikaban: posts small blind $0.02
julianna470: posts big blind $0.05
*** HOLE CARDS ***
Dealt to HubertusB [Th Ac]
andychen66: folds 
JohnyeliteM: folds 
HubertusB: raises $0.05 to $0.10
IGOR 1987600: calls $0.10
gjikaban: raises $0.35 to $0.45
julianna470: folds 
HubertusB: folds 
IGOR 1987600: calls $0.35
*** FLOP *** [2c 5c 6c]
gjikaban: checks 
IGOR 1987600: checks 
*** TURN *** [2c 5c 6c] [Qh]
gjikaban: bets $0.51
IGOR 1987600: folds 
Uncalled bet ($0.51) returned to gjikaban
gjikaban collected $1.01 from pot
gjikaban: doesn't show hand 
*** SUMMARY ***
Total pot $1.05 | Rake $0.04 
Board [2c 5c 6c Qh]
Seat 1: IGOR 1987600 (button) folded on the Turn
Seat 2: gjikaban (small blind) collected ($1.01)
Seat 3: julianna470 (big blind) folded before Flop
Seat 4: andychen66 folded before Flop (didn't bet)
Seat 5: JohnyeliteM folded before Flop (didn't bet)
Seat 6: HubertusB folded before Flop



PokerStars Zoom Hand #185660757321:  Hold'em No Limit ($0.02/$0.05) - 2018/04/26 0:06:22 CCT [2018/04/25 12:06:22 ET]
Table 'Donati' 6-max Seat #1 is the button
Seat 1: ForestKriS ($5.33 in chips) 
Seat 2: Tom_FRG ($5.05 in chips) 
Seat 3: zhdam9 ($5.26 in chips) 
Seat 4: HubertusB ($9 in chips) 
Seat 5: Insignificant ($13.03 in chips) 
Seat 6: kamilson66 ($5.85 in chips) 
Tom_FRG: posts small blind $0.02
zhdam9: posts big blind $0.05
*** HOLE CARDS ***
Dealt to HubertusB [Qc 5s]
HubertusB: folds 
Insignificant: folds 
kamilson66: folds 
ForestKriS: folds 
Tom_FRG: raises $0.05 to $0.10
zhdam9: folds 
Uncalled bet ($0.05) returned to Tom_FRG
Tom_FRG collected $0.10 from pot
Tom_FRG: doesn't show hand 
*** SUMMARY ***
Total pot $0.10 | Rake $0 
Seat 1: ForestKriS (button) folded before Flop (didn't bet)
Seat 2: Tom_FRG (small blind) collected ($0.10)
Seat 3: zhdam9 (big blind) folded before Flop
Seat 4: HubertusB folded before Flop (didn't bet)
Seat 5: Insignificant folded before Flop (didn't bet)
Seat 6: kamilson66 folded before Flop (didn't bet)



PokerStars Zoom Hand #185660753781:  Hold'em No Limit ($0.02/$0.05) - 2018/04/26 0:06:16 CCT [2018/04/25 12:06:16 ET]
Table 'Donati' 6-max Seat #1 is the button
Seat 1: skerdser ($5.08 in chips) 
Seat 2: HubertusB ($9.02 in chips) 
Seat 3: Xadanjel ($5 in chips) 
Seat 4: d-potolok ($5.15 in chips) 
Seat 5: MutbKa01 ($5.24 in chips) 
Seat 6: onebearl4 ($5.97 in chips) 
HubertusB: posts small blind $0.02
Xadanjel: posts big blind $0.05
*** HOLE CARDS ***
Dealt to HubertusB [7h 2d]
d-potolok: folds 
MutbKa01: folds 
onebearl4: raises $0.05 to $0.10
skerdser: folds 
HubertusB: folds 
Xadanjel: calls $0.05
*** FLOP *** [4d 6s 5s]
Xadanjel: checks 
onebearl4: checks 
*** TURN *** [4d 6s 5s] [Jc]
Xadanjel: checks 
onebearl4: checks 
*** RIVER *** [4d 6s 5s Jc] [Tc]
Xadanjel: checks 
onebearl4: bets $0.10
Xadanjel: folds 
Uncalled bet ($0.10) returned to onebearl4
onebearl4 collected $0.21 from pot
onebearl4: doesn't show hand 
*** SUMMARY ***
Total pot $0.22 | Rake $0.01 
Board [4d 6s 5s Jc Tc]
Seat 1: skerdser (button) folded before Flop (didn't bet)
Seat 2: HubertusB (small blind) folded before Flop
Seat 3: Xadanjel (big blind) folded on the River
Seat 4: d-potolok folded before Flop (didn't bet)
Seat 5: MutbKa01 folded before Flop (didn't bet)
Seat 6: onebearl4 collected ($0.21)



PokerStars Zoom Hand #185660763724:  Hold'em No Limit ($0.02/$0.05) - 2018/04/26 0:06:33 CCT [2018/04/25 12:06:33 ET]
Table 'Donati' 6-max Seat #1 is the button
Seat 1: Lady Tanee ($5.86 in chips) 
Seat 2: HubertusB ($9 in chips) 
Seat 3: holdmybreath ($5.12 in chips) 
Seat 4: SL50AMG ($1.81 in chips) 
Seat 5: mamel7777 ($5 in chips) 
Seat 6: UruGabo ($6.42 in chips) 
HubertusB: posts small blind $0.02
holdmybreath: posts big blind $0.05
*** HOLE CARDS ***
Dealt to HubertusB [5s 3s]
SL50AMG: raises $0.10 to $0.15
mamel7777: folds 
UruGabo: folds 
Lady Tanee: folds 
HubertusB: folds 
holdmybreath: folds 
Uncalled bet ($0.10) returned to SL50AMG
SL50AMG collected $0.12 from pot
SL50AMG: doesn't show hand 
*** SUMMARY ***
Total pot $0.12 | Rake $0 
Seat 1: Lady Tanee (button) folded before Flop (didn't bet)
Seat 2: HubertusB (small blind) folded before Flop
Seat 3: holdmybreath (big blind) folded before Flop
Seat 4: SL50AMG collected ($0.12)
Seat 5: mamel7777 folded before Flop (didn't bet)
Seat 6: UruGabo folded before Flop (didn't bet)



PokerStars Zoom Hand #185660760867:  Hold'em No Limit ($0.02/$0.05) - 2018/04/26 0:06:28 CCT [2018/04/25 12:06:28 ET]
Table 'Donati' 6-max Seat #1 is the button
Seat 1: dino.moh ($8.36 in chips) 
Seat 2: Smith1358 ($4.10 in chips) 
Seat 3: d-potolok ($5 in chips) 
Seat 4: HubertusB ($9 in chips) 
Seat 5: mamel7777 ($5 in chips) 
Seat 6: ros100k ($2.96 in chips) 
Smith1358: posts small blind $0.02
d-potolok: posts big blind $0.05
*** HOLE CARDS ***
Dealt to HubertusB [6c 8s]
HubertusB: folds 
mamel7777: folds 
ros100k: folds 
dino.moh: raises $0.10 to $0.15
Smith1358: folds 
d-potolok: folds 
Uncalled bet ($0.10) returned to dino.moh
dino.moh collected $0.12 from pot
dino.moh: doesn't show hand 
*** SUMMARY ***
Total pot $0.12 | Rake $0 
Seat 1: dino.moh (button) collected ($0.12)
Seat 2: Smith1358 (small blind) folded before Flop
Seat 3: d-potolok (big blind) folded before Flop
Seat 4: HubertusB folded before Flop (didn't bet)
Seat 5: mamel7777 folded before Flop (didn't bet)
Seat 6: ros100k folded before Flop (didn't bet)



PokerStars Zoom Hand #185660768922:  Hold'em No Limit ($0.02/$0.05) - 2018/04/26 0:06:42 CCT [2018/04/25 12:06:42 ET]
Table 'Donati' 6-max Seat #1 is the button
Seat 1: HubertusB ($8.98 in chips) 
Seat 2: kamilson66 ($5.80 in chips) 
Seat 3: halesc19 ($2.25 in chips) 
Seat 4: Spencizm ($8.66 in chips) 
Seat 5: krezifrut ($5.23 in chips) 
Seat 6: letmein1 ($4.85 in chips) 
kamilson66: posts small blind $0.02
halesc19: posts big blind $0.05
*** HOLE CARDS ***
Dealt to HubertusB [4c 8h]
Spencizm: folds 
krezifrut: raises $0.07 to $0.12
letmein1: folds 
HubertusB: folds 
kamilson66: folds 
halesc19: folds 
Uncalled bet ($0.07) returned to krezifrut
krezifrut collected $0.12 from pot
krezifrut: doesn't show hand 
*** SUMMARY ***
Total pot $0.12 | Rake $0 
Seat 1: HubertusB (button) folded before Flop (didn't bet)
Seat 2: kamilson66 (small blind) folded before Flop
Seat 3: halesc19 (big blind) folded before Flop
Seat 4: Spencizm folded before Flop (didn't bet)
Seat 5: krezifrut collected ($0.12)
Seat 6: letmein1 folded before Flop (didn't bet)



PokerStars Zoom Hand #185660774717:  Hold'em No Limit ($0.02/$0.05) - 2018/04/26 0:06:52 CCT [2018/04/25 12:06:52 ET]
Table 'Donati' 6-max Seat #1 is the button
Seat 1: skystaruk ($6.20 in chips) 
Seat 2: laughing.poker ($5.38 in chips) 
Seat 3: HubertusB ($8.98 in chips) 
Seat 4: Xodrobalubas ($5.07 in chips) 
Seat 5: FelixZyl ($5.15 in chips) 
Seat 6: HolyBen33 ($7.06 in chips) 
laughing.poker: posts small blind $0.02
HubertusB: posts big blind $0.05
*** HOLE CARDS ***
Dealt to HubertusB [Jc 6c]
Xodrobalubas: folds 
FelixZyl: folds 
HolyBen33: folds 
skystaruk: raises $0.12 to $0.17
laughing.poker: raises $0.41 to $0.58
HubertusB: folds 
skystaruk: folds 
Uncalled bet ($0.41) returned to laughing.poker
laughing.poker collected $0.39 from pot
laughing.poker: doesn't show hand 
*** SUMMARY ***
Total pot $0.39 | Rake $0 
Seat 1: skystaruk (button) folded before Flop
Seat 2: laughing.poker (small blind) collected ($0.39)
Seat 3: HubertusB (big blind) folded before Flop
Seat 4: Xodrobalubas folded before Flop (didn't bet)
Seat 5: FelixZyl folded before Flop (didn't bet)
Seat 6: HolyBen33 folded before Flop (didn't bet)



PokerStars Zoom Hand #185660790941:  Hold'em No Limit ($0.02/$0.05) - 2018/04/26 0:07:20 CCT [2018/04/25 12:07:20 ET]
Table 'Donati' 6-max Seat #1 is the button
Seat 1: kamilson66 ($5.65 in chips) 
Seat 2: pettrowaa ($14.18 in chips) 
Seat 3: Skipper_top1 ($7.17 in chips) 
Seat 4: speedy_1110 ($6.71 in chips) 
Seat 5: HubertusB ($8.93 in chips) 
Seat 6: salamandryko ($6.08 in chips) 
pettrowaa: posts small blind $0.02
Skipper_top1: posts big blind $0.05
*** HOLE CARDS ***
Dealt to HubertusB [5s Ad]
speedy_1110: folds 
HubertusB: raises $0.05 to $0.10
salamandryko: folds 
kamilson66: folds 
pettrowaa: folds 
Skipper_top1: calls $0.05
*** FLOP *** [6d 5h 8c]
Skipper_top1: checks 
HubertusB: bets $0.15
Skipper_top1: raises $0.15 to $0.30
HubertusB: raises $0.30 to $0.60
Skipper_top1: folds 
Uncalled bet ($0.30) returned to HubertusB
HubertusB collected $0.79 from pot
HubertusB: doesn't show hand 
*** SUMMARY ***
Total pot $0.82 | Rake $0.03 
Board [6d 5h 8c]
Seat 1: kamilson66 (button) folded before Flop (didn't bet)
Seat 2: pettrowaa (small blind) folded before Flop
Seat 3: Skipper_top1 (big blind) folded on the Flop
Seat 4: speedy_1110 folded before Flop (didn't bet)
Seat 5: HubertusB collected ($0.79)
Seat 6: salamandryko folded before Flop (didn't bet)



PokerStars Zoom Hand #185660823517:  Hold'em No Limit ($0.02/$0.05) - 2018/04/26 0:08:16 CCT [2018/04/25 12:08:16 ET]
Table 'Donati' 6-max Seat #1 is the button
Seat 1: HubertusB ($9.32 in chips) 
Seat 2: JoSavard 07 ($5.73 in chips) 
Seat 3: RichardxSiph ($6.95 in chips) 
Seat 4: rogueshark10 ($5.28 in chips) 
Seat 5: holdmybreath ($5.29 in chips) 
Seat 6: vougiouks ($21.83 in chips) 
JoSavard 07: posts small blind $0.02
RichardxSiph: posts big blind $0.05
*** HOLE CARDS ***
Dealt to HubertusB [5s 3c]
rogueshark10: folds 
holdmybreath: folds 
vougiouks: folds 
HubertusB: folds 
JoSavard 07: raises $0.09 to $0.14
RichardxSiph: folds 
Uncalled bet ($0.09) returned to JoSavard 07
JoSavard 07 collected $0.10 from pot
JoSavard 07: doesn't show hand 
*** SUMMARY ***
Total pot $0.10 | Rake $0 
Seat 1: HubertusB (button) folded before Flop (didn't bet)
Seat 2: JoSavard 07 (small blind) collected ($0.10)
Seat 3: RichardxSiph (big blind) folded before Flop
Seat 4: rogueshark10 folded before Flop (didn't bet)
Seat 5: holdmybreath folded before Flop (didn't bet)
Seat 6: vougiouks folded before Flop (didn't bet)



PokerStars Zoom Hand #185660827038:  Hold'em No Limit ($0.02/$0.05) - 2018/04/26 0:08:22 CCT [2018/04/25 12:08:22 ET]
Table 'Donati' 6-max Seat #1 is the button
Seat 1: LogikHemp ($5.02 in chips) 
Seat 2: OfCouRse72 ($10.55 in chips) 
Seat 3: HubertusB ($9.32 in chips) 
Seat 4: SpeeLy ($6.95 in chips) 
Seat 5: superboris89 ($4.85 in chips) 
Seat 6: Rapstar86 ($2.99 in chips) 
OfCouRse72: posts small blind $0.02
HubertusB: posts big blind $0.05
*** HOLE CARDS ***
Dealt to HubertusB [7h Qh]
SpeeLy: folds 
superboris89: folds 
Rapstar86: folds 
LogikHemp: folds 
OfCouRse72: folds 
Uncalled bet ($0.03) returned to HubertusB
HubertusB collected $0.04 from pot
HubertusB: doesn't show hand 
*** SUMMARY ***
Total pot $0.04 | Rake $0 
Seat 1: LogikHemp (button) folded before Flop (didn't bet)
Seat 2: OfCouRse72 (small blind) folded before Flop
Seat 3: HubertusB (big blind) collected ($0.04)
Seat 4: SpeeLy folded before Flop (didn't bet)
Seat 5: superboris89 folded before Flop (didn't bet)
Seat 6: Rapstar86 folded before Flop (didn't bet)



PokerStars Zoom Hand #185660820077:  Hold'em No Limit ($0.02/$0.05) - 2018/04/26 0:08:10 CCT [2018/04/25 12:08:10 ET]
Table 'Donati' 6-max Seat #1 is the button
Seat 1: FelixZyl ($5.45 in chips) 
Seat 2: Teta1410 ($6.30 in chips) 
Seat 3: Alexsny13 ($5.62 in chips) 
Seat 4: AsterixBrn ($11.10 in chips) 
Seat 5: crazysnipa ($5.97 in chips) 
Seat 6: HubertusB ($9.32 in chips) 
Teta1410: posts small blind $0.02
Alexsny13: posts big blind $0.05
*** HOLE CARDS ***
Dealt to HubertusB [9h 2c]
AsterixBrn: folds 
crazysnipa: folds 
HubertusB: folds 
FelixZyl: raises $0.07 to $0.12
Teta1410: folds 
Alexsny13: calls $0.07
*** FLOP *** [Jd Th 9c]
Alexsny13: checks 
FelixZyl: checks 
*** TURN *** [Jd Th 9c] [8h]
Alexsny13: checks 
FelixZyl: bets $0.19
Alexsny13: folds 
Uncalled bet ($0.19) returned to FelixZyl
FelixZyl collected $0.25 from pot
FelixZyl: doesn't show hand 
*** SUMMARY ***
Total pot $0.26 | Rake $0.01 
Board [Jd Th 9c 8h]
Seat 1: FelixZyl (button) collected ($0.25)
Seat 2: Teta1410 (small blind) folded before Flop
Seat 3: Alexsny13 (big blind) folded on the Turn
Seat 4: AsterixBrn folded before Flop (didn't bet)
Seat 5: crazysnipa folded before Flop (didn't bet)
Seat 6: HubertusB folded before Flop (didn't bet)



PokerStars Zoom Hand #185660832306:  Hold'em No Limit ($0.02/$0.05) - 2018/04/26 0:08:31 CCT [2018/04/25 12:08:31 ET]
Table 'Donati' 6-max Seat #1 is the button
Seat 1: Willi1604 ($4.46 in chips) 
Seat 2: russland415 ($12.29 in chips) 
Seat 3: JoSavard 07 ($5.78 in chips) 
Seat 4: HubertusB ($9.34 in chips) 
Seat 5: nitron2 ($5.38 in chips) 
Seat 6: SpeeLy ($6.93 in chips) 
russland415: posts small blind $0.02
JoSavard 07: posts big blind $0.05
*** HOLE CARDS ***
Dealt to HubertusB [3c Ah]
HubertusB: folds 
nitron2: folds 
SpeeLy: folds 
Willi1604: raises $0.10 to $0.15
russland415: folds 
JoSavard 07: folds 
Uncalled bet ($0.10) returned to Willi1604
Willi1604 collected $0.12 from pot
Willi1604: doesn't show hand 
*** SUMMARY ***
Total pot $0.12 | Rake $0 
Seat 1: Willi1604 (button) collected ($0.12)
Seat 2: russland415 (small blind) folded before Flop
Seat 3: JoSavard 07 (big blind) folded before Flop
Seat 4: HubertusB folded before Flop (didn't bet)
Seat 5: nitron2 folded before Flop (didn't bet)
Seat 6: SpeeLy folded before Flop (didn't bet)



PokerStars Zoom Hand #185660835868:  Hold'em No Limit ($0.02/$0.05) - 2018/04/26 0:08:37 CCT [2018/04/25 12:08:37 ET]
Table 'Donati' 6-max Seat #1 is the button
Seat 1: greedis555 ($5.93 in chips) 
Seat 2: pulsner78 ($5.22 in chips) 
Seat 3: BrianLodi ($1.73 in chips) 
Seat 4: HubertusB ($9.34 in chips) 
Seat 5: Teta1410 ($6.35 in chips) 
Seat 6: crg1107 ($3.57 in chips) 
pulsner78: posts small blind $0.02
BrianLodi: posts big blind $0.05
*** HOLE CARDS ***
Dealt to HubertusB [Ks Qh]
HubertusB: raises $0.05 to $0.10
Teta1410: folds 
crg1107: folds 
greedis555: calls $0.10
pulsner78: folds 
BrianLodi: folds 
*** FLOP *** [9s 7s Ah]
HubertusB: bets $0.10
greedis555: folds 
Uncalled bet ($0.10) returned to HubertusB
HubertusB collected $0.26 from pot
HubertusB: doesn't show hand 
*** SUMMARY ***
Total pot $0.27 | Rake $0.01 
Board [9s 7s Ah]
Seat 1: greedis555 (button) folded on the Flop
Seat 2: pulsner78 (small blind) folded before Flop
Seat 3: BrianLodi (big blind) folded before Flop
Seat 4: HubertusB collected ($0.26)
Seat 5: Teta1410 folded before Flop (didn't bet)
Seat 6: crg1107 folded before Flop (didn't bet)



PokerStars Zoom Hand #185660848131:  Hold'em No Limit ($0.02/$0.05) - 2018/04/26 0:08:58 CCT [2018/04/25 12:08:58 ET]
Table 'Donati' 6-max Seat #1 is the button
Seat 1: Guest533 ($9.11 in chips) 
Seat 2: HubertusB ($9.50 in chips) 
Seat 3: Neo254 ($10.86 in chips) 
Seat 4: skystaruk ($8.45 in chips) 
Seat 5: IndigoKid000 ($6.08 in chips) 
Seat 6: Mammarella56 ($5.93 in chips) 
HubertusB: posts small blind $0.02
Neo254: posts big blind $0.05
*** HOLE CARDS ***
Dealt to HubertusB [6c Jc]
skystaruk: calls $0.05
IndigoKid000: folds 
Mammarella56: folds 
Guest533: folds 
HubertusB: raises $0.20 to $0.25
Neo254: folds 
skystaruk: calls $0.20
*** FLOP *** [5h 5s Ac]
HubertusB: bets $0.25
skystaruk: folds 
Uncalled bet ($0.25) returned to HubertusB
HubertusB collected $0.53 from pot
HubertusB: doesn't show hand 
*** SUMMARY ***
Total pot $0.55 | Rake $0.02 
Board [5h 5s Ac]
Seat 1: Guest533 (button) folded before Flop (didn't bet)
Seat 2: HubertusB (small blind) collected ($0.53)
Seat 3: Neo254 (big blind) folded before Flop
Seat 4: skystaruk folded on the Flop
Seat 5: IndigoKid000 folded before Flop (didn't bet)
Seat 6: Mammarella56 folded before Flop (didn't bet)



PokerStars Zoom Hand #185660865309:  Hold'em No Limit ($0.02/$0.05) - 2018/04/26 0:09:27 CCT [2018/04/25 12:09:27 ET]
Table 'Donati' 6-max Seat #1 is the button
Seat 1: Marcshep5 ($5.01 in chips) 
Seat 2: VVinner19 ($5 in chips) 
Seat 3: Avtor73 ($5.07 in chips) 
Seat 4: infitoha ($11.96 in chips) 
Seat 5: koyuen123 ($7.12 in chips) 
Seat 6: HubertusB ($9.78 in chips) 
VVinner19: posts small blind $0.02
Avtor73: posts big blind $0.05
*** HOLE CARDS ***
Dealt to HubertusB [Th Td]
infitoha: folds 
koyuen123: folds 
HubertusB: raises $0.05 to $0.10
Marcshep5: raises $0.25 to $0.35
VVinner19: folds 
Avtor73: folds 
HubertusB: calls $0.25
*** FLOP *** [Qh 3d Jc]
HubertusB: checks 
Marcshep5: checks 
*** TURN *** [Qh 3d Jc] [Ks]
HubertusB: checks 
Marcshep5: bets $0.55
HubertusB: folds 
Uncalled bet ($0.55) returned to Marcshep5
Marcshep5 collected $0.74 from pot
Marcshep5: doesn't show hand 
*** SUMMARY ***
Total pot $0.77 | Rake $0.03 
Board [Qh 3d Jc Ks]
Seat 1: Marcshep5 (button) collected ($0.74)
Seat 2: VVinner19 (small blind) folded before Flop
Seat 3: Avtor73 (big blind) folded before Flop
Seat 4: infitoha folded before Flop (didn't bet)
Seat 5: koyuen123 folded before Flop (didn't bet)
Seat 6: HubertusB folded on the Turn



PokerStars Zoom Hand #185660899175:  Hold'em No Limit ($0.02/$0.05) - 2018/04/26 0:10:10 CCT [2018/04/25 12:10:10 ET]
Table 'Donati' 6-max Seat #1 is the button
Seat 1: falcao991 ($14.60 in chips) 
Seat 2: viktor49ru ($12.81 in chips) 
Seat 3: RedAries999 ($6.88 in chips) 
Seat 4: batista772 ($8.12 in chips) 
Seat 5: HubertusB ($9.43 in chips) 
Seat 6: spIeeNy ($5 in chips) 
viktor49ru: posts small blind $0.02
RedAries999: posts big blind $0.05
*** HOLE CARDS ***
Dealt to HubertusB [2h Kd]
batista772: folds 
HubertusB: folds 
spIeeNy: folds 
falcao991: folds 
viktor49ru: folds 
Uncalled bet ($0.03) returned to RedAries999
RedAries999 collected $0.04 from pot
RedAries999: doesn't show hand 
*** SUMMARY ***
Total pot $0.04 | Rake $0 
Seat 1: falcao991 (button) folded before Flop (didn't bet)
Seat 2: viktor49ru (small blind) folded before Flop
Seat 3: RedAries999 (big blind) collected ($0.04)
Seat 4: batista772 folded before Flop (didn't bet)
Seat 5: HubertusB folded before Flop (didn't bet)
Seat 6: spIeeNy folded before Flop (didn't bet)



PokerStars Zoom Hand #185660909133:  Hold'em No Limit ($0.02/$0.05) - 2018/04/26 0:10:27 CCT [2018/04/25 12:10:27 ET]
Table 'Donati' 6-max Seat #1 is the button
Seat 1: HubertusB ($9.38 in chips) 
Seat 2: 1989ace1989 ($6.80 in chips) 
Seat 3: Party Fishy ($5.23 in chips) 
Seat 4: Al_Capone_bro ($5.32 in chips) 
Seat 5: dobrynay ($7.54 in chips) 
Seat 6: fishrus23 ($5 in chips) 
1989ace1989: posts small blind $0.02
Party Fishy: posts big blind $0.05
*** HOLE CARDS ***
Dealt to HubertusB [3d 8d]
Al_Capone_bro: folds 
dobrynay: raises $0.10 to $0.15
fishrus23: folds 
HubertusB: folds 
1989ace1989: folds 
Party Fishy: folds 
Uncalled bet ($0.10) returned to dobrynay
dobrynay collected $0.12 from pot
dobrynay: doesn't show hand 
*** SUMMARY ***
Total pot $0.12 | Rake $0 
Seat 1: HubertusB (button) folded before Flop (didn't bet)
Seat 2: 1989ace1989 (small blind) folded before Flop
Seat 3: Party Fishy (big blind) folded before Flop
Seat 4: Al_Capone_bro folded before Flop (didn't bet)
Seat 5: dobrynay collected ($0.12)
Seat 6: fishrus23 folded before Flop (didn't bet)



PokerStars Zoom Hand #185660896244:  Hold'em No Limit ($0.02/$0.05) - 2018/04/26 0:10:05 CCT [2018/04/25 12:10:05 ET]
Table 'Donati' 6-max Seat #1 is the button
Seat 1: Blackaleksandr ($6.65 in chips) 
Seat 2: Axxxidental ($5 in chips) 
Seat 3: Eduard335 ($3.18 in chips) 
Seat 4: derak488 ($5.43 in chips) 
Seat 5: HubertusB ($9.43 in chips) 
Seat 6: laughing.poker ($10.48 in chips) 
Axxxidental: posts small blind $0.02
Eduard335: posts big blind $0.05
*** HOLE CARDS ***
Dealt to HubertusB [5c Js]
derak488: folds 
HubertusB: folds 
laughing.poker: folds 
Blackaleksandr: folds 
Axxxidental: calls $0.03
Eduard335: checks 
*** FLOP *** [Jc 2s Qh]
Axxxidental: checks 
Eduard335: checks 
*** TURN *** [Jc 2s Qh] [3c]
Axxxidental: bets $0.07
Eduard335: folds 
Uncalled bet ($0.07) returned to Axxxidental
Axxxidental collected $0.10 from pot
Axxxidental: doesn't show hand 
*** SUMMARY ***
Total pot $0.10 | Rake $0 
Board [Jc 2s Qh 3c]
Seat 1: Blackaleksandr (button) folded before Flop (didn't bet)
Seat 2: Axxxidental (small blind) collected ($0.10)
Seat 3: Eduard335 (big blind) folded on the Turn
Seat 4: derak488 folded before Flop (didn't bet)
Seat 5: HubertusB folded before Flop (didn't bet)
Seat 6: laughing.poker folded before Flop (didn't bet)



PokerStars Zoom Hand #185660915569:  Hold'em No Limit ($0.02/$0.05) - 2018/04/26 0:10:38 CCT [2018/04/25 12:10:38 ET]
Table 'Donati' 6-max Seat #1 is the button
Seat 1: winston9000 ($5.81 in chips) 
Seat 2: HubertusB ($9.38 in chips) 
Seat 3: Cimer88 ($5.70 in chips) 
Seat 4: nitron2 ($5.02 in chips) 
Seat 5: Laoise Love ($5.36 in chips) 
Seat 6: Bonch241 ($5.73 in chips) 
HubertusB: posts small blind $0.02
Cimer88: posts big blind $0.05
*** HOLE CARDS ***
Dealt to HubertusB [3c 4s]
nitron2: folds 
Laoise Love: folds 
Bonch241: folds 
winston9000: folds 
HubertusB: folds 
Uncalled bet ($0.03) returned to Cimer88
Cimer88 collected $0.04 from pot
Cimer88: doesn't show hand 
*** SUMMARY ***
Total pot $0.04 | Rake $0 
Seat 1: winston9000 (button) folded before Flop (didn't bet)
Seat 2: HubertusB (small blind) folded before Flop
Seat 3: Cimer88 (big blind) collected ($0.04)
Seat 4: nitron2 folded before Flop (didn't bet)
Seat 5: Laoise Love folded before Flop (didn't bet)
Seat 6: Bonch241 folded before Flop (didn't bet)



PokerStars Zoom Hand #185660902652:  Hold'em No Limit ($0.02/$0.05) - 2018/04/26 0:10:16 CCT [2018/04/25 12:10:16 ET]
Table 'Donati' 6-max Seat #1 is the button
Seat 1: alexkit13 ($4.45 in chips) 
Seat 2: mcmeku ($5.48 in chips) 
Seat 3: HubertusB ($9.43 in chips) 
Seat 4: maltrine ($5 in chips) 
Seat 5: glum434 ($0.73 in chips) 
Seat 6: pashqadk ($5.87 in chips) 
mcmeku: posts small blind $0.02
HubertusB: posts big blind $0.05
*** HOLE CARDS ***
Dealt to HubertusB [Ks 5h]
maltrine: folds 
glum434: calls $0.05
pashqadk: folds 
alexkit13: raises $0.17 to $0.22
mcmeku: raises $0.54 to $0.76
HubertusB: folds 
glum434: calls $0.68 and is all-in
alexkit13: calls $0.54
*** FLOP *** [Ts Ah 4c]
mcmeku: bets $2.20
alexkit13: folds 
Uncalled bet ($2.20) returned to mcmeku
*** TURN *** [Ts Ah 4c] [2d]
*** RIVER *** [Ts Ah 4c 2d] [9h]
*** SHOW DOWN ***
mcmeku: shows [Ac Jd] (a pair of Aces)
mcmeku collected $0.05 from side pot
glum434: shows [Kd Jh] (high card Ace)
mcmeku collected $2.15 from main pot
*** SUMMARY ***
Total pot $2.30 Main pot $2.15. Side pot $0.05. | Rake $0.10 
Board [Ts Ah 4c 2d 9h]
Seat 1: alexkit13 (button) folded on the Flop
Seat 2: mcmeku (small blind) showed [Ac Jd] and won ($2.20) with a pair of Aces
Seat 3: HubertusB (big blind) folded before Flop
Seat 4: maltrine folded before Flop (didn't bet)
Seat 5: glum434 showed [Kd Jh] and lost with high card Ace
Seat 6: pashqadk folded before Flop (didn't bet)



PokerStars Zoom Hand #185660920244:  Hold'em No Limit ($0.02/$0.05) - 2018/04/26 0:10:46 CCT [2018/04/25 12:10:46 ET]
Table 'Donati' 6-max Seat #1 is the button
Seat 1: HubertusB ($9.36 in chips) 
Seat 2: DuggieD ($5 in chips) 
Seat 3: yanbrault ($2.22 in chips) 
Seat 4: Tiltnesss ($5.40 in chips) 
Seat 5: Jovani_Silva ($5.06 in chips) 
Seat 6: ImpalerPoker ($12.30 in chips) 
DuggieD: posts small blind $0.02
yanbrault: posts big blind $0.05
*** HOLE CARDS ***
Dealt to HubertusB [Ac 7c]
Tiltnesss: folds 
Jovani_Silva: folds 
ImpalerPoker: folds 
HubertusB: raises $0.10 to $0.15
DuggieD: folds 
yanbrault: folds 
Uncalled bet ($0.10) returned to HubertusB
HubertusB collected $0.12 from pot
HubertusB: doesn't show hand 
*** SUMMARY ***
Total pot $0.12 | Rake $0 
Seat 1: HubertusB (button) collected ($0.12)
Seat 2: DuggieD (small blind) folded before Flop
Seat 3: yanbrault (big blind) folded before Flop
Seat 4: Tiltnesss folded before Flop (didn't bet)
Seat 5: Jovani_Silva folded before Flop (didn't bet)
Seat 6: ImpalerPoker folded before Flop (didn't bet)



PokerStars Zoom Hand #185660934288:  Hold'em No Limit ($0.02/$0.05) - 2018/04/26 0:11:10 CCT [2018/04/25 12:11:10 ET]
Table 'Donati' 6-max Seat #1 is the button
Seat 1: MutbKa01 ($5.31 in chips) 
Seat 2: Asilvagoat ($5.02 in chips) 
Seat 3: Xadanjel ($5 in chips) 
Seat 4: HubertusB ($9.43 in chips) 
Seat 5: steven_stans ($6.30 in chips) 
Seat 6: rolsy90 ($1.38 in chips) 
Asilvagoat: posts small blind $0.02
Xadanjel: posts big blind $0.05
*** HOLE CARDS ***
Dealt to HubertusB [Tc 8h]
HubertusB: folds 
steven_stans: folds 
rolsy90: folds 
MutbKa01: raises $0.07 to $0.12
Asilvagoat: folds 
Xadanjel: folds 
Uncalled bet ($0.07) returned to MutbKa01
MutbKa01 collected $0.12 from pot
MutbKa01: doesn't show hand 
*** SUMMARY ***
Total pot $0.12 | Rake $0 
Seat 1: MutbKa01 (button) collected ($0.12)
Seat 2: Asilvagoat (small blind) folded before Flop
Seat 3: Xadanjel (big blind) folded before Flop
Seat 4: HubertusB folded before Flop (didn't bet)
Seat 5: steven_stans folded before Flop (didn't bet)
Seat 6: rolsy90 folded before Flop (didn't bet)



PokerStars Zoom Hand #185660938346:  Hold'em No Limit ($0.02/$0.05) - 2018/04/26 0:11:17 CCT [2018/04/25 12:11:17 ET]
Table 'Donati' 6-max Seat #1 is the button
Seat 1: LingPro ($4.93 in chips) 
Seat 2: HubertusB ($9.43 in chips) 
Seat 3: navy463 ($5 in chips) 
Seat 4: someep1ck ($5 in chips) 
Seat 5: T0QOCR ($5 in chips) 
Seat 6: Al_Capone_bro ($5.77 in chips) 
HubertusB: posts small blind $0.02
navy463: posts big blind $0.05
*** HOLE CARDS ***
Dealt to HubertusB [5h 4h]
someep1ck: folds 
T0QOCR: folds 
Al_Capone_bro: raises $0.10 to $0.15
LingPro: folds 
HubertusB: raises $0.30 to $0.45
navy463: folds 
Al_Capone_bro: folds 
Uncalled bet ($0.30) returned to HubertusB
HubertusB collected $0.35 from pot
HubertusB: doesn't show hand 
*** SUMMARY ***
Total pot $0.35 | Rake $0 
Seat 1: LingPro (button) folded before Flop (didn't bet)
Seat 2: HubertusB (small blind) collected ($0.35)
Seat 3: navy463 (big blind) folded before Flop
Seat 4: someep1ck folded before Flop (didn't bet)
Seat 5: T0QOCR folded before Flop (didn't bet)
Seat 6: Al_Capone_bro folded before Flop



PokerStars Zoom Hand #185660912012:  Hold'em No Limit ($0.02/$0.05) - 2018/04/26 0:10:32 CCT [2018/04/25 12:10:32 ET]
Table 'Donati' 6-max Seat #1 is the button
Seat 1: rogueshark10 ($5 in chips) 
Seat 2: NicSt4r ($10.07 in chips) 
Seat 3: seriita ($12.55 in chips) 
Seat 4: MutbKa01 ($5.02 in chips) 
Seat 5: Avtor73 ($5 in chips) 
Seat 6: HubertusB ($9.38 in chips) 
NicSt4r: posts small blind $0.02
seriita: posts big blind $0.05
*** HOLE CARDS ***
Dealt to HubertusB [Tc 8s]
MutbKa01: folds 
Avtor73: raises $0.10 to $0.15
HubertusB: folds 
rogueshark10: raises $0.30 to $0.45
NicSt4r: folds 
seriita: folds 
Avtor73: raises $0.57 to $1.02
rogueshark10: calls $0.57
*** FLOP *** [5d Jc Th]
Avtor73: bets $0.61
rogueshark10: calls $0.61
*** TURN *** [5d Jc Th] [9d]
Avtor73: bets $3.37 and is all-in
rogueshark10: folds 
Uncalled bet ($3.37) returned to Avtor73
Avtor73 collected $3.19 from pot
Avtor73: doesn't show hand 
*** SUMMARY ***
Total pot $3.33 | Rake $0.14 
Board [5d Jc Th 9d]
Seat 1: rogueshark10 (button) folded on the Turn
Seat 2: NicSt4r (small blind) folded before Flop
Seat 3: seriita (big blind) folded before Flop
Seat 4: MutbKa01 folded before Flop (didn't bet)
Seat 5: Avtor73 collected ($3.19)
Seat 6: HubertusB folded before Flop (didn't bet)



PokerStars Zoom Hand #185660955312:  Hold'em No Limit ($0.02/$0.05) - 2018/04/26 0:11:46 CCT [2018/04/25 12:11:46 ET]
Table 'Donati' 6-max Seat #1 is the button
Seat 1: alex2-a.a ($3.93 in chips) 
Seat 2: limity ($13.36 in chips) 
Seat 3: HubertusB ($9.63 in chips) 
Seat 4: kferte ($5.74 in chips) 
Seat 5: SAVA231 ($4 in chips) 
Seat 6: geemang711 ($9.52 in chips) 
limity: posts small blind $0.02
HubertusB: posts big blind $0.05
*** HOLE CARDS ***
Dealt to HubertusB [Qc Tc]
kferte: folds 
SAVA231: raises $0.07 to $0.12
geemang711: folds 
alex2-a.a: folds 
limity: folds 
HubertusB: calls $0.07
*** FLOP *** [Jd 6c 2s]
HubertusB: checks 
SAVA231: checks 
*** TURN *** [Jd 6c 2s] [7s]
HubertusB: bets $0.10
SAVA231: folds 
Uncalled bet ($0.10) returned to HubertusB
HubertusB collected $0.25 from pot
HubertusB: doesn't show hand 
*** SUMMARY ***
Total pot $0.26 | Rake $0.01 
Board [Jd 6c 2s 7s]
Seat 1: alex2-a.a (button) folded before Flop (didn't bet)
Seat 2: limity (small blind) folded before Flop
Seat 3: HubertusB (big blind) collected ($0.25)
Seat 4: kferte folded before Flop (didn't bet)
Seat 5: SAVA231 folded on the Turn
Seat 6: geemang711 folded before Flop (didn't bet)



PokerStars Zoom Hand #185660971796:  Hold'em No Limit ($0.02/$0.05) - 2018/04/26 0:12:14 CCT [2018/04/25 12:12:14 ET]
Table 'Donati' 6-max Seat #1 is the button
Seat 1: krezifrut ($6 in chips) 
Seat 2: yurok_chess ($1.35 in chips) 
Seat 3: roda-mala ($5.14 in chips) 
Seat 4: FoundingDadd ($11.64 in chips) 
Seat 5: Neo254 ($9.75 in chips) 
Seat 6: HubertusB ($9.76 in chips) 
yurok_chess: posts small blind $0.02
roda-mala: posts big blind $0.05
*** HOLE CARDS ***
Dealt to HubertusB [6c Ac]
FoundingDadd: folds 
Neo254: folds 
HubertusB: raises $0.10 to $0.15
krezifrut: folds 
yurok_chess: folds 
roda-mala: calls $0.10
*** FLOP *** [3s 9d 2s]
roda-mala: checks 
HubertusB: bets $0.17
roda-mala: folds 
Uncalled bet ($0.17) returned to HubertusB
HubertusB collected $0.31 from pot
HubertusB: doesn't show hand 
*** SUMMARY ***
Total pot $0.32 | Rake $0.01 
Board [3s 9d 2s]
Seat 1: krezifrut (button) folded before Flop (didn't bet)
Seat 2: yurok_chess (small blind) folded before Flop
Seat 3: roda-mala (big blind) folded on the Flop
Seat 4: FoundingDadd folded before Flop (didn't bet)
Seat 5: Neo254 folded before Flop (didn't bet)
Seat 6: HubertusB collected ($0.31)



