PokerStars Zoom Hand #186643153332:  Hold'em No Limit ($0.02/$0.05) - 2018/05/20 20:08:46 CCT [2018/05/20 8:08:46 ET]
Table 'Donati' 6-max Seat #1 is the button
Seat 1: cassinho20 ($8.19 in chips) 
Seat 2: kingreigns ($6 in chips) 
Seat 3: HubertusB ($5 in chips) 
Seat 4: NICooLIN333 ($10.44 in chips) 
Seat 5: tt1210tt ($4.60 in chips) 
Seat 6: Siorassc ($5.02 in chips) 
kingreigns: posts small blind $0.02
HubertusB: posts big blind $0.05
*** HOLE CARDS ***
Dealt to HubertusB [Th Qs]
NICooLIN333: folds 
tt1210tt: folds 
Siorassc: folds 
cassinho20: folds 
kingreigns: raises $0.07 to $0.12
HubertusB: calls $0.07
*** FLOP *** [2d Ah Kd]
kingreigns: bets $0.15
HubertusB: folds 
Uncalled bet ($0.15) returned to kingreigns
kingreigns collected $0.23 from pot
kingreigns: doesn't show hand 
*** SUMMARY ***
Total pot $0.24 | Rake $0.01 
Board [2d Ah Kd]
Seat 1: cassinho20 (button) folded before Flop (didn't bet)
Seat 2: kingreigns (small blind) collected ($0.23)
Seat 3: HubertusB (big blind) folded on the Flop
Seat 4: NICooLIN333 folded before Flop (didn't bet)
Seat 5: tt1210tt folded before Flop (didn't bet)
Seat 6: Siorassc folded before Flop (didn't bet)



PokerStars Zoom Hand #186643167784:  Hold'em No Limit ($0.02/$0.05) - 2018/05/20 20:09:17 CCT [2018/05/20 8:09:17 ET]
Table 'Donati' 6-max Seat #1 is the button
Seat 1: ANN11061962 ($4.46 in chips) 
Seat 2: HubertusB ($4.88 in chips) 
Seat 3: Oscar__62176 ($5.69 in chips) 
Seat 4: pauwl12 ($7.21 in chips) 
Seat 5: dikiydemon ($5.32 in chips) 
Seat 6: BIBIGON123 ($5.05 in chips) 
HubertusB: posts small blind $0.02
Oscar__62176: posts big blind $0.05
*** HOLE CARDS ***
Dealt to HubertusB [6h 4d]
pauwl12: folds 
dikiydemon: folds 
BIBIGON123: raises $0.10 to $0.15
ANN11061962: folds 
HubertusB: folds 
Oscar__62176: folds 
Uncalled bet ($0.10) returned to BIBIGON123
BIBIGON123 collected $0.12 from pot
BIBIGON123: doesn't show hand 
*** SUMMARY ***
Total pot $0.12 | Rake $0 
Seat 1: ANN11061962 (button) folded before Flop (didn't bet)
Seat 2: HubertusB (small blind) folded before Flop
Seat 3: Oscar__62176 (big blind) folded before Flop
Seat 4: pauwl12 folded before Flop (didn't bet)
Seat 5: dikiydemon folded before Flop (didn't bet)
Seat 6: BIBIGON123 collected ($0.12)



PokerStars Zoom Hand #186643171498:  Hold'em No Limit ($0.02/$0.05) - 2018/05/20 20:09:25 CCT [2018/05/20 8:09:25 ET]
Table 'Donati' 6-max Seat #1 is the button
Seat 1: HubertusB ($4.86 in chips) 
Seat 2: jeffpig16 ($5.74 in chips) 
Seat 3: mengula007 ($11.71 in chips) 
Seat 4: kukkertje ($9.99 in chips) 
Seat 5: Adventuros ($3.79 in chips) 
Seat 6: aDYTKINa ($5.13 in chips) 
jeffpig16: posts small blind $0.02
mengula007: posts big blind $0.05
*** HOLE CARDS ***
Dealt to HubertusB [2c Kh]
kukkertje: raises $0.15 to $0.20
Adventuros: folds 
aDYTKINa: folds 
HubertusB: folds 
jeffpig16: folds 
mengula007: folds 
Uncalled bet ($0.15) returned to kukkertje
kukkertje collected $0.12 from pot
kukkertje: doesn't show hand 
*** SUMMARY ***
Total pot $0.12 | Rake $0 
Seat 1: HubertusB (button) folded before Flop (didn't bet)
Seat 2: jeffpig16 (small blind) folded before Flop
Seat 3: mengula007 (big blind) folded before Flop
Seat 4: kukkertje collected ($0.12)
Seat 5: Adventuros folded before Flop (didn't bet)
Seat 6: aDYTKINa folded before Flop (didn't bet)



PokerStars Zoom Hand #186643176149:  Hold'em No Limit ($0.02/$0.05) - 2018/05/20 20:09:35 CCT [2018/05/20 8:09:35 ET]
Table 'Donati' 6-max Seat #1 is the button
Seat 1: pokerhetty54 ($4.30 in chips) 
Seat 2: kukkertje ($10.06 in chips) 
Seat 3: Kirikulu ($5 in chips) 
Seat 4: N0$tradamu$ ($2.62 in chips) 
Seat 5: Gigike2222 ($1.90 in chips) 
Seat 6: HubertusB ($4.86 in chips) 
kukkertje: posts small blind $0.02
Kirikulu: posts big blind $0.05
*** HOLE CARDS ***
Dealt to HubertusB [Kd 3s]
N0$tradamu$: folds 
Gigike2222: folds 
HubertusB: folds 
pokerhetty54: folds 
kukkertje: folds 
Uncalled bet ($0.03) returned to Kirikulu
Kirikulu collected $0.04 from pot
Kirikulu: doesn't show hand 
*** SUMMARY ***
Total pot $0.04 | Rake $0 
Seat 1: pokerhetty54 (button) folded before Flop (didn't bet)
Seat 2: kukkertje (small blind) folded before Flop
Seat 3: Kirikulu (big blind) collected ($0.04)
Seat 4: N0$tradamu$ folded before Flop (didn't bet)
Seat 5: Gigike2222 folded before Flop (didn't bet)
Seat 6: HubertusB folded before Flop (didn't bet)



PokerStars Zoom Hand #186643182216:  Hold'em No Limit ($0.02/$0.05) - 2018/05/20 20:09:48 CCT [2018/05/20 8:09:48 ET]
Table 'Donati' 6-max Seat #1 is the button
Seat 1: Ka4ibuk@ ($5.13 in chips) 
Seat 2: FAHHH168 ($5.67 in chips) 
Seat 3: HubertusB ($4.86 in chips) 
Seat 4: Jeka Griva ($8.32 in chips) 
Seat 5: WeakmindedV1 ($8.35 in chips) 
Seat 6: ChubakaIII ($5.09 in chips) 
FAHHH168: posts small blind $0.02
HubertusB: posts big blind $0.05
*** HOLE CARDS ***
Dealt to HubertusB [Qc 9d]
Jeka Griva: folds 
WeakmindedV1: folds 
ChubakaIII: folds 
Ka4ibuk@: folds 
FAHHH168: folds 
Uncalled bet ($0.03) returned to HubertusB
HubertusB collected $0.04 from pot
HubertusB: doesn't show hand 
*** SUMMARY ***
Total pot $0.04 | Rake $0 
Seat 1: Ka4ibuk@ (button) folded before Flop (didn't bet)
Seat 2: FAHHH168 (small blind) folded before Flop
Seat 3: HubertusB (big blind) collected ($0.04)
Seat 4: Jeka Griva folded before Flop (didn't bet)
Seat 5: WeakmindedV1 folded before Flop (didn't bet)
Seat 6: ChubakaIII folded before Flop (didn't bet)



PokerStars Zoom Hand #186643178982:  Hold'em No Limit ($0.02/$0.05) - 2018/05/20 20:09:41 CCT [2018/05/20 8:09:41 ET]
Table 'Donati' 6-max Seat #1 is the button
Seat 1: TOMEF1CHA ($9.31 in chips) 
Seat 2: Gissbon ($6.09 in chips) 
Seat 3: Chinga4kuk ($5 in chips) 
Seat 4: BlackMoon57 ($4.71 in chips) 
Seat 5: HubertusB ($4.86 in chips) 
Seat 6: Mattiasgirl ($6.89 in chips) 
Gissbon: posts small blind $0.02
Chinga4kuk: posts big blind $0.05
*** HOLE CARDS ***
Dealt to HubertusB [4d Kh]
BlackMoon57: folds 
HubertusB: folds 
Mattiasgirl: folds 
TOMEF1CHA: folds 
Gissbon: folds 
Uncalled bet ($0.03) returned to Chinga4kuk
Chinga4kuk collected $0.04 from pot
Chinga4kuk: doesn't show hand 
*** SUMMARY ***
Total pot $0.04 | Rake $0 
Seat 1: TOMEF1CHA (button) folded before Flop (didn't bet)
Seat 2: Gissbon (small blind) folded before Flop
Seat 3: Chinga4kuk (big blind) collected ($0.04)
Seat 4: BlackMoon57 folded before Flop (didn't bet)
Seat 5: HubertusB folded before Flop (didn't bet)
Seat 6: Mattiasgirl folded before Flop (didn't bet)



PokerStars Zoom Hand #186643173818:  Hold'em No Limit ($0.02/$0.05) - 2018/05/20 20:09:30 CCT [2018/05/20 8:09:30 ET]
Table 'Donati' 6-max Seat #1 is the button
Seat 1: Savavlad97 ($8.60 in chips) 
Seat 2: CentricTie ($5.01 in chips) 
Seat 3: Ryduk.A ($5.14 in chips) 
Seat 4: HubertusB ($4.86 in chips) 
Seat 5: mengula007 ($11.66 in chips) 
Seat 6: Danil548 ($4.50 in chips) 
CentricTie: posts small blind $0.02
Ryduk.A: posts big blind $0.05
*** HOLE CARDS ***
Dealt to HubertusB [8d 4d]
HubertusB: folds 
mengula007: folds 
Danil548: raises $0.07 to $0.12
Savavlad97: folds 
CentricTie: calls $0.10
Ryduk.A: folds 
*** FLOP *** [6c 7s 4c]
CentricTie: checks 
Danil548: bets $0.08
CentricTie: calls $0.08
*** TURN *** [6c 7s 4c] [9d]
CentricTie: checks 
Danil548: bets $0.22
CentricTie: calls $0.22
*** RIVER *** [6c 7s 4c 9d] [3d]
CentricTie: checks 
Danil548: checks 
*** SHOW DOWN ***
CentricTie: shows [Tc Jc] (high card Jack)
Danil548: shows [9h Ac] (a pair of Nines)
Danil548 collected $0.85 from pot
*** SUMMARY ***
Total pot $0.89 | Rake $0.04 
Board [6c 7s 4c 9d 3d]
Seat 1: Savavlad97 (button) folded before Flop (didn't bet)
Seat 2: CentricTie (small blind) showed [Tc Jc] and lost with high card Jack
Seat 3: Ryduk.A (big blind) folded before Flop
Seat 4: HubertusB folded before Flop (didn't bet)
Seat 5: mengula007 folded before Flop (didn't bet)
Seat 6: Danil548 showed [9h Ac] and won ($0.85) with a pair of Nines



PokerStars Zoom Hand #186643188743:  Hold'em No Limit ($0.02/$0.05) - 2018/05/20 20:10:02 CCT [2018/05/20 8:10:02 ET]
Table 'Donati' 6-max Seat #1 is the button
Seat 1: HubertusB ($4.86 in chips) 
Seat 2: squ33z3r ($5.04 in chips) 
Seat 3: getcrunk187 ($9.72 in chips) 
Seat 4: Overhydra ($6.40 in chips) 
Seat 5: Danil548 ($4.93 in chips) 
Seat 6: jackpot2104 ($6.20 in chips) 
squ33z3r: posts small blind $0.02
getcrunk187: posts big blind $0.05
*** HOLE CARDS ***
Dealt to HubertusB [8s Th]
Overhydra: folds 
Danil548: folds 
jackpot2104: folds 
HubertusB: folds 
squ33z3r: folds 
Uncalled bet ($0.03) returned to getcrunk187
getcrunk187 collected $0.04 from pot
getcrunk187: doesn't show hand 
*** SUMMARY ***
Total pot $0.04 | Rake $0 
Seat 1: HubertusB (button) folded before Flop (didn't bet)
Seat 2: squ33z3r (small blind) folded before Flop
Seat 3: getcrunk187 (big blind) collected ($0.04)
Seat 4: Overhydra folded before Flop (didn't bet)
Seat 5: Danil548 folded before Flop (didn't bet)
Seat 6: jackpot2104 folded before Flop (didn't bet)



PokerStars Zoom Hand #186643185936:  Hold'em No Limit ($0.02/$0.05) - 2018/05/20 20:09:56 CCT [2018/05/20 8:09:56 ET]
Table 'Donati' 6-max Seat #1 is the button
Seat 1: FFTx ($5.63 in chips) 
Seat 2: HubertusB ($4.88 in chips) 
Seat 3: ChubakaIII ($5.11 in chips) 
Seat 4: Ezhewika ($1.86 in chips) 
Seat 5: iKiiiLL4fun ($21.02 in chips) 
Seat 6: bushman86511 ($8.78 in chips) 
HubertusB: posts small blind $0.02
ChubakaIII: posts big blind $0.05
*** HOLE CARDS ***
Dealt to HubertusB [9h 5d]
Ezhewika: folds 
iKiiiLL4fun: raises $0.10 to $0.15
bushman86511: folds 
FFTx: folds 
HubertusB: folds 
ChubakaIII: raises $0.35 to $0.50
iKiiiLL4fun: folds 
Uncalled bet ($0.35) returned to ChubakaIII
ChubakaIII collected $0.32 from pot
ChubakaIII: doesn't show hand 
*** SUMMARY ***
Total pot $0.32 | Rake $0 
Seat 1: FFTx (button) folded before Flop (didn't bet)
Seat 2: HubertusB (small blind) folded before Flop
Seat 3: ChubakaIII (big blind) collected ($0.32)
Seat 4: Ezhewika folded before Flop (didn't bet)
Seat 5: iKiiiLL4fun folded before Flop
Seat 6: bushman86511 folded before Flop (didn't bet)



PokerStars Zoom Hand #186643197593:  Hold'em No Limit ($0.02/$0.05) - 2018/05/20 20:10:21 CCT [2018/05/20 8:10:21 ET]
Table 'Donati' 6-max Seat #1 is the button
Seat 1: esquime72 ($3.62 in chips) 
Seat 2: HubertusB ($4.86 in chips) 
Seat 3: hopsom ($7.08 in chips) 
Seat 4: raf9505 ($5.91 in chips) 
Seat 5: UltraRunnerr ($18.63 in chips) 
Seat 6: bamboocha88 ($10.20 in chips) 
HubertusB: posts small blind $0.02
hopsom: posts big blind $0.05
*** HOLE CARDS ***
Dealt to HubertusB [6c Kd]
raf9505: folds 
UltraRunnerr: folds 
bamboocha88: folds 
esquime72: folds 
HubertusB: folds 
Uncalled bet ($0.03) returned to hopsom
hopsom collected $0.04 from pot
hopsom: doesn't show hand 
*** SUMMARY ***
Total pot $0.04 | Rake $0 
Seat 1: esquime72 (button) folded before Flop (didn't bet)
Seat 2: HubertusB (small blind) folded before Flop
Seat 3: hopsom (big blind) collected ($0.04)
Seat 4: raf9505 folded before Flop (didn't bet)
Seat 5: UltraRunnerr folded before Flop (didn't bet)
Seat 6: bamboocha88 folded before Flop (didn't bet)



PokerStars Zoom Hand #186643192004:  Hold'em No Limit ($0.02/$0.05) - 2018/05/20 20:10:09 CCT [2018/05/20 8:10:09 ET]
Table 'Donati' 6-max Seat #1 is the button
Seat 1: djnemesis101 ($5.85 in chips) 
Seat 2: EventasT ($13.09 in chips) 
Seat 3: 2 SHOGUN 2 ($0.99 in chips) 
Seat 4: zapzarap@patent ($5.53 in chips) 
Seat 5: olivier070 ($5 in chips) 
Seat 6: HubertusB ($4.86 in chips) 
EventasT: posts small blind $0.02
2 SHOGUN 2: posts big blind $0.05
*** HOLE CARDS ***
Dealt to HubertusB [7c Qs]
zapzarap@patent: folds 
olivier070: folds 
HubertusB: folds 
djnemesis101: folds 
EventasT: calls $0.03
2 SHOGUN 2: checks 
*** FLOP *** [8h 2c Jc]
EventasT: bets $0.05
2 SHOGUN 2: folds 
Uncalled bet ($0.05) returned to EventasT
EventasT collected $0.10 from pot
EventasT: doesn't show hand 
*** SUMMARY ***
Total pot $0.10 | Rake $0 
Board [8h 2c Jc]
Seat 1: djnemesis101 (button) folded before Flop (didn't bet)
Seat 2: EventasT (small blind) collected ($0.10)
Seat 3: 2 SHOGUN 2 (big blind) folded on the Flop
Seat 4: zapzarap@patent folded before Flop (didn't bet)
Seat 5: olivier070 folded before Flop (didn't bet)
Seat 6: HubertusB folded before Flop (didn't bet)



PokerStars Zoom Hand #186643195270:  Hold'em No Limit ($0.02/$0.05) - 2018/05/20 20:10:16 CCT [2018/05/20 8:10:16 ET]
Table 'Donati' 6-max Seat #1 is the button
Seat 1: ChubakaIII ($5.04 in chips) 
Seat 2: UltraRunnerr ($10.54 in chips) 
Seat 3: 1Sania1 ($5.98 in chips) 
Seat 4: kagurasiori ($6.16 in chips) 
Seat 5: HubertusB ($4.86 in chips) 
Seat 6: offuca ($5.22 in chips) 
UltraRunnerr: posts small blind $0.02
1Sania1: posts big blind $0.05
*** HOLE CARDS ***
Dealt to HubertusB [2d 8h]
kagurasiori: folds 
HubertusB: folds 
offuca: folds 
ChubakaIII: raises $0.05 to $0.10
UltraRunnerr: folds 
1Sania1: calls $0.05
*** FLOP *** [4c Tc 5d]
1Sania1: checks 
ChubakaIII: bets $0.15
1Sania1: calls $0.15
*** TURN *** [4c Tc 5d] [6c]
1Sania1: checks 
ChubakaIII: checks 
*** RIVER *** [4c Tc 5d 6c] [7s]
1Sania1: bets $0.25
ChubakaIII: calls $0.25
*** SHOW DOWN ***
1Sania1: shows [Qd Ts] (a pair of Tens)
ChubakaIII: shows [4s 4h] (three of a kind, Fours)
ChubakaIII collected $0.98 from pot
*** SUMMARY ***
Total pot $1.02 | Rake $0.04 
Board [4c Tc 5d 6c 7s]
Seat 1: ChubakaIII (button) showed [4s 4h] and won ($0.98) with three of a kind, Fours
Seat 2: UltraRunnerr (small blind) folded before Flop
Seat 3: 1Sania1 (big blind) showed [Qd Ts] and lost with a pair of Tens
Seat 4: kagurasiori folded before Flop (didn't bet)
Seat 5: HubertusB folded before Flop (didn't bet)
Seat 6: offuca folded before Flop (didn't bet)



PokerStars Zoom Hand #186643200117:  Hold'em No Limit ($0.02/$0.05) - 2018/05/20 20:10:26 CCT [2018/05/20 8:10:26 ET]
Table 'Donati' 6-max Seat #1 is the button
Seat 1: PanamaStone ($7.86 in chips) 
Seat 2: barbos2009 ($20.09 in chips) 
Seat 3: HubertusB ($4.84 in chips) 
Seat 4: Chinga4kuk ($5.14 in chips) 
Seat 5: analgin55 ($4.95 in chips) 
Seat 6: faustus1903 ($5.65 in chips) 
barbos2009: posts small blind $0.02
HubertusB: posts big blind $0.05
*** HOLE CARDS ***
Dealt to HubertusB [Qh Ks]
Chinga4kuk: folds 
analgin55: folds 
faustus1903: raises $0.10 to $0.15
PanamaStone: folds 
barbos2009: calls $0.13
HubertusB: calls $0.10
*** FLOP *** [7h 9h Ah]
barbos2009: checks 
HubertusB: bets $0.15
faustus1903: folds 
barbos2009: calls $0.15
*** TURN *** [7h 9h Ah] [3s]
barbos2009: checks 
HubertusB: checks 
*** RIVER *** [7h 9h Ah 3s] [Qd]
barbos2009: checks 
HubertusB: checks 
*** SHOW DOWN ***
barbos2009: shows [Ad 9d] (two pair, Aces and Nines)
HubertusB: mucks hand 
barbos2009 collected $0.72 from pot
*** SUMMARY ***
Total pot $0.75 | Rake $0.03 
Board [7h 9h Ah 3s Qd]
Seat 1: PanamaStone (button) folded before Flop (didn't bet)
Seat 2: barbos2009 (small blind) showed [Ad 9d] and won ($0.72) with two pair, Aces and Nines
Seat 3: HubertusB (big blind) mucked [Qh Ks]
Seat 4: Chinga4kuk folded before Flop (didn't bet)
Seat 5: analgin55 folded before Flop (didn't bet)
Seat 6: faustus1903 folded on the Flop



PokerStars Zoom Hand #186643220813:  Hold'em No Limit ($0.02/$0.05) - 2018/05/20 20:11:10 CCT [2018/05/20 8:11:10 ET]
Table 'Donati' 6-max Seat #1 is the button
Seat 1: HubertusB ($4.54 in chips) 
Seat 2: LuckyBBastar ($14.61 in chips) 
Seat 3: dinfor ($5.35 in chips) 
Seat 4: saha555 ($8.21 in chips) 
Seat 5: JO9JO243 ($7.94 in chips) 
Seat 6: artaxruciv ($5.10 in chips) 
LuckyBBastar: posts small blind $0.02
dinfor: posts big blind $0.05
*** HOLE CARDS ***
Dealt to HubertusB [7c 5d]
saha555: folds 
JO9JO243: folds 
artaxruciv: folds 
HubertusB: folds 
LuckyBBastar: folds 
Uncalled bet ($0.03) returned to dinfor
dinfor collected $0.04 from pot
dinfor: doesn't show hand 
*** SUMMARY ***
Total pot $0.04 | Rake $0 
Seat 1: HubertusB (button) folded before Flop (didn't bet)
Seat 2: LuckyBBastar (small blind) folded before Flop
Seat 3: dinfor (big blind) collected ($0.04)
Seat 4: saha555 folded before Flop (didn't bet)
Seat 5: JO9JO243 folded before Flop (didn't bet)
Seat 6: artaxruciv folded before Flop (didn't bet)



PokerStars Zoom Hand #186643224537:  Hold'em No Limit ($0.02/$0.05) - 2018/05/20 20:11:18 CCT [2018/05/20 8:11:18 ET]
Table 'Donati' 6-max Seat #1 is the button
Seat 1: serge87100 ($5 in chips) 
Seat 2: serg197211 ($5.55 in chips) 
Seat 3: 1Sania1 ($5.46 in chips) 
Seat 4: Ka4ibuk@ ($5 in chips) 
Seat 5: HubertusB ($4.54 in chips) 
Seat 6: esquime72 ($6.85 in chips) 
serg197211: posts small blind $0.02
1Sania1: posts big blind $0.05
*** HOLE CARDS ***
Dealt to HubertusB [4c 2s]
Ka4ibuk@: folds 
HubertusB: folds 
esquime72: folds 
serge87100: folds 
serg197211: raises $0.10 to $0.15
1Sania1: calls $0.10
*** FLOP *** [Td Qs Ad]
serg197211: checks 
1Sania1: bets $0.14
serg197211: folds 
Uncalled bet ($0.14) returned to 1Sania1
1Sania1 collected $0.29 from pot
1Sania1: doesn't show hand 
*** SUMMARY ***
Total pot $0.30 | Rake $0.01 
Board [Td Qs Ad]
Seat 1: serge87100 (button) folded before Flop (didn't bet)
Seat 2: serg197211 (small blind) folded on the Flop
Seat 3: 1Sania1 (big blind) collected ($0.29)
Seat 4: Ka4ibuk@ folded before Flop (didn't bet)
Seat 5: HubertusB folded before Flop (didn't bet)
Seat 6: esquime72 folded before Flop (didn't bet)



PokerStars Zoom Hand #186643232916:  Hold'em No Limit ($0.02/$0.05) - 2018/05/20 20:11:36 CCT [2018/05/20 8:11:36 ET]
Table 'Donati' 6-max Seat #1 is the button
Seat 1: JO9JO243 ($7.94 in chips) 
Seat 2: zwetok ($10.20 in chips) 
Seat 3: Gissbon ($5.48 in chips) 
Seat 4: BL4CK11 ($13.25 in chips) 
Seat 5: HubertusB ($4.54 in chips) 
Seat 6: lasyboy999 ($9.77 in chips) 
zwetok: posts small blind $0.02
Gissbon: posts big blind $0.05
*** HOLE CARDS ***
Dealt to HubertusB [Kc 3d]
BL4CK11: folds 
HubertusB: folds 
lasyboy999: folds 
JO9JO243: folds 
zwetok: folds 
Uncalled bet ($0.03) returned to Gissbon
Gissbon collected $0.04 from pot
Gissbon: doesn't show hand 
*** SUMMARY ***
Total pot $0.04 | Rake $0 
Seat 1: JO9JO243 (button) folded before Flop (didn't bet)
Seat 2: zwetok (small blind) folded before Flop
Seat 3: Gissbon (big blind) collected ($0.04)
Seat 4: BL4CK11 folded before Flop (didn't bet)
Seat 5: HubertusB folded before Flop (didn't bet)
Seat 6: lasyboy999 folded before Flop (didn't bet)



PokerStars Zoom Hand #186643239139:  Hold'em No Limit ($0.02/$0.05) - 2018/05/20 20:11:49 CCT [2018/05/20 8:11:49 ET]
Table 'Donati' 6-max Seat #1 is the button
Seat 1: BPRiemann ($2.88 in chips) 
Seat 2: HubertusB ($4.49 in chips) 
Seat 3: MaStErOwns01 ($10.99 in chips) 
Seat 4: Vinegar2 ($6.71 in chips) 
Seat 5: DonkKing433 ($6.06 in chips) 
Seat 6: kayck07 ($18.40 in chips) 
HubertusB: posts small blind $0.02
MaStErOwns01: posts big blind $0.05
*** HOLE CARDS ***
Dealt to HubertusB [Ad Kd]
Vinegar2: folds 
DonkKing433: raises $0.10 to $0.15
kayck07: folds 
BPRiemann: folds 
HubertusB: raises $0.35 to $0.50
MaStErOwns01: folds 
DonkKing433: folds 
Uncalled bet ($0.35) returned to HubertusB
HubertusB collected $0.35 from pot
HubertusB: doesn't show hand 
*** SUMMARY ***
Total pot $0.35 | Rake $0 
Seat 1: BPRiemann (button) folded before Flop (didn't bet)
Seat 2: HubertusB (small blind) collected ($0.35)
Seat 3: MaStErOwns01 (big blind) folded before Flop
Seat 4: Vinegar2 folded before Flop (didn't bet)
Seat 5: DonkKing433 folded before Flop
Seat 6: kayck07 folded before Flop (didn't bet)



PokerStars Zoom Hand #186643230572:  Hold'em No Limit ($0.02/$0.05) - 2018/05/20 20:11:31 CCT [2018/05/20 8:11:31 ET]
Table 'Donati' 6-max Seat #1 is the button
Seat 1: wessel2908 ($29.48 in chips) 
Seat 2: martyfullll ($6.10 in chips) 
Seat 3: Stademann01 ($5 in chips) 
Seat 4: HubertusB ($4.54 in chips) 
Seat 5: orangedeuce ($6.28 in chips) 
Seat 6: TheN@kedGun ($5 in chips) 
martyfullll: posts small blind $0.02
Stademann01: posts big blind $0.05
*** HOLE CARDS ***
Dealt to HubertusB [2c Qs]
HubertusB: folds 
orangedeuce: raises $0.10 to $0.15
TheN@kedGun: calls $0.15
wessel2908: folds 
martyfullll: folds 
Stademann01: calls $0.10
*** FLOP *** [9h Kh Kc]
Stademann01: bets $0.18
orangedeuce: folds 
TheN@kedGun: folds 
Uncalled bet ($0.18) returned to Stademann01
Stademann01 collected $0.45 from pot
Stademann01: doesn't show hand 
*** SUMMARY ***
Total pot $0.47 | Rake $0.02 
Board [9h Kh Kc]
Seat 1: wessel2908 (button) folded before Flop (didn't bet)
Seat 2: martyfullll (small blind) folded before Flop
Seat 3: Stademann01 (big blind) collected ($0.45)
Seat 4: HubertusB folded before Flop (didn't bet)
Seat 5: orangedeuce folded on the Flop
Seat 6: TheN@kedGun folded on the Flop



PokerStars Zoom Hand #186643226881:  Hold'em No Limit ($0.02/$0.05) - 2018/05/20 20:11:23 CCT [2018/05/20 8:11:23 ET]
Table 'Donati' 6-max Seat #1 is the button
Seat 1: Hilario1983 ($7.19 in chips) 
Seat 2: Julietta1997 ($4.41 in chips) 
Seat 3: NaomiLou14 ($5.79 in chips) 
Seat 4: mamel7777 ($11.36 in chips) 
Seat 5: serge87100 ($5 in chips) 
Seat 6: HubertusB ($4.54 in chips) 
Julietta1997: posts small blind $0.02
NaomiLou14: posts big blind $0.05
*** HOLE CARDS ***
Dealt to HubertusB [2d 5d]
mamel7777: folds 
serge87100: folds 
HubertusB: folds 
Hilario1983: raises $0.15 to $0.20
Julietta1997: folds 
NaomiLou14: calls $0.15
*** FLOP *** [4c Qs 4s]
NaomiLou14: checks 
Hilario1983: checks 
*** TURN *** [4c Qs 4s] [9d]
NaomiLou14: checks 
Hilario1983: checks 
*** RIVER *** [4c Qs 4s 9d] [Qd]
NaomiLou14: checks 
Hilario1983: checks 
*** SHOW DOWN ***
NaomiLou14: shows [5c 8s] (two pair, Queens and Fours)
Hilario1983: shows [Jh Ah] (two pair, Queens and Fours - Ace kicker)
Hilario1983 collected $0.40 from pot
*** SUMMARY ***
Total pot $0.42 | Rake $0.02 
Board [4c Qs 4s 9d Qd]
Seat 1: Hilario1983 (button) showed [Jh Ah] and won ($0.40) with two pair, Queens and Fours
Seat 2: Julietta1997 (small blind) folded before Flop
Seat 3: NaomiLou14 (big blind) showed [5c 8s] and lost with two pair, Queens and Fours
Seat 4: mamel7777 folded before Flop (didn't bet)
Seat 5: serge87100 folded before Flop (didn't bet)
Seat 6: HubertusB folded before Flop (didn't bet)



PokerStars Zoom Hand #186643246168:  Hold'em No Limit ($0.02/$0.05) - 2018/05/20 20:12:04 CCT [2018/05/20 8:12:04 ET]
Table 'Donati' 6-max Seat #1 is the button
Seat 1: HubertusB ($4.69 in chips) 
Seat 2: djnemesis101 ($6.30 in chips) 
Seat 3: mamel7777 ($5.30 in chips) 
Seat 4: Marian V. 31 ($5.77 in chips) 
Seat 5: VLSALT ($5 in chips) 
Seat 6: BL4CK11 ($13.41 in chips) 
djnemesis101: posts small blind $0.02
mamel7777: posts big blind $0.05
*** HOLE CARDS ***
Dealt to HubertusB [Th 5c]
Marian V. 31: folds 
VLSALT: raises $0.10 to $0.15
BL4CK11: folds 
HubertusB: folds 
djnemesis101: folds 
mamel7777: folds 
Uncalled bet ($0.10) returned to VLSALT
VLSALT collected $0.12 from pot
VLSALT: doesn't show hand 
*** SUMMARY ***
Total pot $0.12 | Rake $0 
Seat 1: HubertusB (button) folded before Flop (didn't bet)
Seat 2: djnemesis101 (small blind) folded before Flop
Seat 3: mamel7777 (big blind) folded before Flop
Seat 4: Marian V. 31 folded before Flop (didn't bet)
Seat 5: VLSALT collected ($0.12)
Seat 6: BL4CK11 folded before Flop (didn't bet)



PokerStars Zoom Hand #186643248556:  Hold'em No Limit ($0.02/$0.05) - 2018/05/20 20:12:09 CCT [2018/05/20 8:12:09 ET]
Table 'Donati' 6-max Seat #1 is the button
Seat 1: djnemesis101 ($11.28 in chips) 
Seat 2: Mr. Belvit ($5 in chips) 
Seat 3: andrzej4fun ($7.84 in chips) 
Seat 4: HubertusB ($4.69 in chips) 
Seat 5: kingreigns ($6.61 in chips) 
Seat 6: zapzarap@patent ($8.28 in chips) 
Mr. Belvit: posts small blind $0.02
andrzej4fun: posts big blind $0.05
*** HOLE CARDS ***
Dealt to HubertusB [4d 5d]
HubertusB: folds 
kingreigns: folds 
zapzarap@patent: folds 
djnemesis101: folds 
Mr. Belvit: folds 
Uncalled bet ($0.03) returned to andrzej4fun
andrzej4fun collected $0.04 from pot
andrzej4fun: doesn't show hand 
*** SUMMARY ***
Total pot $0.04 | Rake $0 
Seat 1: djnemesis101 (button) folded before Flop (didn't bet)
Seat 2: Mr. Belvit (small blind) folded before Flop
Seat 3: andrzej4fun (big blind) collected ($0.04)
Seat 4: HubertusB folded before Flop (didn't bet)
Seat 5: kingreigns folded before Flop (didn't bet)
Seat 6: zapzarap@patent folded before Flop (didn't bet)



PokerStars Zoom Hand #186643235321:  Hold'em No Limit ($0.02/$0.05) - 2018/05/20 20:11:41 CCT [2018/05/20 8:11:41 ET]
Table 'Donati' 6-max Seat #1 is the button
Seat 1: Arrenea ($6.13 in chips) 
Seat 2: Overhydra ($10.57 in chips) 
Seat 3: HubertusB ($4.54 in chips) 
Seat 4: 1Sania1 ($5.72 in chips) 
Seat 5: fimbul11 ($10.28 in chips) 
Seat 6: res888122 ($2.43 in chips) 
Overhydra: posts small blind $0.02
HubertusB: posts big blind $0.05
*** HOLE CARDS ***
Dealt to HubertusB [7c 8h]
1Sania1: raises $0.10 to $0.15
fimbul11: folds 
res888122: raises $0.10 to $0.25
Arrenea: folds 
Overhydra: folds 
HubertusB: folds 
1Sania1: calls $0.10
*** FLOP *** [2d 5h 7h]
1Sania1: checks 
res888122: bets $0.10
1Sania1: calls $0.10
*** TURN *** [2d 5h 7h] [2c]
1Sania1: checks 
res888122: bets $0.40
1Sania1: folds 
Uncalled bet ($0.40) returned to res888122
res888122 collected $0.74 from pot
res888122: doesn't show hand 
*** SUMMARY ***
Total pot $0.77 | Rake $0.03 
Board [2d 5h 7h 2c]
Seat 1: Arrenea (button) folded before Flop (didn't bet)
Seat 2: Overhydra (small blind) folded before Flop
Seat 3: HubertusB (big blind) folded before Flop
Seat 4: 1Sania1 folded on the Turn
Seat 5: fimbul11 folded before Flop (didn't bet)
Seat 6: res888122 collected ($0.74)



PokerStars Zoom Hand #186643256064:  Hold'em No Limit ($0.02/$0.05) - 2018/05/20 20:12:25 CCT [2018/05/20 8:12:25 ET]
Table 'Donati' 6-max Seat #1 is the button
Seat 1: nightm71 ($5.40 in chips) 
Seat 2: HubertusB ($4.64 in chips) 
Seat 3: aDYTKINa ($5 in chips) 
Seat 4: zwetok ($5 in chips) 
Seat 5: silver78888 ($4.61 in chips) 
Seat 6: Omicron333 ($5.32 in chips) 
HubertusB: posts small blind $0.02
aDYTKINa: posts big blind $0.05
*** HOLE CARDS ***
Dealt to HubertusB [8c 7h]
zwetok: folds 
silver78888: folds 
Omicron333: raises $0.10 to $0.15
nightm71: folds 
HubertusB: folds 
aDYTKINa: folds 
Uncalled bet ($0.10) returned to Omicron333
Omicron333 collected $0.12 from pot
Omicron333: doesn't show hand 
*** SUMMARY ***
Total pot $0.12 | Rake $0 
Seat 1: nightm71 (button) folded before Flop (didn't bet)
Seat 2: HubertusB (small blind) folded before Flop
Seat 3: aDYTKINa (big blind) folded before Flop
Seat 4: zwetok folded before Flop (didn't bet)
Seat 5: silver78888 folded before Flop (didn't bet)
Seat 6: Omicron333 collected ($0.12)



PokerStars Zoom Hand #186643251371:  Hold'em No Limit ($0.02/$0.05) - 2018/05/20 20:12:15 CCT [2018/05/20 8:12:15 ET]
Table 'Donati' 6-max Seat #1 is the button
Seat 1: kogorou999 ($5.49 in chips) 
Seat 2: Chinga4kuk ($5 in chips) 
Seat 3: HubertusB ($4.69 in chips) 
Seat 4: lukeymandy ($7.24 in chips) 
Seat 5: slob43.ru ($4.70 in chips) 
Seat 6: Gissbon ($6.05 in chips) 
Chinga4kuk: posts small blind $0.02
HubertusB: posts big blind $0.05
*** HOLE CARDS ***
Dealt to HubertusB [9h Td]
lukeymandy: folds 
slob43.ru: raises $0.10 to $0.15
Gissbon: folds 
kogorou999: raises $0.30 to $0.45
Chinga4kuk: folds 
HubertusB: folds 
slob43.ru: folds 
Uncalled bet ($0.30) returned to kogorou999
kogorou999 collected $0.37 from pot
kogorou999: doesn't show hand 
*** SUMMARY ***
Total pot $0.37 | Rake $0 
Seat 1: kogorou999 (button) collected ($0.37)
Seat 2: Chinga4kuk (small blind) folded before Flop
Seat 3: HubertusB (big blind) folded before Flop
Seat 4: lukeymandy folded before Flop (didn't bet)
Seat 5: slob43.ru folded before Flop
Seat 6: Gissbon folded before Flop (didn't bet)



PokerStars Zoom Hand #186643263634:  Hold'em No Limit ($0.02/$0.05) - 2018/05/20 20:12:41 CCT [2018/05/20 8:12:41 ET]
Table 'Donati' 6-max Seat #1 is the button
Seat 1: hopsom ($16.40 in chips) 
Seat 2: Julietta1997 ($4.39 in chips) 
Seat 3: Unclesmoll ($4.27 in chips) 
Seat 4: HubertusB ($4.62 in chips) 
Seat 5: Vinegar2 ($6.82 in chips) 
Seat 6: djnemesis101 ($7.85 in chips) 
Julietta1997: posts small blind $0.02
Unclesmoll: posts big blind $0.05
*** HOLE CARDS ***
Dealt to HubertusB [8d Jd]
HubertusB: folds 
Vinegar2: folds 
djnemesis101: folds 
hopsom: folds 
Julietta1997: raises $0.15 to $0.20
Unclesmoll: folds 
Uncalled bet ($0.15) returned to Julietta1997
Julietta1997 collected $0.10 from pot
Julietta1997: doesn't show hand 
*** SUMMARY ***
Total pot $0.10 | Rake $0 
Seat 1: hopsom (button) folded before Flop (didn't bet)
Seat 2: Julietta1997 (small blind) collected ($0.10)
Seat 3: Unclesmoll (big blind) folded before Flop
Seat 4: HubertusB folded before Flop (didn't bet)
Seat 5: Vinegar2 folded before Flop (didn't bet)
Seat 6: djnemesis101 folded before Flop (didn't bet)



PokerStars Zoom Hand #186643266856:  Hold'em No Limit ($0.02/$0.05) - 2018/05/20 20:12:48 CCT [2018/05/20 8:12:48 ET]
Table 'Donati' 6-max Seat #1 is the button
Seat 1: trol_panda ($5.38 in chips) 
Seat 2: TehPokeHerer ($10.25 in chips) 
Seat 3: Danil548 ($5.28 in chips) 
Seat 4: ChubakaIII ($5.36 in chips) 
Seat 5: HubertusB ($4.62 in chips) 
Seat 6: edy1991 ($2.21 in chips) 
TehPokeHerer: posts small blind $0.02
Danil548: posts big blind $0.05
*** HOLE CARDS ***
Dealt to HubertusB [Ac 3d]
ChubakaIII: folds 
HubertusB: folds 
edy1991: folds 
trol_panda: raises $0.10 to $0.15
TehPokeHerer: folds 
Danil548: folds 
Uncalled bet ($0.10) returned to trol_panda
trol_panda collected $0.12 from pot
trol_panda: doesn't show hand 
*** SUMMARY ***
Total pot $0.12 | Rake $0 
Seat 1: trol_panda (button) collected ($0.12)
Seat 2: TehPokeHerer (small blind) folded before Flop
Seat 3: Danil548 (big blind) folded before Flop
Seat 4: ChubakaIII folded before Flop (didn't bet)
Seat 5: HubertusB folded before Flop (didn't bet)
Seat 6: edy1991 folded before Flop (didn't bet)



PokerStars Zoom Hand #186643272476:  Hold'em No Limit ($0.02/$0.05) - 2018/05/20 20:13:00 CCT [2018/05/20 8:13:00 ET]
Table 'Donati' 6-max Seat #1 is the button
Seat 1: tt1210tt ($4.91 in chips) 
Seat 2: kukkertje ($8.44 in chips) 
Seat 3: HubertusB ($4.62 in chips) 
Seat 4: BL4CK11 ($10.48 in chips) 
Seat 5: mamel7777 ($8.95 in chips) 
Seat 6: DavorDG5 ($1.22 in chips) 
kukkertje: posts small blind $0.02
HubertusB: posts big blind $0.05
*** HOLE CARDS ***
Dealt to HubertusB [Js 2d]
BL4CK11: folds 
mamel7777: raises $0.10 to $0.15
DavorDG5: folds 
tt1210tt: folds 
kukkertje: folds 
HubertusB: folds 
Uncalled bet ($0.10) returned to mamel7777
mamel7777 collected $0.12 from pot
mamel7777: doesn't show hand 
*** SUMMARY ***
Total pot $0.12 | Rake $0 
Seat 1: tt1210tt (button) folded before Flop (didn't bet)
Seat 2: kukkertje (small blind) folded before Flop
Seat 3: HubertusB (big blind) folded before Flop
Seat 4: BL4CK11 folded before Flop (didn't bet)
Seat 5: mamel7777 collected ($0.12)
Seat 6: DavorDG5 folded before Flop (didn't bet)



PokerStars Zoom Hand #186643258865:  Hold'em No Limit ($0.02/$0.05) - 2018/05/20 20:12:31 CCT [2018/05/20 8:12:31 ET]
Table 'Donati' 6-max Seat #1 is the button
Seat 1: Gissbon ($5.41 in chips) 
Seat 2: sedoi746 ($7.78 in chips) 
Seat 3: 2 SHOGUN 2 ($6.56 in chips) 
Seat 4: Kirikulu ($5.29 in chips) 
Seat 5: mamel7777 ($5.23 in chips) 
Seat 6: HubertusB ($4.62 in chips) 
sedoi746: posts small blind $0.02
2 SHOGUN 2: posts big blind $0.05
*** HOLE CARDS ***
Dealt to HubertusB [5d Js]
Kirikulu: folds 
mamel7777: folds 
HubertusB: folds 
Gissbon: raises $0.07 to $0.12
sedoi746: folds 
2 SHOGUN 2: calls $0.07
*** FLOP *** [3s 9c Ts]
2 SHOGUN 2: checks 
Gissbon: checks 
*** TURN *** [3s 9c Ts] [3c]
2 SHOGUN 2: checks 
Gissbon: checks 
*** RIVER *** [3s 9c Ts 3c] [8d]
2 SHOGUN 2: checks 
Gissbon: checks 
*** SHOW DOWN ***
2 SHOGUN 2: shows [5h 6s] (a pair of Threes)
Gissbon: shows [Ac 2c] (a pair of Threes - Ace kicker)
Gissbon collected $0.25 from pot
*** SUMMARY ***
Total pot $0.26 | Rake $0.01 
Board [3s 9c Ts 3c 8d]
Seat 1: Gissbon (button) showed [Ac 2c] and won ($0.25) with a pair of Threes
Seat 2: sedoi746 (small blind) folded before Flop
Seat 3: 2 SHOGUN 2 (big blind) showed [5h 6s] and lost with a pair of Threes
Seat 4: Kirikulu folded before Flop (didn't bet)
Seat 5: mamel7777 folded before Flop (didn't bet)
Seat 6: HubertusB folded before Flop (didn't bet)



PokerStars Zoom Hand #186643261724:  Hold'em No Limit ($0.02/$0.05) - 2018/05/20 20:12:37 CCT [2018/05/20 8:12:37 ET]
Table 'Donati' 6-max Seat #1 is the button
Seat 1: HubertusB ($4.62 in chips) 
Seat 2: TopBlued ($6.05 in chips) 
Seat 3: saleriver ($5.93 in chips) 
Seat 4: FFTx ($5.50 in chips) 
Seat 5: NICooLIN333 ($10.12 in chips) 
Seat 6: silver78888 ($4.61 in chips) 
TopBlued: posts small blind $0.02
saleriver: posts big blind $0.05
*** HOLE CARDS ***
Dealt to HubertusB [7s 2h]
FFTx: folds 
NICooLIN333: folds 
silver78888: folds 
HubertusB: folds 
TopBlued: raises $0.06 to $0.11
saleriver: calls $0.06
*** FLOP *** [6c Ts 5h]
TopBlued: bets $0.11
saleriver: raises $0.24 to $0.35
TopBlued: calls $0.24
*** TURN *** [6c Ts 5h] [Kd]
TopBlued: checks 
saleriver: checks 
*** RIVER *** [6c Ts 5h Kd] [Kc]
TopBlued: bets $0.28
saleriver: folds 
Uncalled bet ($0.28) returned to TopBlued
TopBlued collected $0.88 from pot
TopBlued: doesn't show hand 
*** SUMMARY ***
Total pot $0.92 | Rake $0.04 
Board [6c Ts 5h Kd Kc]
Seat 1: HubertusB (button) folded before Flop (didn't bet)
Seat 2: TopBlued (small blind) collected ($0.88)
Seat 3: saleriver (big blind) folded on the River
Seat 4: FFTx folded before Flop (didn't bet)
Seat 5: NICooLIN333 folded before Flop (didn't bet)
Seat 6: silver78888 folded before Flop (didn't bet)



PokerStars Zoom Hand #186643276308:  Hold'em No Limit ($0.02/$0.05) - 2018/05/20 20:13:08 CCT [2018/05/20 8:13:08 ET]
Table 'Donati' 6-max Seat #1 is the button
Seat 1: HubertusB ($4.57 in chips) 
Seat 2: EventasT ($12.59 in chips) 
Seat 3: Reece1985 ($12.80 in chips) 
Seat 4: luka1981good ($5 in chips) 
Seat 5: JO9JO243 ($5.04 in chips) 
Seat 6: aDYTKINa ($5 in chips) 
EventasT: posts small blind $0.02
Reece1985: posts big blind $0.05
*** HOLE CARDS ***
Dealt to HubertusB [5c 4c]
luka1981good: folds 
JO9JO243: folds 
aDYTKINa: folds 
HubertusB: raises $0.10 to $0.15
EventasT: raises $0.25 to $0.40
Reece1985: folds 
HubertusB: folds 
Uncalled bet ($0.25) returned to EventasT
EventasT collected $0.35 from pot
EventasT: doesn't show hand 
*** SUMMARY ***
Total pot $0.35 | Rake $0 
Seat 1: HubertusB (button) folded before Flop
Seat 2: EventasT (small blind) collected ($0.35)
Seat 3: Reece1985 (big blind) folded before Flop
Seat 4: luka1981good folded before Flop (didn't bet)
Seat 5: JO9JO243 folded before Flop (didn't bet)
Seat 6: aDYTKINa folded before Flop (didn't bet)



PokerStars Zoom Hand #186643269646:  Hold'em No Limit ($0.02/$0.05) - 2018/05/20 20:12:54 CCT [2018/05/20 8:12:54 ET]
Table 'Donati' 6-max Seat #1 is the button
Seat 1: Valerij V.S. ($4.02 in chips) 
Seat 2: barbos2009 ($20.28 in chips) 
Seat 3: artaxruciv ($5.20 in chips) 
Seat 4: Grigoriy40$ ($16.62 in chips) 
Seat 5: NICooLIN333 ($5.05 in chips) 
Seat 6: HubertusB ($4.62 in chips) 
barbos2009: posts small blind $0.02
artaxruciv: posts big blind $0.05
*** HOLE CARDS ***
Dealt to HubertusB [Kh 3c]
Grigoriy40$: folds 
NICooLIN333: folds 
HubertusB: folds 
Valerij V.S.: raises $0.05 to $0.10
barbos2009: folds 
artaxruciv: calls $0.05
*** FLOP *** [Ac 9s 9h]
artaxruciv: checks 
Valerij V.S.: bets $0.20
artaxruciv: raises $0.20 to $0.40
Valerij V.S.: calls $0.20
*** TURN *** [Ac 9s 9h] [Jh]
artaxruciv: bets $0.50
Valerij V.S.: calls $0.50
*** RIVER *** [Ac 9s 9h Jh] [3s]
artaxruciv: bets $1
Valerij V.S.: calls $1
*** SHOW DOWN ***
artaxruciv: shows [7h 9c] (three of a kind, Nines)
Valerij V.S.: mucks hand 
artaxruciv collected $3.85 from pot
*** SUMMARY ***
Total pot $4.02 | Rake $0.17 
Board [Ac 9s 9h Jh 3s]
Seat 1: Valerij V.S. (button) mucked [2h Ah]
Seat 2: barbos2009 (small blind) folded before Flop
Seat 3: artaxruciv (big blind) showed [7h 9c] and won ($3.85) with three of a kind, Nines
Seat 4: Grigoriy40$ folded before Flop (didn't bet)
Seat 5: NICooLIN333 folded before Flop (didn't bet)
Seat 6: HubertusB folded before Flop (didn't bet)



PokerStars Zoom Hand #186643287329:  Hold'em No Limit ($0.02/$0.05) - 2018/05/20 20:13:31 CCT [2018/05/20 8:13:31 ET]
Table 'Donati' 6-max Seat #1 is the button
Seat 1: DonkKing433 ($5.06 in chips) 
Seat 2: HubertusB ($4.42 in chips) 
Seat 3: fedkAa ($10.86 in chips) 
Seat 4: kukkertje ($14.95 in chips) 
Seat 5: kingreigns ($5.93 in chips) 
Seat 6: BL4CK11 ($10.28 in chips) 
HubertusB: posts small blind $0.02
fedkAa: posts big blind $0.05
*** HOLE CARDS ***
Dealt to HubertusB [4c Qh]
kukkertje: folds 
kingreigns: raises $0.07 to $0.12
BL4CK11: calls $0.12
DonkKing433: folds 
HubertusB: folds 
fedkAa: folds 
*** FLOP *** [8d Jc 7h]
kingreigns: bets $0.17
BL4CK11: calls $0.17
*** TURN *** [8d Jc 7h] [7c]
kingreigns: bets $0.34
BL4CK11: calls $0.34
*** RIVER *** [8d Jc 7h 7c] [Ks]
kingreigns: bets $0.86
BL4CK11: folds 
Uncalled bet ($0.86) returned to kingreigns
kingreigns collected $1.27 from pot
kingreigns: doesn't show hand 
*** SUMMARY ***
Total pot $1.33 | Rake $0.06 
Board [8d Jc 7h 7c Ks]
Seat 1: DonkKing433 (button) folded before Flop (didn't bet)
Seat 2: HubertusB (small blind) folded before Flop
Seat 3: fedkAa (big blind) folded before Flop
Seat 4: kukkertje folded before Flop (didn't bet)
Seat 5: kingreigns collected ($1.27)
Seat 6: BL4CK11 folded on the River



PokerStars Zoom Hand #186643289714:  Hold'em No Limit ($0.02/$0.05) - 2018/05/20 20:13:36 CCT [2018/05/20 8:13:36 ET]
Table 'Donati' 6-max Seat #1 is the button
Seat 1: DaviDFoX75 ($14.40 in chips) 
Seat 2: valmihai37 ($4.54 in chips) 
Seat 3: HubertusB ($4.40 in chips) 
Seat 4: Ezhewika ($1.74 in chips) 
Seat 5: squ33z3r ($5.05 in chips) 
Seat 6: Gissbon ($5.56 in chips) 
valmihai37: posts small blind $0.02
HubertusB: posts big blind $0.05
*** HOLE CARDS ***
Dealt to HubertusB [5c 6c]
Ezhewika: folds 
squ33z3r: folds 
Gissbon: raises $0.10 to $0.15
DaviDFoX75: calls $0.15
valmihai37: folds 
HubertusB: calls $0.10
*** FLOP *** [4h Jd 9d]
HubertusB: checks 
Gissbon: bets $0.34
DaviDFoX75: calls $0.34
HubertusB: folds 
*** TURN *** [4h Jd 9d] [9h]
Gissbon: checks 
DaviDFoX75: bets $0.55
Gissbon: folds 
Uncalled bet ($0.55) returned to DaviDFoX75
DaviDFoX75 collected $1.10 from pot
DaviDFoX75: doesn't show hand 
*** SUMMARY ***
Total pot $1.15 | Rake $0.05 
Board [4h Jd 9d 9h]
Seat 1: DaviDFoX75 (button) collected ($1.10)
Seat 2: valmihai37 (small blind) folded before Flop
Seat 3: HubertusB (big blind) folded on the Flop
Seat 4: Ezhewika folded before Flop (didn't bet)
Seat 5: squ33z3r folded before Flop (didn't bet)
Seat 6: Gissbon folded on the Turn



PokerStars Zoom Hand #186643301077:  Hold'em No Limit ($0.02/$0.05) - 2018/05/20 20:14:00 CCT [2018/05/20 8:14:00 ET]
Table 'Donati' 6-max Seat #1 is the button
Seat 1: serg125strg ($2.59 in chips) 
Seat 2: saha555 ($8.23 in chips) 
Seat 3: selko1 ($5.12 in chips) 
Seat 4: I10Poker ($8 in chips) 
Seat 5: Kirikulu ($5.64 in chips) 
Seat 6: HubertusB ($4.25 in chips) 
saha555: posts small blind $0.02
selko1: posts big blind $0.05
*** HOLE CARDS ***
Dealt to HubertusB [3d 5c]
I10Poker: folds 
Kirikulu: folds 
HubertusB: folds 
serg125strg: folds 
saha555: folds 
Uncalled bet ($0.03) returned to selko1
selko1 collected $0.04 from pot
selko1: doesn't show hand 
*** SUMMARY ***
Total pot $0.04 | Rake $0 
Seat 1: serg125strg (button) folded before Flop (didn't bet)
Seat 2: saha555 (small blind) folded before Flop
Seat 3: selko1 (big blind) collected ($0.04)
Seat 4: I10Poker folded before Flop (didn't bet)
Seat 5: Kirikulu folded before Flop (didn't bet)
Seat 6: HubertusB folded before Flop (didn't bet)



PokerStars Zoom Hand #186643306335:  Hold'em No Limit ($0.02/$0.05) - 2018/05/20 20:14:11 CCT [2018/05/20 8:14:11 ET]
Table 'Donati' 6-max Seat #1 is the button
Seat 1: Na Nelly ($8.46 in chips) 
Seat 2: selko1 ($7.57 in chips) 
Seat 3: gievit ($20.56 in chips) 
Seat 4: Kirikulu ($5.64 in chips) 
Seat 5: HubertusB ($4.25 in chips) 
Seat 6: Staz893 ($8.87 in chips) 
selko1: posts small blind $0.02
gievit: posts big blind $0.05
*** HOLE CARDS ***
Dealt to HubertusB [7d Qs]
Kirikulu: folds 
HubertusB: folds 
Staz893: folds 
Na Nelly: folds 
selko1: folds 
Uncalled bet ($0.03) returned to gievit
gievit collected $0.04 from pot
gievit: doesn't show hand 
*** SUMMARY ***
Total pot $0.04 | Rake $0 
Seat 1: Na Nelly (button) folded before Flop (didn't bet)
Seat 2: selko1 (small blind) folded before Flop
Seat 3: gievit (big blind) collected ($0.04)
Seat 4: Kirikulu folded before Flop (didn't bet)
Seat 5: HubertusB folded before Flop (didn't bet)
Seat 6: Staz893 folded before Flop (didn't bet)



PokerStars Zoom Hand #186643313513:  Hold'em No Limit ($0.02/$0.05) - 2018/05/20 20:14:26 CCT [2018/05/20 8:14:26 ET]
Table 'Donati' 6-max Seat #1 is the button
Seat 1: Agno$tic ($7.20 in chips) 
Seat 2: kranovoy22 ($5.25 in chips) 
Seat 3: Valerij V.S. ($2.07 in chips) 
Seat 4: HubertusB ($4.25 in chips) 
Seat 5: Janski90 ($8.79 in chips) 
Seat 6: pauwl12 ($5 in chips) 
kranovoy22: posts small blind $0.02
Valerij V.S.: posts big blind $0.05
*** HOLE CARDS ***
Dealt to HubertusB [8h Td]
HubertusB: folds 
Janski90: folds 
pauwl12: folds 
Agno$tic: folds 
kranovoy22: folds 
Uncalled bet ($0.03) returned to Valerij V.S.
Valerij V.S. collected $0.04 from pot
Valerij V.S.: doesn't show hand 
*** SUMMARY ***
Total pot $0.04 | Rake $0 
Seat 1: Agno$tic (button) folded before Flop (didn't bet)
Seat 2: kranovoy22 (small blind) folded before Flop
Seat 3: Valerij V.S. (big blind) collected ($0.04)
Seat 4: HubertusB folded before Flop (didn't bet)
Seat 5: Janski90 folded before Flop (didn't bet)
Seat 6: pauwl12 folded before Flop (didn't bet)



PokerStars Zoom Hand #186643310665:  Hold'em No Limit ($0.02/$0.05) - 2018/05/20 20:14:20 CCT [2018/05/20 8:14:20 ET]
Table 'Donati' 6-max Seat #1 is the button
Seat 1: Jeka Griva ($8.21 in chips) 
Seat 2: chesm ($6.07 in chips) 
Seat 3: BIBIGON123 ($5.25 in chips) 
Seat 4: HubertusB ($4.25 in chips) 
Seat 5: aDYTKINa ($5 in chips) 
Seat 6: valmihai37 ($4.52 in chips) 
chesm: posts small blind $0.02
BIBIGON123: posts big blind $0.05
*** HOLE CARDS ***
Dealt to HubertusB [7h Ac]
HubertusB: folds 
aDYTKINa: raises $0.10 to $0.15
valmihai37: calls $0.15
Jeka Griva: folds 
chesm: folds 
BIBIGON123: folds 
*** FLOP *** [4h 6d 2s]
aDYTKINa: bets $0.19
valmihai37: folds 
Uncalled bet ($0.19) returned to aDYTKINa
aDYTKINa collected $0.35 from pot
aDYTKINa: doesn't show hand 
*** SUMMARY ***
Total pot $0.37 | Rake $0.02 
Board [4h 6d 2s]
Seat 1: Jeka Griva (button) folded before Flop (didn't bet)
Seat 2: chesm (small blind) folded before Flop
Seat 3: BIBIGON123 (big blind) folded before Flop
Seat 4: HubertusB folded before Flop (didn't bet)
Seat 5: aDYTKINa collected ($0.35)
Seat 6: valmihai37 folded on the Flop



PokerStars Zoom Hand #186643317754:  Hold'em No Limit ($0.02/$0.05) - 2018/05/20 20:14:35 CCT [2018/05/20 8:14:35 ET]
Table 'Donati' 6-max Seat #1 is the button
Seat 1: Chinga4kuk ($5.27 in chips) 
Seat 2: HubertusB ($4.25 in chips) 
Seat 3: djnemesis101 ($6.26 in chips) 
Seat 4: Vasyaga rus ($4.76 in chips) 
Seat 5: QWER7786 ($11.84 in chips) 
Seat 6: VLSALT ($5.34 in chips) 
HubertusB: posts small blind $0.02
djnemesis101: posts big blind $0.05
*** HOLE CARDS ***
Dealt to HubertusB [2h 5h]
Vasyaga rus: raises $0.10 to $0.15
QWER7786: folds 
VLSALT: folds 
Chinga4kuk: folds 
HubertusB: folds 
djnemesis101: folds 
Uncalled bet ($0.10) returned to Vasyaga rus
Vasyaga rus collected $0.12 from pot
Vasyaga rus: doesn't show hand 
*** SUMMARY ***
Total pot $0.12 | Rake $0 
Seat 1: Chinga4kuk (button) folded before Flop (didn't bet)
Seat 2: HubertusB (small blind) folded before Flop
Seat 3: djnemesis101 (big blind) folded before Flop
Seat 4: Vasyaga rus collected ($0.12)
Seat 5: QWER7786 folded before Flop (didn't bet)
Seat 6: VLSALT folded before Flop (didn't bet)



PokerStars Zoom Hand #186643323843:  Hold'em No Limit ($0.02/$0.05) - 2018/05/20 20:14:48 CCT [2018/05/20 8:14:48 ET]
Table 'Donati' 6-max Seat #1 is the button
Seat 1: HubertusB ($4.23 in chips) 
Seat 2: Janski90 ($10.39 in chips) 
Seat 3: kayck07 ($5.49 in chips) 
Seat 4: Faied123 ($6.22 in chips) 
Seat 5: Ahror91 ($2.50 in chips) 
Seat 6: DG_Bilo ($7.44 in chips) 
Janski90: posts small blind $0.02
kayck07: posts big blind $0.05
*** HOLE CARDS ***
Dealt to HubertusB [4h Ah]
Faied123: folds 
Ahror91: folds 
DG_Bilo: folds 
HubertusB: raises $0.10 to $0.15
Janski90: folds 
kayck07: calls $0.10
*** FLOP *** [2s 6d 6c]
kayck07: checks 
HubertusB: bets $0.15
kayck07: calls $0.15
*** TURN *** [2s 6d 6c] [Qd]
kayck07: checks 
HubertusB: bets $0.40
kayck07: folds 
Uncalled bet ($0.40) returned to HubertusB
HubertusB collected $0.59 from pot
HubertusB: doesn't show hand 
*** SUMMARY ***
Total pot $0.62 | Rake $0.03 
Board [2s 6d 6c Qd]
Seat 1: HubertusB (button) collected ($0.59)
Seat 2: Janski90 (small blind) folded before Flop
Seat 3: kayck07 (big blind) folded on the Turn
Seat 4: Faied123 folded before Flop (didn't bet)
Seat 5: Ahror91 folded before Flop (didn't bet)
Seat 6: DG_Bilo folded before Flop (didn't bet)



PokerStars Zoom Hand #186643344462:  Hold'em No Limit ($0.02/$0.05) - 2018/05/20 20:15:31 CCT [2018/05/20 8:15:31 ET]
Table 'Donati' 6-max Seat #1 is the button
Seat 1: djnemesis101 ($8.70 in chips) 
Seat 2: olivier070 ($14.63 in chips) 
Seat 3: ilynskiy ($2.57 in chips) 
Seat 4: iKiiiLL4fun ($7.56 in chips) 
Seat 5: ANANATOR ($5 in chips) 
Seat 6: HubertusB ($4.52 in chips) 
olivier070: posts small blind $0.02
ilynskiy: posts big blind $0.05
*** HOLE CARDS ***
Dealt to HubertusB [Ah 4s]
iKiiiLL4fun: folds 
ANANATOR: folds 
HubertusB: folds 
djnemesis101: folds 
olivier070: raises $0.10 to $0.15
ilynskiy: folds 
Uncalled bet ($0.10) returned to olivier070
olivier070 collected $0.10 from pot
olivier070: doesn't show hand 
*** SUMMARY ***
Total pot $0.10 | Rake $0 
Seat 1: djnemesis101 (button) folded before Flop (didn't bet)
Seat 2: olivier070 (small blind) collected ($0.10)
Seat 3: ilynskiy (big blind) folded before Flop
Seat 4: iKiiiLL4fun folded before Flop (didn't bet)
Seat 5: ANANATOR folded before Flop (didn't bet)
Seat 6: HubertusB folded before Flop (didn't bet)



PokerStars Zoom Hand #186643347738:  Hold'em No Limit ($0.02/$0.05) - 2018/05/20 20:15:38 CCT [2018/05/20 8:15:38 ET]
Table 'Donati' 6-max Seat #1 is the button
Seat 1: Shamaxxx ($5.10 in chips) 
Seat 2: Cadu_171 ($5 in chips) 
Seat 3: Sofiy2013 ($3.93 in chips) 
Seat 4: Clubberer80 ($6.26 in chips) 
Seat 5: HubertusB ($4.52 in chips) 
Seat 6: iKiiiLL4fun ($15.50 in chips) 
Cadu_171: posts small blind $0.02
Sofiy2013: posts big blind $0.05
*** HOLE CARDS ***
Dealt to HubertusB [Ks Th]
Clubberer80: folds 
HubertusB: folds 
iKiiiLL4fun: folds 
Shamaxxx: raises $0.07 to $0.12
Cadu_171: folds 
Sofiy2013: calls $0.07
*** FLOP *** [2d 8h Tc]
Sofiy2013: checks 
Shamaxxx: checks 
*** TURN *** [2d 8h Tc] [3d]
Sofiy2013: bets $0.15
Shamaxxx: folds 
Uncalled bet ($0.15) returned to Sofiy2013
Sofiy2013 collected $0.25 from pot
Sofiy2013: doesn't show hand 
*** SUMMARY ***
Total pot $0.26 | Rake $0.01 
Board [2d 8h Tc 3d]
Seat 1: Shamaxxx (button) folded on the Turn
Seat 2: Cadu_171 (small blind) folded before Flop
Seat 3: Sofiy2013 (big blind) collected ($0.25)
Seat 4: Clubberer80 folded before Flop (didn't bet)
Seat 5: HubertusB folded before Flop (didn't bet)
Seat 6: iKiiiLL4fun folded before Flop (didn't bet)



PokerStars Zoom Hand #186643360119:  Hold'em No Limit ($0.02/$0.05) - 2018/05/20 20:16:04 CCT [2018/05/20 8:16:04 ET]
Table 'Donati' 6-max Seat #1 is the button
Seat 1: HubertusB ($4.45 in chips) 
Seat 2: Unclesmoll ($5.82 in chips) 
Seat 3: MAGE%CARDS ($6.01 in chips) 
Seat 4: goldenbull15 ($9.17 in chips) 
Seat 5: Tutunn ($8.92 in chips) 
Seat 6: dejii ($5.17 in chips) 
Unclesmoll: posts small blind $0.02
MAGE%CARDS: posts big blind $0.05
*** HOLE CARDS ***
Dealt to HubertusB [3d 4d]
goldenbull15: folds 
Tutunn: folds 
dejii: folds 
HubertusB: raises $0.10 to $0.15
Unclesmoll: folds 
MAGE%CARDS: folds 
Uncalled bet ($0.10) returned to HubertusB
HubertusB collected $0.12 from pot
HubertusB: doesn't show hand 
*** SUMMARY ***
Total pot $0.12 | Rake $0 
Seat 1: HubertusB (button) collected ($0.12)
Seat 2: Unclesmoll (small blind) folded before Flop
Seat 3: MAGE%CARDS (big blind) folded before Flop
Seat 4: goldenbull15 folded before Flop (didn't bet)
Seat 5: Tutunn folded before Flop (didn't bet)
Seat 6: dejii folded before Flop (didn't bet)



PokerStars Zoom Hand #186643342498:  Hold'em No Limit ($0.02/$0.05) - 2018/05/20 20:15:27 CCT [2018/05/20 8:15:27 ET]
Table 'Donati' 6-max Seat #1 is the button
Seat 1: jeffpig16 ($5 in chips) 
Seat 2: Aristovoulos ($5 in chips) 
Seat 3: BL4CK11 ($13.20 in chips) 
Seat 4: HubertusB ($4.52 in chips) 
Seat 5: CentricTie ($6.80 in chips) 
Seat 6: Sofiy2013 ($3.93 in chips) 
Aristovoulos: posts small blind $0.02
BL4CK11: posts big blind $0.05
*** HOLE CARDS ***
Dealt to HubertusB [2s 8s]
HubertusB: folds 
CentricTie: calls $0.05
Sofiy2013: folds 
jeffpig16: folds 
Aristovoulos: folds 
BL4CK11: checks 
*** FLOP *** [8c 3h 6c]
BL4CK11: bets $0.10
CentricTie: calls $0.10
*** TURN *** [8c 3h 6c] [3d]
BL4CK11: bets $0.20
CentricTie: folds 
Uncalled bet ($0.20) returned to BL4CK11
BL4CK11 collected $0.31 from pot
BL4CK11: doesn't show hand 
*** SUMMARY ***
Total pot $0.32 | Rake $0.01 
Board [8c 3h 6c 3d]
Seat 1: jeffpig16 (button) folded before Flop (didn't bet)
Seat 2: Aristovoulos (small blind) folded before Flop
Seat 3: BL4CK11 (big blind) collected ($0.31)
Seat 4: HubertusB folded before Flop (didn't bet)
Seat 5: CentricTie folded on the Turn
Seat 6: Sofiy2013 folded before Flop (didn't bet)



PokerStars Zoom Hand #186643350199:  Hold'em No Limit ($0.02/$0.05) - 2018/05/20 20:15:43 CCT [2018/05/20 8:15:43 ET]
Table 'Donati' 6-max Seat #1 is the button
Seat 1: krapiwa0077 ($3.72 in chips) 
Seat 2: mama$0104 ($4.61 in chips) 
Seat 3: HubertusB ($4.52 in chips) 
Seat 4: barbos2009 ($21.49 in chips) 
Seat 5: slob43.ru ($5.45 in chips) 
Seat 6: ilynskiy ($2.50 in chips) 
mama$0104: posts small blind $0.02
HubertusB: posts big blind $0.05
*** HOLE CARDS ***
Dealt to HubertusB [Ac 9d]
barbos2009: folds 
slob43.ru: raises $0.10 to $0.15
ilynskiy: folds 
krapiwa0077: calls $0.15
mama$0104: folds 
HubertusB: folds 
*** FLOP *** [7h 2s 7s]
slob43.ru: checks 
krapiwa0077: checks 
*** TURN *** [7h 2s 7s] [3h]
slob43.ru: checks 
krapiwa0077: bets $0.15
slob43.ru: calls $0.15
*** RIVER *** [7h 2s 7s 3h] [2c]
slob43.ru: checks 
krapiwa0077: checks 
*** SHOW DOWN ***
slob43.ru: shows [4s 4c] (two pair, Sevens and Fours)
krapiwa0077: mucks hand 
slob43.ru collected $0.64 from pot
*** SUMMARY ***
Total pot $0.67 | Rake $0.03 
Board [7h 2s 7s 3h 2c]
Seat 1: krapiwa0077 (button) mucked [Qh Kh]
Seat 2: mama$0104 (small blind) folded before Flop
Seat 3: HubertusB (big blind) folded before Flop
Seat 4: barbos2009 folded before Flop (didn't bet)
Seat 5: slob43.ru showed [4s 4c] and won ($0.64) with two pair, Sevens and Fours
Seat 6: ilynskiy folded before Flop (didn't bet)



PokerStars Zoom Hand #186643357764:  Hold'em No Limit ($0.02/$0.05) - 2018/05/20 20:15:59 CCT [2018/05/20 8:15:59 ET]
Table 'Donati' 6-max Seat #1 is the button
Seat 1: Savavlad97 ($8.91 in chips) 
Seat 2: HubertusB ($4.47 in chips) 
Seat 3: Staz893 ($8.87 in chips) 
Seat 4: Jase4607 ($5.16 in chips) 
Seat 5: przemyslaw35 ($4.71 in chips) 
Seat 6: andrzej4fun ($9.45 in chips) 
HubertusB: posts small blind $0.02
Staz893: posts big blind $0.05
*** HOLE CARDS ***
Dealt to HubertusB [7c 8s]
Jase4607: folds 
przemyslaw35: folds 
andrzej4fun: raises $0.12 to $0.17
Savavlad97: calls $0.17
HubertusB: folds 
Staz893: folds 
*** FLOP *** [8d As 5s]
andrzej4fun: checks 
Savavlad97: bets $0.20
andrzej4fun: folds 
Uncalled bet ($0.20) returned to Savavlad97
Savavlad97 collected $0.39 from pot
Savavlad97: doesn't show hand 
*** SUMMARY ***
Total pot $0.41 | Rake $0.02 
Board [8d As 5s]
Seat 1: Savavlad97 (button) collected ($0.39)
Seat 2: HubertusB (small blind) folded before Flop
Seat 3: Staz893 (big blind) folded before Flop
Seat 4: Jase4607 folded before Flop (didn't bet)
Seat 5: przemyslaw35 folded before Flop (didn't bet)
Seat 6: andrzej4fun folded on the Flop



PokerStars Zoom Hand #186643353517:  Hold'em No Limit ($0.02/$0.05) - 2018/05/20 20:15:50 CCT [2018/05/20 8:15:50 ET]
Table 'Donati' 6-max Seat #1 is the button
Seat 1: jeffpig16 ($6.11 in chips) 
Seat 2: FAHHH168 ($5.23 in chips) 
Seat 3: Krawicz ($5.19 in chips) 
Seat 4: derak488 ($5 in chips) 
Seat 5: prm4life ($5.16 in chips) 
Seat 6: HubertusB ($4.47 in chips) 
FAHHH168: posts small blind $0.02
Krawicz: posts big blind $0.05
*** HOLE CARDS ***
Dealt to HubertusB [4s Qd]
derak488: raises $0.07 to $0.12
prm4life: folds 
HubertusB: folds 
jeffpig16: folds 
FAHHH168: folds 
Krawicz: calls $0.07
*** FLOP *** [Qh Th 3h]
Krawicz: checks 
derak488: bets $0.15
Krawicz: calls $0.15
*** TURN *** [Qh Th 3h] [3s]
Krawicz: checks 
derak488: checks 
*** RIVER *** [Qh Th 3h 3s] [7d]
Krawicz: bets $0.27
derak488: folds 
Uncalled bet ($0.27) returned to Krawicz
Krawicz collected $0.54 from pot
Krawicz: doesn't show hand 
*** SUMMARY ***
Total pot $0.56 | Rake $0.02 
Board [Qh Th 3h 3s 7d]
Seat 1: jeffpig16 (button) folded before Flop (didn't bet)
Seat 2: FAHHH168 (small blind) folded before Flop
Seat 3: Krawicz (big blind) collected ($0.54)
Seat 4: derak488 folded on the River
Seat 5: prm4life folded before Flop (didn't bet)
Seat 6: HubertusB folded before Flop (didn't bet)



PokerStars Zoom Hand #186643365305:  Hold'em No Limit ($0.02/$0.05) - 2018/05/20 20:16:15 CCT [2018/05/20 8:16:15 ET]
Table 'Donati' 6-max Seat #1 is the button
Seat 1: Reshalo.fish ($1.84 in chips) 
Seat 2: ilynskiy ($3.33 in chips) 
Seat 3: adytoditza ($4.56 in chips) 
Seat 4: 1Sania1 ($2.45 in chips) 
Seat 5: HubertusB ($4.52 in chips) 
Seat 6: DonkKing433 ($4.87 in chips) 
ilynskiy: posts small blind $0.02
adytoditza: posts big blind $0.05
*** HOLE CARDS ***
Dealt to HubertusB [Js Ks]
1Sania1: folds 
HubertusB: raises $0.10 to $0.15
DonkKing433: folds 
Reshalo.fish: folds 
ilynskiy: raises $0.35 to $0.50
adytoditza: folds 
HubertusB: calls $0.35
*** FLOP *** [3c Ts 7h]
ilynskiy: bets $0.67
HubertusB: folds 
Uncalled bet ($0.67) returned to ilynskiy
ilynskiy collected $1.01 from pot
ilynskiy: doesn't show hand 
*** SUMMARY ***
Total pot $1.05 | Rake $0.04 
Board [3c Ts 7h]
Seat 1: Reshalo.fish (button) folded before Flop (didn't bet)
Seat 2: ilynskiy (small blind) collected ($1.01)
Seat 3: adytoditza (big blind) folded before Flop
Seat 4: 1Sania1 folded before Flop (didn't bet)
Seat 5: HubertusB folded on the Flop
Seat 6: DonkKing433 folded before Flop (didn't bet)



PokerStars Zoom Hand #186643378688:  Hold'em No Limit ($0.02/$0.05) - 2018/05/20 20:16:43 CCT [2018/05/20 8:16:43 ET]
Table 'Donati' 6-max Seat #1 is the button
Seat 1: Wolvy128 ($5.01 in chips) 
Seat 2: faustus1903 ($6.10 in chips) 
Seat 3: HubertusB ($4.02 in chips) 
Seat 4: Daemon'sKiss ($5 in chips) 
Seat 5: ptolemaios99 ($4.35 in chips) 
Seat 6: Arrenea ($5.64 in chips) 
faustus1903: posts small blind $0.02
HubertusB: posts big blind $0.05
*** HOLE CARDS ***
Dealt to HubertusB [Ah 6d]
Daemon'sKiss: folds 
ptolemaios99: raises $0.05 to $0.10
Arrenea: folds 
Wolvy128: folds 
faustus1903: calls $0.08
HubertusB: folds 
*** FLOP *** [Jh 4d 2s]
faustus1903: checks 
ptolemaios99: checks 
*** TURN *** [Jh 4d 2s] [Td]
faustus1903: bets $0.20
ptolemaios99: raises $0.30 to $0.50
faustus1903: folds 
Uncalled bet ($0.30) returned to ptolemaios99
ptolemaios99 collected $0.62 from pot
ptolemaios99: doesn't show hand 
*** SUMMARY ***
Total pot $0.65 | Rake $0.03 
Board [Jh 4d 2s Td]
Seat 1: Wolvy128 (button) folded before Flop (didn't bet)
Seat 2: faustus1903 (small blind) folded on the Turn
Seat 3: HubertusB (big blind) folded before Flop
Seat 4: Daemon'sKiss folded before Flop (didn't bet)
Seat 5: ptolemaios99 collected ($0.62)
Seat 6: Arrenea folded before Flop (didn't bet)



PokerStars Zoom Hand #186643388837:  Hold'em No Limit ($0.02/$0.05) - 2018/05/20 20:17:04 CCT [2018/05/20 8:17:04 ET]
Table 'Donati' 6-max Seat #1 is the button
Seat 1: HubertusB ($3.95 in chips) 
Seat 2: kagurasiori ($9.59 in chips) 
Seat 3: Gissbon ($5.36 in chips) 
Seat 4: slob43.ru ($5.72 in chips) 
Seat 5: TOMEF1CHA ($9.07 in chips) 
Seat 6: Opcius ($3.69 in chips) 
kagurasiori: posts small blind $0.02
Gissbon: posts big blind $0.05
*** HOLE CARDS ***
Dealt to HubertusB [3h Qc]
slob43.ru: raises $0.10 to $0.15
TOMEF1CHA: folds 
Opcius: folds 
HubertusB: folds 
kagurasiori: folds 
Gissbon: folds 
Uncalled bet ($0.10) returned to slob43.ru
slob43.ru collected $0.12 from pot
slob43.ru: doesn't show hand 
*** SUMMARY ***
Total pot $0.12 | Rake $0 
Seat 1: HubertusB (button) folded before Flop (didn't bet)
Seat 2: kagurasiori (small blind) folded before Flop
Seat 3: Gissbon (big blind) folded before Flop
Seat 4: slob43.ru collected ($0.12)
Seat 5: TOMEF1CHA folded before Flop (didn't bet)
Seat 6: Opcius folded before Flop (didn't bet)



PokerStars Zoom Hand #186643391276:  Hold'em No Limit ($0.02/$0.05) - 2018/05/20 20:17:09 CCT [2018/05/20 8:17:09 ET]
Table 'Donati' 6-max Seat #1 is the button
Seat 1: R0ME0_17 ($3.99 in chips) 
Seat 2: Krawicz ($5.07 in chips) 
Seat 3: Faied123 ($15.49 in chips) 
Seat 4: Oscar__62176 ($6.01 in chips) 
Seat 5: OsloVest ($14.09 in chips) 
Seat 6: HubertusB ($3.95 in chips) 
Krawicz: posts small blind $0.02
Faied123: posts big blind $0.05
*** HOLE CARDS ***
Dealt to HubertusB [Ts 2d]
Oscar__62176: folds 
OsloVest: folds 
HubertusB: folds 
R0ME0_17: folds 
Krawicz: raises $0.10 to $0.15
Faied123: folds 
Uncalled bet ($0.10) returned to Krawicz
Krawicz collected $0.10 from pot
Krawicz: doesn't show hand 
*** SUMMARY ***
Total pot $0.10 | Rake $0 
Seat 1: R0ME0_17 (button) folded before Flop (didn't bet)
Seat 2: Krawicz (small blind) collected ($0.10)
Seat 3: Faied123 (big blind) folded before Flop
Seat 4: Oscar__62176 folded before Flop (didn't bet)
Seat 5: OsloVest folded before Flop (didn't bet)
Seat 6: HubertusB folded before Flop (didn't bet)



PokerStars Zoom Hand #186643393741:  Hold'em No Limit ($0.02/$0.05) - 2018/05/20 20:17:14 CCT [2018/05/20 8:17:14 ET]
Table 'Donati' 6-max Seat #1 is the button
Seat 1: Arrenea ($5.48 in chips) 
Seat 2: sceptick ($5.16 in chips) 
Seat 3: CallMeBunny ($7.15 in chips) 
Seat 4: HubertusB ($3.95 in chips) 
Seat 5: mamel7777 ($8.15 in chips) 
Seat 6: DaviDFoX75 ($14.77 in chips) 
sceptick: posts small blind $0.02
CallMeBunny: posts big blind $0.05
*** HOLE CARDS ***
Dealt to HubertusB [Jc Qd]
HubertusB: raises $0.05 to $0.10
mamel7777: folds 
DaviDFoX75: folds 
Arrenea: folds 
sceptick: folds 
CallMeBunny: folds 
Uncalled bet ($0.05) returned to HubertusB
HubertusB collected $0.12 from pot
HubertusB: doesn't show hand 
*** SUMMARY ***
Total pot $0.12 | Rake $0 
Seat 1: Arrenea (button) folded before Flop (didn't bet)
Seat 2: sceptick (small blind) folded before Flop
Seat 3: CallMeBunny (big blind) folded before Flop
Seat 4: HubertusB collected ($0.12)
Seat 5: mamel7777 folded before Flop (didn't bet)
Seat 6: DaviDFoX75 folded before Flop (didn't bet)



PokerStars Zoom Hand #186643385938:  Hold'em No Limit ($0.02/$0.05) - 2018/05/20 20:16:58 CCT [2018/05/20 8:16:58 ET]
Table 'Donati' 6-max Seat #1 is the button
Seat 1: Faied123 ($15.49 in chips) 
Seat 2: HubertusB ($3.97 in chips) 
Seat 3: Teach133 ($4.40 in chips) 
Seat 4: wujaszek ($5.13 in chips) 
Seat 5: Goosich ($5.76 in chips) 
Seat 6: LingPro ($4.98 in chips) 
HubertusB: posts small blind $0.02
Teach133: posts big blind $0.05
*** HOLE CARDS ***
Dealt to HubertusB [8s 6h]
wujaszek: raises $0.10 to $0.15
Goosich: calls $0.15
LingPro: calls $0.15
Faied123: folds 
HubertusB: folds 
Teach133: calls $0.10
*** FLOP *** [Jh 4h Tc]
Teach133: checks 
wujaszek: checks 
Goosich: checks 
LingPro: bets $0.44
Teach133: folds 
wujaszek: folds 
Goosich: folds 
Uncalled bet ($0.44) returned to LingPro
LingPro collected $0.59 from pot
LingPro: doesn't show hand 
*** SUMMARY ***
Total pot $0.62 | Rake $0.03 
Board [Jh 4h Tc]
Seat 1: Faied123 (button) folded before Flop (didn't bet)
Seat 2: HubertusB (small blind) folded before Flop
Seat 3: Teach133 (big blind) folded on the Flop
Seat 4: wujaszek folded on the Flop
Seat 5: Goosich folded on the Flop
Seat 6: LingPro collected ($0.59)



PokerStars Zoom Hand #186643383051:  Hold'em No Limit ($0.02/$0.05) - 2018/05/20 20:16:52 CCT [2018/05/20 8:16:52 ET]
Table 'Donati' 6-max Seat #1 is the button
Seat 1: TOMEF1CHA ($9.07 in chips) 
Seat 2: Tsundere ($5.18 in chips) 
Seat 3: Staz893 ($8.87 in chips) 
Seat 4: HubertusB ($3.97 in chips) 
Seat 5: Omicron333 ($5 in chips) 
Seat 6: MerseysideG ($4.54 in chips) 
Tsundere: posts small blind $0.02
Staz893: posts big blind $0.05
*** HOLE CARDS ***
Dealt to HubertusB [6h 9c]
HubertusB: folds 
Omicron333: folds 
MerseysideG: folds 
TOMEF1CHA: folds 
Tsundere: raises $0.10 to $0.15
Staz893: calls $0.10
*** FLOP *** [Ts As 8c]
Tsundere: bets $0.18
Staz893: calls $0.18
*** TURN *** [Ts As 8c] [5c]
Tsundere: bets $0.48
Staz893: folds 
Uncalled bet ($0.48) returned to Tsundere
Tsundere collected $0.63 from pot
Tsundere: doesn't show hand 
*** SUMMARY ***
Total pot $0.66 | Rake $0.03 
Board [Ts As 8c 5c]
Seat 1: TOMEF1CHA (button) folded before Flop (didn't bet)
Seat 2: Tsundere (small blind) collected ($0.63)
Seat 3: Staz893 (big blind) folded on the Turn
Seat 4: HubertusB folded before Flop (didn't bet)
Seat 5: Omicron333 folded before Flop (didn't bet)
Seat 6: MerseysideG folded before Flop (didn't bet)



PokerStars Zoom Hand #186643403840:  Hold'em No Limit ($0.02/$0.05) - 2018/05/20 20:17:35 CCT [2018/05/20 8:17:35 ET]
Table 'Donati' 6-max Seat #1 is the button
Seat 1: UltraRunnerr ($7.89 in chips) 
Seat 2: g8m3yst3er ($4.95 in chips) 
Seat 3: d.kach24 ($5 in chips) 
Seat 4: kagurasiori ($9.59 in chips) 
Seat 5: HubertusB ($4.02 in chips) 
Seat 6: alebomos ($5 in chips) 
g8m3yst3er: posts small blind $0.02
d.kach24: posts big blind $0.05
*** HOLE CARDS ***
Dealt to HubertusB [3h 8d]
kagurasiori: folds 
HubertusB: folds 
alebomos: folds 
UltraRunnerr: raises $0.06 to $0.11
g8m3yst3er: folds 
d.kach24: folds 
Uncalled bet ($0.06) returned to UltraRunnerr
UltraRunnerr collected $0.12 from pot
UltraRunnerr: doesn't show hand 
*** SUMMARY ***
Total pot $0.12 | Rake $0 
Seat 1: UltraRunnerr (button) collected ($0.12)
Seat 2: g8m3yst3er (small blind) folded before Flop
Seat 3: d.kach24 (big blind) folded before Flop
Seat 4: kagurasiori folded before Flop (didn't bet)
Seat 5: HubertusB folded before Flop (didn't bet)
Seat 6: alebomos folded before Flop (didn't bet)



PokerStars Zoom Hand #186643405784:  Hold'em No Limit ($0.02/$0.05) - 2018/05/20 20:17:39 CCT [2018/05/20 8:17:39 ET]
Table 'Donati' 6-max Seat #1 is the button
Seat 1: mamel7777 ($8.78 in chips) 
Seat 2: TOMEF1CHA ($8.90 in chips) 
Seat 3: HubertusB ($4.02 in chips) 
Seat 4: aDYTKINa ($5 in chips) 
Seat 5: Ezhewika ($2.91 in chips) 
Seat 6: adytoditza ($4.49 in chips) 
TOMEF1CHA: posts small blind $0.02
HubertusB: posts big blind $0.05
*** HOLE CARDS ***
Dealt to HubertusB [6h 9d]
aDYTKINa: raises $0.10 to $0.15
Ezhewika: folds 
adytoditza: folds 
mamel7777: folds 
TOMEF1CHA: folds 
HubertusB: folds 
Uncalled bet ($0.10) returned to aDYTKINa
aDYTKINa collected $0.12 from pot
aDYTKINa: doesn't show hand 
*** SUMMARY ***
Total pot $0.12 | Rake $0 
Seat 1: mamel7777 (button) folded before Flop (didn't bet)
Seat 2: TOMEF1CHA (small blind) folded before Flop
Seat 3: HubertusB (big blind) folded before Flop
Seat 4: aDYTKINa collected ($0.12)
Seat 5: Ezhewika folded before Flop (didn't bet)
Seat 6: adytoditza folded before Flop (didn't bet)



PokerStars Zoom Hand #186643412966:  Hold'em No Limit ($0.02/$0.05) - 2018/05/20 20:17:54 CCT [2018/05/20 8:17:54 ET]
Table 'Donati' 6-max Seat #1 is the button
Seat 1: HubertusB ($3.95 in chips) 
Seat 2: wraJke ($6.18 in chips) 
Seat 3: <Bogolal> ($5.10 in chips) 
Seat 4: veni554 ($5.14 in chips) 
Seat 5: Boba1888 ($6.15 in chips) 
Seat 6: Leopoldia ($6.76 in chips) 
wraJke: posts small blind $0.02
<Bogolal>: posts big blind $0.05
*** HOLE CARDS ***
Dealt to HubertusB [Ah Qh]
veni554: folds 
Boba1888: folds 
Leopoldia: folds 
HubertusB: raises $0.10 to $0.15
wraJke: folds 
<Bogolal>: folds 
Uncalled bet ($0.10) returned to HubertusB
HubertusB collected $0.12 from pot
HubertusB: doesn't show hand 
*** SUMMARY ***
Total pot $0.12 | Rake $0 
Seat 1: HubertusB (button) collected ($0.12)
Seat 2: wraJke (small blind) folded before Flop
Seat 3: <Bogolal> (big blind) folded before Flop
Seat 4: veni554 folded before Flop (didn't bet)
Seat 5: Boba1888 folded before Flop (didn't bet)
Seat 6: Leopoldia folded before Flop (didn't bet)



PokerStars Zoom Hand #186643410463:  Hold'em No Limit ($0.02/$0.05) - 2018/05/20 20:17:49 CCT [2018/05/20 8:17:49 ET]
Table 'Donati' 6-max Seat #1 is the button
Seat 1: zwetok ($13.91 in chips) 
Seat 2: HubertusB ($3.97 in chips) 
Seat 3: ilynskiy ($2.50 in chips) 
Seat 4: R0ME0_17 ($4.10 in chips) 
Seat 5: Danil548 ($4.97 in chips) 
Seat 6: NICooLIN333 ($8.40 in chips) 
HubertusB: posts small blind $0.02
ilynskiy: posts big blind $0.05
*** HOLE CARDS ***
Dealt to HubertusB [5h 9d]
R0ME0_17: folds 
Danil548: folds 
NICooLIN333: folds 
zwetok: folds 
HubertusB: folds 
Uncalled bet ($0.03) returned to ilynskiy
ilynskiy collected $0.04 from pot
ilynskiy: doesn't show hand 
*** SUMMARY ***
Total pot $0.04 | Rake $0 
Seat 1: zwetok (button) folded before Flop (didn't bet)
Seat 2: HubertusB (small blind) folded before Flop
Seat 3: ilynskiy (big blind) collected ($0.04)
Seat 4: R0ME0_17 folded before Flop (didn't bet)
Seat 5: Danil548 folded before Flop (didn't bet)
Seat 6: NICooLIN333 folded before Flop (didn't bet)



PokerStars Zoom Hand #186643408110:  Hold'em No Limit ($0.02/$0.05) - 2018/05/20 20:17:44 CCT [2018/05/20 8:17:44 ET]
Table 'Donati' 6-max Seat #1 is the button
Seat 1: DavorDG5 ($2.17 in chips) 
Seat 2: Warrendown ($5.07 in chips) 
Seat 3: Goosich ($5.59 in chips) 
Seat 4: HubertusB ($3.97 in chips) 
Seat 5: serge87100 ($5.55 in chips) 
Seat 6: qixilyjs ($10.39 in chips) 
Warrendown: posts small blind $0.02
Goosich: posts big blind $0.05
*** HOLE CARDS ***
Dealt to HubertusB [Th As]
HubertusB: folds 
serge87100: folds 
qixilyjs: calls $0.05
DavorDG5: raises $0.10 to $0.15
Warrendown: folds 
Goosich: folds 
qixilyjs: raises $0.10 to $0.25
DavorDG5: calls $0.10
*** FLOP *** [Qd 2h 3h]
qixilyjs: bets $0.55
DavorDG5: folds 
Uncalled bet ($0.55) returned to qixilyjs
qixilyjs collected $0.55 from pot
qixilyjs: doesn't show hand 
*** SUMMARY ***
Total pot $0.57 | Rake $0.02 
Board [Qd 2h 3h]
Seat 1: DavorDG5 (button) folded on the Flop
Seat 2: Warrendown (small blind) folded before Flop
Seat 3: Goosich (big blind) folded before Flop
Seat 4: HubertusB folded before Flop (didn't bet)
Seat 5: serge87100 folded before Flop (didn't bet)
Seat 6: qixilyjs collected ($0.55)



PokerStars Zoom Hand #186643421682:  Hold'em No Limit ($0.02/$0.05) - 2018/05/20 20:18:12 CCT [2018/05/20 8:18:12 ET]
Table 'Donati' 6-max Seat #1 is the button
Seat 1: kittennose ($5 in chips) 
Seat 2: crazyside.nl ($6.94 in chips) 
Seat 3: Ezhewika ($2.98 in chips) 
Seat 4: amx16 ($5 in chips) 
Seat 5: Goosich ($5.54 in chips) 
Seat 6: HubertusB ($4.02 in chips) 
crazyside.nl: posts small blind $0.02
Ezhewika: posts big blind $0.05
*** HOLE CARDS ***
Dealt to HubertusB [Jd Ah]
amx16: folds 
Goosich: folds 
HubertusB: raises $0.10 to $0.15
kittennose: folds 
crazyside.nl: folds 
Ezhewika: calls $0.10
*** FLOP *** [7d 5d 9s]
Ezhewika: checks 
HubertusB: bets $0.16
Ezhewika: folds 
Uncalled bet ($0.16) returned to HubertusB
HubertusB collected $0.31 from pot
HubertusB: doesn't show hand 
*** SUMMARY ***
Total pot $0.32 | Rake $0.01 
Board [7d 5d 9s]
Seat 1: kittennose (button) folded before Flop (didn't bet)
Seat 2: crazyside.nl (small blind) folded before Flop
Seat 3: Ezhewika (big blind) folded on the Flop
Seat 4: amx16 folded before Flop (didn't bet)
Seat 5: Goosich folded before Flop (didn't bet)
Seat 6: HubertusB collected ($0.31)



PokerStars Zoom Hand #186643437627:  Hold'em No Limit ($0.02/$0.05) - 2018/05/20 20:18:46 CCT [2018/05/20 8:18:46 ET]
Table 'Donati' 6-max Seat #1 is the button
Seat 1: slob43.ru ($6.13 in chips) 
Seat 2: luka1981good ($5.56 in chips) 
Seat 3: ANANATOR ($5.67 in chips) 
Seat 4: DavorDG5 ($1.87 in chips) 
Seat 5: HubertusB ($4.18 in chips) 
Seat 6: DUDUKA81 ($5.65 in chips) 
luka1981good: posts small blind $0.02
ANANATOR: posts big blind $0.05
*** HOLE CARDS ***
Dealt to HubertusB [7c Ad]
DavorDG5: raises $0.05 to $0.10
HubertusB: folds 
DUDUKA81: folds 
slob43.ru: folds 
luka1981good: folds 
ANANATOR: folds 
Uncalled bet ($0.05) returned to DavorDG5
DavorDG5 collected $0.12 from pot
DavorDG5: doesn't show hand 
*** SUMMARY ***
Total pot $0.12 | Rake $0 
Seat 1: slob43.ru (button) folded before Flop (didn't bet)
Seat 2: luka1981good (small blind) folded before Flop
Seat 3: ANANATOR (big blind) folded before Flop
Seat 4: DavorDG5 collected ($0.12)
Seat 5: HubertusB folded before Flop (didn't bet)
Seat 6: DUDUKA81 folded before Flop (didn't bet)



PokerStars Zoom Hand #186643440495:  Hold'em No Limit ($0.02/$0.05) - 2018/05/20 20:18:52 CCT [2018/05/20 8:18:52 ET]
Table 'Donati' 6-max Seat #1 is the button
Seat 1: VLSALT ($5 in chips) 
Seat 2: ChubakaIII ($5.28 in chips) 
Seat 3: HubertusB ($4.18 in chips) 
Seat 4: Janski90 ($10.71 in chips) 
Seat 5: gievit ($20.28 in chips) 
Seat 6: chesm ($5.76 in chips) 
ChubakaIII: posts small blind $0.02
HubertusB: posts big blind $0.05
*** HOLE CARDS ***
Dealt to HubertusB [7c 8c]
Janski90: folds 
gievit: raises $0.09 to $0.14
chesm: folds 
VLSALT: folds 
ChubakaIII: folds 
HubertusB: calls $0.09
*** FLOP *** [Ks 7s 7d]
HubertusB: checks 
gievit: bets $0.24
HubertusB: raises $0.24 to $0.48
gievit: calls $0.24
*** TURN *** [Ks 7s 7d] [Qh]
HubertusB: checks 
gievit: bets $0.84
HubertusB: raises $2.72 to $3.56 and is all-in
gievit: calls $2.72
*** RIVER *** [Ks 7s 7d Qh] [Ts]
*** SHOW DOWN ***
HubertusB: shows [7c 8c] (three of a kind, Sevens)
gievit: shows [Qc Kc] (two pair, Kings and Queens)
HubertusB collected $8.03 from pot
*** SUMMARY ***
Total pot $8.38 | Rake $0.35 
Board [Ks 7s 7d Qh Ts]
Seat 1: VLSALT (button) folded before Flop (didn't bet)
Seat 2: ChubakaIII (small blind) folded before Flop
Seat 3: HubertusB (big blind) showed [7c 8c] and won ($8.03) with three of a kind, Sevens
Seat 4: Janski90 folded before Flop (didn't bet)
Seat 5: gievit showed [Qc Kc] and lost with two pair, Kings and Queens
Seat 6: chesm folded before Flop (didn't bet)



PokerStars Zoom Hand #186643463233:  Hold'em No Limit ($0.02/$0.05) - 2018/05/20 20:19:39 CCT [2018/05/20 8:19:39 ET]
Table 'Donati' 6-max Seat #1 is the button
Seat 1: Reshalo.fish ($4.42 in chips) 
Seat 2: offuca ($5 in chips) 
Seat 3: Leopoldia ($1.71 in chips) 
Seat 4: Mattiasgirl ($7.75 in chips) 
Seat 5: HubertusB ($8.03 in chips) 
Seat 6: Mr. Belvit ($5.26 in chips) 
offuca: posts small blind $0.02
Leopoldia: posts big blind $0.05
*** HOLE CARDS ***
Dealt to HubertusB [5d 6d]
Mattiasgirl: folds 
HubertusB: raises $0.05 to $0.10
Mr. Belvit: raises $0.28 to $0.38
Reshalo.fish: folds 
offuca: folds 
Leopoldia: folds 
HubertusB: folds 
Uncalled bet ($0.28) returned to Mr. Belvit
Mr. Belvit collected $0.27 from pot
Mr. Belvit: doesn't show hand 
*** SUMMARY ***
Total pot $0.27 | Rake $0 
Seat 1: Reshalo.fish (button) folded before Flop (didn't bet)
Seat 2: offuca (small blind) folded before Flop
Seat 3: Leopoldia (big blind) folded before Flop
Seat 4: Mattiasgirl folded before Flop (didn't bet)
Seat 5: HubertusB folded before Flop
Seat 6: Mr. Belvit collected ($0.27)



PokerStars Zoom Hand #186643472564:  Hold'em No Limit ($0.02/$0.05) - 2018/05/20 20:19:58 CCT [2018/05/20 8:19:58 ET]
Table 'Donati' 6-max Seat #1 is the button
Seat 1: gievit ($16.03 in chips) 
Seat 2: HubertusB ($7.93 in chips) 
Seat 3: ferenc1946 ($4.60 in chips) 
Seat 4: SereGka228 ($5.95 in chips) 
Seat 5: offuca ($5 in chips) 
Seat 6: WeakmindedV1 ($14.46 in chips) 
HubertusB: posts small blind $0.02
ferenc1946: posts big blind $0.05
*** HOLE CARDS ***
Dealt to HubertusB [3h 4s]
SereGka228: folds 
offuca: folds 
WeakmindedV1: folds 
gievit: folds 
HubertusB: folds 
Uncalled bet ($0.03) returned to ferenc1946
ferenc1946 collected $0.04 from pot
ferenc1946: doesn't show hand 
*** SUMMARY ***
Total pot $0.04 | Rake $0 
Seat 1: gievit (button) folded before Flop (didn't bet)
Seat 2: HubertusB (small blind) folded before Flop
Seat 3: ferenc1946 (big blind) collected ($0.04)
Seat 4: SereGka228 folded before Flop (didn't bet)
Seat 5: offuca folded before Flop (didn't bet)
Seat 6: WeakmindedV1 folded before Flop (didn't bet)



PokerStars Zoom Hand #186643477871:  Hold'em No Limit ($0.02/$0.05) - 2018/05/20 20:20:09 CCT [2018/05/20 8:20:09 ET]
Table 'Donati' 6-max Seat #1 is the button
Seat 1: jackpot345 ($5 in chips) 
Seat 2: Romzes V ($17.30 in chips) 
Seat 3: barbos2009 ($10.78 in chips) 
Seat 4: HubertusB ($7.91 in chips) 
Seat 5: prm4life ($5.38 in chips) 
Seat 6: VLSALT ($5.57 in chips) 
Romzes V: posts small blind $0.02
barbos2009: posts big blind $0.05
*** HOLE CARDS ***
Dealt to HubertusB [Qc 6d]
HubertusB: folds 
prm4life: folds 
VLSALT: raises $0.07 to $0.12
jackpot345: folds 
Romzes V: folds 
barbos2009: folds 
Uncalled bet ($0.07) returned to VLSALT
VLSALT collected $0.12 from pot
VLSALT: doesn't show hand 
*** SUMMARY ***
Total pot $0.12 | Rake $0 
Seat 1: jackpot345 (button) folded before Flop (didn't bet)
Seat 2: Romzes V (small blind) folded before Flop
Seat 3: barbos2009 (big blind) folded before Flop
Seat 4: HubertusB folded before Flop (didn't bet)
Seat 5: prm4life folded before Flop (didn't bet)
Seat 6: VLSALT collected ($0.12)



PokerStars Zoom Hand #186643485273:  Hold'em No Limit ($0.02/$0.05) - 2018/05/20 20:20:24 CCT [2018/05/20 8:20:24 ET]
Table 'Donati' 6-max Seat #1 is the button
Seat 1: Reece1985 ($4.35 in chips) 
Seat 2: c0nscience ($5.07 in chips) 
Seat 3: NICooLIN333 ($6.85 in chips) 
Seat 4: jeffpig16 ($5.22 in chips) 
Seat 5: VLSALT ($7.06 in chips) 
Seat 6: HubertusB ($7.91 in chips) 
c0nscience: posts small blind $0.02
NICooLIN333: posts big blind $0.05
*** HOLE CARDS ***
Dealt to HubertusB [Js 4s]
jeffpig16: folds 
VLSALT: folds 
HubertusB: folds 
Reece1985: raises $0.12 to $0.17
c0nscience: folds 
NICooLIN333: folds 
Uncalled bet ($0.12) returned to Reece1985
Reece1985 collected $0.12 from pot
Reece1985: doesn't show hand 
*** SUMMARY ***
Total pot $0.12 | Rake $0 
Seat 1: Reece1985 (button) collected ($0.12)
Seat 2: c0nscience (small blind) folded before Flop
Seat 3: NICooLIN333 (big blind) folded before Flop
Seat 4: jeffpig16 folded before Flop (didn't bet)
Seat 5: VLSALT folded before Flop (didn't bet)
Seat 6: HubertusB folded before Flop (didn't bet)



PokerStars Zoom Hand #186643491107:  Hold'em No Limit ($0.02/$0.05) - 2018/05/20 20:20:36 CCT [2018/05/20 8:20:36 ET]
Table 'Donati' 6-max Seat #1 is the button
Seat 1: chesm ($5 in chips) 
Seat 2: sedoi746 ($7.08 in chips) 
Seat 3: HubertusB ($7.91 in chips) 
Seat 4: d.kach24 ($5.62 in chips) 
Seat 5: sec31915197 ($5.55 in chips) 
Seat 6: zapzarap@patent ($5 in chips) 
sedoi746: posts small blind $0.02
HubertusB: posts big blind $0.05
*** HOLE CARDS ***
Dealt to HubertusB [Qc 3s]
d.kach24: folds 
sec31915197: folds 
zapzarap@patent: raises $0.07 to $0.12
chesm: folds 
sedoi746: folds 
HubertusB: folds 
Uncalled bet ($0.07) returned to zapzarap@patent
zapzarap@patent collected $0.12 from pot
zapzarap@patent: doesn't show hand 
*** SUMMARY ***
Total pot $0.12 | Rake $0 
Seat 1: chesm (button) folded before Flop (didn't bet)
Seat 2: sedoi746 (small blind) folded before Flop
Seat 3: HubertusB (big blind) folded before Flop
Seat 4: d.kach24 folded before Flop (didn't bet)
Seat 5: sec31915197 folded before Flop (didn't bet)
Seat 6: zapzarap@patent collected ($0.12)



PokerStars Zoom Hand #186643494976:  Hold'em No Limit ($0.02/$0.05) - 2018/05/20 20:20:44 CCT [2018/05/20 8:20:44 ET]
Table 'Donati' 6-max Seat #1 is the button
Seat 1: Reshalo.fish ($3.68 in chips) 
Seat 2: HubertusB ($7.86 in chips) 
Seat 3: Mattiasgirl ($7.75 in chips) 
Seat 4: serge87100 ($5.12 in chips) 
Seat 5: threeson ($5.02 in chips) 
Seat 6: gosumortiz ($6.21 in chips) 
HubertusB: posts small blind $0.02
Mattiasgirl: posts big blind $0.05
*** HOLE CARDS ***
Dealt to HubertusB [9c 3s]
serge87100: raises $0.10 to $0.15
threeson: folds 
gosumortiz: folds 
Reshalo.fish: folds 
HubertusB: folds 
Mattiasgirl: folds 
Uncalled bet ($0.10) returned to serge87100
serge87100 collected $0.12 from pot
serge87100: doesn't show hand 
*** SUMMARY ***
Total pot $0.12 | Rake $0 
Seat 1: Reshalo.fish (button) folded before Flop (didn't bet)
Seat 2: HubertusB (small blind) folded before Flop
Seat 3: Mattiasgirl (big blind) folded before Flop
Seat 4: serge87100 collected ($0.12)
Seat 5: threeson folded before Flop (didn't bet)
Seat 6: gosumortiz folded before Flop (didn't bet)



PokerStars Zoom Hand #186643482862:  Hold'em No Limit ($0.02/$0.05) - 2018/05/20 20:20:19 CCT [2018/05/20 8:20:19 ET]
Table 'Donati' 6-max Seat #1 is the button
Seat 1: HubertusB ($7.91 in chips) 
Seat 2: dironsamson ($4.55 in chips) 
Seat 3: ali3nt0mmy ($9.39 in chips) 
Seat 4: gosumortiz ($5 in chips) 
Seat 5: mama$0104 ($4.64 in chips) 
Seat 6: zwetok ($5.22 in chips) 
dironsamson: posts small blind $0.02
ali3nt0mmy: posts big blind $0.05
*** HOLE CARDS ***
Dealt to HubertusB [7d 9c]
gosumortiz: folds 
mama$0104: folds 
zwetok: raises $0.06 to $0.11
HubertusB: folds 
dironsamson: folds 
ali3nt0mmy: calls $0.06
*** FLOP *** [5c 2h 5h]
ali3nt0mmy: checks 
zwetok: bets $0.11
ali3nt0mmy: calls $0.11
*** TURN *** [5c 2h 5h] [Jc]
ali3nt0mmy: checks 
zwetok: checks 
*** RIVER *** [5c 2h 5h Jc] [7c]
ali3nt0mmy: checks 
zwetok: checks 
*** SHOW DOWN ***
ali3nt0mmy: shows [8s Ac] (a pair of Fives)
zwetok: shows [4d 4h] (two pair, Fives and Fours)
zwetok collected $0.44 from pot
*** SUMMARY ***
Total pot $0.46 | Rake $0.02 
Board [5c 2h 5h Jc 7c]
Seat 1: HubertusB (button) folded before Flop (didn't bet)
Seat 2: dironsamson (small blind) folded before Flop
Seat 3: ali3nt0mmy (big blind) showed [8s Ac] and lost with a pair of Fives
Seat 4: gosumortiz folded before Flop (didn't bet)
Seat 5: mama$0104 folded before Flop (didn't bet)
Seat 6: zwetok showed [4d 4h] and won ($0.44) with two pair, Fives and Fours



PokerStars Zoom Hand #186643488715:  Hold'em No Limit ($0.02/$0.05) - 2018/05/20 20:20:31 CCT [2018/05/20 8:20:31 ET]
Table 'Donati' 6-max Seat #1 is the button
Seat 1: beluci1 ($2.59 in chips) 
Seat 2: Fredchie ($8.51 in chips) 
Seat 3: squ33z3r ($5.73 in chips) 
Seat 4: HubertusB ($7.91 in chips) 
Seat 5: DUDUKA81 ($5.62 in chips) 
Seat 6: Leopoldia ($1.64 in chips) 
Fredchie: posts small blind $0.02
squ33z3r: posts big blind $0.05
*** HOLE CARDS ***
Dealt to HubertusB [7h 8c]
HubertusB: folds 
DUDUKA81: raises $0.10 to $0.15
Leopoldia: folds 
beluci1: folds 
Fredchie: folds 
squ33z3r: calls $0.10
*** FLOP *** [Kh 2s 7c]
squ33z3r: checks 
DUDUKA81: bets $0.17
squ33z3r: folds 
Uncalled bet ($0.17) returned to DUDUKA81
DUDUKA81 collected $0.31 from pot
DUDUKA81: doesn't show hand 
*** SUMMARY ***
Total pot $0.32 | Rake $0.01 
Board [Kh 2s 7c]
Seat 1: beluci1 (button) folded before Flop (didn't bet)
Seat 2: Fredchie (small blind) folded before Flop
Seat 3: squ33z3r (big blind) folded on the Flop
Seat 4: HubertusB folded before Flop (didn't bet)
Seat 5: DUDUKA81 collected ($0.31)
Seat 6: Leopoldia folded before Flop (didn't bet)



PokerStars Zoom Hand #186643497516:  Hold'em No Limit ($0.02/$0.05) - 2018/05/20 20:20:49 CCT [2018/05/20 8:20:49 ET]
Table 'Donati' 6-max Seat #1 is the button
Seat 1: amx16 ($5 in chips) 
Seat 2: SereGka228 ($5 in chips) 
Seat 3: ANANATOR ($5.67 in chips) 
Seat 4: Viking218 ($3.21 in chips) 
Seat 5: NICooLIN333 ($5 in chips) 
Seat 6: HubertusB ($7.84 in chips) 
SereGka228: posts small blind $0.02
ANANATOR: posts big blind $0.05
*** HOLE CARDS ***
Dealt to HubertusB [Jh 8d]
Viking218: folds 
NICooLIN333: folds 
HubertusB: folds 
amx16: folds 
SereGka228: folds 
Uncalled bet ($0.03) returned to ANANATOR
ANANATOR collected $0.04 from pot
ANANATOR: doesn't show hand 
*** SUMMARY ***
Total pot $0.04 | Rake $0 
Seat 1: amx16 (button) folded before Flop (didn't bet)
Seat 2: SereGka228 (small blind) folded before Flop
Seat 3: ANANATOR (big blind) collected ($0.04)
Seat 4: Viking218 folded before Flop (didn't bet)
Seat 5: NICooLIN333 folded before Flop (didn't bet)
Seat 6: HubertusB folded before Flop (didn't bet)



PokerStars Zoom Hand #186643502368:  Hold'em No Limit ($0.02/$0.05) - 2018/05/20 20:20:59 CCT [2018/05/20 8:20:59 ET]
Table 'Donati' 6-max Seat #1 is the button
Seat 1: HubertusB ($7.84 in chips) 
Seat 2: yokoyoko76 ($5.55 in chips) 
Seat 3: luka1981good ($5 in chips) 
Seat 4: key555866 ($13.03 in chips) 
Seat 5: barbos2009 ($21.71 in chips) 
Seat 6: orangedeuce ($5.34 in chips) 
yokoyoko76: posts small blind $0.02
luka1981good: posts big blind $0.05
*** HOLE CARDS ***
Dealt to HubertusB [Kh 5c]
key555866: folds 
barbos2009: folds 
orangedeuce: raises $0.10 to $0.15
HubertusB: folds 
yokoyoko76: folds 
luka1981good: folds 
Uncalled bet ($0.10) returned to orangedeuce
orangedeuce collected $0.12 from pot
orangedeuce: doesn't show hand 
*** SUMMARY ***
Total pot $0.12 | Rake $0 
Seat 1: HubertusB (button) folded before Flop (didn't bet)
Seat 2: yokoyoko76 (small blind) folded before Flop
Seat 3: luka1981good (big blind) folded before Flop
Seat 4: key555866 folded before Flop (didn't bet)
Seat 5: barbos2009 folded before Flop (didn't bet)
Seat 6: orangedeuce collected ($0.12)



PokerStars Zoom Hand #186643508709:  Hold'em No Limit ($0.02/$0.05) - 2018/05/20 20:21:12 CCT [2018/05/20 8:21:12 ET]
Table 'Donati' 6-max Seat #1 is the button
Seat 1: spazzzmonkey ($12.48 in chips) 
Seat 2: chesm ($5 in chips) 
Seat 3: HubertusB ($7.84 in chips) 
Seat 4: lasyboy999 ($9.59 in chips) 
Seat 5: g8m3yst3er ($5.13 in chips) 
Seat 6: kukkertje ($8.04 in chips) 
chesm: posts small blind $0.02
HubertusB: posts big blind $0.05
*** HOLE CARDS ***
Dealt to HubertusB [8c 3d]
lasyboy999: folds 
g8m3yst3er: folds 
kukkertje: folds 
spazzzmonkey: folds 
chesm: folds 
Uncalled bet ($0.03) returned to HubertusB
HubertusB collected $0.04 from pot
HubertusB: doesn't show hand 
*** SUMMARY ***
Total pot $0.04 | Rake $0 
Seat 1: spazzzmonkey (button) folded before Flop (didn't bet)
Seat 2: chesm (small blind) folded before Flop
Seat 3: HubertusB (big blind) collected ($0.04)
Seat 4: lasyboy999 folded before Flop (didn't bet)
Seat 5: g8m3yst3er folded before Flop (didn't bet)
Seat 6: kukkertje folded before Flop (didn't bet)



PokerStars Zoom Hand #186643505783:  Hold'em No Limit ($0.02/$0.05) - 2018/05/20 20:21:06 CCT [2018/05/20 8:21:06 ET]
Table 'Donati' 6-max Seat #1 is the button
Seat 1: Machylius777 ($2.57 in chips) 
Seat 2: Arrenea ($8.66 in chips) 
Seat 3: Chinga4kuk ($5 in chips) 
Seat 4: Jeka Griva ($7.57 in chips) 
Seat 5: HubertusB ($7.84 in chips) 
Seat 6: leo2030 ($6.74 in chips) 
Arrenea: posts small blind $0.02
Chinga4kuk: posts big blind $0.05
*** HOLE CARDS ***
Dealt to HubertusB [6s 5c]
Jeka Griva: raises $0.10 to $0.15
HubertusB: folds 
leo2030: folds 
Machylius777: calls $0.15
Arrenea: folds 
Chinga4kuk: folds 
*** FLOP *** [Ts 4s 3d]
Jeka Griva: bets $0.20
Machylius777: calls $0.20
*** TURN *** [Ts 4s 3d] [Kh]
Jeka Griva: bets $0.41
Machylius777: calls $0.41
*** RIVER *** [Ts 4s 3d Kh] [3s]
Jeka Griva: bets $0.67
Machylius777: calls $0.67
*** SHOW DOWN ***
Jeka Griva: shows [Kd Jh] (two pair, Kings and Threes)
Machylius777: mucks hand 
Jeka Griva collected $2.81 from pot
*** SUMMARY ***
Total pot $2.93 | Rake $0.12 
Board [Ts 4s 3d Kh 3s]
Seat 1: Machylius777 (button) mucked [6c Kc]
Seat 2: Arrenea (small blind) folded before Flop
Seat 3: Chinga4kuk (big blind) folded before Flop
Seat 4: Jeka Griva showed [Kd Jh] and won ($2.81) with two pair, Kings and Threes
Seat 5: HubertusB folded before Flop (didn't bet)
Seat 6: leo2030 folded before Flop (didn't bet)



PokerStars Zoom Hand #186643516085:  Hold'em No Limit ($0.02/$0.05) - 2018/05/20 20:21:27 CCT [2018/05/20 8:21:27 ET]
Table 'Donati' 6-max Seat #1 is the button
Seat 1: Chinga4kuk ($5 in chips) 
Seat 2: HubertusB ($7.86 in chips) 
Seat 3: bidipro ($9.45 in chips) 
Seat 4: bigazzz67 ($6.91 in chips) 
Seat 5: rafa_santel ($5.55 in chips) 
Seat 6: TOMEF1CHA ($7.06 in chips) 
HubertusB: posts small blind $0.02
bidipro: posts big blind $0.05
*** HOLE CARDS ***
Dealt to HubertusB [Jc 7s]
bigazzz67: folds 
rafa_santel: folds 
TOMEF1CHA: folds 
Chinga4kuk: raises $0.07 to $0.12
HubertusB: folds 
bidipro: folds 
Uncalled bet ($0.07) returned to Chinga4kuk
Chinga4kuk collected $0.12 from pot
Chinga4kuk: doesn't show hand 
*** SUMMARY ***
Total pot $0.12 | Rake $0 
Seat 1: Chinga4kuk (button) collected ($0.12)
Seat 2: HubertusB (small blind) folded before Flop
Seat 3: bidipro (big blind) folded before Flop
Seat 4: bigazzz67 folded before Flop (didn't bet)
Seat 5: rafa_santel folded before Flop (didn't bet)
Seat 6: TOMEF1CHA folded before Flop (didn't bet)



PokerStars Zoom Hand #186643499948:  Hold'em No Limit ($0.02/$0.05) - 2018/05/20 20:20:54 CCT [2018/05/20 8:20:54 ET]
Table 'Donati' 6-max Seat #1 is the button
Seat 1: tigran63 ($8.49 in chips) 
Seat 2: R0ME0_17 ($3.82 in chips) 
Seat 3: QWER7786 ($6.79 in chips) 
Seat 4: HubertusB ($7.84 in chips) 
Seat 5: legitspade12 ($4.28 in chips) 
Seat 6: dejii ($5 in chips) 
R0ME0_17: posts small blind $0.02
QWER7786: posts big blind $0.05
*** HOLE CARDS ***
Dealt to HubertusB [Qh Tc]
HubertusB: folds 
legitspade12: folds 
dejii: raises $0.10 to $0.15
tigran63: folds 
R0ME0_17: calls $0.13
QWER7786: folds 
*** FLOP *** [Qd 8s 4s]
R0ME0_17: checks 
dejii: checks 
*** TURN *** [Qd 8s 4s] [2d]
R0ME0_17: bets $0.17
dejii: calls $0.17
*** RIVER *** [Qd 8s 4s 2d] [Ad]
R0ME0_17: bets $0.53
dejii: folds 
Uncalled bet ($0.53) returned to R0ME0_17
R0ME0_17 collected $0.66 from pot
R0ME0_17: doesn't show hand 
*** SUMMARY ***
Total pot $0.69 | Rake $0.03 
Board [Qd 8s 4s 2d Ad]
Seat 1: tigran63 (button) folded before Flop (didn't bet)
Seat 2: R0ME0_17 (small blind) collected ($0.66)
Seat 3: QWER7786 (big blind) folded before Flop
Seat 4: HubertusB folded before Flop (didn't bet)
Seat 5: legitspade12 folded before Flop (didn't bet)
Seat 6: dejii folded on the River



PokerStars Zoom Hand #186643519003:  Hold'em No Limit ($0.02/$0.05) - 2018/05/20 20:21:33 CCT [2018/05/20 8:21:33 ET]
Table 'Donati' 6-max Seat #1 is the button
Seat 1: HubertusB ($7.84 in chips) 
Seat 2: mama$0104 ($4.64 in chips) 
Seat 3: klon2311 ($7.11 in chips) 
Seat 4: prm4life ($5.72 in chips) 
Seat 5: OsloVest ($6.66 in chips) 
Seat 6: bamboocha88 ($5.05 in chips) 
mama$0104: posts small blind $0.02
klon2311: posts big blind $0.05
*** HOLE CARDS ***
Dealt to HubertusB [Qh Qd]
prm4life: folds 
OsloVest: folds 
bamboocha88: folds 
HubertusB: raises $0.10 to $0.15
mama$0104: folds 
klon2311: raises $0.30 to $0.45
HubertusB: calls $0.30
*** FLOP *** [Td Kc 8d]
klon2311: bets $0.44
HubertusB: calls $0.44
*** TURN *** [Td Kc 8d] [8h]
klon2311: bets $1.30
HubertusB: folds 
Uncalled bet ($1.30) returned to klon2311
klon2311 collected $1.73 from pot
klon2311: doesn't show hand 
*** SUMMARY ***
Total pot $1.80 | Rake $0.07 
Board [Td Kc 8d 8h]
Seat 1: HubertusB (button) folded on the Turn
Seat 2: mama$0104 (small blind) folded before Flop
Seat 3: klon2311 (big blind) collected ($1.73)
Seat 4: prm4life folded before Flop (didn't bet)
Seat 5: OsloVest folded before Flop (didn't bet)
Seat 6: bamboocha88 folded before Flop (didn't bet)



PokerStars Zoom Hand #186643552624:  Hold'em No Limit ($0.02/$0.05) - 2018/05/20 20:22:41 CCT [2018/05/20 8:22:41 ET]
Table 'Donati' 6-max Seat #1 is the button
Seat 1: PM17Lev ($14.04 in chips) 
Seat 2: TheN@kedGun ($5.78 in chips) 
Seat 3: dntp ($5 in chips) 
Seat 4: Opcius ($5.97 in chips) 
Seat 5: kogorou999 ($9.84 in chips) 
Seat 6: HubertusB ($6.95 in chips) 
TheN@kedGun: posts small blind $0.02
dntp: posts big blind $0.05
*** HOLE CARDS ***
Dealt to HubertusB [Ac Tc]
Opcius: raises $0.07 to $0.12
kogorou999: folds 
HubertusB: calls $0.12
PM17Lev: folds 
TheN@kedGun: folds 
dntp: folds 
*** FLOP *** [6d 8s Ts]
Opcius: bets $0.18
HubertusB: calls $0.18
*** TURN *** [6d 8s Ts] [3s]
Opcius: bets $0.26
HubertusB: calls $0.26
*** RIVER *** [6d 8s Ts 3s] [5d]
Opcius: bets $0.46
HubertusB: calls $0.46
*** SHOW DOWN ***
Opcius: shows [Kh Kd] (a pair of Kings)
HubertusB: mucks hand 
Opcius collected $2.02 from pot
*** SUMMARY ***
Total pot $2.11 | Rake $0.09 
Board [6d 8s Ts 3s 5d]
Seat 1: PM17Lev (button) folded before Flop (didn't bet)
Seat 2: TheN@kedGun (small blind) folded before Flop
Seat 3: dntp (big blind) folded before Flop
Seat 4: Opcius showed [Kh Kd] and won ($2.02) with a pair of Kings
Seat 5: kogorou999 folded before Flop (didn't bet)
Seat 6: HubertusB mucked [Ac Tc]



PokerStars Zoom Hand #186643576131:  Hold'em No Limit ($0.02/$0.05) - 2018/05/20 20:23:29 CCT [2018/05/20 8:23:29 ET]
Table 'Donati' 6-max Seat #1 is the button
Seat 1: offuca ($5.29 in chips) 
Seat 2: elbarto4468 ($8.29 in chips) 
Seat 3: WeakmindedV1 ($7.03 in chips) 
Seat 4: sec31915197 ($5.38 in chips) 
Seat 5: HubertusB ($5.93 in chips) 
Seat 6: VitaliiVV89 ($6.33 in chips) 
elbarto4468: posts small blind $0.02
WeakmindedV1: posts big blind $0.05
*** HOLE CARDS ***
Dealt to HubertusB [4c Qs]
sec31915197: folds 
HubertusB: folds 
VitaliiVV89: folds 
offuca: raises $0.07 to $0.12
elbarto4468: folds 
WeakmindedV1: calls $0.07
*** FLOP *** [Ad Ac 7h]
WeakmindedV1: checks 
offuca: bets $0.14
WeakmindedV1: folds 
Uncalled bet ($0.14) returned to offuca
offuca collected $0.25 from pot
offuca: doesn't show hand 
*** SUMMARY ***
Total pot $0.26 | Rake $0.01 
Board [Ad Ac 7h]
Seat 1: offuca (button) collected ($0.25)
Seat 2: elbarto4468 (small blind) folded before Flop
Seat 3: WeakmindedV1 (big blind) folded on the Flop
Seat 4: sec31915197 folded before Flop (didn't bet)
Seat 5: HubertusB folded before Flop (didn't bet)
Seat 6: VitaliiVV89 folded before Flop (didn't bet)



PokerStars Zoom Hand #186643578607:  Hold'em No Limit ($0.02/$0.05) - 2018/05/20 20:23:34 CCT [2018/05/20 8:23:34 ET]
Table 'Donati' 6-max Seat #1 is the button
Seat 1: 111si@v@111 ($4.58 in chips) 
Seat 2: dejii ($5 in chips) 
Seat 3: LuckyBBastar ($19.15 in chips) 
Seat 4: bamboocha88 ($8.66 in chips) 
Seat 5: Julietta1997 ($6.87 in chips) 
Seat 6: HubertusB ($5.93 in chips) 
dejii: posts small blind $0.02
LuckyBBastar: posts big blind $0.05
*** HOLE CARDS ***
Dealt to HubertusB [Kd Td]
bamboocha88: folds 
Julietta1997: folds 
HubertusB: raises $0.10 to $0.15
111si@v@111: calls $0.15
dejii: folds 
LuckyBBastar: folds 
*** FLOP *** [6h 8d Qh]
HubertusB: checks 
111si@v@111: checks 
*** TURN *** [6h 8d Qh] [Qc]
HubertusB: checks 
111si@v@111: checks 
*** RIVER *** [6h 8d Qh Qc] [4c]
HubertusB: checks 
111si@v@111: bets $0.15
HubertusB: folds 
Uncalled bet ($0.15) returned to 111si@v@111
111si@v@111 collected $0.35 from pot
111si@v@111: doesn't show hand 
*** SUMMARY ***
Total pot $0.37 | Rake $0.02 
Board [6h 8d Qh Qc 4c]
Seat 1: 111si@v@111 (button) collected ($0.35)
Seat 2: dejii (small blind) folded before Flop
Seat 3: LuckyBBastar (big blind) folded before Flop
Seat 4: bamboocha88 folded before Flop (didn't bet)
Seat 5: Julietta1997 folded before Flop (didn't bet)
Seat 6: HubertusB folded on the River



PokerStars Zoom Hand #186643589929:  Hold'em No Limit ($0.02/$0.05) - 2018/05/20 20:23:57 CCT [2018/05/20 8:23:57 ET]
Table 'Donati' 6-max Seat #1 is the button
Seat 1: Krawicz ($5 in chips) 
Seat 2: adytoditza ($4.50 in chips) 
Seat 3: HubertusB ($5.78 in chips) 
Seat 4: <Bogolal> ($5.06 in chips) 
Seat 5: olleyzell ($5.01 in chips) 
Seat 6: Original Flo ($2.07 in chips) 
adytoditza: posts small blind $0.02
HubertusB: posts big blind $0.05
*** HOLE CARDS ***
Dealt to HubertusB [7h 9c]
<Bogolal>: raises $0.10 to $0.15
olleyzell: calls $0.15
Original Flo: folds 
Krawicz: folds 
adytoditza: folds 
HubertusB: folds 
*** FLOP *** [5c 8d Ac]
<Bogolal>: bets $0.15
olleyzell: folds 
Uncalled bet ($0.15) returned to <Bogolal>
<Bogolal> collected $0.35 from pot
<Bogolal>: doesn't show hand 
*** SUMMARY ***
Total pot $0.37 | Rake $0.02 
Board [5c 8d Ac]
Seat 1: Krawicz (button) folded before Flop (didn't bet)
Seat 2: adytoditza (small blind) folded before Flop
Seat 3: HubertusB (big blind) folded before Flop
Seat 4: <Bogolal> collected ($0.35)
Seat 5: olleyzell folded on the Flop
Seat 6: Original Flo folded before Flop (didn't bet)



PokerStars Zoom Hand #186643593354:  Hold'em No Limit ($0.02/$0.05) - 2018/05/20 20:24:04 CCT [2018/05/20 8:24:04 ET]
Table 'Donati' 6-max Seat #1 is the button
Seat 1: zwetok ($13.21 in chips) 
Seat 2: d.kach24 ($5 in chips) 
Seat 3: Daemon'sKiss ($5 in chips) 
Seat 4: HubertusB ($5.73 in chips) 
Seat 5: Chinga4kuk ($5 in chips) 
Seat 6: slob43.ru ($5.63 in chips) 
d.kach24: posts small blind $0.02
Daemon'sKiss: posts big blind $0.05
*** HOLE CARDS ***
Dealt to HubertusB [Ts Td]
HubertusB: raises $0.10 to $0.15
Chinga4kuk: folds 
slob43.ru: folds 
zwetok: raises $0.31 to $0.46
d.kach24: folds 
Daemon'sKiss: folds 
HubertusB: calls $0.31
*** FLOP *** [6d 7s Kd]
HubertusB: checks 
zwetok: bets $0.31
HubertusB: calls $0.31
*** TURN *** [6d 7s Kd] [Qs]
HubertusB: checks 
zwetok: checks 
*** RIVER *** [6d 7s Kd Qs] [3d]
HubertusB: checks 
zwetok: checks 
*** SHOW DOWN ***
HubertusB: shows [Ts Td] (a pair of Tens)
zwetok: mucks hand 
HubertusB collected $1.54 from pot
*** SUMMARY ***
Total pot $1.61 | Rake $0.07 
Board [6d 7s Kd Qs 3d]
Seat 1: zwetok (button) mucked [8d 8c]
Seat 2: d.kach24 (small blind) folded before Flop
Seat 3: Daemon'sKiss (big blind) folded before Flop
Seat 4: HubertusB showed [Ts Td] and won ($1.54) with a pair of Tens
Seat 5: Chinga4kuk folded before Flop (didn't bet)
Seat 6: slob43.ru folded before Flop (didn't bet)



PokerStars Zoom Hand #186643609063:  Hold'em No Limit ($0.02/$0.05) - 2018/05/20 20:24:36 CCT [2018/05/20 8:24:36 ET]
Table 'Donati' 6-max Seat #1 is the button
Seat 1: HubertusB ($6.50 in chips) 
Seat 2: squ33z3r ($5.49 in chips) 
Seat 3: cazzzwell ($5.07 in chips) 
Seat 4: J4ckyCola ($4.71 in chips) 
Seat 5: Omicron333 ($12.63 in chips) 
Seat 6: Spookie_1980 ($11.44 in chips) 
squ33z3r: posts small blind $0.02
cazzzwell: posts big blind $0.05
*** HOLE CARDS ***
Dealt to HubertusB [6d Ks]
J4ckyCola: folds 
Omicron333: folds 
Spookie_1980: raises $0.07 to $0.12
HubertusB: folds 
squ33z3r: folds 
cazzzwell: folds 
Uncalled bet ($0.07) returned to Spookie_1980
Spookie_1980 collected $0.12 from pot
Spookie_1980: doesn't show hand 
*** SUMMARY ***
Total pot $0.12 | Rake $0 
Seat 1: HubertusB (button) folded before Flop (didn't bet)
Seat 2: squ33z3r (small blind) folded before Flop
Seat 3: cazzzwell (big blind) folded before Flop
Seat 4: J4ckyCola folded before Flop (didn't bet)
Seat 5: Omicron333 folded before Flop (didn't bet)
Seat 6: Spookie_1980 collected ($0.12)



PokerStars Zoom Hand #186643611512:  Hold'em No Limit ($0.02/$0.05) - 2018/05/20 20:24:41 CCT [2018/05/20 8:24:41 ET]
Table 'Donati' 6-max Seat #1 is the button
Seat 1: Goosich ($9.05 in chips) 
Seat 2: HubertusB ($6.50 in chips) 
Seat 3: sedoi746 ($7.41 in chips) 
Seat 4: przemyslaw35 ($4.72 in chips) 
Seat 5: Farad84 ($5.48 in chips) 
Seat 6: minimus777 ($2.06 in chips) 
HubertusB: posts small blind $0.02
sedoi746: posts big blind $0.05
*** HOLE CARDS ***
Dealt to HubertusB [2d 4d]
przemyslaw35: folds 
Farad84: folds 
minimus777: folds 
Goosich: folds 
HubertusB: folds 
Uncalled bet ($0.03) returned to sedoi746
sedoi746 collected $0.04 from pot
sedoi746: doesn't show hand 
*** SUMMARY ***
Total pot $0.04 | Rake $0 
Seat 1: Goosich (button) folded before Flop (didn't bet)
Seat 2: HubertusB (small blind) folded before Flop
Seat 3: sedoi746 (big blind) collected ($0.04)
Seat 4: przemyslaw35 folded before Flop (didn't bet)
Seat 5: Farad84 folded before Flop (didn't bet)
Seat 6: minimus777 folded before Flop (didn't bet)



PokerStars Zoom Hand #186643619941:  Hold'em No Limit ($0.02/$0.05) - 2018/05/20 20:24:58 CCT [2018/05/20 8:24:58 ET]
Table 'Donati' 6-max Seat #1 is the button
Seat 1: Jiu51 ($7.07 in chips) 
Seat 2: Danil548 ($4.28 in chips) 
Seat 3: bushman86511 ($8.30 in chips) 
Seat 4: HubertusB ($6.43 in chips) 
Seat 5: Romzes V ($17.34 in chips) 
Seat 6: WeakmindedV1 ($14.31 in chips) 
Danil548: posts small blind $0.02
bushman86511: posts big blind $0.05
*** HOLE CARDS ***
Dealt to HubertusB [4d 6s]
HubertusB: folds 
Romzes V: folds 
WeakmindedV1: folds 
Jiu51: folds 
Danil548: folds 
Uncalled bet ($0.03) returned to bushman86511
bushman86511 collected $0.04 from pot
bushman86511: doesn't show hand 
*** SUMMARY ***
Total pot $0.04 | Rake $0 
Seat 1: Jiu51 (button) folded before Flop (didn't bet)
Seat 2: Danil548 (small blind) folded before Flop
Seat 3: bushman86511 (big blind) collected ($0.04)
Seat 4: HubertusB folded before Flop (didn't bet)
Seat 5: Romzes V folded before Flop (didn't bet)
Seat 6: WeakmindedV1 folded before Flop (didn't bet)



PokerStars Zoom Hand #186643613985:  Hold'em No Limit ($0.02/$0.05) - 2018/05/20 20:24:46 CCT [2018/05/20 8:24:46 ET]
Table 'Donati' 6-max Seat #1 is the button
Seat 1: thiusk ($5.07 in chips) 
Seat 2: Blackhare ($5 in chips) 
Seat 3: HubertusB ($6.48 in chips) 
Seat 4: BardJeka ($5.02 in chips) 
Seat 5: iKiiiLL4fun ($5.02 in chips) 
Seat 6: Mr.Nuttts ($5 in chips) 
Blackhare: posts small blind $0.02
HubertusB: posts big blind $0.05
*** HOLE CARDS ***
Dealt to HubertusB [3h Js]
BardJeka: folds 
iKiiiLL4fun: folds 
Mr.Nuttts: folds 
thiusk: raises $0.10 to $0.15
Blackhare: raises $0.35 to $0.50
HubertusB: folds 
thiusk: folds 
Uncalled bet ($0.35) returned to Blackhare
Blackhare collected $0.35 from pot
Blackhare: doesn't show hand 
*** SUMMARY ***
Total pot $0.35 | Rake $0 
Seat 1: thiusk (button) folded before Flop
Seat 2: Blackhare (small blind) collected ($0.35)
Seat 3: HubertusB (big blind) folded before Flop
Seat 4: BardJeka folded before Flop (didn't bet)
Seat 5: iKiiiLL4fun folded before Flop (didn't bet)
Seat 6: Mr.Nuttts folded before Flop (didn't bet)



PokerStars Zoom Hand #186643622896:  Hold'em No Limit ($0.02/$0.05) - 2018/05/20 20:25:04 CCT [2018/05/20 8:25:04 ET]
Table 'Donati' 6-max Seat #1 is the button
Seat 1: DUDUKA81 ($5.48 in chips) 
Seat 2: MAGE%CARDS ($5.18 in chips) 
Seat 3: dedgasik ($3.53 in chips) 
Seat 4: bamboocha88 ($5.02 in chips) 
Seat 5: QWER7786 ($10.25 in chips) 
Seat 6: HubertusB ($6.43 in chips) 
MAGE%CARDS: posts small blind $0.02
dedgasik: posts big blind $0.05
*** HOLE CARDS ***
Dealt to HubertusB [2s 7h]
bamboocha88: folds 
QWER7786: folds 
HubertusB: folds 
DUDUKA81: raises $0.06 to $0.11
MAGE%CARDS: folds 
dedgasik: folds 
Uncalled bet ($0.06) returned to DUDUKA81
DUDUKA81 collected $0.12 from pot
DUDUKA81: doesn't show hand 
*** SUMMARY ***
Total pot $0.12 | Rake $0 
Seat 1: DUDUKA81 (button) collected ($0.12)
Seat 2: MAGE%CARDS (small blind) folded before Flop
Seat 3: dedgasik (big blind) folded before Flop
Seat 4: bamboocha88 folded before Flop (didn't bet)
Seat 5: QWER7786 folded before Flop (didn't bet)
Seat 6: HubertusB folded before Flop (didn't bet)



PokerStars Zoom Hand #186643626806:  Hold'em No Limit ($0.02/$0.05) - 2018/05/20 20:25:12 CCT [2018/05/20 8:25:12 ET]
Table 'Donati' 6-max Seat #1 is the button
Seat 1: HubertusB ($6.41 in chips) 
Seat 2: Teach133 ($4.08 in chips) 
Seat 3: VLSALT ($5.85 in chips) 
Seat 4: edy1991 ($1.50 in chips) 
Seat 5: smoot21 ($13.26 in chips) 
Seat 6: tigran63 ($9.03 in chips) 
Teach133: posts small blind $0.02
VLSALT: posts big blind $0.05
*** HOLE CARDS ***
Dealt to HubertusB [Js 6s]
edy1991: folds 
smoot21: folds 
tigran63: folds 
HubertusB: folds 
Teach133: folds 
Uncalled bet ($0.03) returned to VLSALT
VLSALT collected $0.04 from pot
VLSALT: doesn't show hand 
*** SUMMARY ***
Total pot $0.04 | Rake $0 
Seat 1: HubertusB (button) folded before Flop (didn't bet)
Seat 2: Teach133 (small blind) folded before Flop
Seat 3: VLSALT (big blind) collected ($0.04)
Seat 4: edy1991 folded before Flop (didn't bet)
Seat 5: smoot21 folded before Flop (didn't bet)
Seat 6: tigran63 folded before Flop (didn't bet)



PokerStars Zoom Hand #186643628835:  Hold'em No Limit ($0.02/$0.05) - 2018/05/20 20:25:16 CCT [2018/05/20 8:25:16 ET]
Table 'Donati' 6-max Seat #1 is the button
Seat 1: Krawicz ($5.88 in chips) 
Seat 2: gievit ($9.03 in chips) 
Seat 3: artaxruciv ($8.87 in chips) 
Seat 4: DUDUKA81 ($5.55 in chips) 
Seat 5: HubertusB ($6.41 in chips) 
Seat 6: cazzzwell ($5 in chips) 
gievit: posts small blind $0.02
artaxruciv: posts big blind $0.05
*** HOLE CARDS ***
Dealt to HubertusB [9h Kc]
DUDUKA81: folds 
HubertusB: folds 
cazzzwell: folds 
Krawicz: folds 
gievit: raises $0.11 to $0.16
artaxruciv: calls $0.11
*** FLOP *** [2c 8c 6c]
gievit: checks 
artaxruciv: bets $0.25
gievit: folds 
Uncalled bet ($0.25) returned to artaxruciv
artaxruciv collected $0.31 from pot
artaxruciv: doesn't show hand 
*** SUMMARY ***
Total pot $0.32 | Rake $0.01 
Board [2c 8c 6c]
Seat 1: Krawicz (button) folded before Flop (didn't bet)
Seat 2: gievit (small blind) folded on the Flop
Seat 3: artaxruciv (big blind) collected ($0.31)
Seat 4: DUDUKA81 folded before Flop (didn't bet)
Seat 5: HubertusB folded before Flop (didn't bet)
Seat 6: cazzzwell folded before Flop (didn't bet)



PokerStars Zoom Hand #186643634330:  Hold'em No Limit ($0.02/$0.05) - 2018/05/20 20:25:27 CCT [2018/05/20 8:25:27 ET]
Table 'Donati' 6-max Seat #1 is the button
Seat 1: haqpod ($5 in chips) 
Seat 2: Daemon'sKiss ($5.02 in chips) 
Seat 3: HubertusB ($6.41 in chips) 
Seat 4: BardJeka ($5.55 in chips) 
Seat 5: filifera ($2.98 in chips) 
Seat 6: Farad84 ($17.15 in chips) 
Daemon'sKiss: posts small blind $0.02
HubertusB: posts big blind $0.05
*** HOLE CARDS ***
Dealt to HubertusB [Ah Tc]
BardJeka: folds 
filifera: folds 
Farad84: folds 
haqpod: raises $0.08 to $0.13
Daemon'sKiss: folds 
HubertusB: folds 
Uncalled bet ($0.08) returned to haqpod
haqpod collected $0.12 from pot
haqpod: doesn't show hand 
*** SUMMARY ***
Total pot $0.12 | Rake $0 
Seat 1: haqpod (button) collected ($0.12)
Seat 2: Daemon'sKiss (small blind) folded before Flop
Seat 3: HubertusB (big blind) folded before Flop
Seat 4: BardJeka folded before Flop (didn't bet)
Seat 5: filifera folded before Flop (didn't bet)
Seat 6: Farad84 folded before Flop (didn't bet)



PokerStars Zoom Hand #186643624870:  Hold'em No Limit ($0.02/$0.05) - 2018/05/20 20:25:08 CCT [2018/05/20 8:25:08 ET]
Table 'Donati' 6-max Seat #1 is the button
Seat 1: kukkertje ($6.57 in chips) 
Seat 2: HubertusB ($6.43 in chips) 
Seat 3: zwetok ($5.84 in chips) 
Seat 4: thekvlt ($5 in chips) 
Seat 5: Blackhare ($7.51 in chips) 
Seat 6: LuckyBBastar ($11.39 in chips) 
HubertusB: posts small blind $0.02
zwetok: posts big blind $0.05
*** HOLE CARDS ***
Dealt to HubertusB [Ah 3s]
thekvlt: folds 
Blackhare: raises $0.10 to $0.15
LuckyBBastar: calls $0.15
kukkertje: folds 
HubertusB: folds 
zwetok: calls $0.10
*** FLOP *** [7d Td Qs]
zwetok: checks 
Blackhare: checks 
LuckyBBastar: checks 
*** TURN *** [7d Td Qs] [9d]
zwetok: checks 
Blackhare: checks 
LuckyBBastar: checks 
*** RIVER *** [7d Td Qs 9d] [Jc]
zwetok: checks 
Blackhare: bets $0.34
LuckyBBastar: folds 
zwetok: folds 
Uncalled bet ($0.34) returned to Blackhare
Blackhare collected $0.45 from pot
Blackhare: doesn't show hand 
*** SUMMARY ***
Total pot $0.47 | Rake $0.02 
Board [7d Td Qs 9d Jc]
Seat 1: kukkertje (button) folded before Flop (didn't bet)
Seat 2: HubertusB (small blind) folded before Flop
Seat 3: zwetok (big blind) folded on the River
Seat 4: thekvlt folded before Flop (didn't bet)
Seat 5: Blackhare collected ($0.45)
Seat 6: LuckyBBastar folded on the River



PokerStars Zoom Hand #186643639623:  Hold'em No Limit ($0.02/$0.05) - 2018/05/20 20:25:38 CCT [2018/05/20 8:25:38 ET]
Table 'Donati' 6-max Seat #1 is the button
Seat 1: smoot21 ($13.11 in chips) 
Seat 2: Action Peter ($5.02 in chips) 
Seat 3: FelixZyl ($28.23 in chips) 
Seat 4: TheN@kedGun ($6.18 in chips) 
Seat 5: LuckyBBastar ($19.03 in chips) 
Seat 6: HubertusB ($6.36 in chips) 
Action Peter: posts small blind $0.02
FelixZyl: posts big blind $0.05
*** HOLE CARDS ***
Dealt to HubertusB [4c 8s]
TheN@kedGun: folds 
LuckyBBastar: raises $0.09 to $0.14
HubertusB: folds 
smoot21: folds 
Action Peter: folds 
FelixZyl: folds 
Uncalled bet ($0.09) returned to LuckyBBastar
LuckyBBastar collected $0.12 from pot
LuckyBBastar: doesn't show hand 
*** SUMMARY ***
Total pot $0.12 | Rake $0 
Seat 1: smoot21 (button) folded before Flop (didn't bet)
Seat 2: Action Peter (small blind) folded before Flop
Seat 3: FelixZyl (big blind) folded before Flop
Seat 4: TheN@kedGun folded before Flop (didn't bet)
Seat 5: LuckyBBastar collected ($0.12)
Seat 6: HubertusB folded before Flop (didn't bet)



PokerStars Zoom Hand #186643631276:  Hold'em No Limit ($0.02/$0.05) - 2018/05/20 20:25:21 CCT [2018/05/20 8:25:21 ET]
Table 'Donati' 6-max Seat #1 is the button
Seat 1: Goosich ($5.20 in chips) 
Seat 2: LuckyBBastar ($19.05 in chips) 
Seat 3: sixequjfive ($5.12 in chips) 
Seat 4: jeffpig16 ($5.28 in chips) 
Seat 5: HubertusB ($6.41 in chips) 
Seat 6: polyakov090487 ($2.95 in chips) 
LuckyBBastar: posts small blind $0.02
sixequjfive: posts big blind $0.05
*** HOLE CARDS ***
Dealt to HubertusB [2h 3s]
jeffpig16: folds 
HubertusB: folds 
polyakov090487: calls $0.05
Goosich: folds 
LuckyBBastar: folds 
sixequjfive: checks 
*** FLOP *** [Ts 6h Jc]
sixequjfive: checks 
polyakov090487: checks 
*** TURN *** [Ts 6h Jc] [5d]
sixequjfive: bets $0.08
polyakov090487: calls $0.08
*** RIVER *** [Ts 6h Jc 5d] [5c]
sixequjfive: bets $0.16
polyakov090487: raises $0.16 to $0.32
sixequjfive: calls $0.16
*** SHOW DOWN ***
polyakov090487: shows [Ad 4h] (a pair of Fives)
sixequjfive: shows [7s Jh] (two pair, Jacks and Fives)
sixequjfive collected $0.88 from pot
*** SUMMARY ***
Total pot $0.92 | Rake $0.04 
Board [Ts 6h Jc 5d 5c]
Seat 1: Goosich (button) folded before Flop (didn't bet)
Seat 2: LuckyBBastar (small blind) folded before Flop
Seat 3: sixequjfive (big blind) showed [7s Jh] and won ($0.88) with two pair, Jacks and Fives
Seat 4: jeffpig16 folded before Flop (didn't bet)
Seat 5: HubertusB folded before Flop (didn't bet)
Seat 6: polyakov090487 showed [Ad 4h] and lost with a pair of Fives



PokerStars Zoom Hand #186643644554:  Hold'em No Limit ($0.02/$0.05) - 2018/05/20 20:25:48 CCT [2018/05/20 8:25:48 ET]
Table 'Donati' 6-max Seat #1 is the button
Seat 1: Leopoldia ($6.73 in chips) 
Seat 2: HubertusB ($6.36 in chips) 
Seat 3: TopBlued ($3.92 in chips) 
Seat 4: ilynskiy ($2.85 in chips) 
Seat 5: Omicron333 ($5.53 in chips) 
Seat 6: MoòSh ($5.17 in chips) 
HubertusB: posts small blind $0.02
TopBlued: posts big blind $0.05
*** HOLE CARDS ***
Dealt to HubertusB [As Qs]
ilynskiy: folds 
Omicron333: folds 
MoòSh: folds 
Leopoldia: raises $0.10 to $0.15
HubertusB: raises $0.35 to $0.50
TopBlued: folds 
Leopoldia: folds 
Uncalled bet ($0.35) returned to HubertusB
HubertusB collected $0.35 from pot
HubertusB: doesn't show hand 
*** SUMMARY ***
Total pot $0.35 | Rake $0 
Seat 1: Leopoldia (button) folded before Flop
Seat 2: HubertusB (small blind) collected ($0.35)
Seat 3: TopBlued (big blind) folded before Flop
Seat 4: ilynskiy folded before Flop (didn't bet)
Seat 5: Omicron333 folded before Flop (didn't bet)
Seat 6: MoòSh folded before Flop (didn't bet)



PokerStars Zoom Hand #186643641581:  Hold'em No Limit ($0.02/$0.05) - 2018/05/20 20:25:42 CCT [2018/05/20 8:25:42 ET]
Table 'Donati' 6-max Seat #1 is the button
Seat 1: fedkAa ($9.71 in chips) 
Seat 2: Admiral_real ($4.30 in chips) 
Seat 3: kukkertje ($14 in chips) 
Seat 4: HubertusB ($6.36 in chips) 
Seat 5: ThomaSs223 ($16.74 in chips) 
Seat 6: Kirikulu ($5 in chips) 
Admiral_real: posts small blind $0.02
kukkertje: posts big blind $0.05
*** HOLE CARDS ***
Dealt to HubertusB [5h Ks]
HubertusB: folds 
ThomaSs223: raises $0.07 to $0.12
Kirikulu: folds 
fedkAa: calls $0.12
Admiral_real: calls $0.10
kukkertje: folds 
*** FLOP *** [5c Th 5d]
Admiral_real: bets $0.20
ThomaSs223: folds 
fedkAa: raises $0.40 to $0.60
Admiral_real: calls $0.40
*** TURN *** [5c Th 5d] [Jd]
Admiral_real: bets $0.75
fedkAa: folds 
Uncalled bet ($0.75) returned to Admiral_real
Admiral_real collected $1.54 from pot
Admiral_real: doesn't show hand 
*** SUMMARY ***
Total pot $1.61 | Rake $0.07 
Board [5c Th 5d Jd]
Seat 1: fedkAa (button) folded on the Turn
Seat 2: Admiral_real (small blind) collected ($1.54)
Seat 3: kukkertje (big blind) folded before Flop
Seat 4: HubertusB folded before Flop (didn't bet)
Seat 5: ThomaSs223 folded on the Flop
Seat 6: Kirikulu folded before Flop (didn't bet)



PokerStars Zoom Hand #186643654702:  Hold'em No Limit ($0.02/$0.05) - 2018/05/20 20:26:09 CCT [2018/05/20 8:26:09 ET]
Table 'Donati' 6-max Seat #1 is the button
Seat 1: kingreigns ($7.32 in chips) 
Seat 2: minimus777 ($2.60 in chips) 
Seat 3: prm4life ($6.38 in chips) 
Seat 4: Gissbon ($5.98 in chips) 
Seat 5: HubertusB ($6.56 in chips) 
Seat 6: serg197211 ($5 in chips) 
minimus777: posts small blind $0.02
prm4life: posts big blind $0.05
*** HOLE CARDS ***
Dealt to HubertusB [3c Th]
Gissbon: folds 
HubertusB: folds 
serg197211: folds 
kingreigns: folds 
minimus777: folds 
Uncalled bet ($0.03) returned to prm4life
prm4life collected $0.04 from pot
prm4life: doesn't show hand 
*** SUMMARY ***
Total pot $0.04 | Rake $0 
Seat 1: kingreigns (button) folded before Flop (didn't bet)
Seat 2: minimus777 (small blind) folded before Flop
Seat 3: prm4life (big blind) collected ($0.04)
Seat 4: Gissbon folded before Flop (didn't bet)
Seat 5: HubertusB folded before Flop (didn't bet)
Seat 6: serg197211 folded before Flop (didn't bet)



PokerStars Zoom Hand #186643652302:  Hold'em No Limit ($0.02/$0.05) - 2018/05/20 20:26:04 CCT [2018/05/20 8:26:04 ET]
Table 'Donati' 6-max Seat #1 is the button
Seat 1: HubertusB ($6.56 in chips) 
Seat 2: CentricTie ($5.16 in chips) 
Seat 3: Spookie_1980 ($11.60 in chips) 
Seat 4: elbarto4468 ($6.81 in chips) 
Seat 5: nightm71 ($5.67 in chips) 
Seat 6: MAGE%CARDS ($8.99 in chips) 
CentricTie: posts small blind $0.02
Spookie_1980: posts big blind $0.05
*** HOLE CARDS ***
Dealt to HubertusB [8c 2h]
elbarto4468: folds 
nightm71: folds 
MAGE%CARDS: folds 
HubertusB: folds 
CentricTie: calls $0.03
Spookie_1980: checks 
*** FLOP *** [Jh 9c 8d]
CentricTie: checks 
Spookie_1980: checks 
*** TURN *** [Jh 9c 8d] [Ad]
CentricTie: checks 
Spookie_1980: bets $0.05
CentricTie: folds 
Uncalled bet ($0.05) returned to Spookie_1980
Spookie_1980 collected $0.10 from pot
Spookie_1980: doesn't show hand 
*** SUMMARY ***
Total pot $0.10 | Rake $0 
Board [Jh 9c 8d Ad]
Seat 1: HubertusB (button) folded before Flop (didn't bet)
Seat 2: CentricTie (small blind) folded on the Turn
Seat 3: Spookie_1980 (big blind) collected ($0.10)
Seat 4: elbarto4468 folded before Flop (didn't bet)
Seat 5: nightm71 folded before Flop (didn't bet)
Seat 6: MAGE%CARDS folded before Flop (didn't bet)



PokerStars Zoom Hand #186643657169:  Hold'em No Limit ($0.02/$0.05) - 2018/05/20 20:26:14 CCT [2018/05/20 8:26:14 ET]
Table 'Donati' 6-max Seat #1 is the button
Seat 1: Action Peter ($5 in chips) 
Seat 2: Mirosel ($8.35 in chips) 
Seat 3: barbos2009 ($7.41 in chips) 
Seat 4: HubertusB ($6.56 in chips) 
Seat 5: nishiyann ($3.97 in chips) 
Seat 6: denizzz113 ($1.54 in chips) 
Mirosel: posts small blind $0.02
barbos2009: posts big blind $0.05
*** HOLE CARDS ***
Dealt to HubertusB [Kc 3h]
HubertusB: folds 
nishiyann: folds 
denizzz113: raises $0.12 to $0.17
Action Peter: folds 
Mirosel: folds 
barbos2009: folds 
Uncalled bet ($0.12) returned to denizzz113
denizzz113 collected $0.12 from pot
denizzz113: doesn't show hand 
*** SUMMARY ***
Total pot $0.12 | Rake $0 
Seat 1: Action Peter (button) folded before Flop (didn't bet)
Seat 2: Mirosel (small blind) folded before Flop
Seat 3: barbos2009 (big blind) folded before Flop
Seat 4: HubertusB folded before Flop (didn't bet)
Seat 5: nishiyann folded before Flop (didn't bet)
Seat 6: denizzz113 collected ($0.12)



PokerStars Zoom Hand #186643659637:  Hold'em No Limit ($0.02/$0.05) - 2018/05/20 20:26:19 CCT [2018/05/20 8:26:19 ET]
Table 'Donati' 6-max Seat #1 is the button
Seat 1: Leopoldia ($2.50 in chips) 
Seat 2: Gissbon ($5.98 in chips) 
Seat 3: HubertusB ($6.56 in chips) 
Seat 4: jeffpig16 ($5.33 in chips) 
Seat 5: NICooLIN333 ($5 in chips) 
Seat 6: artaxruciv ($3.86 in chips) 
Gissbon: posts small blind $0.02
HubertusB: posts big blind $0.05
*** HOLE CARDS ***
Dealt to HubertusB [6s 7c]
jeffpig16: folds 
NICooLIN333: folds 
artaxruciv: folds 
Leopoldia: folds 
Gissbon: raises $0.10 to $0.15
HubertusB: folds 
Uncalled bet ($0.10) returned to Gissbon
Gissbon collected $0.10 from pot
Gissbon: doesn't show hand 
*** SUMMARY ***
Total pot $0.10 | Rake $0 
Seat 1: Leopoldia (button) folded before Flop (didn't bet)
Seat 2: Gissbon (small blind) collected ($0.10)
Seat 3: HubertusB (big blind) folded before Flop
Seat 4: jeffpig16 folded before Flop (didn't bet)
Seat 5: NICooLIN333 folded before Flop (didn't bet)
Seat 6: artaxruciv folded before Flop (didn't bet)



PokerStars Zoom Hand #186643665019:  Hold'em No Limit ($0.02/$0.05) - 2018/05/20 20:26:30 CCT [2018/05/20 8:26:30 ET]
Table 'Donati' 6-max Seat #1 is the button
Seat 1: Cadu_171 ($7.02 in chips) 
Seat 2: Genal55 ($6.64 in chips) 
Seat 3: mama$0104 ($5.08 in chips) 
Seat 4: HubertusB ($6.51 in chips) 
Seat 5: Zheka-Alaei ($6.32 in chips) 
Seat 6: przemyslaw35 ($4.93 in chips) 
Genal55: posts small blind $0.02
mama$0104: posts big blind $0.05
*** HOLE CARDS ***
Dealt to HubertusB [7s Ks]
HubertusB: folds 
Zheka-Alaei: folds 
przemyslaw35: folds 
Cadu_171: folds 
Genal55: folds 
Uncalled bet ($0.03) returned to mama$0104
mama$0104 collected $0.04 from pot
mama$0104: doesn't show hand 
*** SUMMARY ***
Total pot $0.04 | Rake $0 
Seat 1: Cadu_171 (button) folded before Flop (didn't bet)
Seat 2: Genal55 (small blind) folded before Flop
Seat 3: mama$0104 (big blind) collected ($0.04)
Seat 4: HubertusB folded before Flop (didn't bet)
Seat 5: Zheka-Alaei folded before Flop (didn't bet)
Seat 6: przemyslaw35 folded before Flop (didn't bet)



PokerStars Zoom Hand #186643667539:  Hold'em No Limit ($0.02/$0.05) - 2018/05/20 20:26:35 CCT [2018/05/20 8:26:35 ET]
Table 'Donati' 6-max Seat #1 is the button
Seat 1: Valerij V.S. ($5.69 in chips) 
Seat 2: HubertusB ($6.51 in chips) 
Seat 3: bamboocha88 ($5 in chips) 
Seat 4: derak488 ($5.39 in chips) 
Seat 5: kittennose ($5 in chips) 
Seat 6: selko1 ($8.42 in chips) 
HubertusB: posts small blind $0.02
bamboocha88: posts big blind $0.05
*** HOLE CARDS ***
Dealt to HubertusB [3d 6h]
derak488: folds 
kittennose: folds 
selko1: raises $0.10 to $0.15
Valerij V.S.: folds 
HubertusB: folds 
bamboocha88: folds 
Uncalled bet ($0.10) returned to selko1
selko1 collected $0.12 from pot
selko1: doesn't show hand 
*** SUMMARY ***
Total pot $0.12 | Rake $0 
Seat 1: Valerij V.S. (button) folded before Flop (didn't bet)
Seat 2: HubertusB (small blind) folded before Flop
Seat 3: bamboocha88 (big blind) folded before Flop
Seat 4: derak488 folded before Flop (didn't bet)
Seat 5: kittennose folded before Flop (didn't bet)
Seat 6: selko1 collected ($0.12)



PokerStars Zoom Hand #186643676439:  Hold'em No Limit ($0.02/$0.05) - 2018/05/20 20:26:53 CCT [2018/05/20 8:26:53 ET]
Table 'Donati' 6-max Seat #1 is the button
Seat 1: polyakov090487 ($2.52 in chips) 
Seat 2: RasNestah ($6.18 in chips) 
Seat 3: HubertusB ($6.49 in chips) 
Seat 4: cazro 77 ($5.04 in chips) 
Seat 5: chips010 ($6.47 in chips) 
Seat 6: deluxe548 ($2.10 in chips) 
RasNestah: posts small blind $0.02
HubertusB: posts big blind $0.05
*** HOLE CARDS ***
Dealt to HubertusB [Qh 3s]
cazro 77: folds 
chips010: folds 
deluxe548: folds 
polyakov090487: folds 
RasNestah: folds 
Uncalled bet ($0.03) returned to HubertusB
HubertusB collected $0.04 from pot
HubertusB: doesn't show hand 
*** SUMMARY ***
Total pot $0.04 | Rake $0 
Seat 1: polyakov090487 (button) folded before Flop (didn't bet)
Seat 2: RasNestah (small blind) folded before Flop
Seat 3: HubertusB (big blind) collected ($0.04)
Seat 4: cazro 77 folded before Flop (didn't bet)
Seat 5: chips010 folded before Flop (didn't bet)
Seat 6: deluxe548 folded before Flop (didn't bet)



PokerStars Zoom Hand #186643673543:  Hold'em No Limit ($0.02/$0.05) - 2018/05/20 20:26:47 CCT [2018/05/20 8:26:47 ET]
Table 'Donati' 6-max Seat #1 is the button
Seat 1: HubertusB ($6.49 in chips) 
Seat 2: Daemon'sKiss ($6.68 in chips) 
Seat 3: OsloVest ($6.85 in chips) 
Seat 4: jeffpig16 ($5.05 in chips) 
Seat 5: WeakmindedV1 ($5.21 in chips) 
Seat 6: SereGka228 ($5.57 in chips) 
Daemon'sKiss: posts small blind $0.02
OsloVest: posts big blind $0.05
*** HOLE CARDS ***
Dealt to HubertusB [Td 5s]
jeffpig16: folds 
WeakmindedV1: folds 
SereGka228: raises $0.07 to $0.12
HubertusB: folds 
Daemon'sKiss: folds 
OsloVest: calls $0.07
*** FLOP *** [Js Kc Ac]
OsloVest: checks 
SereGka228: bets $0.13
OsloVest: calls $0.13
*** TURN *** [Js Kc Ac] [2h]
OsloVest: checks 
SereGka228: bets $0.62
OsloVest: folds 
Uncalled bet ($0.62) returned to SereGka228
SereGka228 collected $0.50 from pot
SereGka228: doesn't show hand 
*** SUMMARY ***
Total pot $0.52 | Rake $0.02 
Board [Js Kc Ac 2h]
Seat 1: HubertusB (button) folded before Flop (didn't bet)
Seat 2: Daemon'sKiss (small blind) folded before Flop
Seat 3: OsloVest (big blind) folded on the Turn
Seat 4: jeffpig16 folded before Flop (didn't bet)
Seat 5: WeakmindedV1 folded before Flop (didn't bet)
Seat 6: SereGka228 collected ($0.50)



PokerStars Zoom Hand #186643686015:  Hold'em No Limit ($0.02/$0.05) - 2018/05/20 20:27:12 CCT [2018/05/20 8:27:12 ET]
Table 'Donati' 6-max Seat #1 is the button
Seat 1: denizzz113 ($1.75 in chips) 
Seat 2: HubertusB ($6.51 in chips) 
Seat 3: bosbo1987 ($2.47 in chips) 
Seat 4: Florea2312 ($8.68 in chips) 
Seat 5: cazro 77 ($5.46 in chips) 
Seat 6: gosumortiz ($11.21 in chips) 
HubertusB: posts small blind $0.02
bosbo1987: posts big blind $0.05
*** HOLE CARDS ***
Dealt to HubertusB [Js 4h]
Florea2312: folds 
cazro 77: folds 
gosumortiz: folds 
denizzz113: folds 
HubertusB: folds 
Uncalled bet ($0.03) returned to bosbo1987
bosbo1987 collected $0.04 from pot
bosbo1987: doesn't show hand 
*** SUMMARY ***
Total pot $0.04 | Rake $0 
Seat 1: denizzz113 (button) folded before Flop (didn't bet)
Seat 2: HubertusB (small blind) folded before Flop
Seat 3: bosbo1987 (big blind) collected ($0.04)
Seat 4: Florea2312 folded before Flop (didn't bet)
Seat 5: cazro 77 folded before Flop (didn't bet)
Seat 6: gosumortiz folded before Flop (didn't bet)



PokerStars Zoom Hand #186643682436:  Hold'em No Limit ($0.02/$0.05) - 2018/05/20 20:27:05 CCT [2018/05/20 8:27:05 ET]
Table 'Donati' 6-max Seat #1 is the button
Seat 1: bamboocha88 ($5 in chips) 
Seat 2: PM17Lev ($14.72 in chips) 
Seat 3: LuckyBBastar ($19.38 in chips) 
Seat 4: chips010 ($6.47 in chips) 
Seat 5: tomo808 ($12.39 in chips) 
Seat 6: HubertusB ($6.51 in chips) 
PM17Lev: posts small blind $0.02
LuckyBBastar: posts big blind $0.05
*** HOLE CARDS ***
Dealt to HubertusB [5s Qc]
chips010: folds 
tomo808: folds 
HubertusB: folds 
bamboocha88: raises $0.06 to $0.11
PM17Lev: folds 
LuckyBBastar: folds 
Uncalled bet ($0.06) returned to bamboocha88
bamboocha88 collected $0.12 from pot
bamboocha88: doesn't show hand 
*** SUMMARY ***
Total pot $0.12 | Rake $0 
Seat 1: bamboocha88 (button) collected ($0.12)
Seat 2: PM17Lev (small blind) folded before Flop
Seat 3: LuckyBBastar (big blind) folded before Flop
Seat 4: chips010 folded before Flop (didn't bet)
Seat 5: tomo808 folded before Flop (didn't bet)
Seat 6: HubertusB folded before Flop (didn't bet)



PokerStars Zoom Hand #186643688372:  Hold'em No Limit ($0.02/$0.05) - 2018/05/20 20:27:17 CCT [2018/05/20 8:27:17 ET]
Table 'Donati' 6-max Seat #1 is the button
Seat 1: Fredchie ($7.94 in chips) 
Seat 2: chep73 ($5.33 in chips) 
Seat 3: Gissbon ($5.48 in chips) 
Seat 4: Ka4ibuk@ ($5.58 in chips) 
Seat 5: bronson220 ($0.84 in chips) 
Seat 6: HubertusB ($6.49 in chips) 
chep73: posts small blind $0.02
Gissbon: posts big blind $0.05
*** HOLE CARDS ***
Dealt to HubertusB [2d Ac]
Ka4ibuk@: raises $0.10 to $0.15
bronson220: folds 
HubertusB: folds 
Fredchie: folds 
chep73: folds 
Gissbon: folds 
Uncalled bet ($0.10) returned to Ka4ibuk@
Ka4ibuk@ collected $0.12 from pot
Ka4ibuk@: doesn't show hand 
*** SUMMARY ***
Total pot $0.12 | Rake $0 
Seat 1: Fredchie (button) folded before Flop (didn't bet)
Seat 2: chep73 (small blind) folded before Flop
Seat 3: Gissbon (big blind) folded before Flop
Seat 4: Ka4ibuk@ collected ($0.12)
Seat 5: bronson220 folded before Flop (didn't bet)
Seat 6: HubertusB folded before Flop (didn't bet)



PokerStars Zoom Hand #186643691801:  Hold'em No Limit ($0.02/$0.05) - 2018/05/20 20:27:24 CCT [2018/05/20 8:27:24 ET]
Table 'Donati' 6-max Seat #1 is the button
Seat 1: kogorou999 ($5.04 in chips) 
Seat 2: JazziesdadUK ($6.61 in chips) 
Seat 3: C-class man ($8.77 in chips) 
Seat 4: CallMeBunny ($6.71 in chips) 
Seat 5: HubertusB ($6.49 in chips) 
Seat 6: benigomu ($5.18 in chips) 
JazziesdadUK: posts small blind $0.02
C-class man: posts big blind $0.05
*** HOLE CARDS ***
Dealt to HubertusB [8c 9d]
CallMeBunny: folds 
HubertusB: folds 
benigomu: folds 
kogorou999: raises $0.10 to $0.15
JazziesdadUK: folds 
C-class man: folds 
Uncalled bet ($0.10) returned to kogorou999
kogorou999 collected $0.12 from pot
kogorou999: doesn't show hand 
*** SUMMARY ***
Total pot $0.12 | Rake $0 
Seat 1: kogorou999 (button) collected ($0.12)
Seat 2: JazziesdadUK (small blind) folded before Flop
Seat 3: C-class man (big blind) folded before Flop
Seat 4: CallMeBunny folded before Flop (didn't bet)
Seat 5: HubertusB folded before Flop (didn't bet)
Seat 6: benigomu folded before Flop (didn't bet)



PokerStars Zoom Hand #186643694717:  Hold'em No Limit ($0.02/$0.05) - 2018/05/20 20:27:30 CCT [2018/05/20 8:27:30 ET]
Table 'Donati' 6-max Seat #1 is the button
Seat 1: zapzarap@patent ($6.55 in chips) 
Seat 2: Janski90 ($10.92 in chips) 
Seat 3: Jeka Griva ($5.07 in chips) 
Seat 4: HubertusB ($6.49 in chips) 
Seat 5: vizes8as ($4.04 in chips) 
Seat 6: MoòSh ($5.24 in chips) 
Janski90: posts small blind $0.02
Jeka Griva: posts big blind $0.05
*** HOLE CARDS ***
Dealt to HubertusB [4s Ac]
HubertusB: folds 
vizes8as: folds 
MoòSh: folds 
zapzarap@patent: folds 
Janski90: folds 
Uncalled bet ($0.03) returned to Jeka Griva
Jeka Griva collected $0.04 from pot
Jeka Griva: doesn't show hand 
*** SUMMARY ***
Total pot $0.04 | Rake $0 
Seat 1: zapzarap@patent (button) folded before Flop (didn't bet)
Seat 2: Janski90 (small blind) folded before Flop
Seat 3: Jeka Griva (big blind) collected ($0.04)
Seat 4: HubertusB folded before Flop (didn't bet)
Seat 5: vizes8as folded before Flop (didn't bet)
Seat 6: MoòSh folded before Flop (didn't bet)



PokerStars Zoom Hand #186643697720:  Hold'em No Limit ($0.02/$0.05) - 2018/05/20 20:27:36 CCT [2018/05/20 8:27:36 ET]
Table 'Donati' 6-max Seat #1 is the button
Seat 1: ilynskiy ($2.77 in chips) 
Seat 2: Krawicz ($5.48 in chips) 
Seat 3: HubertusB ($6.49 in chips) 
Seat 4: Romzes V ($12.29 in chips) 
Seat 5: FelixZyl ($9.69 in chips) 
Seat 6: DUDUKA81 ($6.61 in chips) 
Krawicz: posts small blind $0.02
HubertusB: posts big blind $0.05
*** HOLE CARDS ***
Dealt to HubertusB [7s 8d]
Romzes V: folds 
FelixZyl: folds 
DUDUKA81: folds 
ilynskiy: folds 
Krawicz: folds 
Uncalled bet ($0.03) returned to HubertusB
HubertusB collected $0.04 from pot
HubertusB: doesn't show hand 
*** SUMMARY ***
Total pot $0.04 | Rake $0 
Seat 1: ilynskiy (button) folded before Flop (didn't bet)
Seat 2: Krawicz (small blind) folded before Flop
Seat 3: HubertusB (big blind) collected ($0.04)
Seat 4: Romzes V folded before Flop (didn't bet)
Seat 5: FelixZyl folded before Flop (didn't bet)
Seat 6: DUDUKA81 folded before Flop (didn't bet)



PokerStars Zoom Hand #186643706413:  Hold'em No Limit ($0.02/$0.05) - 2018/05/20 20:27:54 CCT [2018/05/20 8:27:54 ET]
Table 'Donati' 6-max Seat #1 is the button
Seat 1: minimus777 ($2.91 in chips) 
Seat 2: KAMSHULER ($5 in chips) 
Seat 3: iKiiiLL4fun ($18.07 in chips) 
Seat 4: AKKbank ($8.87 in chips) 
Seat 5: Faied123 ($5 in chips) 
Seat 6: HubertusB ($6.51 in chips) 
KAMSHULER: posts small blind $0.02
iKiiiLL4fun: posts big blind $0.05
*** HOLE CARDS ***
Dealt to HubertusB [7d Ah]
AKKbank: folds 
Faied123: raises $0.10 to $0.15
HubertusB: folds 
minimus777: folds 
KAMSHULER: folds 
iKiiiLL4fun: folds 
Uncalled bet ($0.10) returned to Faied123
Faied123 collected $0.12 from pot
Faied123: doesn't show hand 
*** SUMMARY ***
Total pot $0.12 | Rake $0 
Seat 1: minimus777 (button) folded before Flop (didn't bet)
Seat 2: KAMSHULER (small blind) folded before Flop
Seat 3: iKiiiLL4fun (big blind) folded before Flop
Seat 4: AKKbank folded before Flop (didn't bet)
Seat 5: Faied123 collected ($0.12)
Seat 6: HubertusB folded before Flop (didn't bet)



PokerStars Zoom Hand #186643711867:  Hold'em No Limit ($0.02/$0.05) - 2018/05/20 20:28:05 CCT [2018/05/20 8:28:05 ET]
Table 'Donati' 6-max Seat #1 is the button
Seat 1: sport300184 ($5 in chips) 
Seat 2: HubertusB ($6.51 in chips) 
Seat 3: kayck07 ($7.31 in chips) 
Seat 4: andrzej4fun ($9.36 in chips) 
Seat 5: bidipro ($14.17 in chips) 
Seat 6: TOMEF1CHA ($7.60 in chips) 
HubertusB: posts small blind $0.02
kayck07: posts big blind $0.05
*** HOLE CARDS ***
Dealt to HubertusB [8h Ad]
andrzej4fun: folds 
bidipro: folds 
TOMEF1CHA: folds 
sport300184: raises $0.10 to $0.15
HubertusB: folds 
kayck07: folds 
Uncalled bet ($0.10) returned to sport300184
sport300184 collected $0.12 from pot
sport300184: doesn't show hand 
*** SUMMARY ***
Total pot $0.12 | Rake $0 
Seat 1: sport300184 (button) collected ($0.12)
Seat 2: HubertusB (small blind) folded before Flop
Seat 3: kayck07 (big blind) folded before Flop
Seat 4: andrzej4fun folded before Flop (didn't bet)
Seat 5: bidipro folded before Flop (didn't bet)
Seat 6: TOMEF1CHA folded before Flop (didn't bet)



PokerStars Zoom Hand #186643714851:  Hold'em No Limit ($0.02/$0.05) - 2018/05/20 20:28:11 CCT [2018/05/20 8:28:11 ET]
Table 'Donati' 6-max Seat #1 is the button
Seat 1: kukkertje ($14 in chips) 
Seat 2: Krawicz ($6.13 in chips) 
Seat 3: maxgild85 ($5.03 in chips) 
Seat 4: orangedeuce ($5.82 in chips) 
Seat 5: HubertusB ($6.49 in chips) 
Seat 6: sceptick ($5.05 in chips) 
Krawicz: posts small blind $0.02
maxgild85: posts big blind $0.05
*** HOLE CARDS ***
Dealt to HubertusB [3d 3s]
orangedeuce: folds 
HubertusB: raises $0.05 to $0.10
sceptick: folds 
kukkertje: raises $0.20 to $0.30
Krawicz: folds 
maxgild85: folds 
HubertusB: folds 
Uncalled bet ($0.20) returned to kukkertje
kukkertje collected $0.27 from pot
kukkertje: doesn't show hand 
*** SUMMARY ***
Total pot $0.27 | Rake $0 
Seat 1: kukkertje (button) collected ($0.27)
Seat 2: Krawicz (small blind) folded before Flop
Seat 3: maxgild85 (big blind) folded before Flop
Seat 4: orangedeuce folded before Flop (didn't bet)
Seat 5: HubertusB folded before Flop
Seat 6: sceptick folded before Flop (didn't bet)



PokerStars Zoom Hand #186643727191:  Hold'em No Limit ($0.02/$0.05) - 2018/05/20 20:28:36 CCT [2018/05/20 8:28:36 ET]
Table 'Donati' 6-max Seat #1 is the button
Seat 1: Wolvy128 ($4.71 in chips) 
Seat 2: zapzarap@patent ($5.36 in chips) 
Seat 3: mama$0104 ($4.86 in chips) 
Seat 4: HubertusB ($6.39 in chips) 
Seat 5: minimus777 ($2.04 in chips) 
Seat 6: andrzej4fun ($6.93 in chips) 
zapzarap@patent: posts small blind $0.02
mama$0104: posts big blind $0.05
*** HOLE CARDS ***
Dealt to HubertusB [Qd 2s]
HubertusB: folds 
minimus777: folds 
andrzej4fun: folds 
Wolvy128: folds 
zapzarap@patent: folds 
Uncalled bet ($0.03) returned to mama$0104
mama$0104 collected $0.04 from pot
mama$0104: doesn't show hand 
*** SUMMARY ***
Total pot $0.04 | Rake $0 
Seat 1: Wolvy128 (button) folded before Flop (didn't bet)
Seat 2: zapzarap@patent (small blind) folded before Flop
Seat 3: mama$0104 (big blind) collected ($0.04)
Seat 4: HubertusB folded before Flop (didn't bet)
Seat 5: minimus777 folded before Flop (didn't bet)
Seat 6: andrzej4fun folded before Flop (didn't bet)



PokerStars Zoom Hand #186643703520:  Hold'em No Limit ($0.02/$0.05) - 2018/05/20 20:27:48 CCT [2018/05/20 8:27:48 ET]
Table 'Donati' 6-max Seat #1 is the button
Seat 1: HubertusB ($6.51 in chips) 
Seat 2: Gissbon ($5.15 in chips) 
Seat 3: QWER7786 ($5 in chips) 
Seat 4: C-class man ($8.72 in chips) 
Seat 5: Omicron333 ($6.99 in chips) 
Seat 6: Papa_Prey ($5.82 in chips) 
Gissbon: posts small blind $0.02
QWER7786: posts big blind $0.05
*** HOLE CARDS ***
Dealt to HubertusB [Ac 5h]
C-class man: folds 
Omicron333: raises $0.10 to $0.15
Papa_Prey: calls $0.15
HubertusB: folds 
Gissbon: folds 
QWER7786: calls $0.10
*** FLOP *** [7c 6s Tc]
QWER7786: checks 
Omicron333: bets $0.24
Papa_Prey: calls $0.24
QWER7786: folds 
*** TURN *** [7c 6s Tc] [3d]
Omicron333: bets $0.67
Papa_Prey: folds 
Uncalled bet ($0.67) returned to Omicron333
Omicron333 collected $0.91 from pot
Omicron333: doesn't show hand 
*** SUMMARY ***
Total pot $0.95 | Rake $0.04 
Board [7c 6s Tc 3d]
Seat 1: HubertusB (button) folded before Flop (didn't bet)
Seat 2: Gissbon (small blind) folded before Flop
Seat 3: QWER7786 (big blind) folded on the Flop
Seat 4: C-class man folded before Flop (didn't bet)
Seat 5: Omicron333 collected ($0.91)
Seat 6: Papa_Prey folded on the Turn



PokerStars Zoom Hand #186643729632:  Hold'em No Limit ($0.02/$0.05) - 2018/05/20 20:28:41 CCT [2018/05/20 8:28:41 ET]
Table 'Donati' 6-max Seat #1 is the button
Seat 1: HubertusB ($6.39 in chips) 
Seat 2: zapzarap@patent ($5.11 in chips) 
Seat 3: OsloVest ($9.57 in chips) 
Seat 4: lasyboy999 ($14.46 in chips) 
Seat 5: JDOldham503 ($4.28 in chips) 
Seat 6: DonkKing433 ($8.83 in chips) 
zapzarap@patent: posts small blind $0.02
OsloVest: posts big blind $0.05
*** HOLE CARDS ***
Dealt to HubertusB [6c 9c]
lasyboy999: folds 
JDOldham503: folds 
DonkKing433: raises $0.10 to $0.15
HubertusB: folds 
zapzarap@patent: folds 
OsloVest: folds 
Uncalled bet ($0.10) returned to DonkKing433
DonkKing433 collected $0.12 from pot
DonkKing433: doesn't show hand 
*** SUMMARY ***
Total pot $0.12 | Rake $0 
Seat 1: HubertusB (button) folded before Flop (didn't bet)
Seat 2: zapzarap@patent (small blind) folded before Flop
Seat 3: OsloVest (big blind) folded before Flop
Seat 4: lasyboy999 folded before Flop (didn't bet)
Seat 5: JDOldham503 folded before Flop (didn't bet)
Seat 6: DonkKing433 collected ($0.12)



PokerStars Zoom Hand #186643737043:  Hold'em No Limit ($0.02/$0.05) - 2018/05/20 20:28:56 CCT [2018/05/20 8:28:56 ET]
Table 'Donati' 6-max Seat #1 is the button
Seat 1: JazziesdadUK ($7.78 in chips) 
Seat 2: HubertusB ($6.34 in chips) 
Seat 3: Wolvy128 ($4.71 in chips) 
Seat 4: sceptick ($5.15 in chips) 
Seat 5: LuckyBBastar ($14.98 in chips) 
Seat 6: OsloVest ($9.52 in chips) 
HubertusB: posts small blind $0.02
Wolvy128: posts big blind $0.05
*** HOLE CARDS ***
Dealt to HubertusB [Ks Jh]
sceptick: folds 
LuckyBBastar: folds 
OsloVest: raises $0.08 to $0.13
JazziesdadUK: folds 
HubertusB: folds 
Wolvy128: calls $0.08
*** FLOP *** [6d 8d Kh]
Wolvy128: checks 
OsloVest: bets $0.13
Wolvy128: folds 
Uncalled bet ($0.13) returned to OsloVest
OsloVest collected $0.27 from pot
OsloVest: doesn't show hand 
*** SUMMARY ***
Total pot $0.28 | Rake $0.01 
Board [6d 8d Kh]
Seat 1: JazziesdadUK (button) folded before Flop (didn't bet)
Seat 2: HubertusB (small blind) folded before Flop
Seat 3: Wolvy128 (big blind) folded on the Flop
Seat 4: sceptick folded before Flop (didn't bet)
Seat 5: LuckyBBastar folded before Flop (didn't bet)
Seat 6: OsloVest collected ($0.27)



PokerStars Zoom Hand #186643741926:  Hold'em No Limit ($0.02/$0.05) - 2018/05/20 20:29:06 CCT [2018/05/20 8:29:06 ET]
Table 'Donati' 6-max Seat #1 is the button
Seat 1: msskmss ($6.10 in chips) 
Seat 2: Grigoriy40$ ($15.55 in chips) 
Seat 3: bidipro ($12.62 in chips) 
Seat 4: HubertusB ($6.32 in chips) 
Seat 5: Gundelas ($4.92 in chips) 
Seat 6: Savavlad97 ($8.25 in chips) 
Grigoriy40$: posts small blind $0.02
bidipro: posts big blind $0.05
*** HOLE CARDS ***
Dealt to HubertusB [Ad Qc]
HubertusB: raises $0.10 to $0.15
Gundelas: folds 
Savavlad97: folds 
msskmss: folds 
Grigoriy40$: folds 
bidipro: folds 
Uncalled bet ($0.10) returned to HubertusB
HubertusB collected $0.12 from pot
HubertusB: doesn't show hand 
*** SUMMARY ***
Total pot $0.12 | Rake $0 
Seat 1: msskmss (button) folded before Flop (didn't bet)
Seat 2: Grigoriy40$ (small blind) folded before Flop
Seat 3: bidipro (big blind) folded before Flop
Seat 4: HubertusB collected ($0.12)
Seat 5: Gundelas folded before Flop (didn't bet)
Seat 6: Savavlad97 folded before Flop (didn't bet)



PokerStars Zoom Hand #186643739558:  Hold'em No Limit ($0.02/$0.05) - 2018/05/20 20:29:01 CCT [2018/05/20 8:29:01 ET]
Table 'Donati' 6-max Seat #1 is the button
Seat 1: Bluffstar20 ($3.42 in chips) 
Seat 2: gosumortiz ($5 in chips) 
Seat 3: TehPokeHerer ($7.39 in chips) 
Seat 4: JazziesdadUK ($7.78 in chips) 
Seat 5: TOMEF1CHA ($7.62 in chips) 
Seat 6: HubertusB ($6.32 in chips) 
gosumortiz: posts small blind $0.02
TehPokeHerer: posts big blind $0.05
*** HOLE CARDS ***
Dealt to HubertusB [Td 4h]
JazziesdadUK: folds 
TOMEF1CHA: raises $0.10 to $0.15
HubertusB: folds 
Bluffstar20: folds 
gosumortiz: folds 
TehPokeHerer: folds 
Uncalled bet ($0.10) returned to TOMEF1CHA
TOMEF1CHA collected $0.12 from pot
TOMEF1CHA: doesn't show hand 
*** SUMMARY ***
Total pot $0.12 | Rake $0 
Seat 1: Bluffstar20 (button) folded before Flop (didn't bet)
Seat 2: gosumortiz (small blind) folded before Flop
Seat 3: TehPokeHerer (big blind) folded before Flop
Seat 4: JazziesdadUK folded before Flop (didn't bet)
Seat 5: TOMEF1CHA collected ($0.12)
Seat 6: HubertusB folded before Flop (didn't bet)



PokerStars Zoom Hand #186643750426:  Hold'em No Limit ($0.02/$0.05) - 2018/05/20 20:29:23 CCT [2018/05/20 8:29:23 ET]
Table 'Donati' 6-max Seat #1 is the button
Seat 1: Omicron333 ($5.43 in chips) 
Seat 2: Adventuros ($3.53 in chips) 
Seat 3: Zicepig ($5.71 in chips) 
Seat 4: HubertusB ($6.39 in chips) 
Seat 5: kukkertje ($7.26 in chips) 
Seat 6: Jeka Griva ($4.75 in chips) 
Adventuros: posts small blind $0.02
Zicepig: posts big blind $0.05
*** HOLE CARDS ***
Dealt to HubertusB [Tc 3d]
HubertusB: folds 
kukkertje: folds 
Jeka Griva: raises $0.09 to $0.14
Omicron333: folds 
Adventuros: folds 
Zicepig: folds 
Uncalled bet ($0.09) returned to Jeka Griva
Jeka Griva collected $0.12 from pot
Jeka Griva: doesn't show hand 
*** SUMMARY ***
Total pot $0.12 | Rake $0 
Seat 1: Omicron333 (button) folded before Flop (didn't bet)
Seat 2: Adventuros (small blind) folded before Flop
Seat 3: Zicepig (big blind) folded before Flop
Seat 4: HubertusB folded before Flop (didn't bet)
Seat 5: kukkertje folded before Flop (didn't bet)
Seat 6: Jeka Griva collected ($0.12)



PokerStars Zoom Hand #186643753360:  Hold'em No Limit ($0.02/$0.05) - 2018/05/20 20:29:29 CCT [2018/05/20 8:29:29 ET]
Table 'Donati' 6-max Seat #1 is the button
Seat 1: HubertusB ($6.39 in chips) 
Seat 2: Old--Men 50 ($1.89 in chips) 
Seat 3: jaanis1983 ($5.80 in chips) 
Seat 4: Warrendown ($5 in chips) 
Seat 5: denizzz113 ($1.70 in chips) 
Seat 6: Mikko86 ($2.62 in chips) 
Old--Men 50: posts small blind $0.02
jaanis1983: posts big blind $0.05
*** HOLE CARDS ***
Dealt to HubertusB [2d Js]
Warrendown: folds 
denizzz113: folds 
Mikko86: folds 
HubertusB: folds 
Old--Men 50: folds 
Uncalled bet ($0.03) returned to jaanis1983
jaanis1983 collected $0.04 from pot
jaanis1983: doesn't show hand 
*** SUMMARY ***
Total pot $0.04 | Rake $0 
Seat 1: HubertusB (button) folded before Flop (didn't bet)
Seat 2: Old--Men 50 (small blind) folded before Flop
Seat 3: jaanis1983 (big blind) collected ($0.04)
Seat 4: Warrendown folded before Flop (didn't bet)
Seat 5: denizzz113 folded before Flop (didn't bet)
Seat 6: Mikko86 folded before Flop (didn't bet)



PokerStars Zoom Hand #186643734117:  Hold'em No Limit ($0.02/$0.05) - 2018/05/20 20:28:50 CCT [2018/05/20 8:28:50 ET]
Table 'Donati' 6-max Seat #1 is the button
Seat 1: kittennose ($10.14 in chips) 
Seat 2: andrzej4fun ($6.93 in chips) 
Seat 3: HubertusB ($6.39 in chips) 
Seat 4: sport300184 ($6.69 in chips) 
Seat 5: mamel7777 ($7.59 in chips) 
Seat 6: amx16 ($5 in chips) 
andrzej4fun: posts small blind $0.02
HubertusB: posts big blind $0.05
*** HOLE CARDS ***
Dealt to HubertusB [6c 2d]
sport300184: raises $0.05 to $0.10
mamel7777: folds 
amx16: folds 
kittennose: raises $0.30 to $0.40
andrzej4fun: calls $0.38
HubertusB: folds 
sport300184: calls $0.30
*** FLOP *** [6s 7d 8h]
andrzej4fun: checks 
sport300184: bets $0.60
kittennose: calls $0.60
andrzej4fun: raises $1.50 to $2.10
sport300184: folds 
kittennose: calls $1.50
*** TURN *** [6s 7d 8h] [5h]
andrzej4fun: bets $2.90
kittennose: folds 
Uncalled bet ($2.90) returned to andrzej4fun
andrzej4fun collected $5.80 from pot
andrzej4fun: doesn't show hand 
*** SUMMARY ***
Total pot $6.05 | Rake $0.25 
Board [6s 7d 8h 5h]
Seat 1: kittennose (button) folded on the Turn
Seat 2: andrzej4fun (small blind) collected ($5.80)
Seat 3: HubertusB (big blind) folded before Flop
Seat 4: sport300184 folded on the Flop
Seat 5: mamel7777 folded before Flop (didn't bet)
Seat 6: amx16 folded before Flop (didn't bet)



PokerStars Zoom Hand #186643756391:  Hold'em No Limit ($0.02/$0.05) - 2018/05/20 20:29:35 CCT [2018/05/20 8:29:35 ET]
Table 'Donati' 6-max Seat #1 is the button
Seat 1: M4il4o ($10.60 in chips) 
Seat 2: qwer96_PS ($5.16 in chips) 
Seat 3: HubertusB ($6.39 in chips) 
Seat 4: vince369169 ($6.49 in chips) 
Seat 5: slob43.ru ($7.69 in chips) 
Seat 6: Shalev7 ($8.44 in chips) 
qwer96_PS: posts small blind $0.02
HubertusB: posts big blind $0.05
*** HOLE CARDS ***
Dealt to HubertusB [As 5s]
vince369169: folds 
slob43.ru: raises $0.10 to $0.15
Shalev7: calls $0.15
M4il4o: folds 
qwer96_PS: folds 
HubertusB: calls $0.10
*** FLOP *** [Js 2c 8h]
HubertusB: checks 
slob43.ru: checks 
Shalev7: checks 
*** TURN *** [Js 2c 8h] [7d]
HubertusB: checks 
slob43.ru: checks 
Shalev7: checks 
*** RIVER *** [Js 2c 8h 7d] [Qh]
HubertusB: checks 
slob43.ru: checks 
Shalev7: checks 
*** SHOW DOWN ***
HubertusB: shows [As 5s] (high card Ace)
slob43.ru: mucks hand 
Shalev7: mucks hand 
HubertusB collected $0.45 from pot
*** SUMMARY ***
Total pot $0.47 | Rake $0.02 
Board [Js 2c 8h 7d Qh]
Seat 1: M4il4o (button) folded before Flop (didn't bet)
Seat 2: qwer96_PS (small blind) folded before Flop
Seat 3: HubertusB (big blind) showed [As 5s] and won ($0.45) with high card Ace
Seat 4: vince369169 folded before Flop (didn't bet)
Seat 5: slob43.ru mucked [9d Kd]
Seat 6: Shalev7 mucked [6h 5h]



PokerStars Zoom Hand #186643778761:  Hold'em No Limit ($0.02/$0.05) - 2018/05/20 20:30:20 CCT [2018/05/20 8:30:20 ET]
Table 'Donati' 6-max Seat #1 is the button
Seat 1: VitaliiVV89 ($7.76 in chips) 
Seat 2: HubertusB ($6.69 in chips) 
Seat 3: jeffpig16 ($5.03 in chips) 
Seat 4: Warrendown ($8.23 in chips) 
Seat 5: przemyslaw35 ($5.47 in chips) 
Seat 6: Shamaxxx ($8.41 in chips) 
HubertusB: posts small blind $0.02
jeffpig16: posts big blind $0.05
*** HOLE CARDS ***
Dealt to HubertusB [9s 4h]
Warrendown: folds 
przemyslaw35: folds 
Shamaxxx: folds 
VitaliiVV89: folds 
HubertusB: folds 
Uncalled bet ($0.03) returned to jeffpig16
jeffpig16 collected $0.04 from pot
jeffpig16: doesn't show hand 
*** SUMMARY ***
Total pot $0.04 | Rake $0 
Seat 1: VitaliiVV89 (button) folded before Flop (didn't bet)
Seat 2: HubertusB (small blind) folded before Flop
Seat 3: jeffpig16 (big blind) collected ($0.04)
Seat 4: Warrendown folded before Flop (didn't bet)
Seat 5: przemyslaw35 folded before Flop (didn't bet)
Seat 6: Shamaxxx folded before Flop (didn't bet)



PokerStars Zoom Hand #186643776754:  Hold'em No Limit ($0.02/$0.05) - 2018/05/20 20:30:16 CCT [2018/05/20 8:30:16 ET]
Table 'Donati' 6-max Seat #1 is the button
Seat 1: DonkKing433 ($8.40 in chips) 
Seat 2: beluci1 ($2.65 in chips) 
Seat 3: zwetok ($5.35 in chips) 
Seat 4: artaxruciv ($3.43 in chips) 
Seat 5: HubertusB ($6.69 in chips) 
Seat 6: Opcius ($2.76 in chips) 
beluci1: posts small blind $0.02
zwetok: posts big blind $0.05
*** HOLE CARDS ***
Dealt to HubertusB [4s 9d]
artaxruciv: raises $0.10 to $0.15
HubertusB: folds 
Opcius: folds 
DonkKing433: folds 
beluci1: folds 
zwetok: calls $0.10
*** FLOP *** [As Th 5d]
zwetok: checks 
artaxruciv: bets $0.21
zwetok: folds 
Uncalled bet ($0.21) returned to artaxruciv
artaxruciv collected $0.31 from pot
artaxruciv: doesn't show hand 
*** SUMMARY ***
Total pot $0.32 | Rake $0.01 
Board [As Th 5d]
Seat 1: DonkKing433 (button) folded before Flop (didn't bet)
Seat 2: beluci1 (small blind) folded before Flop
Seat 3: zwetok (big blind) folded on the Flop
Seat 4: artaxruciv collected ($0.31)
Seat 5: HubertusB folded before Flop (didn't bet)
Seat 6: Opcius folded before Flop (didn't bet)



PokerStars Zoom Hand #186643781279:  Hold'em No Limit ($0.02/$0.05) - 2018/05/20 20:30:25 CCT [2018/05/20 8:30:25 ET]
Table 'Donati' 6-max Seat #1 is the button
Seat 1: HubertusB ($6.67 in chips) 
Seat 2: Savavlad97 ($8.10 in chips) 
Seat 3: gosumortiz ($11.38 in chips) 
Seat 4: BardJeka ($5.70 in chips) 
Seat 5: zapzarap@patent ($5 in chips) 
Seat 6: Krawicz ($6.04 in chips) 
Savavlad97: posts small blind $0.02
gosumortiz: posts big blind $0.05
*** HOLE CARDS ***
Dealt to HubertusB [7c Ac]
BardJeka: raises $0.10 to $0.15
zapzarap@patent: folds 
Krawicz: folds 
HubertusB: raises $0.30 to $0.45
Savavlad97: folds 
gosumortiz: folds 
BardJeka: folds 
Uncalled bet ($0.30) returned to HubertusB
HubertusB collected $0.37 from pot
HubertusB: doesn't show hand 
*** SUMMARY ***
Total pot $0.37 | Rake $0 
Seat 1: HubertusB (button) collected ($0.37)
Seat 2: Savavlad97 (small blind) folded before Flop
Seat 3: gosumortiz (big blind) folded before Flop
Seat 4: BardJeka folded before Flop
Seat 5: zapzarap@patent folded before Flop (didn't bet)
Seat 6: Krawicz folded before Flop (didn't bet)



PokerStars Zoom Hand #186643799880:  Hold'em No Limit ($0.02/$0.05) - 2018/05/20 20:31:02 CCT [2018/05/20 8:31:02 ET]
Table 'Donati' 6-max Seat #1 is the button
Seat 1: OsloVest ($5.94 in chips) 
Seat 2: kogorou999 ($5.52 in chips) 
Seat 3: Lady.Lyck ($5.07 in chips) 
Seat 4: przemyslaw35 ($5.49 in chips) 
Seat 5: HubertusB ($6.89 in chips) 
Seat 6: Goosich ($12.06 in chips) 
kogorou999: posts small blind $0.02
Lady.Lyck: posts big blind $0.05
*** HOLE CARDS ***
Dealt to HubertusB [6h Tc]
przemyslaw35: folds 
HubertusB: folds 
Goosich: folds 
OsloVest: folds 
kogorou999: folds 
Uncalled bet ($0.03) returned to Lady.Lyck
Lady.Lyck collected $0.04 from pot
Lady.Lyck: doesn't show hand 
*** SUMMARY ***
Total pot $0.04 | Rake $0 
Seat 1: OsloVest (button) folded before Flop (didn't bet)
Seat 2: kogorou999 (small blind) folded before Flop
Seat 3: Lady.Lyck (big blind) collected ($0.04)
Seat 4: przemyslaw35 folded before Flop (didn't bet)
Seat 5: HubertusB folded before Flop (didn't bet)
Seat 6: Goosich folded before Flop (didn't bet)



PokerStars Zoom Hand #186643806329:  Hold'em No Limit ($0.02/$0.05) - 2018/05/20 20:31:15 CCT [2018/05/20 8:31:15 ET]
Table 'Donati' 6-max Seat #1 is the button
Seat 1: Blackhare ($10.02 in chips) 
Seat 2: Qebel ($5 in chips) 
Seat 3: HubertusB ($6.87 in chips) 
Seat 4: Valerij V.S. ($6.93 in chips) 
Seat 5: tigran63 ($8.90 in chips) 
Seat 6: Krawicz ($5.97 in chips) 
Qebel: posts small blind $0.02
HubertusB: posts big blind $0.05
*** HOLE CARDS ***
Dealt to HubertusB [8c Qd]
Valerij V.S.: raises $0.05 to $0.10
tigran63: folds 
Krawicz: folds 
Blackhare: raises $0.35 to $0.45
Qebel: folds 
HubertusB: folds 
Valerij V.S.: folds 
Uncalled bet ($0.35) returned to Blackhare
Blackhare collected $0.27 from pot
Blackhare: doesn't show hand 
*** SUMMARY ***
Total pot $0.27 | Rake $0 
Seat 1: Blackhare (button) collected ($0.27)
Seat 2: Qebel (small blind) folded before Flop
Seat 3: HubertusB (big blind) folded before Flop
Seat 4: Valerij V.S. folded before Flop
Seat 5: tigran63 folded before Flop (didn't bet)
Seat 6: Krawicz folded before Flop (didn't bet)



PokerStars Zoom Hand #186643796910:  Hold'em No Limit ($0.02/$0.05) - 2018/05/20 20:30:56 CCT [2018/05/20 8:30:56 ET]
Table 'Donati' 6-max Seat #1 is the button
Seat 1: LuckyBBastar ($11.25 in chips) 
Seat 2: kittennose ($5.31 in chips) 
Seat 3: BardJeka ($5.05 in chips) 
Seat 4: SereGka228 ($5.17 in chips) 
Seat 5: bushman86511 ($9.92 in chips) 
Seat 6: HubertusB ($6.89 in chips) 
kittennose: posts small blind $0.02
BardJeka: posts big blind $0.05
*** HOLE CARDS ***
Dealt to HubertusB [6c 5h]
SereGka228: folds 
bushman86511: raises $0.05 to $0.10
HubertusB: folds 
LuckyBBastar: calls $0.10
kittennose: folds 
BardJeka: calls $0.05
*** FLOP *** [2c 2d 5d]
BardJeka: checks 
bushman86511: bets $0.15
LuckyBBastar: calls $0.15
BardJeka: folds 
*** TURN *** [2c 2d 5d] [2h]
bushman86511: bets $0.30
LuckyBBastar: calls $0.30
*** RIVER *** [2c 2d 5d 2h] [Jc]
bushman86511: bets $0.60
LuckyBBastar: calls $0.60
*** SHOW DOWN ***
bushman86511: shows [8s Js] (a full house, Deuces full of Jacks)
LuckyBBastar: mucks hand 
bushman86511 collected $2.32 from pot
*** SUMMARY ***
Total pot $2.42 | Rake $0.10 
Board [2c 2d 5d 2h Jc]
Seat 1: LuckyBBastar (button) mucked [Th Td]
Seat 2: kittennose (small blind) folded before Flop
Seat 3: BardJeka (big blind) folded on the Flop
Seat 4: SereGka228 folded before Flop (didn't bet)
Seat 5: bushman86511 showed [8s Js] and won ($2.32) with a full house, Deuces full of Jacks
Seat 6: HubertusB folded before Flop (didn't bet)



PokerStars Zoom Hand #186643808939:  Hold'em No Limit ($0.02/$0.05) - 2018/05/20 20:31:20 CCT [2018/05/20 8:31:20 ET]
Table 'Donati' 6-max Seat #1 is the button
Seat 1: HubertusB ($6.82 in chips) 
Seat 2: NICooLIN333 ($11.49 in chips) 
Seat 3: Adventuros ($3.62 in chips) 
Seat 4: Chinga4kuk ($5 in chips) 
Seat 5: Zheka-Alaei ($5 in chips) 
Seat 6: Kirikulu ($5 in chips) 
NICooLIN333: posts small blind $0.02
Adventuros: posts big blind $0.05
*** HOLE CARDS ***
Dealt to HubertusB [7c 3c]
Chinga4kuk: folds 
Zheka-Alaei: folds 
Kirikulu: folds 
HubertusB: folds 
NICooLIN333: raises $0.07 to $0.12
Adventuros: folds 
Uncalled bet ($0.07) returned to NICooLIN333
NICooLIN333 collected $0.10 from pot
NICooLIN333: doesn't show hand 
*** SUMMARY ***
Total pot $0.10 | Rake $0 
Seat 1: HubertusB (button) folded before Flop (didn't bet)
Seat 2: NICooLIN333 (small blind) collected ($0.10)
Seat 3: Adventuros (big blind) folded before Flop
Seat 4: Chinga4kuk folded before Flop (didn't bet)
Seat 5: Zheka-Alaei folded before Flop (didn't bet)
Seat 6: Kirikulu folded before Flop (didn't bet)



PokerStars Zoom Hand #186643811455:  Hold'em No Limit ($0.02/$0.05) - 2018/05/20 20:31:25 CCT [2018/05/20 8:31:25 ET]
Table 'Donati' 6-max Seat #1 is the button
Seat 1: spellwilli90 ($5 in chips) 
Seat 2: zapzarap@patent ($6.96 in chips) 
Seat 3: Spookie_1980 ($15.27 in chips) 
Seat 4: serg197211 ($5 in chips) 
Seat 5: squ33z3r ($5.60 in chips) 
Seat 6: HubertusB ($6.82 in chips) 
zapzarap@patent: posts small blind $0.02
Spookie_1980: posts big blind $0.05
*** HOLE CARDS ***
Dealt to HubertusB [Jc Qs]
serg197211: folds 
squ33z3r: raises $0.10 to $0.15
HubertusB: raises $0.30 to $0.45
spellwilli90: folds 
zapzarap@patent: folds 
Spookie_1980: folds 
squ33z3r: calls $0.30
*** FLOP *** [9d Qc 8s]
squ33z3r: checks 
HubertusB: bets $0.50
squ33z3r: folds 
Uncalled bet ($0.50) returned to HubertusB
HubertusB collected $0.93 from pot
HubertusB: doesn't show hand 
*** SUMMARY ***
Total pot $0.97 | Rake $0.04 
Board [9d Qc 8s]
Seat 1: spellwilli90 (button) folded before Flop (didn't bet)
Seat 2: zapzarap@patent (small blind) folded before Flop
Seat 3: Spookie_1980 (big blind) folded before Flop
Seat 4: serg197211 folded before Flop (didn't bet)
Seat 5: squ33z3r folded on the Flop
Seat 6: HubertusB collected ($0.93)



PokerStars Zoom Hand #186643829838:  Hold'em No Limit ($0.02/$0.05) - 2018/05/20 20:32:02 CCT [2018/05/20 8:32:02 ET]
Table 'Donati' 6-max Seat #1 is the button
Seat 1: Blackhare ($5 in chips) 
Seat 2: Unclesmoll ($1.47 in chips) 
Seat 3: hirokun0303 ($4.91 in chips) 
Seat 4: Gundelas ($4.03 in chips) 
Seat 5: HubertusB ($7.30 in chips) 
Seat 6: qwer96_PS ($5.25 in chips) 
Unclesmoll: posts small blind $0.02
hirokun0303: posts big blind $0.05
*** HOLE CARDS ***
Dealt to HubertusB [7d 3d]
Gundelas: folds 
HubertusB: folds 
qwer96_PS: raises $0.10 to $0.15
Blackhare: folds 
Unclesmoll: folds 
hirokun0303: folds 
Uncalled bet ($0.10) returned to qwer96_PS
qwer96_PS collected $0.12 from pot
qwer96_PS: doesn't show hand 
*** SUMMARY ***
Total pot $0.12 | Rake $0 
Seat 1: Blackhare (button) folded before Flop (didn't bet)
Seat 2: Unclesmoll (small blind) folded before Flop
Seat 3: hirokun0303 (big blind) folded before Flop
Seat 4: Gundelas folded before Flop (didn't bet)
Seat 5: HubertusB folded before Flop (didn't bet)
Seat 6: qwer96_PS collected ($0.12)



PokerStars Zoom Hand #186643802384:  Hold'em No Limit ($0.02/$0.05) - 2018/05/20 20:31:07 CCT [2018/05/20 8:31:07 ET]
Table 'Donati' 6-max Seat #1 is the button
Seat 1: Cleantough ($14.30 in chips) 
Seat 2: HubertusB ($6.89 in chips) 
Seat 3: ANANATOR ($5.68 in chips) 
Seat 4: Gissbon ($5 in chips) 
Seat 5: ilynskiy ($3.74 in chips) 
Seat 6: denizzz113 ($1.61 in chips) 
HubertusB: posts small blind $0.02
ANANATOR: posts big blind $0.05
*** HOLE CARDS ***
Dealt to HubertusB [8d Qd]
Gissbon: folds 
ilynskiy: raises $0.10 to $0.15
denizzz113: calls $0.15
Cleantough: raises $0.52 to $0.67
HubertusB: folds 
ANANATOR: folds 
ilynskiy: calls $0.52
denizzz113: folds 
*** FLOP *** [Ac Th Jd]
ilynskiy: checks 
Cleantough: bets $0.60
ilynskiy: calls $0.60
*** TURN *** [Ac Th Jd] [Td]
ilynskiy: checks 
Cleantough: checks 
*** RIVER *** [Ac Th Jd Td] [9s]
ilynskiy: checks 
Cleantough: checks 
*** SHOW DOWN ***
ilynskiy: shows [Qh Jh] (two pair, Jacks and Tens)
Cleantough: mucks hand 
ilynskiy collected $2.65 from pot
*** SUMMARY ***
Total pot $2.76 | Rake $0.11 
Board [Ac Th Jd Td 9s]
Seat 1: Cleantough (button) mucked [Kc 8c]
Seat 2: HubertusB (small blind) folded before Flop
Seat 3: ANANATOR (big blind) folded before Flop
Seat 4: Gissbon folded before Flop (didn't bet)
Seat 5: ilynskiy showed [Qh Jh] and won ($2.65) with two pair, Jacks and Tens
Seat 6: denizzz113 folded before Flop



PokerStars Zoom Hand #186643832894:  Hold'em No Limit ($0.02/$0.05) - 2018/05/20 20:32:08 CCT [2018/05/20 8:32:08 ET]
Table 'Donati' 6-max Seat #1 is the button
Seat 1: bamboocha88 ($4.89 in chips) 
Seat 2: KAMSHULER ($5 in chips) 
Seat 3: PiNe4ppLe ($5 in chips) 
Seat 4: HubertusB ($7.30 in chips) 
Seat 5: kirilin.ru ($20.41 in chips) 
Seat 6: jaanis1983 ($6.09 in chips) 
KAMSHULER: posts small blind $0.02
PiNe4ppLe: posts big blind $0.05
*** HOLE CARDS ***
Dealt to HubertusB [Tc 7s]
HubertusB: folds 
kirilin.ru: folds 
jaanis1983: folds 
bamboocha88: raises $0.06 to $0.11
KAMSHULER: folds 
PiNe4ppLe: folds 
Uncalled bet ($0.06) returned to bamboocha88
bamboocha88 collected $0.12 from pot
bamboocha88: doesn't show hand 
*** SUMMARY ***
Total pot $0.12 | Rake $0 
Seat 1: bamboocha88 (button) collected ($0.12)
Seat 2: KAMSHULER (small blind) folded before Flop
Seat 3: PiNe4ppLe (big blind) folded before Flop
Seat 4: HubertusB folded before Flop (didn't bet)
Seat 5: kirilin.ru folded before Flop (didn't bet)
Seat 6: jaanis1983 folded before Flop (didn't bet)



PokerStars Zoom Hand #186643835902:  Hold'em No Limit ($0.02/$0.05) - 2018/05/20 20:32:14 CCT [2018/05/20 8:32:14 ET]
Table 'Donati' 6-max Seat #1 is the button
Seat 1: threeson ($5.34 in chips) 
Seat 2: na_onda ($5.23 in chips) 
Seat 3: ykxmli ($5 in chips) 
Seat 4: HubertusB ($7.30 in chips) 
Seat 5: ConQuRoR25 ($1.98 in chips) 
Seat 6: sixequjfive ($5.21 in chips) 
na_onda: posts small blind $0.02
ykxmli: posts big blind $0.05
*** HOLE CARDS ***
Dealt to HubertusB [Qd 2c]
HubertusB: folds 
ConQuRoR25: folds 
sixequjfive: folds 
threeson: folds 
na_onda: raises $0.05 to $0.10
ykxmli: folds 
Uncalled bet ($0.05) returned to na_onda
na_onda collected $0.10 from pot
na_onda: doesn't show hand 
*** SUMMARY ***
Total pot $0.10 | Rake $0 
Seat 1: threeson (button) folded before Flop (didn't bet)
Seat 2: na_onda (small blind) collected ($0.10)
Seat 3: ykxmli (big blind) folded before Flop
Seat 4: HubertusB folded before Flop (didn't bet)
Seat 5: ConQuRoR25 folded before Flop (didn't bet)
Seat 6: sixequjfive folded before Flop (didn't bet)



PokerStars Zoom Hand #186643839462:  Hold'em No Limit ($0.02/$0.05) - 2018/05/20 20:32:21 CCT [2018/05/20 8:32:21 ET]
Table 'Donati' 6-max Seat #1 is the button
Seat 1: Staz893 ($7.86 in chips) 
Seat 2: seregha16 ($7.31 in chips) 
Seat 3: HubertusB ($7.30 in chips) 
Seat 4: Viking218 ($2.28 in chips) 
Seat 5: maxgild85 ($5.05 in chips) 
Seat 6: olivier070 ($5 in chips) 
seregha16: posts small blind $0.02
HubertusB: posts big blind $0.05
*** HOLE CARDS ***
Dealt to HubertusB [7s Jd]
Viking218: folds 
maxgild85: raises $0.10 to $0.15
olivier070: folds 
Staz893: folds 
seregha16: folds 
HubertusB: folds 
Uncalled bet ($0.10) returned to maxgild85
maxgild85 collected $0.12 from pot
maxgild85: doesn't show hand 
*** SUMMARY ***
Total pot $0.12 | Rake $0 
Seat 1: Staz893 (button) folded before Flop (didn't bet)
Seat 2: seregha16 (small blind) folded before Flop
Seat 3: HubertusB (big blind) folded before Flop
Seat 4: Viking218 folded before Flop (didn't bet)
Seat 5: maxgild85 collected ($0.12)
Seat 6: olivier070 folded before Flop (didn't bet)



PokerStars Zoom Hand #186643860429:  Hold'em No Limit ($0.02/$0.05) - 2018/05/20 20:33:03 CCT [2018/05/20 8:33:03 ET]
Table 'Donati' 6-max Seat #1 is the button
Seat 1: kogorou999 ($6.67 in chips) 
Seat 2: Jase4607 ($4.21 in chips) 
Seat 3: orangedeuce ($5.75 in chips) 
Seat 4: Blackhare ($5 in chips) 
Seat 5: Lacky_DNK ($6.55 in chips) 
Seat 6: HubertusB ($7.10 in chips) 
Jase4607: posts small blind $0.02
orangedeuce: posts big blind $0.05
*** HOLE CARDS ***
Dealt to HubertusB [Ts 5d]
Blackhare: folds 
Lacky_DNK: folds 
HubertusB: folds 
kogorou999: folds 
Jase4607: folds 
Uncalled bet ($0.03) returned to orangedeuce
orangedeuce collected $0.04 from pot
orangedeuce: doesn't show hand 
*** SUMMARY ***
Total pot $0.04 | Rake $0 
Seat 1: kogorou999 (button) folded before Flop (didn't bet)
Seat 2: Jase4607 (small blind) folded before Flop
Seat 3: orangedeuce (big blind) collected ($0.04)
Seat 4: Blackhare folded before Flop (didn't bet)
Seat 5: Lacky_DNK folded before Flop (didn't bet)
Seat 6: HubertusB folded before Flop (didn't bet)



PokerStars Zoom Hand #186643863364:  Hold'em No Limit ($0.02/$0.05) - 2018/05/20 20:33:09 CCT [2018/05/20 8:33:09 ET]
Table 'Donati' 6-max Seat #1 is the button
Seat 1: olivier070 ($7.94 in chips) 
Seat 2: Lady.Lyck ($4.93 in chips) 
Seat 3: ykxmli ($5.50 in chips) 
Seat 4: FelixZyl ($10.28 in chips) 
Seat 5: HubertusB ($7.10 in chips) 
Seat 6: <Bogolal> ($5.71 in chips) 
Lady.Lyck: posts small blind $0.02
ykxmli: posts big blind $0.05
*** HOLE CARDS ***
Dealt to HubertusB [3h 3d]
FelixZyl: folds 
HubertusB: raises $0.10 to $0.15
<Bogolal>: folds 
olivier070: folds 
Lady.Lyck: folds 
ykxmli: folds 
Uncalled bet ($0.10) returned to HubertusB
HubertusB collected $0.12 from pot
HubertusB: doesn't show hand 
*** SUMMARY ***
Total pot $0.12 | Rake $0 
Seat 1: olivier070 (button) folded before Flop (didn't bet)
Seat 2: Lady.Lyck (small blind) folded before Flop
Seat 3: ykxmli (big blind) folded before Flop
Seat 4: FelixZyl folded before Flop (didn't bet)
Seat 5: HubertusB collected ($0.12)
Seat 6: <Bogolal> folded before Flop (didn't bet)



PokerStars Zoom Hand #186643843978:  Hold'em No Limit ($0.02/$0.05) - 2018/05/20 20:32:30 CCT [2018/05/20 8:32:30 ET]
Table 'Donati' 6-max Seat #1 is the button
Seat 1: bamboocha88 ($6.59 in chips) 
Seat 2: HubertusB ($7.25 in chips) 
Seat 3: seregha16 ($7.29 in chips) 
Seat 4: 8outsLeft ($6.62 in chips) 
Seat 5: Lady.Lyck ($5.04 in chips) 
Seat 6: marinesko1984 ($3.88 in chips) 
HubertusB: posts small blind $0.02
seregha16: posts big blind $0.05
*** HOLE CARDS ***
Dealt to HubertusB [3h 3c]
8outsLeft: raises $0.10 to $0.15
Lady.Lyck: folds 
marinesko1984: calls $0.15
bamboocha88: folds 
HubertusB: calls $0.13
seregha16: folds 
*** FLOP *** [9h Ts 4c]
HubertusB: checks 
8outsLeft: bets $0.30
marinesko1984: calls $0.30
HubertusB: folds 
*** TURN *** [9h Ts 4c] [Th]
8outsLeft: checks 
marinesko1984: bets $0.60
8outsLeft: folds 
Uncalled bet ($0.60) returned to marinesko1984
marinesko1984 collected $1.05 from pot
marinesko1984: doesn't show hand 
*** SUMMARY ***
Total pot $1.10 | Rake $0.05 
Board [9h Ts 4c Th]
Seat 1: bamboocha88 (button) folded before Flop (didn't bet)
Seat 2: HubertusB (small blind) folded on the Flop
Seat 3: seregha16 (big blind) folded before Flop
Seat 4: 8outsLeft folded on the Turn
Seat 5: Lady.Lyck folded before Flop (didn't bet)
Seat 6: marinesko1984 collected ($1.05)



PokerStars Zoom Hand #186643870280:  Hold'em No Limit ($0.02/$0.05) - 2018/05/20 20:33:23 CCT [2018/05/20 8:33:23 ET]
Table 'Donati' 6-max Seat #1 is the button
Seat 1: HubertusB ($7.17 in chips) 
Seat 2: TOMEF1CHA ($7.63 in chips) 
Seat 3: barbos2009 ($8.13 in chips) 
Seat 4: Warrendown ($6.11 in chips) 
Seat 5: Lacky_DNK ($6.55 in chips) 
Seat 6: chips010 ($4.52 in chips) 
TOMEF1CHA: posts small blind $0.02
barbos2009: posts big blind $0.05
*** HOLE CARDS ***
Dealt to HubertusB [2d Jh]
Warrendown: folds 
Lacky_DNK: folds 
chips010: raises $0.10 to $0.15
HubertusB: folds 
TOMEF1CHA: folds 
barbos2009: folds 
Uncalled bet ($0.10) returned to chips010
chips010 collected $0.12 from pot
chips010: doesn't show hand 
*** SUMMARY ***
Total pot $0.12 | Rake $0 
Seat 1: HubertusB (button) folded before Flop (didn't bet)
Seat 2: TOMEF1CHA (small blind) folded before Flop
Seat 3: barbos2009 (big blind) folded before Flop
Seat 4: Warrendown folded before Flop (didn't bet)
Seat 5: Lacky_DNK folded before Flop (didn't bet)
Seat 6: chips010 collected ($0.12)



PokerStars Zoom Hand #186643873242:  Hold'em No Limit ($0.02/$0.05) - 2018/05/20 20:33:29 CCT [2018/05/20 8:33:29 ET]
Table 'Donati' 6-max Seat #1 is the button
Seat 1: edger4013 ($8.68 in chips) 
Seat 2: Palapl ($4.36 in chips) 
Seat 3: C007M ($4.73 in chips) 
Seat 4: kayck07 ($6.99 in chips) 
Seat 5: Arrenea ($10.18 in chips) 
Seat 6: HubertusB ($7.17 in chips) 
Palapl: posts small blind $0.02
C007M: posts big blind $0.05
*** HOLE CARDS ***
Dealt to HubertusB [6d 9c]
kayck07: folds 
Arrenea: folds 
HubertusB: folds 
edger4013: folds 
Palapl: folds 
Uncalled bet ($0.03) returned to C007M
C007M collected $0.04 from pot
C007M: doesn't show hand 
*** SUMMARY ***
Total pot $0.04 | Rake $0 
Seat 1: edger4013 (button) folded before Flop (didn't bet)
Seat 2: Palapl (small blind) folded before Flop
Seat 3: C007M (big blind) collected ($0.04)
Seat 4: kayck07 folded before Flop (didn't bet)
Seat 5: Arrenea folded before Flop (didn't bet)
Seat 6: HubertusB folded before Flop (didn't bet)



PokerStars Zoom Hand #186643877292:  Hold'em No Limit ($0.02/$0.05) - 2018/05/20 20:33:37 CCT [2018/05/20 8:33:37 ET]
Table 'Donati' 6-max Seat #1 is the button
Seat 1: HubertusB ($7.17 in chips) 
Seat 2: lasyboy999 ($14.36 in chips) 
Seat 3: Brun0C0elh0 ($5 in chips) 
Seat 4: FelixZyl ($14.33 in chips) 
Seat 5: Jase4607 ($4.21 in chips) 
Seat 6: Reshalo.fish ($4.65 in chips) 
lasyboy999: posts small blind $0.02
Brun0C0elh0: posts big blind $0.05
*** HOLE CARDS ***
Dealt to HubertusB [Ks 8s]
FelixZyl: folds 
Jase4607: folds 
Reshalo.fish: folds 
HubertusB: folds 
lasyboy999: folds 
Uncalled bet ($0.03) returned to Brun0C0elh0
Brun0C0elh0 collected $0.04 from pot
Brun0C0elh0: doesn't show hand 
*** SUMMARY ***
Total pot $0.04 | Rake $0 
Seat 1: HubertusB (button) folded before Flop (didn't bet)
Seat 2: lasyboy999 (small blind) folded before Flop
Seat 3: Brun0C0elh0 (big blind) collected ($0.04)
Seat 4: FelixZyl folded before Flop (didn't bet)
Seat 5: Jase4607 folded before Flop (didn't bet)
Seat 6: Reshalo.fish folded before Flop (didn't bet)



PokerStars Zoom Hand #186643880232:  Hold'em No Limit ($0.02/$0.05) - 2018/05/20 20:33:43 CCT [2018/05/20 8:33:43 ET]
Table 'Donati' 6-max Seat #1 is the button
Seat 1: DonkKing433 ($6.87 in chips) 
Seat 2: FelixZyl ($10.35 in chips) 
Seat 3: HubertusB ($7.17 in chips) 
Seat 4: Original Flo ($2.43 in chips) 
Seat 5: Zheka-Alaei ($6.10 in chips) 
Seat 6: ANANATOR ($7.83 in chips) 
FelixZyl: posts small blind $0.02
HubertusB: posts big blind $0.05
*** HOLE CARDS ***
Dealt to HubertusB [3d 4d]
Original Flo: folds 
Zheka-Alaei: folds 
ANANATOR: folds 
DonkKing433 has timed out
DonkKing433: folds 
FelixZyl: folds 
Uncalled bet ($0.03) returned to HubertusB
HubertusB collected $0.04 from pot
HubertusB: doesn't show hand 
*** SUMMARY ***
Total pot $0.04 | Rake $0 
Seat 1: DonkKing433 (button) folded before Flop (didn't bet)
Seat 2: FelixZyl (small blind) folded before Flop
Seat 3: HubertusB (big blind) collected ($0.04)
Seat 4: Original Flo folded before Flop (didn't bet)
Seat 5: Zheka-Alaei folded before Flop (didn't bet)
Seat 6: ANANATOR folded before Flop (didn't bet)



PokerStars Zoom Hand #186643902146:  Hold'em No Limit ($0.02/$0.05) - 2018/05/20 20:34:27 CCT [2018/05/20 8:34:27 ET]
Table 'Donati' 6-max Seat #1 is the button
Seat 1: mamel7777 ($7.18 in chips) 
Seat 2: edger4013 ($8.58 in chips) 
Seat 3: Leopoldia ($3.18 in chips) 
Seat 4: HubertusB ($7.17 in chips) 
Seat 5: kittennose ($5 in chips) 
Seat 6: Qebel ($5 in chips) 
edger4013: posts small blind $0.02
Leopoldia: posts big blind $0.05
*** HOLE CARDS ***
Dealt to HubertusB [7d 5s]
HubertusB: folds 
kittennose: folds 
Qebel: folds 
mamel7777: folds 
edger4013: folds 
Uncalled bet ($0.03) returned to Leopoldia
Leopoldia collected $0.04 from pot
Leopoldia: doesn't show hand 
*** SUMMARY ***
Total pot $0.04 | Rake $0 
Seat 1: mamel7777 (button) folded before Flop (didn't bet)
Seat 2: edger4013 (small blind) folded before Flop
Seat 3: Leopoldia (big blind) collected ($0.04)
Seat 4: HubertusB folded before Flop (didn't bet)
Seat 5: kittennose folded before Flop (didn't bet)
Seat 6: Qebel folded before Flop (didn't bet)



PokerStars Zoom Hand #186643899696:  Hold'em No Limit ($0.02/$0.05) - 2018/05/20 20:34:22 CCT [2018/05/20 8:34:22 ET]
Table 'Donati' 6-max Seat #1 is the button
Seat 1: na_onda ($5.04 in chips) 
Seat 2: mearlog18 ($5.02 in chips) 
Seat 3: Arrenea ($15.91 in chips) 
Seat 4: VLSALT ($6.37 in chips) 
Seat 5: HubertusB ($7.17 in chips) 
Seat 6: sedoi746 ($5.58 in chips) 
mearlog18: posts small blind $0.02
Arrenea: posts big blind $0.05
*** HOLE CARDS ***
Dealt to HubertusB [Kc 4h]
VLSALT: folds 
HubertusB: folds 
sedoi746: folds 
na_onda: folds 
mearlog18: raises $0.07 to $0.12
Arrenea: folds 
Uncalled bet ($0.07) returned to mearlog18
mearlog18 collected $0.10 from pot
mearlog18: doesn't show hand 
*** SUMMARY ***
Total pot $0.10 | Rake $0 
Seat 1: na_onda (button) folded before Flop (didn't bet)
Seat 2: mearlog18 (small blind) collected ($0.10)
Seat 3: Arrenea (big blind) folded before Flop
Seat 4: VLSALT folded before Flop (didn't bet)
Seat 5: HubertusB folded before Flop (didn't bet)
Seat 6: sedoi746 folded before Flop (didn't bet)



PokerStars Zoom Hand #186643896750:  Hold'em No Limit ($0.02/$0.05) - 2018/05/20 20:34:16 CCT [2018/05/20 8:34:16 ET]
Table 'Donati' 6-max Seat #1 is the button
Seat 1: c0nscience ($5 in chips) 
Seat 2: HubertusB ($7.19 in chips) 
Seat 3: Mattiasgirl ($6.47 in chips) 
Seat 4: Rexike1 ($4.13 in chips) 
Seat 5: FelixZyl ($10.20 in chips) 
Seat 6: offuca ($5 in chips) 
HubertusB: posts small blind $0.02
Mattiasgirl: posts big blind $0.05
*** HOLE CARDS ***
Dealt to HubertusB [9d 5s]
Rexike1: raises $0.05 to $0.10
FelixZyl: folds 
offuca: folds 
c0nscience: folds 
HubertusB: folds 
Mattiasgirl: raises $0.45 to $0.55
Rexike1: calls $0.45
*** FLOP *** [2d Th 4c]
Mattiasgirl: bets $1.07
Rexike1: calls $1.07
*** TURN *** [2d Th 4c] [8d]
Mattiasgirl: checks 
Rexike1: bets $1.56
Mattiasgirl: folds 
Uncalled bet ($1.56) returned to Rexike1
Rexike1 collected $3.12 from pot
Rexike1: doesn't show hand 
*** SUMMARY ***
Total pot $3.26 | Rake $0.14 
Board [2d Th 4c 8d]
Seat 1: c0nscience (button) folded before Flop (didn't bet)
Seat 2: HubertusB (small blind) folded before Flop
Seat 3: Mattiasgirl (big blind) folded on the Turn
Seat 4: Rexike1 collected ($3.12)
Seat 5: FelixZyl folded before Flop (didn't bet)
Seat 6: offuca folded before Flop (didn't bet)



PokerStars Zoom Hand #186643905222:  Hold'em No Limit ($0.02/$0.05) - 2018/05/20 20:34:33 CCT [2018/05/20 8:34:33 ET]
Table 'Donati' 6-max Seat #1 is the button
Seat 1: hirokun0303 ($8.75 in chips) 
Seat 2: Adventuros ($1.91 in chips) 
Seat 3: Zheka-Alaei ($6.03 in chips) 
Seat 4: Janski90 ($11.29 in chips) 
Seat 5: HubertusB ($7.17 in chips) 
Seat 6: LuckyBBastar ($13.36 in chips) 
Adventuros: posts small blind $0.02
Zheka-Alaei: posts big blind $0.05
*** HOLE CARDS ***
Dealt to HubertusB [Qh As]
Janski90: folds 
HubertusB: raises $0.10 to $0.15
LuckyBBastar: folds 
hirokun0303: folds 
Adventuros: calls $0.13
Zheka-Alaei: folds 
*** FLOP *** [3d 5s 6s]
Adventuros: checks 
HubertusB: checks 
*** TURN *** [3d 5s 6s] [3h]
Adventuros: bets $0.15
HubertusB: calls $0.15
*** RIVER *** [3d 5s 6s 3h] [4c]
Adventuros: bets $0.27
HubertusB: calls $0.27
*** SHOW DOWN ***
Adventuros: shows [Ts 9s] (a pair of Threes)
HubertusB: shows [Qh As] (a pair of Threes - Ace kicker)
HubertusB collected $1.14 from pot
*** SUMMARY ***
Total pot $1.19 | Rake $0.05 
Board [3d 5s 6s 3h 4c]
Seat 1: hirokun0303 (button) folded before Flop (didn't bet)
Seat 2: Adventuros (small blind) showed [Ts 9s] and lost with a pair of Threes
Seat 3: Zheka-Alaei (big blind) folded before Flop
Seat 4: Janski90 folded before Flop (didn't bet)
Seat 5: HubertusB showed [Qh As] and won ($1.14) with a pair of Threes
Seat 6: LuckyBBastar folded before Flop (didn't bet)



PokerStars Zoom Hand #186643925774:  Hold'em No Limit ($0.02/$0.05) - 2018/05/20 20:35:14 CCT [2018/05/20 8:35:14 ET]
Table 'Donati' 6-max Seat #1 is the button
Seat 1: shjordy ($4.95 in chips) 
Seat 2: ANANATOR ($5.90 in chips) 
Seat 3: mamel7777 ($7.53 in chips) 
Seat 4: Vasyaga rus ($4.30 in chips) 
Seat 5: alleck31 ($4.97 in chips) 
Seat 6: HubertusB ($7.74 in chips) 
ANANATOR: posts small blind $0.02
mamel7777: posts big blind $0.05
*** HOLE CARDS ***
Dealt to HubertusB [8s Ks]
Vasyaga rus: raises $0.10 to $0.15
alleck31: folds 
HubertusB: folds 
shjordy: folds 
ANANATOR: folds 
mamel7777: folds 
Uncalled bet ($0.10) returned to Vasyaga rus
Vasyaga rus collected $0.12 from pot
Vasyaga rus: doesn't show hand 
*** SUMMARY ***
Total pot $0.12 | Rake $0 
Seat 1: shjordy (button) folded before Flop (didn't bet)
Seat 2: ANANATOR (small blind) folded before Flop
Seat 3: mamel7777 (big blind) folded before Flop
Seat 4: Vasyaga rus collected ($0.12)
Seat 5: alleck31 folded before Flop (didn't bet)
Seat 6: HubertusB folded before Flop (didn't bet)



PokerStars Zoom Hand #186643931847:  Hold'em No Limit ($0.02/$0.05) - 2018/05/20 20:35:26 CCT [2018/05/20 8:35:26 ET]
Table 'Donati' 6-max Seat #1 is the button
Seat 1: NaomiLou14 ($14.53 in chips) 
Seat 2: Lacky_DNK ($4.19 in chips) 
Seat 3: HubertusB ($7.74 in chips) 
Seat 4: iKiiiLL4fun ($15.57 in chips) 
Seat 5: Oscar__62176 ($6 in chips) 
Seat 6: frappo ($7.23 in chips) 
Lacky_DNK: posts small blind $0.02
HubertusB: posts big blind $0.05
*** HOLE CARDS ***
Dealt to HubertusB [3c 2h]
iKiiiLL4fun: raises $0.10 to $0.15
Oscar__62176: folds 
frappo: calls $0.15
NaomiLou14: folds 
Lacky_DNK: folds 
HubertusB: folds 
*** FLOP *** [Qd 4d Jc]
iKiiiLL4fun: bets $0.26
frappo: folds 
Uncalled bet ($0.26) returned to iKiiiLL4fun
iKiiiLL4fun collected $0.35 from pot
iKiiiLL4fun: doesn't show hand 
*** SUMMARY ***
Total pot $0.37 | Rake $0.02 
Board [Qd 4d Jc]
Seat 1: NaomiLou14 (button) folded before Flop (didn't bet)
Seat 2: Lacky_DNK (small blind) folded before Flop
Seat 3: HubertusB (big blind) folded before Flop
Seat 4: iKiiiLL4fun collected ($0.35)
Seat 5: Oscar__62176 folded before Flop (didn't bet)
Seat 6: frappo folded on the Flop



PokerStars Zoom Hand #186643934854:  Hold'em No Limit ($0.02/$0.05) - 2018/05/20 20:35:32 CCT [2018/05/20 8:35:32 ET]
Table 'Donati' 6-max Seat #1 is the button
Seat 1: chips010 ($8.54 in chips) 
Seat 2: HubertusB ($7.69 in chips) 
Seat 3: SereGka228 ($5 in chips) 
Seat 4: LuckyBBastar ($13.24 in chips) 
Seat 5: Grigoriy40$ ($16.80 in chips) 
Seat 6: BHuelse ($5.16 in chips) 
HubertusB: posts small blind $0.02
SereGka228: posts big blind $0.05
*** HOLE CARDS ***
Dealt to HubertusB [4c 9c]
LuckyBBastar: folds 
Grigoriy40$: folds 
BHuelse: raises $0.10 to $0.15
chips010: folds 
HubertusB: folds 
SereGka228: folds 
Uncalled bet ($0.10) returned to BHuelse
BHuelse collected $0.12 from pot
BHuelse: doesn't show hand 
*** SUMMARY ***
Total pot $0.12 | Rake $0 
Seat 1: chips010 (button) folded before Flop (didn't bet)
Seat 2: HubertusB (small blind) folded before Flop
Seat 3: SereGka228 (big blind) folded before Flop
Seat 4: LuckyBBastar folded before Flop (didn't bet)
Seat 5: Grigoriy40$ folded before Flop (didn't bet)
Seat 6: BHuelse collected ($0.12)



PokerStars Zoom Hand #186643939409:  Hold'em No Limit ($0.02/$0.05) - 2018/05/20 20:35:41 CCT [2018/05/20 8:35:41 ET]
Table 'Donati' 6-max Seat #1 is the button
Seat 1: HubertusB ($7.67 in chips) 
Seat 2: M4il4o ($5.07 in chips) 
Seat 3: barbos2009 ($7.73 in chips) 
Seat 4: olleyzell ($4.71 in chips) 
Seat 5: Hunt3r.A.A. ($8.92 in chips) 
Seat 6: orangedeuce ($9.49 in chips) 
M4il4o: posts small blind $0.02
barbos2009: posts big blind $0.05
*** HOLE CARDS ***
Dealt to HubertusB [4d 5c]
olleyzell: folds 
Hunt3r.A.A.: folds 
orangedeuce: folds 
HubertusB: folds 
M4il4o: folds 
Uncalled bet ($0.03) returned to barbos2009
barbos2009 collected $0.04 from pot
barbos2009: doesn't show hand 
*** SUMMARY ***
Total pot $0.04 | Rake $0 
Seat 1: HubertusB (button) folded before Flop (didn't bet)
Seat 2: M4il4o (small blind) folded before Flop
Seat 3: barbos2009 (big blind) collected ($0.04)
Seat 4: olleyzell folded before Flop (didn't bet)
Seat 5: Hunt3r.A.A. folded before Flop (didn't bet)
Seat 6: orangedeuce folded before Flop (didn't bet)



PokerStars Zoom Hand #186643943835:  Hold'em No Limit ($0.02/$0.05) - 2018/05/20 20:35:50 CCT [2018/05/20 8:35:50 ET]
Table 'Donati' 6-max Seat #1 is the button
Seat 1: LQ Wu ($4.93 in chips) 
Seat 2: orangedeuce ($9.49 in chips) 
Seat 3: slob43.ru ($4.38 in chips) 
Seat 4: Grigoriy40$ ($16.80 in chips) 
Seat 5: qwer9019 ($6.65 in chips) 
Seat 6: HubertusB ($7.67 in chips) 
orangedeuce: posts small blind $0.02
slob43.ru: posts big blind $0.05
*** HOLE CARDS ***
Dealt to HubertusB [Ks Kd]
Grigoriy40$: folds 
qwer9019: raises $0.10 to $0.15
HubertusB: raises $0.30 to $0.45
LQ Wu: folds 
orangedeuce: folds 
slob43.ru: folds 
qwer9019: calls $0.30
*** FLOP *** [9s 3s 9c]
qwer9019: checks 
HubertusB: bets $0.45
qwer9019: raises $0.90 to $1.35
HubertusB: raises $5.87 to $7.22 and is all-in
qwer9019: calls $4.85 and is all-in
Uncalled bet ($1.02) returned to HubertusB
*** TURN *** [9s 3s 9c] [8s]
*** RIVER *** [9s 3s 9c 8s] [5c]
*** SHOW DOWN ***
qwer9019: shows [Jh Jc] (two pair, Jacks and Nines)
HubertusB: shows [Ks Kd] (two pair, Kings and Nines)
HubertusB collected $12.82 from pot
*** SUMMARY ***
Total pot $13.37 | Rake $0.55 
Board [9s 3s 9c 8s 5c]
Seat 1: LQ Wu (button) folded before Flop (didn't bet)
Seat 2: orangedeuce (small blind) folded before Flop
Seat 3: slob43.ru (big blind) folded before Flop
Seat 4: Grigoriy40$ folded before Flop (didn't bet)
Seat 5: qwer9019 showed [Jh Jc] and lost with two pair, Jacks and Nines
Seat 6: HubertusB showed [Ks Kd] and won ($12.82) with two pair, Kings and Nines



