PokerStars Zoom Hand #178481237724:  Hold'em No Limit ($0.02/$0.05) - 2017/11/20 20:27:11 CCT [2017/11/20 7:27:11 ET]
Table 'Donati' 6-max Seat #1 is the button
Seat 1: freakmania86 ($6.78 in chips) 
Seat 2: Polypops ($5.31 in chips) 
Seat 3: HubertusB ($5 in chips) 
Seat 4: stason777 ($6.12 in chips) 
Seat 5: ddp1985 ($9.24 in chips) 
Seat 6: Imola701 ($5 in chips) 
Polypops: posts small blind $0.02
HubertusB: posts big blind $0.05
*** HOLE CARDS ***
Dealt to HubertusB [Kh 4s]
stason777: folds 
ddp1985: folds 
Imola701: raises $0.07 to $0.12
freakmania86: folds 
Polypops: folds 
HubertusB: folds 
Uncalled bet ($0.07) returned to Imola701
Imola701 collected $0.12 from pot
Imola701: doesn't show hand 
*** SUMMARY ***
Total pot $0.12 | Rake $0 
Seat 1: freakmania86 (button) folded before Flop (didn't bet)
Seat 2: Polypops (small blind) folded before Flop
Seat 3: HubertusB (big blind) folded before Flop
Seat 4: stason777 folded before Flop (didn't bet)
Seat 5: ddp1985 folded before Flop (didn't bet)
Seat 6: Imola701 collected ($0.12)



PokerStars Zoom Hand #178481243663:  Hold'em No Limit ($0.02/$0.05) - 2017/11/20 20:27:25 CCT [2017/11/20 7:27:25 ET]
Table 'Donati' 6-max Seat #1 is the button
Seat 1: TomSawyerz ($4.93 in chips) 
Seat 2: HubertusB ($4.95 in chips) 
Seat 3: ddp1985 ($5.57 in chips) 
Seat 4: Agull1109 ($9.97 in chips) 
Seat 5: IanMalique9 ($11.50 in chips) 
Seat 6: cel1974 ($6.27 in chips) 
HubertusB: posts small blind $0.02
ddp1985: posts big blind $0.05
*** HOLE CARDS ***
Dealt to HubertusB [8c 2s]
Agull1109: folds 
IanMalique9: folds 
cel1974: raises $0.10 to $0.15
TomSawyerz: folds 
HubertusB: folds 
ddp1985: folds 
Uncalled bet ($0.10) returned to cel1974
cel1974 collected $0.12 from pot
cel1974: doesn't show hand 
*** SUMMARY ***
Total pot $0.12 | Rake $0 
Seat 1: TomSawyerz (button) folded before Flop (didn't bet)
Seat 2: HubertusB (small blind) folded before Flop
Seat 3: ddp1985 (big blind) folded before Flop
Seat 4: Agull1109 folded before Flop (didn't bet)
Seat 5: IanMalique9 folded before Flop (didn't bet)
Seat 6: cel1974 collected ($0.12)



PokerStars Zoom Hand #178481248335:  Hold'em No Limit ($0.02/$0.05) - 2017/11/20 20:27:36 CCT [2017/11/20 7:27:36 ET]
Table 'Donati' 6-max Seat #1 is the button
Seat 1: wilzkye ($8.16 in chips) 
Seat 2: hovlaa ($5.71 in chips) 
Seat 3: HubertusB ($4.93 in chips) 
Seat 4: Tautietis852 ($12.27 in chips) 
Seat 5: vanek-95all@ ($7.08 in chips) 
Seat 6: tis ikke123 ($5.46 in chips) 
hovlaa: posts small blind $0.02
HubertusB: posts big blind $0.05
*** HOLE CARDS ***
Dealt to HubertusB [2s Jd]
Tautietis852: folds 
vanek-95all@: folds 
tis ikke123: raises $0.05 to $0.10
wilzkye: calls $0.10
hovlaa: raises $0.40 to $0.50
HubertusB: folds 
tis ikke123: folds 
wilzkye: folds 
Uncalled bet ($0.40) returned to hovlaa
hovlaa collected $0.35 from pot
hovlaa: doesn't show hand 
*** SUMMARY ***
Total pot $0.35 | Rake $0 
Seat 1: wilzkye (button) folded before Flop
Seat 2: hovlaa (small blind) collected ($0.35)
Seat 3: HubertusB (big blind) folded before Flop
Seat 4: Tautietis852 folded before Flop (didn't bet)
Seat 5: vanek-95all@ folded before Flop (didn't bet)
Seat 6: tis ikke123 folded before Flop



PokerStars Zoom Hand #178481257363:  Hold'em No Limit ($0.02/$0.05) - 2017/11/20 20:27:57 CCT [2017/11/20 7:27:57 ET]
Table 'Donati' 6-max Seat #1 is the button
Seat 1: ddp1985 ($10.25 in chips) 
Seat 2: dark h0r$e ($5 in chips) 
Seat 3: jochenfratz ($5.43 in chips) 
Seat 4: Curtix1023 ($5.15 in chips) 
Seat 5: HubertusB ($4.88 in chips) 
Seat 6: RenningStone ($10.88 in chips) 
dark h0r$e: posts small blind $0.02
jochenfratz: posts big blind $0.05
*** HOLE CARDS ***
Dealt to HubertusB [7h 3s]
Curtix1023: raises $0.10 to $0.15
HubertusB: folds 
RenningStone: folds 
ddp1985: folds 
dark h0r$e: folds 
jochenfratz: folds 
Uncalled bet ($0.10) returned to Curtix1023
Curtix1023 collected $0.12 from pot
Curtix1023: doesn't show hand 
*** SUMMARY ***
Total pot $0.12 | Rake $0 
Seat 1: ddp1985 (button) folded before Flop (didn't bet)
Seat 2: dark h0r$e (small blind) folded before Flop
Seat 3: jochenfratz (big blind) folded before Flop
Seat 4: Curtix1023 collected ($0.12)
Seat 5: HubertusB folded before Flop (didn't bet)
Seat 6: RenningStone folded before Flop (didn't bet)



PokerStars Zoom Hand #178481255202:  Hold'em No Limit ($0.02/$0.05) - 2017/11/20 20:27:52 CCT [2017/11/20 7:27:52 ET]
Table 'Donati' 6-max Seat #1 is the button
Seat 1: ciucanu666 ($2.50 in chips) 
Seat 2: Baenre12 ($7.64 in chips) 
Seat 3: freakmania86 ($9.43 in chips) 
Seat 4: WangHaoWei ($6.25 in chips) 
Seat 5: CaH4esskO ($5.45 in chips) 
Seat 6: HubertusB ($4.88 in chips) 
Baenre12: posts small blind $0.02
freakmania86: posts big blind $0.05
*** HOLE CARDS ***
Dealt to HubertusB [Qc 4d]
WangHaoWei: folds 
CaH4esskO: folds 
HubertusB: folds 
ciucanu666: raises $0.10 to $0.15
Baenre12: folds 
freakmania86: folds 
Uncalled bet ($0.10) returned to ciucanu666
ciucanu666 collected $0.12 from pot
ciucanu666: doesn't show hand 
*** SUMMARY ***
Total pot $0.12 | Rake $0 
Seat 1: ciucanu666 (button) collected ($0.12)
Seat 2: Baenre12 (small blind) folded before Flop
Seat 3: freakmania86 (big blind) folded before Flop
Seat 4: WangHaoWei folded before Flop (didn't bet)
Seat 5: CaH4esskO folded before Flop (didn't bet)
Seat 6: HubertusB folded before Flop (didn't bet)



PokerStars Zoom Hand #178481262069:  Hold'em No Limit ($0.02/$0.05) - 2017/11/20 20:28:08 CCT [2017/11/20 7:28:08 ET]
Table 'Donati' 6-max Seat #1 is the button
Seat 1: behappy989 ($9.35 in chips) 
Seat 2: HubertusB ($4.88 in chips) 
Seat 3: AlStFish ($7.36 in chips) 
Seat 4: alexaalealex ($1.18 in chips) 
Seat 5: JCG22222 ($5.23 in chips) 
Seat 6: KKrtva ($5.86 in chips) 
HubertusB: posts small blind $0.02
AlStFish: posts big blind $0.05
*** HOLE CARDS ***
Dealt to HubertusB [Td As]
alexaalealex: folds 
JCG22222: folds 
KKrtva: folds 
behappy989: folds 
HubertusB: raises $0.05 to $0.10
AlStFish: folds 
Uncalled bet ($0.05) returned to HubertusB
HubertusB collected $0.10 from pot
HubertusB: doesn't show hand 
*** SUMMARY ***
Total pot $0.10 | Rake $0 
Seat 1: behappy989 (button) folded before Flop (didn't bet)
Seat 2: HubertusB (small blind) collected ($0.10)
Seat 3: AlStFish (big blind) folded before Flop
Seat 4: alexaalealex folded before Flop (didn't bet)
Seat 5: JCG22222 folded before Flop (didn't bet)
Seat 6: KKrtva folded before Flop (didn't bet)



PokerStars Zoom Hand #178481259529:  Hold'em No Limit ($0.02/$0.05) - 2017/11/20 20:28:02 CCT [2017/11/20 7:28:02 ET]
Table 'Donati' 6-max Seat #1 is the button
Seat 1: kkllaass ($5.09 in chips) 
Seat 2: 17edm ($5.80 in chips) 
Seat 3: igrokstar379 ($6.19 in chips) 
Seat 4: HubertusB ($4.88 in chips) 
Seat 5: PartyDolphin ($5.16 in chips) 
Seat 6: DiBully ($4.31 in chips) 
17edm: posts small blind $0.02
igrokstar379: posts big blind $0.05
*** HOLE CARDS ***
Dealt to HubertusB [6d Qc]
HubertusB: folds 
PartyDolphin: raises $0.10 to $0.15
DiBully: folds 
kkllaass: folds 
17edm: calls $0.13
igrokstar379: folds 
*** FLOP *** [7d 3c Kd]
17edm: checks 
PartyDolphin: bets $0.23
17edm: folds 
Uncalled bet ($0.23) returned to PartyDolphin
PartyDolphin collected $0.34 from pot
PartyDolphin: doesn't show hand 
*** SUMMARY ***
Total pot $0.35 | Rake $0.01 
Board [7d 3c Kd]
Seat 1: kkllaass (button) folded before Flop (didn't bet)
Seat 2: 17edm (small blind) folded on the Flop
Seat 3: igrokstar379 (big blind) folded before Flop
Seat 4: HubertusB folded before Flop (didn't bet)
Seat 5: PartyDolphin collected ($0.34)
Seat 6: DiBully folded before Flop (didn't bet)



PokerStars Zoom Hand #178481245790:  Hold'em No Limit ($0.02/$0.05) - 2017/11/20 20:27:30 CCT [2017/11/20 7:27:30 ET]
Table 'Donati' 6-max Seat #1 is the button
Seat 1: HubertusB ($4.93 in chips) 
Seat 2: Marka555 ($6.59 in chips) 
Seat 3: Bommel885 ($3.86 in chips) 
Seat 4: stason777 ($6.17 in chips) 
Seat 5: ostrim ($5.49 in chips) 
Seat 6: WahaBeat ($2.76 in chips) 
Marka555: posts small blind $0.02
Bommel885: posts big blind $0.05
*** HOLE CARDS ***
Dealt to HubertusB [3d Th]
stason777: folds 
ostrim: raises $0.05 to $0.10
WahaBeat: calls $0.10
HubertusB: folds 
Marka555: folds 
Bommel885 has timed out
Bommel885: folds 
*** FLOP *** [Ts Jh 5h]
ostrim: bets $0.10
WahaBeat: calls $0.10
*** TURN *** [Ts Jh 5h] [8d]
ostrim: bets $0.15
WahaBeat: calls $0.15
*** RIVER *** [Ts Jh 5h 8d] [Ks]
ostrim: checks 
WahaBeat: bets $0.44
ostrim: folds 
Uncalled bet ($0.44) returned to WahaBeat
WahaBeat collected $0.74 from pot
WahaBeat: doesn't show hand 
*** SUMMARY ***
Total pot $0.77 | Rake $0.03 
Board [Ts Jh 5h 8d Ks]
Seat 1: HubertusB (button) folded before Flop (didn't bet)
Seat 2: Marka555 (small blind) folded before Flop
Seat 3: Bommel885 (big blind) folded before Flop
Seat 4: stason777 folded before Flop (didn't bet)
Seat 5: ostrim folded on the River
Seat 6: WahaBeat collected ($0.74)



PokerStars Zoom Hand #178481267940:  Hold'em No Limit ($0.02/$0.05) - 2017/11/20 20:28:22 CCT [2017/11/20 7:28:22 ET]
Table 'Donati' 6-max Seat #1 is the button
Seat 1: HubertusB ($4.93 in chips) 
Seat 2: Quorthon_Zei ($8.34 in chips) 
Seat 3: ProTeamjan ($1.57 in chips) 
Seat 4: coolgrays ($5.29 in chips) 
Seat 5: bassxsp ($5.28 in chips) 
Seat 6: BCE bUDET ($18.23 in chips) 
Quorthon_Zei: posts small blind $0.02
ProTeamjan: posts big blind $0.05
*** HOLE CARDS ***
Dealt to HubertusB [Kd 9h]
coolgrays: folds 
bassxsp: folds 
BCE bUDET: folds 
HubertusB: raises $0.05 to $0.10
Quorthon_Zei: folds 
ProTeamjan: calls $0.05
*** FLOP *** [Js 4d Qd]
ProTeamjan: bets $0.05
HubertusB: calls $0.05
*** TURN *** [Js 4d Qd] [2h]
ProTeamjan: bets $0.05
HubertusB: calls $0.05
*** RIVER *** [Js 4d Qd 2h] [Ad]
ProTeamjan: checks 
HubertusB: checks 
*** SHOW DOWN ***
ProTeamjan: shows [Jc 9c] (a pair of Jacks)
HubertusB: mucks hand 
ProTeamjan collected $0.40 from pot
*** SUMMARY ***
Total pot $0.42 | Rake $0.02 
Board [Js 4d Qd 2h Ad]
Seat 1: HubertusB (button) mucked [Kd 9h]
Seat 2: Quorthon_Zei (small blind) folded before Flop
Seat 3: ProTeamjan (big blind) showed [Jc 9c] and won ($0.40) with a pair of Jacks
Seat 4: coolgrays folded before Flop (didn't bet)
Seat 5: bassxsp folded before Flop (didn't bet)
Seat 6: BCE bUDET folded before Flop (didn't bet)



PokerStars Zoom Hand #178481278748:  Hold'em No Limit ($0.02/$0.05) - 2017/11/20 20:28:47 CCT [2017/11/20 7:28:47 ET]
Table 'Donati' 6-max Seat #1 is the button
Seat 1: skychevsky ($5 in chips) 
Seat 2: tis ikke123 ($5.14 in chips) 
Seat 3: KKrtva ($7.25 in chips) 
Seat 4: dogijs89 ($5.96 in chips) 
Seat 5: t1mka09367 ($9.06 in chips) 
Seat 6: HubertusB ($4.73 in chips) 
tis ikke123: posts small blind $0.02
KKrtva: posts big blind $0.05
*** HOLE CARDS ***
Dealt to HubertusB [Jc 4s]
dogijs89: folds 
t1mka09367: folds 
HubertusB: folds 
skychevsky: folds 
tis ikke123: folds 
Uncalled bet ($0.03) returned to KKrtva
KKrtva collected $0.04 from pot
KKrtva: doesn't show hand 
*** SUMMARY ***
Total pot $0.04 | Rake $0 
Seat 1: skychevsky (button) folded before Flop (didn't bet)
Seat 2: tis ikke123 (small blind) folded before Flop
Seat 3: KKrtva (big blind) collected ($0.04)
Seat 4: dogijs89 folded before Flop (didn't bet)
Seat 5: t1mka09367 folded before Flop (didn't bet)
Seat 6: HubertusB folded before Flop (didn't bet)



PokerStars Zoom Hand #178481280866:  Hold'em No Limit ($0.02/$0.05) - 2017/11/20 20:28:52 CCT [2017/11/20 7:28:52 ET]
Table 'Donati' 6-max Seat #1 is the button
Seat 1: djronalein ($5.91 in chips) 
Seat 2: Kluch2017 ($8.62 in chips) 
Seat 3: WahaBeat ($3.15 in chips) 
Seat 4: HubertusB ($4.73 in chips) 
Seat 5: wilzkye ($7.87 in chips) 
Seat 6: WangHaoWei ($8.10 in chips) 
Kluch2017: posts small blind $0.02
WahaBeat: posts big blind $0.05
*** HOLE CARDS ***
Dealt to HubertusB [6s Ad]
HubertusB: folds 
wilzkye: folds 
WangHaoWei: folds 
djronalein: folds 
Kluch2017: folds 
Uncalled bet ($0.03) returned to WahaBeat
WahaBeat collected $0.04 from pot
WahaBeat: doesn't show hand 
*** SUMMARY ***
Total pot $0.04 | Rake $0 
Seat 1: djronalein (button) folded before Flop (didn't bet)
Seat 2: Kluch2017 (small blind) folded before Flop
Seat 3: WahaBeat (big blind) collected ($0.04)
Seat 4: HubertusB folded before Flop (didn't bet)
Seat 5: wilzkye folded before Flop (didn't bet)
Seat 6: WangHaoWei folded before Flop (didn't bet)



PokerStars Zoom Hand #178481283440:  Hold'em No Limit ($0.02/$0.05) - 2017/11/20 20:28:58 CCT [2017/11/20 7:28:58 ET]
Table 'Donati' 6-max Seat #1 is the button
Seat 1: thomas112017 ($2.29 in chips) 
Seat 2: BCE bUDET ($18.18 in chips) 
Seat 3: HubertusB ($4.73 in chips) 
Seat 4: sshotokann ($5.55 in chips) 
Seat 5: chester8676 ($6.92 in chips) 
Seat 6: freakmania86 ($5.65 in chips) 
BCE bUDET: posts small blind $0.02
HubertusB: posts big blind $0.05
*** HOLE CARDS ***
Dealt to HubertusB [5c 4d]
sshotokann: folds 
chester8676: folds 
freakmania86: raises $0.10 to $0.15
thomas112017: calls $0.15
BCE bUDET: folds 
HubertusB: folds 
*** FLOP *** [Ts Ac 2h]
freakmania86: checks 
thomas112017: checks 
*** TURN *** [Ts Ac 2h] [2c]
freakmania86: bets $0.25
thomas112017: folds 
Uncalled bet ($0.25) returned to freakmania86
freakmania86 collected $0.35 from pot
freakmania86: doesn't show hand 
*** SUMMARY ***
Total pot $0.37 | Rake $0.02 
Board [Ts Ac 2h 2c]
Seat 1: thomas112017 (button) folded on the Turn
Seat 2: BCE bUDET (small blind) folded before Flop
Seat 3: HubertusB (big blind) folded before Flop
Seat 4: sshotokann folded before Flop (didn't bet)
Seat 5: chester8676 folded before Flop (didn't bet)
Seat 6: freakmania86 collected ($0.35)



PokerStars Zoom Hand #178481287285:  Hold'em No Limit ($0.02/$0.05) - 2017/11/20 20:29:07 CCT [2017/11/20 7:29:07 ET]
Table 'Donati' 6-max Seat #1 is the button
Seat 1: HubertusB ($4.68 in chips) 
Seat 2: Marka555 ($5.02 in chips) 
Seat 3: Mr. Roquim ($5.01 in chips) 
Seat 4: K.Kusto ($5.41 in chips) 
Seat 5: coolgrays ($8.17 in chips) 
Seat 6: McLaude669 ($3.36 in chips) 
Marka555: posts small blind $0.02
Mr. Roquim: posts big blind $0.05
*** HOLE CARDS ***
Dealt to HubertusB [4h 9s]
K.Kusto: folds 
coolgrays: raises $0.10 to $0.15
McLaude669: folds 
HubertusB: folds 
Marka555: folds 
Mr. Roquim: folds 
Uncalled bet ($0.10) returned to coolgrays
coolgrays collected $0.12 from pot
coolgrays: doesn't show hand 
*** SUMMARY ***
Total pot $0.12 | Rake $0 
Seat 1: HubertusB (button) folded before Flop (didn't bet)
Seat 2: Marka555 (small blind) folded before Flop
Seat 3: Mr. Roquim (big blind) folded before Flop
Seat 4: K.Kusto folded before Flop (didn't bet)
Seat 5: coolgrays collected ($0.12)
Seat 6: McLaude669 folded before Flop (didn't bet)



PokerStars Zoom Hand #178481289800:  Hold'em No Limit ($0.02/$0.05) - 2017/11/20 20:29:13 CCT [2017/11/20 7:29:13 ET]
Table 'Donati' 6-max Seat #1 is the button
Seat 1: TitanX1 ($1.11 in chips) 
Seat 2: Akutagawa ($5.55 in chips) 
Seat 3: Tautietis852 ($7.35 in chips) 
Seat 4: sshotokann ($7.60 in chips) 
Seat 5: HubertusB ($4.68 in chips) 
Seat 6: K.Tyrrell ($5.09 in chips) 
Akutagawa: posts small blind $0.02
Tautietis852: posts big blind $0.05
*** HOLE CARDS ***
Dealt to HubertusB [5c 8s]
sshotokann: folds 
HubertusB: folds 
K.Tyrrell: folds 
TitanX1: calls $0.05
Akutagawa: folds 
Tautietis852: checks 
*** FLOP *** [4d 2d Ks]
Tautietis852: checks 
TitanX1: bets $0.06
Tautietis852: raises $0.14 to $0.20
TitanX1: folds 
Uncalled bet ($0.14) returned to Tautietis852
Tautietis852 collected $0.23 from pot
Tautietis852: doesn't show hand 
*** SUMMARY ***
Total pot $0.24 | Rake $0.01 
Board [4d 2d Ks]
Seat 1: TitanX1 (button) folded on the Flop
Seat 2: Akutagawa (small blind) folded before Flop
Seat 3: Tautietis852 (big blind) collected ($0.23)
Seat 4: sshotokann folded before Flop (didn't bet)
Seat 5: HubertusB folded before Flop (didn't bet)
Seat 6: K.Tyrrell folded before Flop (didn't bet)



PokerStars Zoom Hand #178481291976:  Hold'em No Limit ($0.02/$0.05) - 2017/11/20 20:29:18 CCT [2017/11/20 7:29:18 ET]
Table 'Donati' 6-max Seat #1 is the button
Seat 1: Bumbarak83 ($5.32 in chips) 
Seat 2: HubertusB ($4.68 in chips) 
Seat 3: Fi$hAndChipz ($11.57 in chips) 
Seat 4: Roockie4Life ($6.06 in chips) 
Seat 5: zouzounos86 ($3.24 in chips) 
Seat 6: Egor2331 ($2.97 in chips) 
HubertusB: posts small blind $0.02
Fi$hAndChipz: posts big blind $0.05
*** HOLE CARDS ***
Dealt to HubertusB [4c Ts]
Roockie4Life: folds 
zouzounos86: folds 
Egor2331: calls $0.05
Bumbarak83: raises $0.15 to $0.20
HubertusB: folds 
Fi$hAndChipz: folds 
Egor2331: calls $0.15
*** FLOP *** [Ac 7h 6h]
Egor2331: bets $0.05
Bumbarak83: calls $0.05
*** TURN *** [Ac 7h 6h] [Td]
Egor2331: bets $0.05
Bumbarak83: calls $0.05
*** RIVER *** [Ac 7h 6h Td] [9h]
Egor2331: checks 
Bumbarak83: bets $1
Egor2331: folds 
Uncalled bet ($1) returned to Bumbarak83
Bumbarak83 collected $0.64 from pot
Bumbarak83: doesn't show hand 
*** SUMMARY ***
Total pot $0.67 | Rake $0.03 
Board [Ac 7h 6h Td 9h]
Seat 1: Bumbarak83 (button) collected ($0.64)
Seat 2: HubertusB (small blind) folded before Flop
Seat 3: Fi$hAndChipz (big blind) folded before Flop
Seat 4: Roockie4Life folded before Flop (didn't bet)
Seat 5: zouzounos86 folded before Flop (didn't bet)
Seat 6: Egor2331 folded on the River



PokerStars Zoom Hand #178481297611:  Hold'em No Limit ($0.02/$0.05) - 2017/11/20 20:29:31 CCT [2017/11/20 7:29:31 ET]
Table 'Donati' 6-max Seat #1 is the button
Seat 1: Al3Goulart ($12.82 in chips) 
Seat 2: leo08238118 ($6.04 in chips) 
Seat 3: FloFla777 ($5.98 in chips) 
Seat 4: HenoBarista ($6.01 in chips) 
Seat 5: lexus00174 ($4.56 in chips) 
Seat 6: HubertusB ($4.66 in chips) 
leo08238118: posts small blind $0.02
FloFla777: posts big blind $0.05
*** HOLE CARDS ***
Dealt to HubertusB [Jc 9s]
HenoBarista: calls $0.05
lexus00174: folds 
HubertusB: raises $0.15 to $0.20
Al3Goulart: folds 
leo08238118: raises $0.50 to $0.70
FloFla777: calls $0.65
HenoBarista: folds 
HubertusB: folds 
*** FLOP *** [2c Tc 8c]
leo08238118: bets $0.79
FloFla777: calls $0.79
*** TURN *** [2c Tc 8c] [3s]
leo08238118: checks 
FloFla777: bets $1.55
leo08238118: folds 
Uncalled bet ($1.55) returned to FloFla777
FloFla777 collected $3.10 from pot
FloFla777: doesn't show hand 
*** SUMMARY ***
Total pot $3.23 | Rake $0.13 
Board [2c Tc 8c 3s]
Seat 1: Al3Goulart (button) folded before Flop (didn't bet)
Seat 2: leo08238118 (small blind) folded on the Turn
Seat 3: FloFla777 (big blind) collected ($3.10)
Seat 4: HenoBarista folded before Flop
Seat 5: lexus00174 folded before Flop (didn't bet)
Seat 6: HubertusB folded before Flop



PokerStars Zoom Hand #178481317324:  Hold'em No Limit ($0.02/$0.05) - 2017/11/20 20:30:16 CCT [2017/11/20 7:30:16 ET]
Table 'Donati' 6-max Seat #1 is the button
Seat 1: nervss ($5 in chips) 
Seat 2: coolgrays ($5.02 in chips) 
Seat 3: PartyDolphin ($14.74 in chips) 
Seat 4: HubertusB ($4.46 in chips) 
Seat 5: dogijs89 ($6.34 in chips) 
Seat 6: ananoliiy ($9.05 in chips) 
coolgrays: posts small blind $0.02
PartyDolphin: posts big blind $0.05
*** HOLE CARDS ***
Dealt to HubertusB [8d 6h]
HubertusB: folds 
dogijs89: folds 
ananoliiy: raises $0.12 to $0.17
nervss: folds 
coolgrays: folds 
PartyDolphin: folds 
Uncalled bet ($0.12) returned to ananoliiy
ananoliiy collected $0.12 from pot
ananoliiy: doesn't show hand 
*** SUMMARY ***
Total pot $0.12 | Rake $0 
Seat 1: nervss (button) folded before Flop (didn't bet)
Seat 2: coolgrays (small blind) folded before Flop
Seat 3: PartyDolphin (big blind) folded before Flop
Seat 4: HubertusB folded before Flop (didn't bet)
Seat 5: dogijs89 folded before Flop (didn't bet)
Seat 6: ananoliiy collected ($0.12)



PokerStars Zoom Hand #178481323696:  Hold'em No Limit ($0.02/$0.05) - 2017/11/20 20:30:31 CCT [2017/11/20 7:30:31 ET]
Table 'Donati' 6-max Seat #1 is the button
Seat 1: wilbert1961 ($5.78 in chips) 
Seat 2: WangHaoWei ($12.90 in chips) 
Seat 3: plusnov99 ($5.07 in chips) 
Seat 4: chester8676 ($7.15 in chips) 
Seat 5: sashver ($9.97 in chips) 
Seat 6: HubertusB ($4.41 in chips) 
WangHaoWei: posts small blind $0.02
plusnov99: posts big blind $0.05
*** HOLE CARDS ***
Dealt to HubertusB [7h 5c]
chester8676: folds 
sashver: folds 
HubertusB: folds 
wilbert1961: folds 
WangHaoWei: folds 
Uncalled bet ($0.03) returned to plusnov99
plusnov99 collected $0.04 from pot
plusnov99: doesn't show hand 
*** SUMMARY ***
Total pot $0.04 | Rake $0 
Seat 1: wilbert1961 (button) folded before Flop (didn't bet)
Seat 2: WangHaoWei (small blind) folded before Flop
Seat 3: plusnov99 (big blind) collected ($0.04)
Seat 4: chester8676 folded before Flop (didn't bet)
Seat 5: sashver folded before Flop (didn't bet)
Seat 6: HubertusB folded before Flop (didn't bet)



PokerStars Zoom Hand #178481319381:  Hold'em No Limit ($0.02/$0.05) - 2017/11/20 20:30:21 CCT [2017/11/20 7:30:21 ET]
Table 'Donati' 6-max Seat #1 is the button
Seat 1: ALazarev157 ($5.58 in chips) 
Seat 2: Santorino ($5.82 in chips) 
Seat 3: HubertusB ($4.46 in chips) 
Seat 4: PartyDolphin ($5.48 in chips) 
Seat 5: xThePhil ($6.65 in chips) 
Seat 6: Polypops ($9.11 in chips) 
Santorino: posts small blind $0.02
HubertusB: posts big blind $0.05
*** HOLE CARDS ***
Dealt to HubertusB [4c Qc]
PartyDolphin: folds 
xThePhil: folds 
Polypops: raises $0.07 to $0.12
ALazarev157: calls $0.12
Santorino: raises $0.41 to $0.53
HubertusB: folds 
Polypops: calls $0.41
ALazarev157: folds 
*** FLOP *** [2d 9h Kc]
Santorino: bets $0.94
Polypops: calls $0.94
*** TURN *** [2d 9h Kc] [3s]
Santorino: bets $2.09
Polypops: folds 
Uncalled bet ($2.09) returned to Santorino
Santorino collected $2.98 from pot
Santorino: doesn't show hand 
*** SUMMARY ***
Total pot $3.11 | Rake $0.13 
Board [2d 9h Kc 3s]
Seat 1: ALazarev157 (button) folded before Flop
Seat 2: Santorino (small blind) collected ($2.98)
Seat 3: HubertusB (big blind) folded before Flop
Seat 4: PartyDolphin folded before Flop (didn't bet)
Seat 5: xThePhil folded before Flop (didn't bet)
Seat 6: Polypops folded on the Turn



PokerStars Zoom Hand #178481326234:  Hold'em No Limit ($0.02/$0.05) - 2017/11/20 20:30:37 CCT [2017/11/20 7:30:37 ET]
Table 'Donati' 6-max Seat #1 is the button
Seat 1: CaH4esskO ($5.45 in chips) 
Seat 2: RenningStone ($14.29 in chips) 
Seat 3: Akutagawa ($5.58 in chips) 
Seat 4: Valerij V.S. ($6.29 in chips) 
Seat 5: HubertusB ($4.41 in chips) 
Seat 6: IanMalique9 ($16.78 in chips) 
RenningStone: posts small blind $0.02
Akutagawa: posts big blind $0.05
*** HOLE CARDS ***
Dealt to HubertusB [8h 3d]
Valerij V.S.: folds 
HubertusB: folds 
IanMalique9: folds 
CaH4esskO: raises $0.10 to $0.15
RenningStone: folds 
Akutagawa: calls $0.10
*** FLOP *** [Th 4h Ts]
Akutagawa: checks 
CaH4esskO: checks 
*** TURN *** [Th 4h Ts] [9h]
Akutagawa: checks 
CaH4esskO: bets $0.16
Akutagawa: calls $0.16
*** RIVER *** [Th 4h Ts 9h] [6d]
Akutagawa: checks 
CaH4esskO: bets $0.31
Akutagawa: folds 
Uncalled bet ($0.31) returned to CaH4esskO
CaH4esskO collected $0.61 from pot
CaH4esskO: doesn't show hand 
*** SUMMARY ***
Total pot $0.64 | Rake $0.03 
Board [Th 4h Ts 9h 6d]
Seat 1: CaH4esskO (button) collected ($0.61)
Seat 2: RenningStone (small blind) folded before Flop
Seat 3: Akutagawa (big blind) folded on the River
Seat 4: Valerij V.S. folded before Flop (didn't bet)
Seat 5: HubertusB folded before Flop (didn't bet)
Seat 6: IanMalique9 folded before Flop (didn't bet)



PokerStars Zoom Hand #178481328830:  Hold'em No Limit ($0.02/$0.05) - 2017/11/20 20:30:43 CCT [2017/11/20 7:30:43 ET]
Table 'Donati' 6-max Seat #1 is the button
Seat 1: sinyong0709 ($5.01 in chips) 
Seat 2: HubertusB ($4.41 in chips) 
Seat 3: pipi.ufa ($3.53 in chips) 
Seat 4: simple s0o ($11.92 in chips) 
Seat 5: GeorgeyBoy19 ($4.94 in chips) 
Seat 6: lususfortuna ($6.05 in chips) 
HubertusB: posts small blind $0.02
pipi.ufa: posts big blind $0.05
*** HOLE CARDS ***
Dealt to HubertusB [Qh Ad]
simple s0o: folds 
GeorgeyBoy19: calls $0.05
lususfortuna: raises $0.20 to $0.25
sinyong0709: folds 
HubertusB: calls $0.23
pipi.ufa: folds 
GeorgeyBoy19: calls $0.20
*** FLOP *** [7s 8d Tc]
HubertusB: checks 
GeorgeyBoy19: checks 
lususfortuna: bets $0.54
HubertusB: folds 
GeorgeyBoy19: calls $0.54
*** TURN *** [7s 8d Tc] [Js]
GeorgeyBoy19: checks 
lususfortuna: checks 
*** RIVER *** [7s 8d Tc Js] [2d]
GeorgeyBoy19: bets $1
lususfortuna: calls $1
*** SHOW DOWN ***
GeorgeyBoy19: shows [Kd Jh] (a pair of Jacks)
lususfortuna: shows [Qc Qd] (a pair of Queens)
lususfortuna collected $3.72 from pot
*** SUMMARY ***
Total pot $3.88 | Rake $0.16 
Board [7s 8d Tc Js 2d]
Seat 1: sinyong0709 (button) folded before Flop (didn't bet)
Seat 2: HubertusB (small blind) folded on the Flop
Seat 3: pipi.ufa (big blind) folded before Flop
Seat 4: simple s0o folded before Flop (didn't bet)
Seat 5: GeorgeyBoy19 showed [Kd Jh] and lost with a pair of Jacks
Seat 6: lususfortuna showed [Qc Qd] and won ($3.72) with a pair of Queens



PokerStars Zoom Hand #178481350625:  Hold'em No Limit ($0.02/$0.05) - 2017/11/20 20:31:33 CCT [2017/11/20 7:31:33 ET]
Table 'Donati' 6-max Seat #1 is the button
Seat 1: HubertusB ($4.16 in chips) 
Seat 2: hancockkas ($5.55 in chips) 
Seat 3: dogijs89 ($6.28 in chips) 
Seat 4: KKrtva ($5 in chips) 
Seat 5: hobbididence ($5.71 in chips) 
Seat 6: dark h0r$e ($5 in chips) 
hancockkas: posts small blind $0.02
dogijs89: posts big blind $0.05
*** HOLE CARDS ***
Dealt to HubertusB [6s Kd]
KKrtva: folds 
hobbididence: folds 
dark h0r$e: folds 
HubertusB: raises $0.05 to $0.10
hancockkas: folds 
dogijs89: calls $0.05
*** FLOP *** [7c Ac 3h]
dogijs89: checks 
HubertusB: bets $0.09
dogijs89: folds 
Uncalled bet ($0.09) returned to HubertusB
HubertusB collected $0.21 from pot
HubertusB: doesn't show hand 
*** SUMMARY ***
Total pot $0.22 | Rake $0.01 
Board [7c Ac 3h]
Seat 1: HubertusB (button) collected ($0.21)
Seat 2: hancockkas (small blind) folded before Flop
Seat 3: dogijs89 (big blind) folded on the Flop
Seat 4: KKrtva folded before Flop (didn't bet)
Seat 5: hobbididence folded before Flop (didn't bet)
Seat 6: dark h0r$e folded before Flop (didn't bet)



PokerStars Zoom Hand #178481357684:  Hold'em No Limit ($0.02/$0.05) - 2017/11/20 20:31:49 CCT [2017/11/20 7:31:49 ET]
Table 'Donati' 6-max Seat #1 is the button
Seat 1: DiBully ($4.69 in chips) 
Seat 2: X.MatuS ($5 in chips) 
Seat 3: HubertusB ($4.27 in chips) 
Seat 4: kylebic ($5.26 in chips) 
Seat 5: wilzkye ($7.93 in chips) 
Seat 6: D.Korz ($3.62 in chips) 
X.MatuS: posts small blind $0.02
HubertusB: posts big blind $0.05
*** HOLE CARDS ***
Dealt to HubertusB [2s 3c]
kylebic: folds 
wilzkye: raises $0.07 to $0.12
D.Korz: folds 
DiBully: folds 
X.MatuS: folds 
HubertusB: folds 
Uncalled bet ($0.07) returned to wilzkye
wilzkye collected $0.12 from pot
wilzkye: doesn't show hand 
*** SUMMARY ***
Total pot $0.12 | Rake $0 
Seat 1: DiBully (button) folded before Flop (didn't bet)
Seat 2: X.MatuS (small blind) folded before Flop
Seat 3: HubertusB (big blind) folded before Flop
Seat 4: kylebic folded before Flop (didn't bet)
Seat 5: wilzkye collected ($0.12)
Seat 6: D.Korz folded before Flop (didn't bet)



PokerStars Zoom Hand #178481360690:  Hold'em No Limit ($0.02/$0.05) - 2017/11/20 20:31:56 CCT [2017/11/20 7:31:56 ET]
Table 'Donati' 6-max Seat #1 is the button
Seat 1: lexus00174 ($6.52 in chips) 
Seat 2: HubertusB ($4.22 in chips) 
Seat 3: CaH4esskO ($5.13 in chips) 
Seat 4: ciucanu666 ($4.11 in chips) 
Seat 5: RenningStone ($13.98 in chips) 
Seat 6: kirtsy244 ($4.87 in chips) 
HubertusB: posts small blind $0.02
CaH4esskO: posts big blind $0.05
*** HOLE CARDS ***
Dealt to HubertusB [Qh 7c]
ciucanu666: folds 
RenningStone: folds 
kirtsy244: folds 
lexus00174: raises $0.05 to $0.10
HubertusB: folds 
CaH4esskO: folds 
Uncalled bet ($0.05) returned to lexus00174
lexus00174 collected $0.12 from pot
lexus00174: doesn't show hand 
*** SUMMARY ***
Total pot $0.12 | Rake $0 
Seat 1: lexus00174 (button) collected ($0.12)
Seat 2: HubertusB (small blind) folded before Flop
Seat 3: CaH4esskO (big blind) folded before Flop
Seat 4: ciucanu666 folded before Flop (didn't bet)
Seat 5: RenningStone folded before Flop (didn't bet)
Seat 6: kirtsy244 folded before Flop (didn't bet)



PokerStars Zoom Hand #178481365521:  Hold'em No Limit ($0.02/$0.05) - 2017/11/20 20:32:07 CCT [2017/11/20 7:32:07 ET]
Table 'Donati' 6-max Seat #1 is the button
Seat 1: HubertusB ($4.20 in chips) 
Seat 2: Edyard182 ($2.52 in chips) 
Seat 3: yumi2003 ($4.02 in chips) 
Seat 4: Kutis33 ($9.01 in chips) 
Seat 5: marcioadrs ($5.62 in chips) 
Seat 6: Blankota ($5.84 in chips) 
Edyard182: posts small blind $0.02
yumi2003: posts big blind $0.05
*** HOLE CARDS ***
Dealt to HubertusB [Qc 4s]
Kutis33: folds 
marcioadrs: raises $0.10 to $0.15
Blankota: raises $0.37 to $0.52
HubertusB: folds 
Edyard182: folds 
yumi2003: folds 
marcioadrs: folds 
Uncalled bet ($0.37) returned to Blankota
Blankota collected $0.37 from pot
Blankota: doesn't show hand 
*** SUMMARY ***
Total pot $0.37 | Rake $0 
Seat 1: HubertusB (button) folded before Flop (didn't bet)
Seat 2: Edyard182 (small blind) folded before Flop
Seat 3: yumi2003 (big blind) folded before Flop
Seat 4: Kutis33 folded before Flop (didn't bet)
Seat 5: marcioadrs folded before Flop
Seat 6: Blankota collected ($0.37)



PokerStars Zoom Hand #178481362874:  Hold'em No Limit ($0.02/$0.05) - 2017/11/20 20:32:01 CCT [2017/11/20 7:32:01 ET]
Table 'Donati' 6-max Seat #1 is the button
Seat 1: plusnov99 ($6.97 in chips) 
Seat 2: Marka555 ($5 in chips) 
Seat 3: alodor ($5.13 in chips) 
Seat 4: Santorino ($5.38 in chips) 
Seat 5: HubertusB ($4.20 in chips) 
Seat 6: Fousty-Pish ($0.29 in chips) 
Marka555: posts small blind $0.02
alodor: posts big blind $0.05
*** HOLE CARDS ***
Dealt to HubertusB [3h 5s]
Santorino: raises $0.10 to $0.15
HubertusB: folds 
Fousty-Pish: folds 
plusnov99: raises $0.37 to $0.52
Marka555: folds 
alodor: folds 
Santorino: folds 
Uncalled bet ($0.37) returned to plusnov99
plusnov99 collected $0.37 from pot
plusnov99: doesn't show hand 
*** SUMMARY ***
Total pot $0.37 | Rake $0 
Seat 1: plusnov99 (button) collected ($0.37)
Seat 2: Marka555 (small blind) folded before Flop
Seat 3: alodor (big blind) folded before Flop
Seat 4: Santorino folded before Flop
Seat 5: HubertusB folded before Flop (didn't bet)
Seat 6: Fousty-Pish folded before Flop (didn't bet)



PokerStars Zoom Hand #178481368635:  Hold'em No Limit ($0.02/$0.05) - 2017/11/20 20:32:14 CCT [2017/11/20 7:32:14 ET]
Table 'Donati' 6-max Seat #1 is the button
Seat 1: sinyong0709 ($5.51 in chips) 
Seat 2: Acedan1369 ($9.50 in chips) 
Seat 3: guerilla2004 ($0.92 in chips) 
Seat 4: HubertusB ($4.20 in chips) 
Seat 5: vanek-95all@ ($6.48 in chips) 
Seat 6: sonya222620 ($2.12 in chips) 
Acedan1369: posts small blind $0.02
guerilla2004: posts big blind $0.05
*** HOLE CARDS ***
Dealt to HubertusB [Qh 2d]
HubertusB: folds 
vanek-95all@: folds 
sonya222620: folds 
sinyong0709: folds 
Acedan1369: folds 
Uncalled bet ($0.03) returned to guerilla2004
guerilla2004 collected $0.04 from pot
guerilla2004: doesn't show hand 
*** SUMMARY ***
Total pot $0.04 | Rake $0 
Seat 1: sinyong0709 (button) folded before Flop (didn't bet)
Seat 2: Acedan1369 (small blind) folded before Flop
Seat 3: guerilla2004 (big blind) collected ($0.04)
Seat 4: HubertusB folded before Flop (didn't bet)
Seat 5: vanek-95all@ folded before Flop (didn't bet)
Seat 6: sonya222620 folded before Flop (didn't bet)



PokerStars Zoom Hand #178481370819:  Hold'em No Limit ($0.02/$0.05) - 2017/11/20 20:32:19 CCT [2017/11/20 7:32:19 ET]
Table 'Donati' 6-max Seat #1 is the button
Seat 1: "diogogoal" ($9.29 in chips) 
Seat 2: plusnov99 ($5 in chips) 
Seat 3: vintik.by ($10.46 in chips) 
Seat 4: Na43 ($2.88 in chips) 
Seat 5: dimkor69 ($5.11 in chips) 
Seat 6: HubertusB ($4.20 in chips) 
plusnov99: posts small blind $0.02
vintik.by: posts big blind $0.05
*** HOLE CARDS ***
Dealt to HubertusB [Qd 9c]
Na43: folds 
dimkor69: folds 
HubertusB: raises $0.05 to $0.10
"diogogoal": raises $0.10 to $0.20
plusnov99: folds 
vintik.by: folds 
HubertusB: calls $0.10
*** FLOP *** [4h 4c 9s]
HubertusB: checks 
"diogogoal": bets $0.35
HubertusB: calls $0.35
*** TURN *** [4h 4c 9s] [3s]
HubertusB: checks 
"diogogoal": bets $0.60
HubertusB: calls $0.60
*** RIVER *** [4h 4c 9s 3s] [4s]
HubertusB: checks 
"diogogoal": bets $1.80
HubertusB: calls $1.80
*** SHOW DOWN ***
"diogogoal": shows [8s 9d] (a full house, Fours full of Nines)
HubertusB: shows [Qd 9c] (a full house, Fours full of Nines)
HubertusB collected $2.86 from pot
"diogogoal" collected $2.86 from pot
*** SUMMARY ***
Total pot $5.97 | Rake $0.25 
Board [4h 4c 9s 3s 4s]
Seat 1: "diogogoal" (button) showed [8s 9d] and won ($2.86) with a full house, Fours full of Nines
Seat 2: plusnov99 (small blind) folded before Flop
Seat 3: vintik.by (big blind) folded before Flop
Seat 4: Na43 folded before Flop (didn't bet)
Seat 5: dimkor69 folded before Flop (didn't bet)
Seat 6: HubertusB showed [Qd 9c] and won ($2.86) with a full house, Fours full of Nines



PokerStars Zoom Hand #178481410418:  Hold'em No Limit ($0.02/$0.05) - 2017/11/20 20:33:49 CCT [2017/11/20 7:33:49 ET]
Table 'Donati' 6-max Seat #1 is the button
Seat 1: C0!3r@ ($9.62 in chips) 
Seat 2: VIT789 ($6.32 in chips) 
Seat 3: Ale M 84 ($3.52 in chips) 
Seat 4: HubertusB ($4.11 in chips) 
Seat 5: guerilla2004 ($1.38 in chips) 
Seat 6: Dasperin ($7.13 in chips) 
VIT789: posts small blind $0.02
Ale M 84: posts big blind $0.05
*** HOLE CARDS ***
Dealt to HubertusB [7c Ac]
HubertusB: raises $0.05 to $0.10
guerilla2004: folds 
Dasperin: folds 
C0!3r@: folds 
VIT789: folds 
Ale M 84: calls $0.05
*** FLOP *** [6c Jh 5d]
Ale M 84: checks 
HubertusB: checks 
*** TURN *** [6c Jh 5d] [2d]
Ale M 84: checks 
HubertusB: checks 
*** RIVER *** [6c Jh 5d 2d] [2s]
Ale M 84: checks 
HubertusB: checks 
*** SHOW DOWN ***
Ale M 84: shows [Qc Kc] (a pair of Deuces)
HubertusB: shows [7c Ac] (a pair of Deuces - Ace kicker)
HubertusB collected $0.21 from pot
*** SUMMARY ***
Total pot $0.22 | Rake $0.01 
Board [6c Jh 5d 2d 2s]
Seat 1: C0!3r@ (button) folded before Flop (didn't bet)
Seat 2: VIT789 (small blind) folded before Flop
Seat 3: Ale M 84 (big blind) showed [Qc Kc] and lost with a pair of Deuces
Seat 4: HubertusB showed [7c Ac] and won ($0.21) with a pair of Deuces
Seat 5: guerilla2004 folded before Flop (didn't bet)
Seat 6: Dasperin folded before Flop (didn't bet)



PokerStars Zoom Hand #178481434923:  Hold'em No Limit ($0.02/$0.05) - 2017/11/20 20:34:45 CCT [2017/11/20 7:34:45 ET]
Table 'Donati' 6-max Seat #1 is the button
Seat 1: wongkosolsuk ($4.46 in chips) 
Seat 2: kylebic ($5.27 in chips) 
Seat 3: HubertusB ($4.22 in chips) 
Seat 4: Blankota ($5.45 in chips) 
Seat 5: YourTiltRush ($5.55 in chips) 
Seat 6: artem3660 ($5 in chips) 
kylebic: posts small blind $0.02
HubertusB: posts big blind $0.05
*** HOLE CARDS ***
Dealt to HubertusB [Ks 9s]
Blankota: folds 
YourTiltRush: raises $0.10 to $0.15
artem3660: folds 
wongkosolsuk: folds 
kylebic: folds 
HubertusB: folds 
Uncalled bet ($0.10) returned to YourTiltRush
YourTiltRush collected $0.12 from pot
YourTiltRush: doesn't show hand 
*** SUMMARY ***
Total pot $0.12 | Rake $0 
Seat 1: wongkosolsuk (button) folded before Flop (didn't bet)
Seat 2: kylebic (small blind) folded before Flop
Seat 3: HubertusB (big blind) folded before Flop
Seat 4: Blankota folded before Flop (didn't bet)
Seat 5: YourTiltRush collected ($0.12)
Seat 6: artem3660 folded before Flop (didn't bet)



PokerStars Zoom Hand #178481438861:  Hold'em No Limit ($0.02/$0.05) - 2017/11/20 20:34:54 CCT [2017/11/20 7:34:54 ET]
Table 'Donati' 6-max Seat #1 is the button
Seat 1: Dt_Hyde ($5.39 in chips) 
Seat 2: HubertusB ($4.17 in chips) 
Seat 3: ayhshhh ($5.50 in chips) 
Seat 4: Dasperin ($6.42 in chips) 
Seat 5: WahaBeat ($6.49 in chips) 
Seat 6: KindandBad77 ($5.11 in chips) 
HubertusB: posts small blind $0.02
ayhshhh: posts big blind $0.05
*** HOLE CARDS ***
Dealt to HubertusB [7d Td]
Dasperin: folds 
WahaBeat: folds 
KindandBad77: raises $0.07 to $0.12
Dt_Hyde: folds 
HubertusB: folds 
ayhshhh: folds 
Uncalled bet ($0.07) returned to KindandBad77
KindandBad77 collected $0.12 from pot
KindandBad77: doesn't show hand 
*** SUMMARY ***
Total pot $0.12 | Rake $0 
Seat 1: Dt_Hyde (button) folded before Flop (didn't bet)
Seat 2: HubertusB (small blind) folded before Flop
Seat 3: ayhshhh (big blind) folded before Flop
Seat 4: Dasperin folded before Flop (didn't bet)
Seat 5: WahaBeat folded before Flop (didn't bet)
Seat 6: KindandBad77 collected ($0.12)



PokerStars Zoom Hand #178481445804:  Hold'em No Limit ($0.02/$0.05) - 2017/11/20 20:35:10 CCT [2017/11/20 7:35:10 ET]
Table 'Donati' 6-max Seat #1 is the button
Seat 1: HubertusB ($4.15 in chips) 
Seat 2: Blankota ($5.73 in chips) 
Seat 3: mel1in ($5 in chips) 
Seat 4: Fi$hAndChipz ($10.82 in chips) 
Seat 5: KindandBad77 ($7.37 in chips) 
Seat 6: iskander575 ($3.24 in chips) 
Blankota: posts small blind $0.02
mel1in: posts big blind $0.05
*** HOLE CARDS ***
Dealt to HubertusB [Td 8d]
Fi$hAndChipz: raises $0.10 to $0.15
KindandBad77: folds 
iskander575: folds 
HubertusB: folds 
Blankota: folds 
mel1in: folds 
Uncalled bet ($0.10) returned to Fi$hAndChipz
Fi$hAndChipz collected $0.12 from pot
Fi$hAndChipz: doesn't show hand 
*** SUMMARY ***
Total pot $0.12 | Rake $0 
Seat 1: HubertusB (button) folded before Flop (didn't bet)
Seat 2: Blankota (small blind) folded before Flop
Seat 3: mel1in (big blind) folded before Flop
Seat 4: Fi$hAndChipz collected ($0.12)
Seat 5: KindandBad77 folded before Flop (didn't bet)
Seat 6: iskander575 folded before Flop (didn't bet)



PokerStars Zoom Hand #178481448802:  Hold'em No Limit ($0.02/$0.05) - 2017/11/20 20:35:17 CCT [2017/11/20 7:35:17 ET]
Table 'Donati' 6-max Seat #1 is the button
Seat 1: PartyDolphin ($6.82 in chips) 
Seat 2: jext ($5 in chips) 
Seat 3: Nicosan.ru ($6.20 in chips) 
Seat 4: JCG22222 ($9.91 in chips) 
Seat 5: sshotokann ($6.90 in chips) 
Seat 6: HubertusB ($4.15 in chips) 
jext: posts small blind $0.02
Nicosan.ru: posts big blind $0.05
*** HOLE CARDS ***
Dealt to HubertusB [Jd 5h]
JCG22222: folds 
sshotokann: folds 
HubertusB: raises $0.05 to $0.10
PartyDolphin: raises $0.27 to $0.37
jext: folds 
Nicosan.ru: folds 
HubertusB: folds 
Uncalled bet ($0.27) returned to PartyDolphin
PartyDolphin collected $0.27 from pot
PartyDolphin: doesn't show hand 
*** SUMMARY ***
Total pot $0.27 | Rake $0 
Seat 1: PartyDolphin (button) collected ($0.27)
Seat 2: jext (small blind) folded before Flop
Seat 3: Nicosan.ru (big blind) folded before Flop
Seat 4: JCG22222 folded before Flop (didn't bet)
Seat 5: sshotokann folded before Flop (didn't bet)
Seat 6: HubertusB folded before Flop



PokerStars Zoom Hand #178481454080:  Hold'em No Limit ($0.02/$0.05) - 2017/11/20 20:35:29 CCT [2017/11/20 7:35:29 ET]
Table 'Donati' 6-max Seat #1 is the button
Seat 1: WangHaoWei ($12.84 in chips) 
Seat 2: kaesspo ($10.96 in chips) 
Seat 3: Energetix12. ($5.05 in chips) 
Seat 4: Norik009 ($4.34 in chips) 
Seat 5: HubertusB ($4.05 in chips) 
Seat 6: With_no_Pain ($5.78 in chips) 
kaesspo: posts small blind $0.02
Energetix12.: posts big blind $0.05
*** HOLE CARDS ***
Dealt to HubertusB [Ad Ts]
Norik009: folds 
HubertusB: raises $0.05 to $0.10
With_no_Pain: folds 
WangHaoWei: folds 
kaesspo: calls $0.08
Energetix12.: calls $0.05
*** FLOP *** [Qc 5s Tc]
kaesspo: checks 
Energetix12.: checks 
HubertusB: bets $0.25
kaesspo: folds 
Energetix12.: folds 
Uncalled bet ($0.25) returned to HubertusB
HubertusB collected $0.29 from pot
HubertusB: doesn't show hand 
*** SUMMARY ***
Total pot $0.30 | Rake $0.01 
Board [Qc 5s Tc]
Seat 1: WangHaoWei (button) folded before Flop (didn't bet)
Seat 2: kaesspo (small blind) folded on the Flop
Seat 3: Energetix12. (big blind) folded on the Flop
Seat 4: Norik009 folded before Flop (didn't bet)
Seat 5: HubertusB collected ($0.29)
Seat 6: With_no_Pain folded before Flop (didn't bet)



PokerStars Zoom Hand #178481467991:  Hold'em No Limit ($0.02/$0.05) - 2017/11/20 20:36:01 CCT [2017/11/20 7:36:01 ET]
Table 'Donati' 6-max Seat #1 is the button
Seat 1: simple s0o ($17.98 in chips) 
Seat 2: stason777 ($5.68 in chips) 
Seat 3: HubertusB ($4.24 in chips) 
Seat 4: stray cat84 ($5.13 in chips) 
Seat 5: Marka555 ($5.30 in chips) 
Seat 6: ddp1985 ($5.07 in chips) 
stason777: posts small blind $0.02
HubertusB: posts big blind $0.05
*** HOLE CARDS ***
Dealt to HubertusB [9c 3d]
stray cat84: folds 
Marka555: folds 
ddp1985: folds 
simple s0o: raises $0.07 to $0.12
stason777: folds 
HubertusB: folds 
Uncalled bet ($0.07) returned to simple s0o
simple s0o collected $0.12 from pot
simple s0o: doesn't show hand 
*** SUMMARY ***
Total pot $0.12 | Rake $0 
Seat 1: simple s0o (button) collected ($0.12)
Seat 2: stason777 (small blind) folded before Flop
Seat 3: HubertusB (big blind) folded before Flop
Seat 4: stray cat84 folded before Flop (didn't bet)
Seat 5: Marka555 folded before Flop (didn't bet)
Seat 6: ddp1985 folded before Flop (didn't bet)



PokerStars Zoom Hand #178481465358:  Hold'em No Limit ($0.02/$0.05) - 2017/11/20 20:35:55 CCT [2017/11/20 7:35:55 ET]
Table 'Donati' 6-max Seat #1 is the button
Seat 1: Tautietis852 ($5.07 in chips) 
Seat 2: AbraRoy ($5.65 in chips) 
Seat 3: telmanov ($3.67 in chips) 
Seat 4: HubertusB ($4.24 in chips) 
Seat 5: ALazarev157 ($6.12 in chips) 
Seat 6: plusnov99 ($7.76 in chips) 
AbraRoy: posts small blind $0.02
telmanov: posts big blind $0.05
*** HOLE CARDS ***
Dealt to HubertusB [Qs 9h]
HubertusB: folds 
ALazarev157: folds 
plusnov99: folds 
Tautietis852: folds 
AbraRoy: raises $0.10 to $0.15
telmanov: folds 
Uncalled bet ($0.10) returned to AbraRoy
AbraRoy collected $0.10 from pot
AbraRoy: doesn't show hand 
*** SUMMARY ***
Total pot $0.10 | Rake $0 
Seat 1: Tautietis852 (button) folded before Flop (didn't bet)
Seat 2: AbraRoy (small blind) collected ($0.10)
Seat 3: telmanov (big blind) folded before Flop
Seat 4: HubertusB folded before Flop (didn't bet)
Seat 5: ALazarev157 folded before Flop (didn't bet)
Seat 6: plusnov99 folded before Flop (didn't bet)



PokerStars Zoom Hand #178481472320:  Hold'em No Limit ($0.02/$0.05) - 2017/11/20 20:36:11 CCT [2017/11/20 7:36:11 ET]
Table 'Donati' 6-max Seat #1 is the button
Seat 1: Energetix12. ($4.93 in chips) 
Seat 2: HubertusB ($4.19 in chips) 
Seat 3: WangHaoWei ($4.62 in chips) 
Seat 4: EBPEÜ ($8.35 in chips) 
Seat 5: sixxxpac ($6.13 in chips) 
Seat 6: jext ($5.09 in chips) 
HubertusB: posts small blind $0.02
WangHaoWei: posts big blind $0.05
*** HOLE CARDS ***
Dealt to HubertusB [Kc Qc]
EBPEÜ: folds 
sixxxpac: folds 
jext: folds 
Energetix12.: folds 
HubertusB: raises $0.05 to $0.10
WangHaoWei: folds 
Uncalled bet ($0.05) returned to HubertusB
HubertusB collected $0.10 from pot
HubertusB: doesn't show hand 
*** SUMMARY ***
Total pot $0.10 | Rake $0 
Seat 1: Energetix12. (button) folded before Flop (didn't bet)
Seat 2: HubertusB (small blind) collected ($0.10)
Seat 3: WangHaoWei (big blind) folded before Flop
Seat 4: EBPEÜ folded before Flop (didn't bet)
Seat 5: sixxxpac folded before Flop (didn't bet)
Seat 6: jext folded before Flop (didn't bet)



PokerStars Zoom Hand #178481478081:  Hold'em No Limit ($0.02/$0.05) - 2017/11/20 20:36:24 CCT [2017/11/20 7:36:24 ET]
Table 'Donati' 6-max Seat #1 is the button
Seat 1: HubertusB ($4.24 in chips) 
Seat 2: dubbbbme ($4.56 in chips) 
Seat 3: Akutagawa ($5 in chips) 
Seat 4: dogijs89 ($6.25 in chips) 
Seat 5: IanMalique9 ($15 in chips) 
Seat 6: freakmania86 ($5 in chips) 
dubbbbme: posts small blind $0.02
Akutagawa: posts big blind $0.05
*** HOLE CARDS ***
Dealt to HubertusB [8d Js]
dogijs89: folds 
IanMalique9: folds 
freakmania86: folds 
HubertusB: raises $0.05 to $0.10
dubbbbme: raises $0.25 to $0.35
Akutagawa: folds 
HubertusB: folds 
Uncalled bet ($0.25) returned to dubbbbme
dubbbbme collected $0.25 from pot
dubbbbme: doesn't show hand 
*** SUMMARY ***
Total pot $0.25 | Rake $0 
Seat 1: HubertusB (button) folded before Flop
Seat 2: dubbbbme (small blind) collected ($0.25)
Seat 3: Akutagawa (big blind) folded before Flop
Seat 4: dogijs89 folded before Flop (didn't bet)
Seat 5: IanMalique9 folded before Flop (didn't bet)
Seat 6: freakmania86 folded before Flop (didn't bet)



PokerStars Zoom Hand #178481491391:  Hold'em No Limit ($0.02/$0.05) - 2017/11/20 20:36:55 CCT [2017/11/20 7:36:55 ET]
Table 'Donati' 6-max Seat #1 is the button
Seat 1: gama159 ($3.16 in chips) 
Seat 2: kelevra__375 ($5 in chips) 
Seat 3: WangHaoWei ($4.55 in chips) 
Seat 4: kirtsy244 ($5.72 in chips) 
Seat 5: HubertusB ($4.14 in chips) 
Seat 6: MAAXIIMUSS ($4.93 in chips) 
kelevra__375: posts small blind $0.02
WangHaoWei: posts big blind $0.05
*** HOLE CARDS ***
Dealt to HubertusB [Kd 2d]
kirtsy244: folds 
HubertusB: raises $0.05 to $0.10
MAAXIIMUSS: calls $0.10
gama159: folds 
kelevra__375: folds 
WangHaoWei: folds 
*** FLOP *** [Kc Tc 5d]
HubertusB: checks 
MAAXIIMUSS: checks 
*** TURN *** [Kc Tc 5d] [4c]
HubertusB: bets $0.15
MAAXIIMUSS: folds 
Uncalled bet ($0.15) returned to HubertusB
HubertusB collected $0.26 from pot
HubertusB: doesn't show hand 
*** SUMMARY ***
Total pot $0.27 | Rake $0.01 
Board [Kc Tc 5d 4c]
Seat 1: gama159 (button) folded before Flop (didn't bet)
Seat 2: kelevra__375 (small blind) folded before Flop
Seat 3: WangHaoWei (big blind) folded before Flop
Seat 4: kirtsy244 folded before Flop (didn't bet)
Seat 5: HubertusB collected ($0.26)
Seat 6: MAAXIIMUSS folded on the Turn



PokerStars Zoom Hand #178481503182:  Hold'em No Limit ($0.02/$0.05) - 2017/11/20 20:37:22 CCT [2017/11/20 7:37:22 ET]
Table 'Donati' 6-max Seat #1 is the button
Seat 1: D.Korz ($4.07 in chips) 
Seat 2: Dasperin ($5.53 in chips) 
Seat 3: HubertusB ($4.30 in chips) 
Seat 4: LetsGrindIt ($6.46 in chips) 
Seat 5: Amigo113 ($5.47 in chips) 
Seat 6: popey1977 ($4.31 in chips) 
Dasperin: posts small blind $0.02
HubertusB: posts big blind $0.05
*** HOLE CARDS ***
Dealt to HubertusB [2s Kd]
LetsGrindIt: folds 
Amigo113: folds 
popey1977: folds 
D.Korz: raises $0.05 to $0.10
Dasperin: folds 
HubertusB: folds 
Uncalled bet ($0.05) returned to D.Korz
D.Korz collected $0.12 from pot
D.Korz: doesn't show hand 
*** SUMMARY ***
Total pot $0.12 | Rake $0 
Seat 1: D.Korz (button) collected ($0.12)
Seat 2: Dasperin (small blind) folded before Flop
Seat 3: HubertusB (big blind) folded before Flop
Seat 4: LetsGrindIt folded before Flop (didn't bet)
Seat 5: Amigo113 folded before Flop (didn't bet)
Seat 6: popey1977 folded before Flop (didn't bet)



PokerStars Zoom Hand #178481487545:  Hold'em No Limit ($0.02/$0.05) - 2017/11/20 20:36:46 CCT [2017/11/20 7:36:46 ET]
Table 'Donati' 6-max Seat #1 is the button
Seat 1: Marka555 ($5.32 in chips) 
Seat 2: behappy989 ($13.97 in chips) 
Seat 3: dimkor69 ($5 in chips) 
Seat 4: edcrfvrtgb ($8.13 in chips) 
Seat 5: Bossnia007 ($5.37 in chips) 
Seat 6: HubertusB ($4.14 in chips) 
behappy989: posts small blind $0.02
dimkor69: posts big blind $0.05
*** HOLE CARDS ***
Dealt to HubertusB [3d Ac]
edcrfvrtgb: raises $0.15 to $0.20
Bossnia007: folds 
HubertusB: folds 
Marka555: folds 
behappy989: folds 
dimkor69: calls $0.15
*** FLOP *** [5d 6c 9d]
dimkor69: checks 
edcrfvrtgb: bets $0.10
dimkor69: calls $0.10
*** TURN *** [5d 6c 9d] [3c]
dimkor69: checks 
edcrfvrtgb: bets $0.05
dimkor69: raises $0.69 to $0.74
edcrfvrtgb: calls $0.69
*** RIVER *** [5d 6c 9d 3c] [Qh]
dimkor69: checks 
edcrfvrtgb: bets $0.20
dimkor69: calls $0.20
*** SHOW DOWN ***
edcrfvrtgb: shows [7d 6d] (a pair of Sixes)
dimkor69: shows [Tc Ts] (a pair of Tens)
dimkor69 collected $2.40 from pot
*** SUMMARY ***
Total pot $2.50 | Rake $0.10 
Board [5d 6c 9d 3c Qh]
Seat 1: Marka555 (button) folded before Flop (didn't bet)
Seat 2: behappy989 (small blind) folded before Flop
Seat 3: dimkor69 (big blind) showed [Tc Ts] and won ($2.40) with a pair of Tens
Seat 4: edcrfvrtgb showed [7d 6d] and lost with a pair of Sixes
Seat 5: Bossnia007 folded before Flop (didn't bet)
Seat 6: HubertusB folded before Flop (didn't bet)



PokerStars Zoom Hand #178481506158:  Hold'em No Limit ($0.02/$0.05) - 2017/11/20 20:37:29 CCT [2017/11/20 7:37:29 ET]
Table 'Donati' 6-max Seat #1 is the button
Seat 1: $Denisson71$ ($2.72 in chips) 
Seat 2: popey1977 ($6.66 in chips) 
Seat 3: nvutincho ($2.53 in chips) 
Seat 4: Nicosan.ru ($5.02 in chips) 
Seat 5: HubertusB ($4.25 in chips) 
Seat 6: meyong2012 ($3.71 in chips) 
popey1977: posts small blind $0.02
nvutincho: posts big blind $0.05
*** HOLE CARDS ***
Dealt to HubertusB [Ad Ac]
Nicosan.ru: folds 
HubertusB: raises $0.10 to $0.15
meyong2012: calls $0.15
$Denisson71$: folds 
popey1977: folds 
nvutincho: folds 
*** FLOP *** [2d Jd Qc]
HubertusB: bets $0.25
meyong2012: folds 
Uncalled bet ($0.25) returned to HubertusB
HubertusB collected $0.35 from pot
HubertusB: doesn't show hand 
*** SUMMARY ***
Total pot $0.37 | Rake $0.02 
Board [2d Jd Qc]
Seat 1: $Denisson71$ (button) folded before Flop (didn't bet)
Seat 2: popey1977 (small blind) folded before Flop
Seat 3: nvutincho (big blind) folded before Flop
Seat 4: Nicosan.ru folded before Flop (didn't bet)
Seat 5: HubertusB collected ($0.35)
Seat 6: meyong2012 folded on the Flop



PokerStars Zoom Hand #178481518439:  Hold'em No Limit ($0.02/$0.05) - 2017/11/20 20:37:57 CCT [2017/11/20 7:37:57 ET]
Table 'Donati' 6-max Seat #1 is the button
Seat 1: flapwill ($5.95 in chips) 
Seat 2: lususfortuna ($4.25 in chips) 
Seat 3: VIT789 ($6.02 in chips) 
Seat 4: HubertusB ($4.45 in chips) 
Seat 5: ananoliiy ($5 in chips) 
Seat 6: wilbert1961 ($6.29 in chips) 
lususfortuna: posts small blind $0.02
VIT789: posts big blind $0.05
*** HOLE CARDS ***
Dealt to HubertusB [2d 2c]
HubertusB: raises $0.05 to $0.10
ananoliiy: raises $0.27 to $0.37
wilbert1961: folds 
flapwill: folds 
lususfortuna: folds 
VIT789: folds 
HubertusB: calls $0.27
*** FLOP *** [6s 9d Qh]
HubertusB: checks 
ananoliiy: bets $0.55
HubertusB: folds 
Uncalled bet ($0.55) returned to ananoliiy
ananoliiy collected $0.78 from pot
ananoliiy: doesn't show hand 
*** SUMMARY ***
Total pot $0.81 | Rake $0.03 
Board [6s 9d Qh]
Seat 1: flapwill (button) folded before Flop (didn't bet)
Seat 2: lususfortuna (small blind) folded before Flop
Seat 3: VIT789 (big blind) folded before Flop
Seat 4: HubertusB folded on the Flop
Seat 5: ananoliiy collected ($0.78)
Seat 6: wilbert1961 folded before Flop (didn't bet)



PokerStars Zoom Hand #178481536269:  Hold'em No Limit ($0.02/$0.05) - 2017/11/20 20:38:38 CCT [2017/11/20 7:38:38 ET]
Table 'Donati' 6-max Seat #1 is the button
Seat 1: viktor_KK ($5.33 in chips) 
Seat 2: simple s0o ($5.22 in chips) 
Seat 3: TitanX1 ($1.75 in chips) 
Seat 4: CaH4esskO ($5.90 in chips) 
Seat 5: bassxsp ($7.21 in chips) 
Seat 6: HubertusB ($4.06 in chips) 
simple s0o: posts small blind $0.02
TitanX1: posts big blind $0.05
*** HOLE CARDS ***
Dealt to HubertusB [Qd 8s]
CaH4esskO: raises $0.10 to $0.15
bassxsp: folds 
HubertusB: folds 
viktor_KK: folds 
simple s0o: folds 
TitanX1: folds 
Uncalled bet ($0.10) returned to CaH4esskO
CaH4esskO collected $0.12 from pot
CaH4esskO: doesn't show hand 
*** SUMMARY ***
Total pot $0.12 | Rake $0 
Seat 1: viktor_KK (button) folded before Flop (didn't bet)
Seat 2: simple s0o (small blind) folded before Flop
Seat 3: TitanX1 (big blind) folded before Flop
Seat 4: CaH4esskO collected ($0.12)
Seat 5: bassxsp folded before Flop (didn't bet)
Seat 6: HubertusB folded before Flop (didn't bet)



PokerStars Zoom Hand #178481538400:  Hold'em No Limit ($0.02/$0.05) - 2017/11/20 20:38:43 CCT [2017/11/20 7:38:43 ET]
Table 'Donati' 6-max Seat #1 is the button
Seat 1: Na43 ($4.52 in chips) 
Seat 2: Thedams04 ($6.34 in chips) 
Seat 3: mentorius1 ($15.29 in chips) 
Seat 4: LetsGrindIt ($6.56 in chips) 
Seat 5: HubertusB ($4.06 in chips) 
Seat 6: KKrtva ($5.22 in chips) 
Thedams04: posts small blind $0.02
mentorius1: posts big blind $0.05
*** HOLE CARDS ***
Dealt to HubertusB [8s 2h]
LetsGrindIt: folds 
HubertusB: folds 
KKrtva: folds 
Na43: folds 
Thedams04: folds 
Uncalled bet ($0.03) returned to mentorius1
mentorius1 collected $0.04 from pot
mentorius1: doesn't show hand 
*** SUMMARY ***
Total pot $0.04 | Rake $0 
Seat 1: Na43 (button) folded before Flop (didn't bet)
Seat 2: Thedams04 (small blind) folded before Flop
Seat 3: mentorius1 (big blind) collected ($0.04)
Seat 4: LetsGrindIt folded before Flop (didn't bet)
Seat 5: HubertusB folded before Flop (didn't bet)
Seat 6: KKrtva folded before Flop (didn't bet)



PokerStars Zoom Hand #178481531487:  Hold'em No Limit ($0.02/$0.05) - 2017/11/20 20:38:27 CCT [2017/11/20 7:38:27 ET]
Table 'Donati' 6-max Seat #1 is the button
Seat 1: HubertusB ($4.08 in chips) 
Seat 2: Polypops ($5 in chips) 
Seat 3: Agull1109 ($10.90 in chips) 
Seat 4: sarychevss ($2.57 in chips) 
Seat 5: CaH4esskO ($5.92 in chips) 
Seat 6: VIT789 ($5.95 in chips) 
Polypops: posts small blind $0.02
Agull1109: posts big blind $0.05
*** HOLE CARDS ***
Dealt to HubertusB [9h 4c]
sarychevss: calls $0.05
CaH4esskO: folds 
VIT789: folds 
HubertusB: folds 
Polypops: folds 
Agull1109: raises $0.10 to $0.15
sarychevss: calls $0.10
*** FLOP *** [Ah 4s 3c]
Agull1109: bets $0.20
sarychevss: calls $0.20
*** TURN *** [Ah 4s 3c] [Qs]
Agull1109: checks 
sarychevss: bets $0.35
Agull1109: folds 
Uncalled bet ($0.35) returned to sarychevss
sarychevss collected $0.69 from pot
sarychevss: doesn't show hand 
*** SUMMARY ***
Total pot $0.72 | Rake $0.03 
Board [Ah 4s 3c Qs]
Seat 1: HubertusB (button) folded before Flop (didn't bet)
Seat 2: Polypops (small blind) folded before Flop
Seat 3: Agull1109 (big blind) folded on the Turn
Seat 4: sarychevss collected ($0.69)
Seat 5: CaH4esskO folded before Flop (didn't bet)
Seat 6: VIT789 folded before Flop (didn't bet)



PokerStars Zoom Hand #178481540976:  Hold'em No Limit ($0.02/$0.05) - 2017/11/20 20:38:49 CCT [2017/11/20 7:38:49 ET]
Table 'Donati' 6-max Seat #1 is the button
Seat 1: nagjo ($1.97 in chips) 
Seat 2: viggli ($6.35 in chips) 
Seat 3: Edyard182 ($3.88 in chips) 
Seat 4: HubertusB ($4.06 in chips) 
Seat 5: WangHaoWei ($4.52 in chips) 
Seat 6: RiSk.Fortune ($5 in chips) 
viggli: posts small blind $0.02
Edyard182: posts big blind $0.05
*** HOLE CARDS ***
Dealt to HubertusB [3c 4d]
HubertusB: folds 
WangHaoWei: folds 
RiSk.Fortune: folds 
nagjo: folds 
viggli: folds 
Uncalled bet ($0.03) returned to Edyard182
Edyard182 collected $0.04 from pot
Edyard182: doesn't show hand 
*** SUMMARY ***
Total pot $0.04 | Rake $0 
Seat 1: nagjo (button) folded before Flop (didn't bet)
Seat 2: viggli (small blind) folded before Flop
Seat 3: Edyard182 (big blind) collected ($0.04)
Seat 4: HubertusB folded before Flop (didn't bet)
Seat 5: WangHaoWei folded before Flop (didn't bet)
Seat 6: RiSk.Fortune folded before Flop (didn't bet)



PokerStars Zoom Hand #178481543114:  Hold'em No Limit ($0.02/$0.05) - 2017/11/20 20:38:54 CCT [2017/11/20 7:38:54 ET]
Table 'Donati' 6-max Seat #1 is the button
Seat 1: keenakeena73 ($4.29 in chips) 
Seat 2: vanek-95all@ ($7.07 in chips) 
Seat 3: HubertusB ($4.06 in chips) 
Seat 4: Bahom ($9.82 in chips) 
Seat 5: ev[gen1y]b ($5 in chips) 
Seat 6: Romuks33 ($6.72 in chips) 
vanek-95all@: posts small blind $0.02
HubertusB: posts big blind $0.05
*** HOLE CARDS ***
Dealt to HubertusB [Qc Js]
Bahom: folds 
ev[gen1y]b: folds 
Romuks33: folds 
keenakeena73: folds 
vanek-95all@: folds 
Uncalled bet ($0.03) returned to HubertusB
HubertusB collected $0.04 from pot
HubertusB: doesn't show hand 
*** SUMMARY ***
Total pot $0.04 | Rake $0 
Seat 1: keenakeena73 (button) folded before Flop (didn't bet)
Seat 2: vanek-95all@ (small blind) folded before Flop
Seat 3: HubertusB (big blind) collected ($0.04)
Seat 4: Bahom folded before Flop (didn't bet)
Seat 5: ev[gen1y]b folded before Flop (didn't bet)
Seat 6: Romuks33 folded before Flop (didn't bet)



PokerStars Zoom Hand #178481534070:  Hold'em No Limit ($0.02/$0.05) - 2017/11/20 20:38:33 CCT [2017/11/20 7:38:33 ET]
Table 'Donati' 6-max Seat #1 is the button
Seat 1: kostet100 ($5.47 in chips) 
Seat 2: HubertusB ($4.08 in chips) 
Seat 3: FriskyBear ($5.90 in chips) 
Seat 4: Na43 ($4.57 in chips) 
Seat 5: TitanX1 ($1.75 in chips) 
Seat 6: pakintooo ($6.26 in chips) 
HubertusB: posts small blind $0.02
FriskyBear: posts big blind $0.05
*** HOLE CARDS ***
Dealt to HubertusB [9c Kh]
Na43: folds 
TitanX1: folds 
pakintooo: folds 
kostet100: raises $0.10 to $0.15
HubertusB: folds 
FriskyBear: calls $0.10
*** FLOP *** [7c 3s Ad]
FriskyBear: checks 
kostet100: checks 
*** TURN *** [7c 3s Ad] [3h]
FriskyBear: bets $0.18
kostet100: calls $0.18
*** RIVER *** [7c 3s Ad 3h] [Ks]
FriskyBear: bets $0.26
kostet100: raises $1.19 to $1.45
FriskyBear: folds 
Uncalled bet ($1.19) returned to kostet100
kostet100 collected $1.15 from pot
kostet100: doesn't show hand 
*** SUMMARY ***
Total pot $1.20 | Rake $0.05 
Board [7c 3s Ad 3h Ks]
Seat 1: kostet100 (button) collected ($1.15)
Seat 2: HubertusB (small blind) folded before Flop
Seat 3: FriskyBear (big blind) folded on the River
Seat 4: Na43 folded before Flop (didn't bet)
Seat 5: TitanX1 folded before Flop (didn't bet)
Seat 6: pakintooo folded before Flop (didn't bet)



PokerStars Zoom Hand #178481547966:  Hold'em No Limit ($0.02/$0.05) - 2017/11/20 20:39:05 CCT [2017/11/20 7:39:05 ET]
Table 'Donati' 6-max Seat #1 is the button
Seat 1: kirtsy244 ($6.62 in chips) 
Seat 2: HubertusB ($4.08 in chips) 
Seat 3: Fi$hAndChipz ($6.86 in chips) 
Seat 4: chilean777 ($8.57 in chips) 
Seat 5: flatbelieve ($5.42 in chips) 
Seat 6: Serhio119 ($4.90 in chips) 
HubertusB: posts small blind $0.02
Fi$hAndChipz: posts big blind $0.05
*** HOLE CARDS ***
Dealt to HubertusB [7h Jc]
chilean777: folds 
flatbelieve: folds 
Serhio119: folds 
kirtsy244: folds 
HubertusB: folds 
Uncalled bet ($0.03) returned to Fi$hAndChipz
Fi$hAndChipz collected $0.04 from pot
Fi$hAndChipz: doesn't show hand 
*** SUMMARY ***
Total pot $0.04 | Rake $0 
Seat 1: kirtsy244 (button) folded before Flop (didn't bet)
Seat 2: HubertusB (small blind) folded before Flop
Seat 3: Fi$hAndChipz (big blind) collected ($0.04)
Seat 4: chilean777 folded before Flop (didn't bet)
Seat 5: flatbelieve folded before Flop (didn't bet)
Seat 6: Serhio119 folded before Flop (didn't bet)



PokerStars Zoom Hand #178481552748:  Hold'em No Limit ($0.02/$0.05) - 2017/11/20 20:39:16 CCT [2017/11/20 7:39:16 ET]
Table 'Donati' 6-max Seat #1 is the button
Seat 1: tstf0705 ($4.58 in chips) 
Seat 2: SHUR43 ($5.05 in chips) 
Seat 3: sonya222620 ($2.64 in chips) 
Seat 4: sashver ($6.96 in chips) 
Seat 5: HubertusB ($4.06 in chips) 
Seat 6: LetsGrindIt ($5.27 in chips) 
SHUR43: posts small blind $0.02
sonya222620: posts big blind $0.05
*** HOLE CARDS ***
Dealt to HubertusB [Jd 9s]
sashver: folds 
HubertusB: folds 
LetsGrindIt: folds 
tstf0705: folds 
SHUR43: raises $0.07 to $0.12
sonya222620: folds 
Uncalled bet ($0.07) returned to SHUR43
SHUR43 collected $0.10 from pot
SHUR43: doesn't show hand 
*** SUMMARY ***
Total pot $0.10 | Rake $0 
Seat 1: tstf0705 (button) folded before Flop (didn't bet)
Seat 2: SHUR43 (small blind) collected ($0.10)
Seat 3: sonya222620 (big blind) folded before Flop
Seat 4: sashver folded before Flop (didn't bet)
Seat 5: HubertusB folded before Flop (didn't bet)
Seat 6: LetsGrindIt folded before Flop (didn't bet)



PokerStars Zoom Hand #178481555358:  Hold'em No Limit ($0.02/$0.05) - 2017/11/20 20:39:22 CCT [2017/11/20 7:39:22 ET]
Table 'Donati' 6-max Seat #1 is the button
Seat 1: Romuks33 ($6.65 in chips) 
Seat 2: djben2005 ($5.26 in chips) 
Seat 3: Vagabond000 ($5.72 in chips) 
Seat 4: igrokstar379 ($7.63 in chips) 
Seat 5: t1mka09367 ($20.15 in chips) 
Seat 6: HubertusB ($4.06 in chips) 
djben2005: posts small blind $0.02
Vagabond000: posts big blind $0.05
*** HOLE CARDS ***
Dealt to HubertusB [3h 7h]
igrokstar379: raises $0.09 to $0.14
t1mka09367: folds 
HubertusB: folds 
Romuks33: folds 
djben2005: folds 
Vagabond000: folds 
Uncalled bet ($0.09) returned to igrokstar379
igrokstar379 collected $0.12 from pot
igrokstar379: doesn't show hand 
*** SUMMARY ***
Total pot $0.12 | Rake $0 
Seat 1: Romuks33 (button) folded before Flop (didn't bet)
Seat 2: djben2005 (small blind) folded before Flop
Seat 3: Vagabond000 (big blind) folded before Flop
Seat 4: igrokstar379 collected ($0.12)
Seat 5: t1mka09367 folded before Flop (didn't bet)
Seat 6: HubertusB folded before Flop (didn't bet)



PokerStars Zoom Hand #178481558110:  Hold'em No Limit ($0.02/$0.05) - 2017/11/20 20:39:28 CCT [2017/11/20 7:39:28 ET]
Table 'Donati' 6-max Seat #1 is the button
Seat 1: Fi$hAndChipz ($17.24 in chips) 
Seat 2: yumi2003 ($5.04 in chips) 
Seat 3: HubertusB ($4.06 in chips) 
Seat 4: Dubok86 ($5 in chips) 
Seat 5: sshotokann ($8.61 in chips) 
Seat 6: Blankota ($5 in chips) 
yumi2003: posts small blind $0.02
HubertusB: posts big blind $0.05
*** HOLE CARDS ***
Dealt to HubertusB [Qh Jh]
Dubok86: folds 
sshotokann: folds 
Blankota: folds 
Fi$hAndChipz: folds 
yumi2003: folds 
Uncalled bet ($0.03) returned to HubertusB
HubertusB collected $0.04 from pot
HubertusB: doesn't show hand 
*** SUMMARY ***
Total pot $0.04 | Rake $0 
Seat 1: Fi$hAndChipz (button) folded before Flop (didn't bet)
Seat 2: yumi2003 (small blind) folded before Flop
Seat 3: HubertusB (big blind) collected ($0.04)
Seat 4: Dubok86 folded before Flop (didn't bet)
Seat 5: sshotokann folded before Flop (didn't bet)
Seat 6: Blankota folded before Flop (didn't bet)



PokerStars Zoom Hand #178481550604:  Hold'em No Limit ($0.02/$0.05) - 2017/11/20 20:39:11 CCT [2017/11/20 7:39:11 ET]
Table 'Donati' 6-max Seat #1 is the button
Seat 1: Mochiyuki ($6.10 in chips) 
Seat 2: Al3Goulart ($5 in chips) 
Seat 3: flatbelieve ($5.42 in chips) 
Seat 4: HubertusB ($4.06 in chips) 
Seat 5: adiaspora ($13.61 in chips) 
Seat 6: Bossnia007 ($5.09 in chips) 
Al3Goulart: posts small blind $0.02
flatbelieve: posts big blind $0.05
*** HOLE CARDS ***
Dealt to HubertusB [9d 2d]
HubertusB: folds 
adiaspora: raises $0.10 to $0.15
Bossnia007: calls $0.15
Mochiyuki: calls $0.15
Al3Goulart: folds 
flatbelieve: folds 
*** FLOP *** [3h 7d 8d]
adiaspora: bets $0.50
Bossnia007: folds 
Mochiyuki: folds 
Uncalled bet ($0.50) returned to adiaspora
adiaspora collected $0.50 from pot
adiaspora: doesn't show hand 
*** SUMMARY ***
Total pot $0.52 | Rake $0.02 
Board [3h 7d 8d]
Seat 1: Mochiyuki (button) folded on the Flop
Seat 2: Al3Goulart (small blind) folded before Flop
Seat 3: flatbelieve (big blind) folded before Flop
Seat 4: HubertusB folded before Flop (didn't bet)
Seat 5: adiaspora collected ($0.50)
Seat 6: Bossnia007 folded on the Flop



PokerStars Zoom Hand #178481564625:  Hold'em No Limit ($0.02/$0.05) - 2017/11/20 20:39:43 CCT [2017/11/20 7:39:43 ET]
Table 'Donati' 6-max Seat #1 is the button
Seat 1: Skreelb ($1.81 in chips) 
Seat 2: HubertusB ($4.08 in chips) 
Seat 3: Blankota ($5 in chips) 
Seat 4: hancockkas ($6.40 in chips) 
Seat 5: pakintooo ($6.25 in chips) 
Seat 6: labdacs7 ($3.11 in chips) 
HubertusB: posts small blind $0.02
Blankota: posts big blind $0.05
*** HOLE CARDS ***
Dealt to HubertusB [4c 6d]
hancockkas: folds 
pakintooo: folds 
labdacs7: folds 
Skreelb: folds 
HubertusB: folds 
Uncalled bet ($0.03) returned to Blankota
Blankota collected $0.04 from pot
Blankota: doesn't show hand 
*** SUMMARY ***
Total pot $0.04 | Rake $0 
Seat 1: Skreelb (button) folded before Flop (didn't bet)
Seat 2: HubertusB (small blind) folded before Flop
Seat 3: Blankota (big blind) collected ($0.04)
Seat 4: hancockkas folded before Flop (didn't bet)
Seat 5: pakintooo folded before Flop (didn't bet)
Seat 6: labdacs7 folded before Flop (didn't bet)



PokerStars Zoom Hand #178481573417:  Hold'em No Limit ($0.02/$0.05) - 2017/11/20 20:40:03 CCT [2017/11/20 7:40:03 ET]
Table 'Donati' 6-max Seat #1 is the button
Seat 1: mikk2468 ($5.42 in chips) 
Seat 2: Dubok86 ($5 in chips) 
Seat 3: chip-runn474 ($5.19 in chips) 
Seat 4: BCE bUDET ($18.63 in chips) 
Seat 5: crappyquads ($13.28 in chips) 
Seat 6: HubertusB ($4.06 in chips) 
Dubok86: posts small blind $0.02
chip-runn474: posts big blind $0.05
*** HOLE CARDS ***
Dealt to HubertusB [8s 7s]
BCE bUDET: folds 
crappyquads: folds 
HubertusB: raises $0.05 to $0.10
mikk2468: folds 
Dubok86: folds 
chip-runn474: folds 
Uncalled bet ($0.05) returned to HubertusB
HubertusB collected $0.12 from pot
HubertusB: doesn't show hand 
*** SUMMARY ***
Total pot $0.12 | Rake $0 
Seat 1: mikk2468 (button) folded before Flop (didn't bet)
Seat 2: Dubok86 (small blind) folded before Flop
Seat 3: chip-runn474 (big blind) folded before Flop
Seat 4: BCE bUDET folded before Flop (didn't bet)
Seat 5: crappyquads folded before Flop (didn't bet)
Seat 6: HubertusB collected ($0.12)



PokerStars Zoom Hand #178481570357:  Hold'em No Limit ($0.02/$0.05) - 2017/11/20 20:39:56 CCT [2017/11/20 7:39:56 ET]
Table 'Donati' 6-max Seat #1 is the button
Seat 1: HubertusB ($4.06 in chips) 
Seat 2: meyong2012 ($3.84 in chips) 
Seat 3: KindandBad77 ($8.74 in chips) 
Seat 4: shingo1203 ($5.44 in chips) 
Seat 5: AbraRoy ($5.59 in chips) 
Seat 6: FBI 2014 ($20.41 in chips) 
meyong2012: posts small blind $0.02
KindandBad77: posts big blind $0.05
*** HOLE CARDS ***
Dealt to HubertusB [5h 7s]
shingo1203: folds 
AbraRoy: raises $0.10 to $0.15
FBI 2014: folds 
HubertusB: folds 
meyong2012: folds 
KindandBad77: raises $0.35 to $0.50
AbraRoy: folds 
Uncalled bet ($0.35) returned to KindandBad77
KindandBad77 collected $0.32 from pot
KindandBad77: doesn't show hand 
*** SUMMARY ***
Total pot $0.32 | Rake $0 
Seat 1: HubertusB (button) folded before Flop (didn't bet)
Seat 2: meyong2012 (small blind) folded before Flop
Seat 3: KindandBad77 (big blind) collected ($0.32)
Seat 4: shingo1203 folded before Flop (didn't bet)
Seat 5: AbraRoy folded before Flop
Seat 6: FBI 2014 folded before Flop (didn't bet)



PokerStars Zoom Hand #178481578720:  Hold'em No Limit ($0.02/$0.05) - 2017/11/20 20:40:15 CCT [2017/11/20 7:40:15 ET]
Table 'Donati' 6-max Seat #1 is the button
Seat 1: LetsGrindIt ($5.42 in chips) 
Seat 2: HubertusB ($4.13 in chips) 
Seat 3: tigerrrrli ($5 in chips) 
Seat 4: Bahom ($9.87 in chips) 
Seat 5: djronalein ($13.98 in chips) 
Seat 6: FriskyBear ($5.49 in chips) 
HubertusB: posts small blind $0.02
tigerrrrli: posts big blind $0.05
*** HOLE CARDS ***
Dealt to HubertusB [8d 5h]
Bahom: folds 
djronalein: folds 
FriskyBear: folds 
LetsGrindIt: folds 
HubertusB: folds 
Uncalled bet ($0.03) returned to tigerrrrli
tigerrrrli collected $0.04 from pot
tigerrrrli: doesn't show hand 
*** SUMMARY ***
Total pot $0.04 | Rake $0 
Seat 1: LetsGrindIt (button) folded before Flop (didn't bet)
Seat 2: HubertusB (small blind) folded before Flop
Seat 3: tigerrrrli (big blind) collected ($0.04)
Seat 4: Bahom folded before Flop (didn't bet)
Seat 5: djronalein folded before Flop (didn't bet)
Seat 6: FriskyBear folded before Flop (didn't bet)



PokerStars Zoom Hand #178481581296:  Hold'em No Limit ($0.02/$0.05) - 2017/11/20 20:40:21 CCT [2017/11/20 7:40:21 ET]
Table 'Donati' 6-max Seat #1 is the button
Seat 1: Tautietis852 ($5.76 in chips) 
Seat 2: AAgenaWin ($1.90 in chips) 
Seat 3: zetlife ($5 in chips) 
Seat 4: HubertusB ($4.11 in chips) 
Seat 5: kylebic ($5.68 in chips) 
Seat 6: AbraRoy ($5.44 in chips) 
AAgenaWin: posts small blind $0.02
zetlife: posts big blind $0.05
*** HOLE CARDS ***
Dealt to HubertusB [4h 8c]
HubertusB: folds 
kylebic: folds 
AbraRoy: folds 
Tautietis852: folds 
AAgenaWin: folds 
Uncalled bet ($0.03) returned to zetlife
zetlife collected $0.04 from pot
zetlife: doesn't show hand 
*** SUMMARY ***
Total pot $0.04 | Rake $0 
Seat 1: Tautietis852 (button) folded before Flop (didn't bet)
Seat 2: AAgenaWin (small blind) folded before Flop
Seat 3: zetlife (big blind) collected ($0.04)
Seat 4: HubertusB folded before Flop (didn't bet)
Seat 5: kylebic folded before Flop (didn't bet)
Seat 6: AbraRoy folded before Flop (didn't bet)



PokerStars Zoom Hand #178481586690:  Hold'em No Limit ($0.02/$0.05) - 2017/11/20 20:40:33 CCT [2017/11/20 7:40:33 ET]
Table 'Donati' 6-max Seat #1 is the button
Seat 1: zyannsinn ($5.89 in chips) 
Seat 2: djben2005 ($5 in chips) 
Seat 3: Oliana88 ($5.94 in chips) 
Seat 4: ddp1985 ($9.50 in chips) 
Seat 5: HubertusB ($4.11 in chips) 
Seat 6: flatbelieve ($6.91 in chips) 
djben2005: posts small blind $0.02
Oliana88: posts big blind $0.05
*** HOLE CARDS ***
Dealt to HubertusB [Kd 9s]
ddp1985: folds 
HubertusB: folds 
flatbelieve: folds 
zyannsinn: folds 
djben2005: raises $0.10 to $0.15
Oliana88: folds 
Uncalled bet ($0.10) returned to djben2005
djben2005 collected $0.10 from pot
djben2005: doesn't show hand 
*** SUMMARY ***
Total pot $0.10 | Rake $0 
Seat 1: zyannsinn (button) folded before Flop (didn't bet)
Seat 2: djben2005 (small blind) collected ($0.10)
Seat 3: Oliana88 (big blind) folded before Flop
Seat 4: ddp1985 folded before Flop (didn't bet)
Seat 5: HubertusB folded before Flop (didn't bet)
Seat 6: flatbelieve folded before Flop (didn't bet)



PokerStars Zoom Hand #178481588872:  Hold'em No Limit ($0.02/$0.05) - 2017/11/20 20:40:38 CCT [2017/11/20 7:40:38 ET]
Table 'Donati' 6-max Seat #1 is the button
Seat 1: ayhshhh ($14.64 in chips) 
Seat 2: psychowallst ($5.21 in chips) 
Seat 3: HubertusB ($4.11 in chips) 
Seat 4: Lobos2102 ($5.10 in chips) 
Seat 5: Mikos108 ($5.27 in chips) 
Seat 6: sshotokann ($8.51 in chips) 
psychowallst: posts small blind $0.02
HubertusB: posts big blind $0.05
*** HOLE CARDS ***
Dealt to HubertusB [Kc 3h]
Lobos2102: folds 
Mikos108: raises $0.10 to $0.15
sshotokann: folds 
ayhshhh: folds 
psychowallst: folds 
HubertusB: folds 
Uncalled bet ($0.10) returned to Mikos108
Mikos108 collected $0.12 from pot
Mikos108: doesn't show hand 
*** SUMMARY ***
Total pot $0.12 | Rake $0 
Seat 1: ayhshhh (button) folded before Flop (didn't bet)
Seat 2: psychowallst (small blind) folded before Flop
Seat 3: HubertusB (big blind) folded before Flop
Seat 4: Lobos2102 folded before Flop (didn't bet)
Seat 5: Mikos108 collected ($0.12)
Seat 6: sshotokann folded before Flop (didn't bet)



PokerStars Zoom Hand #178481594622:  Hold'em No Limit ($0.02/$0.05) - 2017/11/20 20:40:51 CCT [2017/11/20 7:40:51 ET]
Table 'Donati' 6-max Seat #1 is the button
Seat 1: HubertusB ($4.06 in chips) 
Seat 2: Le Bicois ($5.32 in chips) 
Seat 3: ddp1985 ($5 in chips) 
Seat 4: dimon36krut ($6.49 in chips) 
Seat 5: Lambert Yeh ($5 in chips) 
Seat 6: With_no_Pain ($6.30 in chips) 
Le Bicois: posts small blind $0.02
ddp1985: posts big blind $0.05
*** HOLE CARDS ***
Dealt to HubertusB [9s Th]
dimon36krut: folds 
Lambert Yeh: folds 
With_no_Pain: folds 
HubertusB: folds 
Le Bicois: raises $0.10 to $0.15
ddp1985: folds 
Uncalled bet ($0.10) returned to Le Bicois
Le Bicois collected $0.10 from pot
Le Bicois: doesn't show hand 
*** SUMMARY ***
Total pot $0.10 | Rake $0 
Seat 1: HubertusB (button) folded before Flop (didn't bet)
Seat 2: Le Bicois (small blind) collected ($0.10)
Seat 3: ddp1985 (big blind) folded before Flop
Seat 4: dimon36krut folded before Flop (didn't bet)
Seat 5: Lambert Yeh folded before Flop (didn't bet)
Seat 6: With_no_Pain folded before Flop (didn't bet)



PokerStars Zoom Hand #178481591488:  Hold'em No Limit ($0.02/$0.05) - 2017/11/20 20:40:44 CCT [2017/11/20 7:40:44 ET]
Table 'Donati' 6-max Seat #1 is the button
Seat 1: Mr. Roquim ($6.60 in chips) 
Seat 2: lehaara2 ($27.04 in chips) 
Seat 3: C3TN1K ($5 in chips) 
Seat 4: serhio77 ($5.07 in chips) 
Seat 5: HubertusB ($4.06 in chips) 
Seat 6: Energetix12. ($6.39 in chips) 
lehaara2: posts small blind $0.02
C3TN1K: posts big blind $0.05
*** HOLE CARDS ***
Dealt to HubertusB [Ah 6s]
serhio77: folds 
HubertusB: folds 
Energetix12.: folds 
Mr. Roquim: folds 
lehaara2: folds 
Uncalled bet ($0.03) returned to C3TN1K
C3TN1K collected $0.04 from pot
C3TN1K: doesn't show hand 
*** SUMMARY ***
Total pot $0.04 | Rake $0 
Seat 1: Mr. Roquim (button) folded before Flop (didn't bet)
Seat 2: lehaara2 (small blind) folded before Flop
Seat 3: C3TN1K (big blind) collected ($0.04)
Seat 4: serhio77 folded before Flop (didn't bet)
Seat 5: HubertusB folded before Flop (didn't bet)
Seat 6: Energetix12. folded before Flop (didn't bet)



PokerStars Zoom Hand #178481599088:  Hold'em No Limit ($0.02/$0.05) - 2017/11/20 20:41:01 CCT [2017/11/20 7:41:01 ET]
Table 'Donati' 6-max Seat #1 is the button
Seat 1: Dobriyputnik ($4.12 in chips) 
Seat 2: Kileak99 ($5.25 in chips) 
Seat 3: HubertusB ($4.06 in chips) 
Seat 4: behappy989 ($12.67 in chips) 
Seat 5: zouzounos86 ($4.06 in chips) 
Seat 6: Oliana88 ($5.96 in chips) 
Kileak99: posts small blind $0.02
HubertusB: posts big blind $0.05
*** HOLE CARDS ***
Dealt to HubertusB [Kd Qh]
behappy989: folds 
zouzounos86: folds 
Oliana88: folds 
Dobriyputnik: calls $0.05
Kileak99: folds 
HubertusB: raises $0.15 to $0.20
Dobriyputnik: folds 
Uncalled bet ($0.15) returned to HubertusB
HubertusB collected $0.12 from pot
HubertusB: doesn't show hand 
*** SUMMARY ***
Total pot $0.12 | Rake $0 
Seat 1: Dobriyputnik (button) folded before Flop
Seat 2: Kileak99 (small blind) folded before Flop
Seat 3: HubertusB (big blind) collected ($0.12)
Seat 4: behappy989 folded before Flop (didn't bet)
Seat 5: zouzounos86 folded before Flop (didn't bet)
Seat 6: Oliana88 folded before Flop (didn't bet)



PokerStars Zoom Hand #178481606581:  Hold'em No Limit ($0.02/$0.05) - 2017/11/20 20:41:18 CCT [2017/11/20 7:41:18 ET]
Table 'Donati' 6-max Seat #1 is the button
Seat 1: Tamik05 ($9.57 in chips) 
Seat 2: HubertusB ($4.13 in chips) 
Seat 3: Amigo113 ($6.15 in chips) 
Seat 4: flatbelieve ($7.13 in chips) 
Seat 5: VelosNM ($7.66 in chips) 
Seat 6: selja-killer ($4.78 in chips) 
HubertusB: posts small blind $0.02
Amigo113: posts big blind $0.05
*** HOLE CARDS ***
Dealt to HubertusB [7h 5c]
flatbelieve: folds 
VelosNM: folds 
selja-killer: raises $0.05 to $0.10
Tamik05: folds 
HubertusB: folds 
Amigo113: folds 
Uncalled bet ($0.05) returned to selja-killer
selja-killer collected $0.12 from pot
selja-killer: doesn't show hand 
*** SUMMARY ***
Total pot $0.12 | Rake $0 
Seat 1: Tamik05 (button) folded before Flop (didn't bet)
Seat 2: HubertusB (small blind) folded before Flop
Seat 3: Amigo113 (big blind) folded before Flop
Seat 4: flatbelieve folded before Flop (didn't bet)
Seat 5: VelosNM folded before Flop (didn't bet)
Seat 6: selja-killer collected ($0.12)



PokerStars Zoom Hand #178481612001:  Hold'em No Limit ($0.02/$0.05) - 2017/11/20 20:41:30 CCT [2017/11/20 7:41:30 ET]
Table 'Donati' 6-max Seat #1 is the button
Seat 1: HubertusB ($4.11 in chips) 
Seat 2: ChibediRO ($1.57 in chips) 
Seat 3: WangHaoWei ($4.86 in chips) 
Seat 4: Romuks33 ($6.51 in chips) 
Seat 5: fantom20620 ($6.67 in chips) 
Seat 6: C20k ($9.87 in chips) 
ChibediRO: posts small blind $0.02
WangHaoWei: posts big blind $0.05
*** HOLE CARDS ***
Dealt to HubertusB [Qd 2c]
Romuks33: raises $0.10 to $0.15
fantom20620: folds 
C20k: folds 
HubertusB: folds 
ChibediRO: folds 
WangHaoWei: folds 
Uncalled bet ($0.10) returned to Romuks33
Romuks33 collected $0.12 from pot
Romuks33: doesn't show hand 
*** SUMMARY ***
Total pot $0.12 | Rake $0 
Seat 1: HubertusB (button) folded before Flop (didn't bet)
Seat 2: ChibediRO (small blind) folded before Flop
Seat 3: WangHaoWei (big blind) folded before Flop
Seat 4: Romuks33 collected ($0.12)
Seat 5: fantom20620 folded before Flop (didn't bet)
Seat 6: C20k folded before Flop (didn't bet)



PokerStars Zoom Hand #178481583550:  Hold'em No Limit ($0.02/$0.05) - 2017/11/20 20:40:26 CCT [2017/11/20 7:40:26 ET]
Table 'Donati' 6-max Seat #1 is the button
Seat 1: HubertusB ($4.11 in chips) 
Seat 2: tavi111 ($10.35 in chips) 
Seat 3: popey1977 ($1.07 in chips) 
Seat 4: MAAXIIMUSS ($4.91 in chips) 
Seat 5: vikandr03 ($7.16 in chips) 
Seat 6: sinyong0709 ($2.65 in chips) 
tavi111: posts small blind $0.02
popey1977: posts big blind $0.05
*** HOLE CARDS ***
Dealt to HubertusB [8s 4c]
MAAXIIMUSS: calls $0.05
vikandr03: folds 
sinyong0709: raises $0.10 to $0.15
HubertusB: folds 
tavi111: calls $0.13
popey1977: folds 
MAAXIIMUSS: calls $0.10
*** FLOP *** [8d 2d 2h]
tavi111: checks 
MAAXIIMUSS: checks 
sinyong0709: bets $0.14
tavi111: raises $0.21 to $0.35
MAAXIIMUSS: calls $0.35
sinyong0709: folds 
*** TURN *** [8d 2d 2h] [Th]
tavi111: bets $0.70
MAAXIIMUSS: calls $0.70
*** RIVER *** [8d 2d 2h Th] [Qh]
tavi111: bets $1.65
MAAXIIMUSS: calls $1.65
*** SHOW DOWN ***
tavi111: shows [Jh 5h] (a flush, Queen high)
MAAXIIMUSS: mucks hand 
tavi111 collected $5.79 from pot
*** SUMMARY ***
Total pot $6.04 | Rake $0.25 
Board [8d 2d 2h Th Qh]
Seat 1: HubertusB (button) folded before Flop (didn't bet)
Seat 2: tavi111 (small blind) showed [Jh 5h] and won ($5.79) with a flush, Queen high
Seat 3: popey1977 (big blind) folded before Flop
Seat 4: MAAXIIMUSS mucked [Kd Qd]
Seat 5: vikandr03 folded before Flop (didn't bet)
Seat 6: sinyong0709 folded on the Flop



PokerStars Zoom Hand #178481609240:  Hold'em No Limit ($0.02/$0.05) - 2017/11/20 20:41:24 CCT [2017/11/20 7:41:24 ET]
Table 'Donati' 6-max Seat #1 is the button
Seat 1: FriskyBear ($5.26 in chips) 
Seat 2: AdamPoker91 ($5.15 in chips) 
Seat 3: chr1stmas01 ($18.31 in chips) 
Seat 4: Moskvich951 ($14.04 in chips) 
Seat 5: stray cat84 ($5.16 in chips) 
Seat 6: HubertusB ($4.11 in chips) 
AdamPoker91: posts small blind $0.02
chr1stmas01: posts big blind $0.05
*** HOLE CARDS ***
Dealt to HubertusB [Kd 5s]
Moskvich951: folds 
stray cat84: folds 
HubertusB: folds 
FriskyBear: raises $0.07 to $0.12
AdamPoker91: folds 
chr1stmas01: folds 
Uncalled bet ($0.07) returned to FriskyBear
FriskyBear collected $0.12 from pot
FriskyBear: doesn't show hand 
*** SUMMARY ***
Total pot $0.12 | Rake $0 
Seat 1: FriskyBear (button) collected ($0.12)
Seat 2: AdamPoker91 (small blind) folded before Flop
Seat 3: chr1stmas01 (big blind) folded before Flop
Seat 4: Moskvich951 folded before Flop (didn't bet)
Seat 5: stray cat84 folded before Flop (didn't bet)
Seat 6: HubertusB folded before Flop (didn't bet)



PokerStars Zoom Hand #178481614209:  Hold'em No Limit ($0.02/$0.05) - 2017/11/20 20:41:35 CCT [2017/11/20 7:41:35 ET]
Table 'Donati' 6-max Seat #1 is the button
Seat 1: NatalTe ($5.81 in chips) 
Seat 2: Ale M 84 ($2.50 in chips) 
Seat 3: Tautietis852 ($8.43 in chips) 
Seat 4: ddp1985 ($5 in chips) 
Seat 5: jochenfratz ($5.47 in chips) 
Seat 6: HubertusB ($4.11 in chips) 
Ale M 84: posts small blind $0.02
Tautietis852: posts big blind $0.05
*** HOLE CARDS ***
Dealt to HubertusB [4d Kd]
ddp1985: raises $0.10 to $0.15
jochenfratz: folds 
HubertusB: raises $0.30 to $0.45
NatalTe: folds 
Ale M 84: folds 
Tautietis852: folds 
ddp1985: folds 
Uncalled bet ($0.30) returned to HubertusB
HubertusB collected $0.37 from pot
HubertusB: doesn't show hand 
*** SUMMARY ***
Total pot $0.37 | Rake $0 
Seat 1: NatalTe (button) folded before Flop (didn't bet)
Seat 2: Ale M 84 (small blind) folded before Flop
Seat 3: Tautietis852 (big blind) folded before Flop
Seat 4: ddp1985 folded before Flop
Seat 5: jochenfratz folded before Flop (didn't bet)
Seat 6: HubertusB collected ($0.37)



PokerStars Zoom Hand #178481622227:  Hold'em No Limit ($0.02/$0.05) - 2017/11/20 20:41:53 CCT [2017/11/20 7:41:53 ET]
Table 'Donati' 6-max Seat #1 is the button
Seat 1: matulinkk ($5.02 in chips) 
Seat 2: ev[gen1y]b ($5 in chips) 
Seat 3: LetsGrindIt ($5.49 in chips) 
Seat 4: vanek-95all@ ($6.73 in chips) 
Seat 5: HubertusB ($4.33 in chips) 
Seat 6: KKrtva ($5 in chips) 
ev[gen1y]b: posts small blind $0.02
LetsGrindIt: posts big blind $0.05
*** HOLE CARDS ***
Dealt to HubertusB [7s Ad]
vanek-95all@: folds 
HubertusB: folds 
KKrtva: folds 
matulinkk: folds 
ev[gen1y]b: folds 
Uncalled bet ($0.03) returned to LetsGrindIt
LetsGrindIt collected $0.04 from pot
LetsGrindIt: doesn't show hand 
*** SUMMARY ***
Total pot $0.04 | Rake $0 
Seat 1: matulinkk (button) folded before Flop (didn't bet)
Seat 2: ev[gen1y]b (small blind) folded before Flop
Seat 3: LetsGrindIt (big blind) collected ($0.04)
Seat 4: vanek-95all@ folded before Flop (didn't bet)
Seat 5: HubertusB folded before Flop (didn't bet)
Seat 6: KKrtva folded before Flop (didn't bet)



PokerStars Zoom Hand #178481625448:  Hold'em No Limit ($0.02/$0.05) - 2017/11/20 20:42:00 CCT [2017/11/20 7:42:00 ET]
Table 'Donati' 6-max Seat #1 is the button
Seat 1: Serhio119 ($3.68 in chips) 
Seat 2: HubertusB ($4.33 in chips) 
Seat 3: igrokstar379 ($15.35 in chips) 
Seat 4: ayhshhh ($6.09 in chips) 
Seat 5: darkmagic29 ($2.31 in chips) 
Seat 6: Nicosan.ru ($4.81 in chips) 
HubertusB: posts small blind $0.02
igrokstar379: posts big blind $0.05
*** HOLE CARDS ***
Dealt to HubertusB [6h 5s]
ayhshhh: folds 
darkmagic29: raises $0.05 to $0.10
Nicosan.ru: folds 
Serhio119: calls $0.10
HubertusB: folds 
igrokstar379: calls $0.05
*** FLOP *** [3c Kh Th]
igrokstar379: checks 
darkmagic29: bets $0.10
Serhio119: calls $0.10
igrokstar379: calls $0.10
*** TURN *** [3c Kh Th] [4h]
igrokstar379: bets $0.18
darkmagic29: folds 
Serhio119: calls $0.18
*** RIVER *** [3c Kh Th 4h] [9d]
igrokstar379: bets $1.84
Serhio119: folds 
Uncalled bet ($1.84) returned to igrokstar379
igrokstar379 collected $0.94 from pot
igrokstar379: doesn't show hand 
*** SUMMARY ***
Total pot $0.98 | Rake $0.04 
Board [3c Kh Th 4h 9d]
Seat 1: Serhio119 (button) folded on the River
Seat 2: HubertusB (small blind) folded before Flop
Seat 3: igrokstar379 (big blind) collected ($0.94)
Seat 4: ayhshhh folded before Flop (didn't bet)
Seat 5: darkmagic29 folded on the Turn
Seat 6: Nicosan.ru folded before Flop (didn't bet)



PokerStars Zoom Hand #178481628018:  Hold'em No Limit ($0.02/$0.05) - 2017/11/20 20:42:06 CCT [2017/11/20 7:42:06 ET]
Table 'Donati' 6-max Seat #1 is the button
Seat 1: Dima4ka001 ($8.41 in chips) 
Seat 2: 1kukla ($2.44 in chips) 
Seat 3: HubertusB ($4.31 in chips) 
Seat 4: xxxdaro ($4.49 in chips) 
Seat 5: iskander575 ($3.51 in chips) 
Seat 6: WahaBeat ($8.29 in chips) 
1kukla: posts small blind $0.02
HubertusB: posts big blind $0.05
*** HOLE CARDS ***
Dealt to HubertusB [As 8s]
xxxdaro: folds 
iskander575: folds 
WahaBeat: folds 
Dima4ka001: folds 
1kukla: raises $0.05 to $0.10
HubertusB: calls $0.05
*** FLOP *** [Jh 9d Td]
1kukla: bets $0.10
HubertusB: calls $0.10
*** TURN *** [Jh 9d Td] [2s]
1kukla: bets $0.19
HubertusB: calls $0.19
*** RIVER *** [Jh 9d Td 2s] [3c]
1kukla: bets $0.50
HubertusB: raises $3.42 to $3.92 and is all-in
1kukla: calls $1.55 and is all-in
Uncalled bet ($1.87) returned to HubertusB
*** SHOW DOWN ***
HubertusB: shows [As 8s] (high card Ace)
1kukla: shows [8h Qd] (a straight, Eight to Queen)
1kukla collected $4.68 from pot
*** SUMMARY ***
Total pot $4.88 | Rake $0.20 
Board [Jh 9d Td 2s 3c]
Seat 1: Dima4ka001 (button) folded before Flop (didn't bet)
Seat 2: 1kukla (small blind) showed [8h Qd] and won ($4.68) with a straight, Eight to Queen
Seat 3: HubertusB (big blind) showed [As 8s] and lost with high card Ace
Seat 4: xxxdaro folded before Flop (didn't bet)
Seat 5: iskander575 folded before Flop (didn't bet)
Seat 6: WahaBeat folded before Flop (didn't bet)



PokerStars Zoom Hand #178481675820:  Hold'em No Limit ($0.02/$0.05) - 2017/11/20 20:43:54 CCT [2017/11/20 7:43:54 ET]
Table 'Donati' 6-max Seat #1 is the button
Seat 1: HubertusB ($1.87 in chips) 
Seat 2: chester8676 ($4.78 in chips) 
Seat 3: With_no_Pain ($7.31 in chips) 
Seat 4: Dorogoi57 ($5 in chips) 
Seat 5: KKrtva ($5.46 in chips) 
Seat 6: Marka555 ($5.88 in chips) 
chester8676: posts small blind $0.02
With_no_Pain: posts big blind $0.05
*** HOLE CARDS ***
Dealt to HubertusB [Ks 4d]
Dorogoi57: folds 
KKrtva: folds 
Marka555: folds 
HubertusB: folds 
chester8676: folds 
Uncalled bet ($0.03) returned to With_no_Pain
With_no_Pain collected $0.04 from pot
With_no_Pain: doesn't show hand 
*** SUMMARY ***
Total pot $0.04 | Rake $0 
Seat 1: HubertusB (button) folded before Flop (didn't bet)
Seat 2: chester8676 (small blind) folded before Flop
Seat 3: With_no_Pain (big blind) collected ($0.04)
Seat 4: Dorogoi57 folded before Flop (didn't bet)
Seat 5: KKrtva folded before Flop (didn't bet)
Seat 6: Marka555 folded before Flop (didn't bet)



PokerStars Zoom Hand #178481678067:  Hold'em No Limit ($0.02/$0.05) - 2017/11/20 20:43:59 CCT [2017/11/20 7:43:59 ET]
Table 'Donati' 6-max Seat #1 is the button
Seat 1: simple s0o ($5 in chips) 
Seat 2: K.Kusto ($9.70 in chips) 
Seat 3: KindandBad77 ($9.11 in chips) 
Seat 4: tias1974 ($4.86 in chips) 
Seat 5: HubertusB ($1.87 in chips) 
Seat 6: dubbbbme ($7.51 in chips) 
K.Kusto: posts small blind $0.02
KindandBad77: posts big blind $0.05
*** HOLE CARDS ***
Dealt to HubertusB [6s Qh]
tias1974: raises $0.07 to $0.12
HubertusB: folds 
dubbbbme: folds 
simple s0o: folds 
K.Kusto: folds 
KindandBad77: folds 
Uncalled bet ($0.07) returned to tias1974
tias1974 collected $0.12 from pot
tias1974: doesn't show hand 
*** SUMMARY ***
Total pot $0.12 | Rake $0 
Seat 1: simple s0o (button) folded before Flop (didn't bet)
Seat 2: K.Kusto (small blind) folded before Flop
Seat 3: KindandBad77 (big blind) folded before Flop
Seat 4: tias1974 collected ($0.12)
Seat 5: HubertusB folded before Flop (didn't bet)
Seat 6: dubbbbme folded before Flop (didn't bet)



PokerStars Zoom Hand #178481680682:  Hold'em No Limit ($0.02/$0.05) - 2017/11/20 20:44:05 CCT [2017/11/20 7:44:05 ET]
Table 'Donati' 6-max Seat #1 is the button
Seat 1: RedDynast ($5.37 in chips) 
Seat 2: Dt_Hyde ($8.35 in chips) 
Seat 3: kacrak ($5 in chips) 
Seat 4: HubertusB ($1.87 in chips) 
Seat 5: Vagabond000 ($6.04 in chips) 
Seat 6: Blankota ($7.05 in chips) 
Dt_Hyde: posts small blind $0.02
kacrak: posts big blind $0.05
*** HOLE CARDS ***
Dealt to HubertusB [7c Ks]
HubertusB: folds 
Vagabond000: folds 
Blankota: folds 
RedDynast: folds 
Dt_Hyde: folds 
Uncalled bet ($0.03) returned to kacrak
kacrak collected $0.04 from pot
kacrak: doesn't show hand 
*** SUMMARY ***
Total pot $0.04 | Rake $0 
Seat 1: RedDynast (button) folded before Flop (didn't bet)
Seat 2: Dt_Hyde (small blind) folded before Flop
Seat 3: kacrak (big blind) collected ($0.04)
Seat 4: HubertusB folded before Flop (didn't bet)
Seat 5: Vagabond000 folded before Flop (didn't bet)
Seat 6: Blankota folded before Flop (didn't bet)



PokerStars Zoom Hand #178481671422:  Hold'em No Limit ($0.02/$0.05) - 2017/11/20 20:43:44 CCT [2017/11/20 7:43:44 ET]
Table 'Donati' 6-max Seat #1 is the button
Seat 1: PsBadBluff ($5 in chips) 
Seat 2: pakintooo ($6.62 in chips) 
Seat 3: tigerrrrli ($5.55 in chips) 
Seat 4: HubertusB ($1.87 in chips) 
Seat 5: Lambert Yeh ($5.07 in chips) 
Seat 6: ayhshhh ($10.27 in chips) 
pakintooo: posts small blind $0.02
tigerrrrli: posts big blind $0.05
*** HOLE CARDS ***
Dealt to HubertusB [Qh 3h]
HubertusB: folds 
Lambert Yeh: raises $0.10 to $0.15
ayhshhh: folds 
PsBadBluff: folds 
pakintooo: calls $0.13
tigerrrrli: folds 
*** FLOP *** [5h Jd Qs]
pakintooo: bets $0.17
Lambert Yeh: folds 
Uncalled bet ($0.17) returned to pakintooo
pakintooo collected $0.34 from pot
pakintooo: doesn't show hand 
*** SUMMARY ***
Total pot $0.35 | Rake $0.01 
Board [5h Jd Qs]
Seat 1: PsBadBluff (button) folded before Flop (didn't bet)
Seat 2: pakintooo (small blind) collected ($0.34)
Seat 3: tigerrrrli (big blind) folded before Flop
Seat 4: HubertusB folded before Flop (didn't bet)
Seat 5: Lambert Yeh folded on the Flop
Seat 6: ayhshhh folded before Flop (didn't bet)



PokerStars Zoom Hand #178481682897:  Hold'em No Limit ($0.02/$0.05) - 2017/11/20 20:44:10 CCT [2017/11/20 7:44:10 ET]
Table 'Donati' 6-max Seat #1 is the button
Seat 1: Ronny88278 ($3.08 in chips) 
Seat 2: chester8676 ($5.02 in chips) 
Seat 3: keenakeena73 ($3.82 in chips) 
Seat 4: CaH4esskO ($13.07 in chips) 
Seat 5: Marka555 ($5.41 in chips) 
Seat 6: HubertusB ($1.87 in chips) 
chester8676: posts small blind $0.02
keenakeena73: posts big blind $0.05
*** HOLE CARDS ***
Dealt to HubertusB [4s 7d]
CaH4esskO: folds 
Marka555: raises $0.10 to $0.15
HubertusB: folds 
Ronny88278: calls $0.15
chester8676: folds 
keenakeena73: folds 
*** FLOP *** [3h 5c 9c]
Marka555: bets $0.18
Ronny88278: calls $0.18
*** TURN *** [3h 5c 9c] [Jd]
Marka555: checks 
Ronny88278: checks 
*** RIVER *** [3h 5c 9c Jd] [As]
Marka555: checks 
Ronny88278: checks 
*** SHOW DOWN ***
Marka555: shows [5h 4h] (a pair of Fives)
Ronny88278: mucks hand 
Marka555 collected $0.70 from pot
*** SUMMARY ***
Total pot $0.73 | Rake $0.03 
Board [3h 5c 9c Jd As]
Seat 1: Ronny88278 (button) mucked [6c Kd]
Seat 2: chester8676 (small blind) folded before Flop
Seat 3: keenakeena73 (big blind) folded before Flop
Seat 4: CaH4esskO folded before Flop (didn't bet)
Seat 5: Marka555 showed [5h 4h] and won ($0.70) with a pair of Fives
Seat 6: HubertusB folded before Flop (didn't bet)



PokerStars Zoom Hand #178481685530:  Hold'em No Limit ($0.02/$0.05) - 2017/11/20 20:44:16 CCT [2017/11/20 7:44:16 ET]
Table 'Donati' 6-max Seat #1 is the button
Seat 1: Romuks33 ($7.12 in chips) 
Seat 2: ludaslol ($5.95 in chips) 
Seat 3: KKrtva ($5.09 in chips) 
Seat 4: JCG22222 ($8.35 in chips) 
Seat 5: HubertusB ($1.87 in chips) 
Seat 6: IronRuss ($5.07 in chips) 
ludaslol: posts small blind $0.02
KKrtva: posts big blind $0.05
*** HOLE CARDS ***
Dealt to HubertusB [Kh Jd]
JCG22222: folds 
HubertusB: raises $0.05 to $0.10
IronRuss: folds 
Romuks33: folds 
ludaslol: calls $0.08
KKrtva: folds 
*** FLOP *** [3d 5c 3s]
ludaslol: checks 
HubertusB: checks 
*** TURN *** [3d 5c 3s] [2c]
ludaslol: bets $0.11
HubertusB: calls $0.11
*** RIVER *** [3d 5c 3s 2c] [2h]
ludaslol: bets $0.15
HubertusB: calls $0.15
*** SHOW DOWN ***
ludaslol: shows [4h 4s] (two pair, Fours and Threes)
HubertusB: mucks hand 
ludaslol collected $0.74 from pot
*** SUMMARY ***
Total pot $0.77 | Rake $0.03 
Board [3d 5c 3s 2c 2h]
Seat 1: Romuks33 (button) folded before Flop (didn't bet)
Seat 2: ludaslol (small blind) showed [4h 4s] and won ($0.74) with two pair, Fours and Threes
Seat 3: KKrtva (big blind) folded before Flop
Seat 4: JCG22222 folded before Flop (didn't bet)
Seat 5: HubertusB mucked [Kh Jd]
Seat 6: IronRuss folded before Flop (didn't bet)



PokerStars Zoom Hand #178481705619:  Hold'em No Limit ($0.02/$0.05) - 2017/11/20 20:45:01 CCT [2017/11/20 7:45:01 ET]
Table 'Donati' 6-max Seat #1 is the button
Seat 1: 0201yuta ($4.93 in chips) 
Seat 2: denis313 86 ($2.81 in chips) 
Seat 3: nabuxito ($4.33 in chips) 
Seat 4: HubertusB ($1.51 in chips) 
Seat 5: flapwill ($6.93 in chips) 
Seat 6: ananoliiy ($19.36 in chips) 
denis313 86: posts small blind $0.02
nabuxito: posts big blind $0.05
*** HOLE CARDS ***
Dealt to HubertusB [3d Qh]
HubertusB: folds 
flapwill: folds 
ananoliiy: folds 
0201yuta: folds 
denis313 86: calls $0.03
nabuxito: raises $0.13 to $0.18
denis313 86: folds 
Uncalled bet ($0.13) returned to nabuxito
nabuxito collected $0.10 from pot
nabuxito: doesn't show hand 
*** SUMMARY ***
Total pot $0.10 | Rake $0 
Seat 1: 0201yuta (button) folded before Flop (didn't bet)
Seat 2: denis313 86 (small blind) folded before Flop
Seat 3: nabuxito (big blind) collected ($0.10)
Seat 4: HubertusB folded before Flop (didn't bet)
Seat 5: flapwill folded before Flop (didn't bet)
Seat 6: ananoliiy folded before Flop (didn't bet)



PokerStars Zoom Hand #178481708253:  Hold'em No Limit ($0.02/$0.05) - 2017/11/20 20:45:07 CCT [2017/11/20 7:45:07 ET]
Table 'Donati' 6-max Seat #1 is the button
Seat 1: OttoShtekker ($5.29 in chips) 
Seat 2: IanMalique9 ($17.61 in chips) 
Seat 3: HubertusB ($1.51 in chips) 
Seat 4: clotree ($2.14 in chips) 
Seat 5: Blankota ($6.16 in chips) 
Seat 6: ananoliiy ($6.37 in chips) 
IanMalique9: posts small blind $0.02
HubertusB: posts big blind $0.05
*** HOLE CARDS ***
Dealt to HubertusB [Ts 6d]
clotree: folds 
Blankota: folds 
ananoliiy: folds 
OttoShtekker: folds 
IanMalique9: folds 
Uncalled bet ($0.03) returned to HubertusB
HubertusB collected $0.04 from pot
HubertusB: doesn't show hand 
*** SUMMARY ***
Total pot $0.04 | Rake $0 
Seat 1: OttoShtekker (button) folded before Flop (didn't bet)
Seat 2: IanMalique9 (small blind) folded before Flop
Seat 3: HubertusB (big blind) collected ($0.04)
Seat 4: clotree folded before Flop (didn't bet)
Seat 5: Blankota folded before Flop (didn't bet)
Seat 6: ananoliiy folded before Flop (didn't bet)



PokerStars Zoom Hand #178481714838:  Hold'em No Limit ($0.02/$0.05) - 2017/11/20 20:45:22 CCT [2017/11/20 7:45:22 ET]
Table 'Donati' 6-max Seat #1 is the button
Seat 1: telmanov ($4.50 in chips) 
Seat 2: HubertusB ($1.53 in chips) 
Seat 3: FriskyBear ($6.04 in chips) 
Seat 4: KKrtva ($5.21 in chips) 
Seat 5: ddp1985 ($10.28 in chips) 
Seat 6: PsBadBluff ($5.18 in chips) 
HubertusB: posts small blind $0.02
FriskyBear: posts big blind $0.05
*** HOLE CARDS ***
Dealt to HubertusB [6d Tc]
KKrtva: folds 
ddp1985: folds 
PsBadBluff: folds 
telmanov: folds 
HubertusB: folds 
Uncalled bet ($0.03) returned to FriskyBear
FriskyBear collected $0.04 from pot
FriskyBear: doesn't show hand 
*** SUMMARY ***
Total pot $0.04 | Rake $0 
Seat 1: telmanov (button) folded before Flop (didn't bet)
Seat 2: HubertusB (small blind) folded before Flop
Seat 3: FriskyBear (big blind) collected ($0.04)
Seat 4: KKrtva folded before Flop (didn't bet)
Seat 5: ddp1985 folded before Flop (didn't bet)
Seat 6: PsBadBluff folded before Flop (didn't bet)



PokerStars Zoom Hand #178481717059:  Hold'em No Limit ($0.02/$0.05) - 2017/11/20 20:45:27 CCT [2017/11/20 7:45:27 ET]
Table 'Donati' 6-max Seat #1 is the button
Seat 1: HubertusB ($1.51 in chips) 
Seat 2: crappyquads ($7.72 in chips) 
Seat 3: Marka555 ($5.76 in chips) 
Seat 4: tigerrrrli ($10.06 in chips) 
Seat 5: baltazarSido ($4.23 in chips) 
Seat 6: yumi2003 ($5.38 in chips) 
crappyquads: posts small blind $0.02
Marka555: posts big blind $0.05
*** HOLE CARDS ***
Dealt to HubertusB [8d Qd]
tigerrrrli: folds 
baltazarSido: folds 
yumi2003: folds 
HubertusB: raises $0.05 to $0.10
crappyquads: raises $0.30 to $0.40
Marka555: folds 
HubertusB: folds 
Uncalled bet ($0.30) returned to crappyquads
crappyquads collected $0.25 from pot
crappyquads: doesn't show hand 
*** SUMMARY ***
Total pot $0.25 | Rake $0 
Seat 1: HubertusB (button) folded before Flop
Seat 2: crappyquads (small blind) collected ($0.25)
Seat 3: Marka555 (big blind) folded before Flop
Seat 4: tigerrrrli folded before Flop (didn't bet)
Seat 5: baltazarSido folded before Flop (didn't bet)
Seat 6: yumi2003 folded before Flop (didn't bet)



PokerStars Zoom Hand #178481723326:  Hold'em No Limit ($0.02/$0.05) - 2017/11/20 20:45:41 CCT [2017/11/20 7:45:41 ET]
Table 'Donati' 6-max Seat #1 is the button
Seat 1: dubbbbme ($7.44 in chips) 
Seat 2: LuizCarlo28 ($5.07 in chips) 
Seat 3: akazonae ($5.28 in chips) 
Seat 4: Quorthon_Zei ($6.40 in chips) 
Seat 5: Oliana88 ($5.28 in chips) 
Seat 6: HubertusB ($1.41 in chips) 
LuizCarlo28: posts small blind $0.02
akazonae: posts big blind $0.05
*** HOLE CARDS ***
Dealt to HubertusB [Jd 9s]
Quorthon_Zei: folds 
Oliana88: folds 
HubertusB: raises $0.05 to $0.10
dubbbbme: raises $0.25 to $0.35
LuizCarlo28: folds 
akazonae: folds 
HubertusB: raises $1.06 to $1.41 and is all-in
dubbbbme: calls $1.06
*** FLOP *** [9d 2s 7s]
*** TURN *** [9d 2s 7s] [Th]
*** RIVER *** [9d 2s 7s Th] [Kc]
*** SHOW DOWN ***
HubertusB: shows [Jd 9s] (a pair of Nines)
dubbbbme: shows [Ad 6d] (high card Ace)
HubertusB collected $2.77 from pot
*** SUMMARY ***
Total pot $2.89 | Rake $0.12 
Board [9d 2s 7s Th Kc]
Seat 1: dubbbbme (button) showed [Ad 6d] and lost with high card Ace
Seat 2: LuizCarlo28 (small blind) folded before Flop
Seat 3: akazonae (big blind) folded before Flop
Seat 4: Quorthon_Zei folded before Flop (didn't bet)
Seat 5: Oliana88 folded before Flop (didn't bet)
Seat 6: HubertusB showed [Jd 9s] and won ($2.77) with a pair of Nines



PokerStars Zoom Hand #178481735900:  Hold'em No Limit ($0.02/$0.05) - 2017/11/20 20:46:09 CCT [2017/11/20 7:46:09 ET]
Table 'Donati' 6-max Seat #1 is the button
Seat 1: MAAXIIMUSS ($2.92 in chips) 
Seat 2: bumbowski ($7.30 in chips) 
Seat 3: chip-runn474 ($4.98 in chips) 
Seat 4: HubertusB ($2.77 in chips) 
Seat 5: zouzounos86 ($4.97 in chips) 
Seat 6: C0!3r@ ($10.49 in chips) 
bumbowski: posts small blind $0.02
chip-runn474: posts big blind $0.05
*** HOLE CARDS ***
Dealt to HubertusB [Qs 7h]
HubertusB: folds 
zouzounos86: folds 
C0!3r@: raises $0.10 to $0.15
MAAXIIMUSS: folds 
bumbowski: folds 
chip-runn474: folds 
Uncalled bet ($0.10) returned to C0!3r@
C0!3r@ collected $0.12 from pot
C0!3r@: doesn't show hand 
*** SUMMARY ***
Total pot $0.12 | Rake $0 
Seat 1: MAAXIIMUSS (button) folded before Flop (didn't bet)
Seat 2: bumbowski (small blind) folded before Flop
Seat 3: chip-runn474 (big blind) folded before Flop
Seat 4: HubertusB folded before Flop (didn't bet)
Seat 5: zouzounos86 folded before Flop (didn't bet)
Seat 6: C0!3r@ collected ($0.12)



PokerStars Zoom Hand #178481745671:  Hold'em No Limit ($0.02/$0.05) - 2017/11/20 20:46:31 CCT [2017/11/20 7:46:31 ET]
Table 'Donati' 6-max Seat #1 is the button
Seat 1: Amigo113 ($5 in chips) 
Seat 2: mikk2468 ($7.91 in chips) 
Seat 3: HubertusB ($2.75 in chips) 
Seat 4: freakmania86 ($7.16 in chips) 
Seat 5: Mr. Roquim ($5.83 in chips) 
Seat 6: tigerrrrli ($10.06 in chips) 
mikk2468: posts small blind $0.02
HubertusB: posts big blind $0.05
*** HOLE CARDS ***
Dealt to HubertusB [5h 3c]
freakmania86: folds 
Mr. Roquim: folds 
tigerrrrli: folds 
Amigo113: folds 
mikk2468: folds 
Uncalled bet ($0.03) returned to HubertusB
HubertusB collected $0.04 from pot
HubertusB: doesn't show hand 
*** SUMMARY ***
Total pot $0.04 | Rake $0 
Seat 1: Amigo113 (button) folded before Flop (didn't bet)
Seat 2: mikk2468 (small blind) folded before Flop
Seat 3: HubertusB (big blind) collected ($0.04)
Seat 4: freakmania86 folded before Flop (didn't bet)
Seat 5: Mr. Roquim folded before Flop (didn't bet)
Seat 6: tigerrrrli folded before Flop (didn't bet)



PokerStars Zoom Hand #178481739893:  Hold'em No Limit ($0.02/$0.05) - 2017/11/20 20:46:18 CCT [2017/11/20 7:46:18 ET]
Table 'Donati' 6-max Seat #1 is the button
Seat 1: Ale M 84 ($5.91 in chips) 
Seat 2: HubertusB ($2.77 in chips) 
Seat 3: Amigo113 ($5 in chips) 
Seat 4: Duboin ($8.68 in chips) 
Seat 5: billyguru ($5 in chips) 
Seat 6: vanek-95all@ ($6.25 in chips) 
HubertusB: posts small blind $0.02
Amigo113: posts big blind $0.05
*** HOLE CARDS ***
Dealt to HubertusB [6h 7c]
Duboin: folds 
billyguru: folds 
vanek-95all@: folds 
Ale M 84: raises $0.07 to $0.12
HubertusB: folds 
Amigo113: calls $0.07
*** FLOP *** [6d 8h Tc]
Amigo113: checks 
Ale M 84: checks 
*** TURN *** [6d 8h Tc] [3d]
Amigo113: bets $0.19
Ale M 84: calls $0.19
*** RIVER *** [6d 8h Tc 3d] [Qd]
Amigo113: checks 
Ale M 84: bets $0.23
Amigo113: calls $0.23
*** SHOW DOWN ***
Ale M 84: shows [Ad Kh] (high card Ace)
Amigo113: shows [Js Td] (a pair of Tens)
Amigo113 collected $1.05 from pot
*** SUMMARY ***
Total pot $1.10 | Rake $0.05 
Board [6d 8h Tc 3d Qd]
Seat 1: Ale M 84 (button) showed [Ad Kh] and lost with high card Ace
Seat 2: HubertusB (small blind) folded before Flop
Seat 3: Amigo113 (big blind) showed [Js Td] and won ($1.05) with a pair of Tens
Seat 4: Duboin folded before Flop (didn't bet)
Seat 5: billyguru folded before Flop (didn't bet)
Seat 6: vanek-95all@ folded before Flop (didn't bet)



PokerStars Zoom Hand #178481756496:  Hold'em No Limit ($0.02/$0.05) - 2017/11/20 20:46:55 CCT [2017/11/20 7:46:55 ET]
Table 'Donati' 6-max Seat #1 is the button
Seat 1: Card_Sharp78 ($4.46 in chips) 
Seat 2: zyannsinn ($6.52 in chips) 
Seat 3: MAAXIIMUSS ($2.92 in chips) 
Seat 4: billyguru ($5 in chips) 
Seat 5: sepik200 ($7.24 in chips) 
Seat 6: HubertusB ($2.77 in chips) 
zyannsinn: posts small blind $0.02
MAAXIIMUSS: posts big blind $0.05
*** HOLE CARDS ***
Dealt to HubertusB [Th Qc]
billyguru: folds 
sepik200: calls $0.05
HubertusB: raises $0.15 to $0.20
Card_Sharp78: folds 
zyannsinn: folds 
MAAXIIMUSS: folds 
sepik200: calls $0.15
*** FLOP *** [5s 3h 9s]
sepik200: bets $0.05
HubertusB: calls $0.05
*** TURN *** [5s 3h 9s] [Ks]
sepik200: bets $0.05
HubertusB: calls $0.05
*** RIVER *** [5s 3h 9s Ks] [3c]
sepik200: bets $0.64
HubertusB: folds 
Uncalled bet ($0.64) returned to sepik200
sepik200 collected $0.64 from pot
sepik200: doesn't show hand 
*** SUMMARY ***
Total pot $0.67 | Rake $0.03 
Board [5s 3h 9s Ks 3c]
Seat 1: Card_Sharp78 (button) folded before Flop (didn't bet)
Seat 2: zyannsinn (small blind) folded before Flop
Seat 3: MAAXIIMUSS (big blind) folded before Flop
Seat 4: billyguru folded before Flop (didn't bet)
Seat 5: sepik200 collected ($0.64)
Seat 6: HubertusB folded on the River



PokerStars Zoom Hand #178481768741:  Hold'em No Limit ($0.02/$0.05) - 2017/11/20 20:47:22 CCT [2017/11/20 7:47:22 ET]
Table 'Donati' 6-max Seat #1 is the button
Seat 1: HubertusB ($2.47 in chips) 
Seat 2: viktor_KK ($7.22 in chips) 
Seat 3: serhio77 ($8.21 in chips) 
Seat 4: zyannsinn ($6.50 in chips) 
Seat 5: #Jang123# ($7.32 in chips) 
Seat 6: olsekpoker ($9.58 in chips) 
viktor_KK: posts small blind $0.02
serhio77: posts big blind $0.05
*** HOLE CARDS ***
Dealt to HubertusB [2s Js]
zyannsinn: folds 
#Jang123#: folds 
olsekpoker: folds 
HubertusB: raises $0.05 to $0.10
viktor_KK: raises $0.25 to $0.35
serhio77: folds 
HubertusB: folds 
Uncalled bet ($0.25) returned to viktor_KK
viktor_KK collected $0.25 from pot
viktor_KK: doesn't show hand 
*** SUMMARY ***
Total pot $0.25 | Rake $0 
Seat 1: HubertusB (button) folded before Flop
Seat 2: viktor_KK (small blind) collected ($0.25)
Seat 3: serhio77 (big blind) folded before Flop
Seat 4: zyannsinn folded before Flop (didn't bet)
Seat 5: #Jang123# folded before Flop (didn't bet)
Seat 6: olsekpoker folded before Flop (didn't bet)



PokerStars Zoom Hand #178481779174:  Hold'em No Limit ($0.02/$0.05) - 2017/11/20 20:47:45 CCT [2017/11/20 7:47:45 ET]
Table 'Donati' 6-max Seat #1 is the button
Seat 1: TitanX1 ($3 in chips) 
Seat 2: Muurzik ($5.22 in chips) 
Seat 3: telmanov ($5.18 in chips) 
Seat 4: svansong ($5 in chips) 
Seat 5: HubertusB ($2.37 in chips) 
Seat 6: zale73 ($6.09 in chips) 
Muurzik: posts small blind $0.02
telmanov: posts big blind $0.05
*** HOLE CARDS ***
Dealt to HubertusB [6h Jc]
svansong: folds 
HubertusB: folds 
zale73: folds 
TitanX1: folds 
Muurzik: folds 
Uncalled bet ($0.03) returned to telmanov
telmanov collected $0.04 from pot
telmanov: doesn't show hand 
*** SUMMARY ***
Total pot $0.04 | Rake $0 
Seat 1: TitanX1 (button) folded before Flop (didn't bet)
Seat 2: Muurzik (small blind) folded before Flop
Seat 3: telmanov (big blind) collected ($0.04)
Seat 4: svansong folded before Flop (didn't bet)
Seat 5: HubertusB folded before Flop (didn't bet)
Seat 6: zale73 folded before Flop (didn't bet)



PokerStars Zoom Hand #178481785879:  Hold'em No Limit ($0.02/$0.05) - 2017/11/20 20:48:00 CCT [2017/11/20 7:48:00 ET]
Table 'Donati' 6-max Seat #1 is the button
Seat 1: HubertusB ($2.37 in chips) 
Seat 2: bassxsp ($5 in chips) 
Seat 3: VIT789 ($7.24 in chips) 
Seat 4: K.Tyrrell ($5 in chips) 
Seat 5: AlexDeLargee ($5 in chips) 
Seat 6: zyannsinn ($5.74 in chips) 
bassxsp: posts small blind $0.02
VIT789: posts big blind $0.05
*** HOLE CARDS ***
Dealt to HubertusB [Ks 5s]
K.Tyrrell: folds 
AlexDeLargee: folds 
zyannsinn: folds 
HubertusB: raises $0.05 to $0.10
bassxsp: folds 
VIT789: folds 
Uncalled bet ($0.05) returned to HubertusB
HubertusB collected $0.12 from pot
HubertusB: doesn't show hand 
*** SUMMARY ***
Total pot $0.12 | Rake $0 
Seat 1: HubertusB (button) collected ($0.12)
Seat 2: bassxsp (small blind) folded before Flop
Seat 3: VIT789 (big blind) folded before Flop
Seat 4: K.Tyrrell folded before Flop (didn't bet)
Seat 5: AlexDeLargee folded before Flop (didn't bet)
Seat 6: zyannsinn folded before Flop (didn't bet)



PokerStars Zoom Hand #178481782264:  Hold'em No Limit ($0.02/$0.05) - 2017/11/20 20:47:52 CCT [2017/11/20 7:47:52 ET]
Table 'Donati' 6-max Seat #1 is the button
Seat 1: Nicosan.ru ($3.11 in chips) 
Seat 2: serhio77 ($8.16 in chips) 
Seat 3: dark h0r$e ($9.34 in chips) 
Seat 4: HubertusB ($2.37 in chips) 
Seat 5: hellraiserAA ($8.28 in chips) 
Seat 6: alex_xics ($3.27 in chips) 
serhio77: posts small blind $0.02
dark h0r$e: posts big blind $0.05
*** HOLE CARDS ***
Dealt to HubertusB [4s 8c]
HubertusB: folds 
hellraiserAA: folds 
alex_xics: folds 
Nicosan.ru: folds 
serhio77: raises $0.10 to $0.15
dark h0r$e: raises $0.30 to $0.45
serhio77: calls $0.30
*** FLOP *** [6d Td 4h]
serhio77: checks 
dark h0r$e: bets $0.43
serhio77: calls $0.43
*** TURN *** [6d Td 4h] [Tc]
serhio77: checks 
dark h0r$e: checks 
*** RIVER *** [6d Td 4h Tc] [3c]
serhio77: bets $1.13
dark h0r$e: calls $1.13
*** SHOW DOWN ***
serhio77: shows [Ks 2s] (a pair of Tens)
dark h0r$e: shows [Ah Ad] (two pair, Aces and Tens)
dark h0r$e collected $3.85 from pot
*** SUMMARY ***
Total pot $4.02 | Rake $0.17 
Board [6d Td 4h Tc 3c]
Seat 1: Nicosan.ru (button) folded before Flop (didn't bet)
Seat 2: serhio77 (small blind) showed [Ks 2s] and lost with a pair of Tens
Seat 3: dark h0r$e (big blind) showed [Ah Ad] and won ($3.85) with two pair, Aces and Tens
Seat 4: HubertusB folded before Flop (didn't bet)
Seat 5: hellraiserAA folded before Flop (didn't bet)
Seat 6: alex_xics folded before Flop (didn't bet)



PokerStars Zoom Hand #178481793987:  Hold'em No Limit ($0.02/$0.05) - 2017/11/20 20:48:18 CCT [2017/11/20 7:48:18 ET]
Table 'Donati' 6-max Seat #1 is the button
Seat 1: KindandBad77 ($9.01 in chips) 
Seat 2: AAgenaWin ($6.93 in chips) 
Seat 3: HubertusB ($2.44 in chips) 
Seat 4: sshotokann ($5.80 in chips) 
Seat 5: Akutagawa ($5 in chips) 
Seat 6: kacrak ($5.01 in chips) 
AAgenaWin: posts small blind $0.02
HubertusB: posts big blind $0.05
*** HOLE CARDS ***
Dealt to HubertusB [Tc 4s]
sshotokann: folds 
Akutagawa: folds 
kacrak: folds 
KindandBad77: folds 
AAgenaWin: raises $0.10 to $0.15
HubertusB: folds 
Uncalled bet ($0.10) returned to AAgenaWin
AAgenaWin collected $0.10 from pot
AAgenaWin: doesn't show hand 
*** SUMMARY ***
Total pot $0.10 | Rake $0 
Seat 1: KindandBad77 (button) folded before Flop (didn't bet)
Seat 2: AAgenaWin (small blind) collected ($0.10)
Seat 3: HubertusB (big blind) folded before Flop
Seat 4: sshotokann folded before Flop (didn't bet)
Seat 5: Akutagawa folded before Flop (didn't bet)
Seat 6: kacrak folded before Flop (didn't bet)



PokerStars Zoom Hand #178481799407:  Hold'em No Limit ($0.02/$0.05) - 2017/11/20 20:48:30 CCT [2017/11/20 7:48:30 ET]
Table 'Donati' 6-max Seat #1 is the button
Seat 1: PsBadBluff ($5 in chips) 
Seat 2: HubertusB ($2.39 in chips) 
Seat 3: BCE bUDET ($6.67 in chips) 
Seat 4: hellraiserAA ($8.28 in chips) 
Seat 5: talbotrich ($11.55 in chips) 
Seat 6: Marka555 ($4.91 in chips) 
HubertusB: posts small blind $0.02
BCE bUDET: posts big blind $0.05
*** HOLE CARDS ***
Dealt to HubertusB [9c 6d]
hellraiserAA: folds 
talbotrich: folds 
Marka555: raises $0.07 to $0.12
PsBadBluff: folds 
HubertusB: folds 
BCE bUDET: folds 
Uncalled bet ($0.07) returned to Marka555
Marka555 collected $0.12 from pot
Marka555: doesn't show hand 
*** SUMMARY ***
Total pot $0.12 | Rake $0 
Seat 1: PsBadBluff (button) folded before Flop (didn't bet)
Seat 2: HubertusB (small blind) folded before Flop
Seat 3: BCE bUDET (big blind) folded before Flop
Seat 4: hellraiserAA folded before Flop (didn't bet)
Seat 5: talbotrich folded before Flop (didn't bet)
Seat 6: Marka555 collected ($0.12)



PokerStars Zoom Hand #178481801727:  Hold'em No Limit ($0.02/$0.05) - 2017/11/20 20:48:35 CCT [2017/11/20 7:48:35 ET]
Table 'Donati' 6-max Seat #1 is the button
Seat 1: NatalTe ($6.15 in chips) 
Seat 2: telmanov ($5.55 in chips) 
Seat 3: Skreelb ($1.50 in chips) 
Seat 4: ddp1985 ($10.18 in chips) 
Seat 5: flatbelieve ($5.88 in chips) 
Seat 6: HubertusB ($2.37 in chips) 
telmanov: posts small blind $0.02
Skreelb: posts big blind $0.05
*** HOLE CARDS ***
Dealt to HubertusB [Qh 4c]
ddp1985: folds 
flatbelieve: raises $0.06 to $0.11
HubertusB: folds 
NatalTe: folds 
telmanov: folds 
Skreelb: folds 
Uncalled bet ($0.06) returned to flatbelieve
flatbelieve collected $0.12 from pot
flatbelieve: doesn't show hand 
*** SUMMARY ***
Total pot $0.12 | Rake $0 
Seat 1: NatalTe (button) folded before Flop (didn't bet)
Seat 2: telmanov (small blind) folded before Flop
Seat 3: Skreelb (big blind) folded before Flop
Seat 4: ddp1985 folded before Flop (didn't bet)
Seat 5: flatbelieve collected ($0.12)
Seat 6: HubertusB folded before Flop (didn't bet)



PokerStars Zoom Hand #178481804508:  Hold'em No Limit ($0.02/$0.05) - 2017/11/20 20:48:41 CCT [2017/11/20 7:48:41 ET]
Table 'Donati' 6-max Seat #1 is the button
Seat 1: meyong2012 ($5.19 in chips) 
Seat 2: pimposhkius ($3.54 in chips) 
Seat 3: ddp1985 ($10.18 in chips) 
Seat 4: olsekpoker ($5.85 in chips) 
Seat 5: HubertusB ($2.37 in chips) 
Seat 6: kaesspo ($11.09 in chips) 
pimposhkius: posts small blind $0.02
ddp1985: posts big blind $0.05
*** HOLE CARDS ***
Dealt to HubertusB [9c 3s]
olsekpoker: folds 
HubertusB: folds 
kaesspo: raises $0.10 to $0.15
meyong2012: folds 
pimposhkius: calls $0.13
ddp1985: folds 
*** FLOP *** [9s Kd Jc]
pimposhkius: checks 
kaesspo: bets $0.15
pimposhkius: folds 
Uncalled bet ($0.15) returned to kaesspo
kaesspo collected $0.34 from pot
kaesspo: doesn't show hand 
*** SUMMARY ***
Total pot $0.35 | Rake $0.01 
Board [9s Kd Jc]
Seat 1: meyong2012 (button) folded before Flop (didn't bet)
Seat 2: pimposhkius (small blind) folded on the Flop
Seat 3: ddp1985 (big blind) folded before Flop
Seat 4: olsekpoker folded before Flop (didn't bet)
Seat 5: HubertusB folded before Flop (didn't bet)
Seat 6: kaesspo collected ($0.34)



PokerStars Zoom Hand #178481810790:  Hold'em No Limit ($0.02/$0.05) - 2017/11/20 20:48:55 CCT [2017/11/20 7:48:55 ET]
Table 'Donati' 6-max Seat #1 is the button
Seat 1: LEKSANDR82 ($5 in chips) 
Seat 2: DROFNEBMAS ($4.95 in chips) 
Seat 3: Mikos108 ($4.46 in chips) 
Seat 4: paxton2468 ($9.29 in chips) 
Seat 5: HubertusB ($2.37 in chips) 
Seat 6: grunge&punk ($4.72 in chips) 
DROFNEBMAS: posts small blind $0.02
Mikos108: posts big blind $0.05
*** HOLE CARDS ***
Dealt to HubertusB [Kh Jd]
paxton2468: folds 
HubertusB: raises $0.05 to $0.10
grunge&punk: folds 
LEKSANDR82: folds 
DROFNEBMAS: folds 
Mikos108: folds 
Uncalled bet ($0.05) returned to HubertusB
HubertusB collected $0.12 from pot
HubertusB: doesn't show hand 
*** SUMMARY ***
Total pot $0.12 | Rake $0 
Seat 1: LEKSANDR82 (button) folded before Flop (didn't bet)
Seat 2: DROFNEBMAS (small blind) folded before Flop
Seat 3: Mikos108 (big blind) folded before Flop
Seat 4: paxton2468 folded before Flop (didn't bet)
Seat 5: HubertusB collected ($0.12)
Seat 6: grunge&punk folded before Flop (didn't bet)



PokerStars Zoom Hand #178481807612:  Hold'em No Limit ($0.02/$0.05) - 2017/11/20 20:48:48 CCT [2017/11/20 7:48:48 ET]
Table 'Donati' 6-max Seat #1 is the button
Seat 1: paradiseg174 ($13.54 in chips) 
Seat 2: DudinAndrey ($24.04 in chips) 
Seat 3: Le Bicois ($9.91 in chips) 
Seat 4: HubertusB ($2.37 in chips) 
Seat 5: JCG22222 ($7.09 in chips) 
Seat 6: kelevra__375 ($5.28 in chips) 
DudinAndrey: posts small blind $0.02
Le Bicois: posts big blind $0.05
*** HOLE CARDS ***
Dealt to HubertusB [Qs 5d]
HubertusB: folds 
JCG22222: raises $0.05 to $0.10
kelevra__375: folds 
paradiseg174: folds 
DudinAndrey: folds 
Le Bicois: calls $0.05
*** FLOP *** [Jh 3h 9s]
Le Bicois: bets $0.11
JCG22222: calls $0.11
*** TURN *** [Jh 3h 9s] [Qc]
Le Bicois: bets $0.21
JCG22222: calls $0.21
*** RIVER *** [Jh 3h 9s Qc] [Kc]
Le Bicois: bets $0.41
JCG22222: calls $0.41
*** SHOW DOWN ***
Le Bicois: shows [7h 7d] (a pair of Sevens)
JCG22222: shows [Ah Qd] (a pair of Queens)
JCG22222 collected $1.61 from pot
*** SUMMARY ***
Total pot $1.68 | Rake $0.07 
Board [Jh 3h 9s Qc Kc]
Seat 1: paradiseg174 (button) folded before Flop (didn't bet)
Seat 2: DudinAndrey (small blind) folded before Flop
Seat 3: Le Bicois (big blind) showed [7h 7d] and lost with a pair of Sevens
Seat 4: HubertusB folded before Flop (didn't bet)
Seat 5: JCG22222 showed [Ah Qd] and won ($1.61) with a pair of Queens
Seat 6: kelevra__375 folded before Flop (didn't bet)



PokerStars Zoom Hand #178481819766:  Hold'em No Limit ($0.02/$0.05) - 2017/11/20 20:49:15 CCT [2017/11/20 7:49:15 ET]
Table 'Donati' 6-max Seat #1 is the button
Seat 1: sarychevss ($5.80 in chips) 
Seat 2: Oliana88 ($9.47 in chips) 
Seat 3: HubertusB ($2.44 in chips) 
Seat 4: Zupek7 ($5.22 in chips) 
Seat 5: djben2005 ($5.37 in chips) 
Seat 6: VIT789 ($7.24 in chips) 
Oliana88: posts small blind $0.02
HubertusB: posts big blind $0.05
*** HOLE CARDS ***
Dealt to HubertusB [4h Td]
Zupek7: folds 
djben2005: folds 
VIT789: raises $0.11 to $0.16
sarychevss: folds 
Oliana88: folds 
HubertusB: folds 
Uncalled bet ($0.11) returned to VIT789
VIT789 collected $0.12 from pot
VIT789: doesn't show hand 
*** SUMMARY ***
Total pot $0.12 | Rake $0 
Seat 1: sarychevss (button) folded before Flop (didn't bet)
Seat 2: Oliana88 (small blind) folded before Flop
Seat 3: HubertusB (big blind) folded before Flop
Seat 4: Zupek7 folded before Flop (didn't bet)
Seat 5: djben2005 folded before Flop (didn't bet)
Seat 6: VIT789 collected ($0.12)



PokerStars Zoom Hand #178481824199:  Hold'em No Limit ($0.02/$0.05) - 2017/11/20 20:49:25 CCT [2017/11/20 7:49:25 ET]
Table 'Donati' 6-max Seat #1 is the button
Seat 1: FBI 2014 ($21.78 in chips) 
Seat 2: HubertusB ($2.39 in chips) 
Seat 3: crappyquads ($6.44 in chips) 
Seat 4: kugulta72 ($6.19 in chips) 
Seat 5: NatalTe ($6.13 in chips) 
Seat 6: shevv1727 ($6.49 in chips) 
HubertusB: posts small blind $0.02
crappyquads: posts big blind $0.05
*** HOLE CARDS ***
Dealt to HubertusB [2s 8d]
kugulta72: folds 
NatalTe: folds 
shevv1727: raises $0.10 to $0.15
FBI 2014: folds 
HubertusB: folds 
crappyquads: folds 
Uncalled bet ($0.10) returned to shevv1727
shevv1727 collected $0.12 from pot
shevv1727: doesn't show hand 
*** SUMMARY ***
Total pot $0.12 | Rake $0 
Seat 1: FBI 2014 (button) folded before Flop (didn't bet)
Seat 2: HubertusB (small blind) folded before Flop
Seat 3: crappyquads (big blind) folded before Flop
Seat 4: kugulta72 folded before Flop (didn't bet)
Seat 5: NatalTe folded before Flop (didn't bet)
Seat 6: shevv1727 collected ($0.12)



PokerStars Zoom Hand #178481826970:  Hold'em No Limit ($0.02/$0.05) - 2017/11/20 20:49:31 CCT [2017/11/20 7:49:31 ET]
Table 'Donati' 6-max Seat #1 is the button
Seat 1: HubertusB ($2.37 in chips) 
Seat 2: viggli ($5 in chips) 
Seat 3: K.Tyrrell ($5 in chips) 
Seat 4: Spartiat993 ($4.62 in chips) 
Seat 5: emilskrede ($4.42 in chips) 
Seat 6: dark h0r$e ($5.16 in chips) 
viggli: posts small blind $0.02
K.Tyrrell: posts big blind $0.05
*** HOLE CARDS ***
Dealt to HubertusB [5h 8c]
Spartiat993: calls $0.05
emilskrede: folds 
dark h0r$e: folds 
HubertusB: folds 
viggli: folds 
K.Tyrrell: checks 
*** FLOP *** [8h 7s 5d]
K.Tyrrell: checks 
Spartiat993: bets $0.10
K.Tyrrell: folds 
Uncalled bet ($0.10) returned to Spartiat993
Spartiat993 collected $0.12 from pot
Spartiat993: doesn't show hand 
*** SUMMARY ***
Total pot $0.12 | Rake $0 
Board [8h 7s 5d]
Seat 1: HubertusB (button) folded before Flop (didn't bet)
Seat 2: viggli (small blind) folded before Flop
Seat 3: K.Tyrrell (big blind) folded on the Flop
Seat 4: Spartiat993 collected ($0.12)
Seat 5: emilskrede folded before Flop (didn't bet)
Seat 6: dark h0r$e folded before Flop (didn't bet)



PokerStars Zoom Hand #178481830218:  Hold'em No Limit ($0.02/$0.05) - 2017/11/20 20:49:38 CCT [2017/11/20 7:49:38 ET]
Table 'Donati' 6-max Seat #1 is the button
Seat 1: mel1in ($10.65 in chips) 
Seat 2: crappyquads ($6.39 in chips) 
Seat 3: chilean777 ($6.02 in chips) 
Seat 4: vanek-95all@ ($7.26 in chips) 
Seat 5: dark h0r$e ($5.16 in chips) 
Seat 6: HubertusB ($2.37 in chips) 
crappyquads: posts small blind $0.02
chilean777: posts big blind $0.05
*** HOLE CARDS ***
Dealt to HubertusB [Qh Td]
vanek-95all@: folds 
dark h0r$e: folds 
HubertusB: raises $0.05 to $0.10
mel1in: folds 
crappyquads: folds 
chilean777: calls $0.05
*** FLOP *** [Ah 6d Ad]
chilean777: checks 
HubertusB: checks 
*** TURN *** [Ah 6d Ad] [Qs]
chilean777: checks 
HubertusB: bets $0.15
chilean777: folds 
Uncalled bet ($0.15) returned to HubertusB
HubertusB collected $0.21 from pot
HubertusB: doesn't show hand 
*** SUMMARY ***
Total pot $0.22 | Rake $0.01 
Board [Ah 6d Ad Qs]
Seat 1: mel1in (button) folded before Flop (didn't bet)
Seat 2: crappyquads (small blind) folded before Flop
Seat 3: chilean777 (big blind) folded on the Turn
Seat 4: vanek-95all@ folded before Flop (didn't bet)
Seat 5: dark h0r$e folded before Flop (didn't bet)
Seat 6: HubertusB collected ($0.21)



PokerStars Zoom Hand #178481845134:  Hold'em No Limit ($0.02/$0.05) - 2017/11/20 20:50:11 CCT [2017/11/20 7:50:11 ET]
Table 'Donati' 6-max Seat #1 is the button
Seat 1: K.Kusto ($5.07 in chips) 
Seat 2: Polypops ($5.79 in chips) 
Seat 3: denis313 86 ($2.48 in chips) 
Seat 4: viggli ($5 in chips) 
Seat 5: HubertusB ($2.48 in chips) 
Seat 6: AlexDeLargee ($7.65 in chips) 
Polypops: posts small blind $0.02
denis313 86: posts big blind $0.05
*** HOLE CARDS ***
Dealt to HubertusB [4h 7h]
viggli: folds 
HubertusB: folds 
AlexDeLargee: raises $0.10 to $0.15
K.Kusto: folds 
Polypops: folds 
denis313 86: calls $0.10
*** FLOP *** [8c Td Jc]
denis313 86: bets $0.31
AlexDeLargee: folds 
Uncalled bet ($0.31) returned to denis313 86
denis313 86 collected $0.31 from pot
denis313 86: doesn't show hand 
*** SUMMARY ***
Total pot $0.32 | Rake $0.01 
Board [8c Td Jc]
Seat 1: K.Kusto (button) folded before Flop (didn't bet)
Seat 2: Polypops (small blind) folded before Flop
Seat 3: denis313 86 (big blind) collected ($0.31)
Seat 4: viggli folded before Flop (didn't bet)
Seat 5: HubertusB folded before Flop (didn't bet)
Seat 6: AlexDeLargee folded on the Flop



PokerStars Zoom Hand #178481842482:  Hold'em No Limit ($0.02/$0.05) - 2017/11/20 20:50:05 CCT [2017/11/20 7:50:05 ET]
Table 'Donati' 6-max Seat #1 is the button
Seat 1: Lobos2102 ($7.01 in chips) 
Seat 2: AlexDeLargee ($5.25 in chips) 
Seat 3: mikk2468 ($6.27 in chips) 
Seat 4: HubertusB ($2.48 in chips) 
Seat 5: p3rf3ct00 ($9.52 in chips) 
Seat 6: AverianovA ($5.91 in chips) 
AlexDeLargee: posts small blind $0.02
mikk2468: posts big blind $0.05
*** HOLE CARDS ***
Dealt to HubertusB [8s 2c]
HubertusB: folds 
p3rf3ct00: raises $0.10 to $0.15
AverianovA: folds 
Lobos2102: folds 
AlexDeLargee: folds 
mikk2468: calls $0.10
*** FLOP *** [5h 4c 6h]
mikk2468: checks 
p3rf3ct00: checks 
*** TURN *** [5h 4c 6h] [Jh]
mikk2468: bets $0.25
p3rf3ct00: raises $0.30 to $0.55
mikk2468: folds 
Uncalled bet ($0.30) returned to p3rf3ct00
p3rf3ct00 collected $0.79 from pot
p3rf3ct00: doesn't show hand 
*** SUMMARY ***
Total pot $0.82 | Rake $0.03 
Board [5h 4c 6h Jh]
Seat 1: Lobos2102 (button) folded before Flop (didn't bet)
Seat 2: AlexDeLargee (small blind) folded before Flop
Seat 3: mikk2468 (big blind) folded on the Turn
Seat 4: HubertusB folded before Flop (didn't bet)
Seat 5: p3rf3ct00 collected ($0.79)
Seat 6: AverianovA folded before Flop (didn't bet)



PokerStars Zoom Hand #178481847841:  Hold'em No Limit ($0.02/$0.05) - 2017/11/20 20:50:17 CCT [2017/11/20 7:50:17 ET]
Table 'Donati' 6-max Seat #1 is the button
Seat 1: KKrtva ($5 in chips) 
Seat 2: botrobot777 ($5.05 in chips) 
Seat 3: HubertusB ($2.48 in chips) 
Seat 4: krzys19697 ($5.22 in chips) 
Seat 5: ALIAKSANDR28 ($3.51 in chips) 
Seat 6: popey1977 ($4.71 in chips) 
botrobot777: posts small blind $0.02
HubertusB: posts big blind $0.05
*** HOLE CARDS ***
Dealt to HubertusB [9s Jh]
krzys19697: folds 
ALIAKSANDR28: folds 
popey1977: folds 
KKrtva: folds 
botrobot777: raises $0.05 to $0.10
HubertusB: calls $0.05
*** FLOP *** [5h Jc 9c]
botrobot777: checks 
HubertusB: bets $0.15
botrobot777: folds 
Uncalled bet ($0.15) returned to HubertusB
HubertusB collected $0.19 from pot
HubertusB: doesn't show hand 
*** SUMMARY ***
Total pot $0.20 | Rake $0.01 
Board [5h Jc 9c]
Seat 1: KKrtva (button) folded before Flop (didn't bet)
Seat 2: botrobot777 (small blind) folded on the Flop
Seat 3: HubertusB (big blind) collected ($0.19)
Seat 4: krzys19697 folded before Flop (didn't bet)
Seat 5: ALIAKSANDR28 folded before Flop (didn't bet)
Seat 6: popey1977 folded before Flop (didn't bet)



PokerStars Zoom Hand #178481865460:  Hold'em No Limit ($0.02/$0.05) - 2017/11/20 20:50:56 CCT [2017/11/20 7:50:56 ET]
Table 'Donati' 6-max Seat #1 is the button
Seat 1: hceyms ($5.10 in chips) 
Seat 2: HubertusB ($2.57 in chips) 
Seat 3: lususfortuna ($5.97 in chips) 
Seat 4: C0!3r@ ($10.26 in chips) 
Seat 5: KKrtva ($5 in chips) 
Seat 6: p00ker_pl ($6.03 in chips) 
HubertusB: posts small blind $0.02
lususfortuna: posts big blind $0.05
*** HOLE CARDS ***
Dealt to HubertusB [Qd Jh]
C0!3r@: folds 
KKrtva: raises $0.07 to $0.12
p00ker_pl: folds 
hceyms: folds 
HubertusB: folds 
lususfortuna: folds 
Uncalled bet ($0.07) returned to KKrtva
KKrtva collected $0.12 from pot
KKrtva: doesn't show hand 
*** SUMMARY ***
Total pot $0.12 | Rake $0 
Seat 1: hceyms (button) folded before Flop (didn't bet)
Seat 2: HubertusB (small blind) folded before Flop
Seat 3: lususfortuna (big blind) folded before Flop
Seat 4: C0!3r@ folded before Flop (didn't bet)
Seat 5: KKrtva collected ($0.12)
Seat 6: p00ker_pl folded before Flop (didn't bet)



PokerStars Zoom Hand #178481869962:  Hold'em No Limit ($0.02/$0.05) - 2017/11/20 20:51:06 CCT [2017/11/20 7:51:06 ET]
Table 'Donati' 6-max Seat #1 is the button
Seat 1: WangHaoWei ($3.76 in chips) 
Seat 2: Polypops ($12.62 in chips) 
Seat 3: Spi4ek ($5.39 in chips) 
Seat 4: ev[gen1y]b ($5 in chips) 
Seat 5: Al3Goulart ($5.42 in chips) 
Seat 6: HubertusB ($2.55 in chips) 
Polypops: posts small blind $0.02
Spi4ek: posts big blind $0.05
*** HOLE CARDS ***
Dealt to HubertusB [3s Jd]
ev[gen1y]b: folds 
Al3Goulart: folds 
HubertusB: folds 
WangHaoWei: folds 
Polypops: folds 
Uncalled bet ($0.03) returned to Spi4ek
Spi4ek collected $0.04 from pot
Spi4ek: doesn't show hand 
*** SUMMARY ***
Total pot $0.04 | Rake $0 
Seat 1: WangHaoWei (button) folded before Flop (didn't bet)
Seat 2: Polypops (small blind) folded before Flop
Seat 3: Spi4ek (big blind) collected ($0.04)
Seat 4: ev[gen1y]b folded before Flop (didn't bet)
Seat 5: Al3Goulart folded before Flop (didn't bet)
Seat 6: HubertusB folded before Flop (didn't bet)



PokerStars Zoom Hand #178481873077:  Hold'em No Limit ($0.02/$0.05) - 2017/11/20 20:51:13 CCT [2017/11/20 7:51:13 ET]
Table 'Donati' 6-max Seat #1 is the button
Seat 1: HubertusB ($2.55 in chips) 
Seat 2: viggli ($5.16 in chips) 
Seat 3: Dima4ka001 ($9.65 in chips) 
Seat 4: 1kukla ($4.20 in chips) 
Seat 5: AlexDeLargee ($5.46 in chips) 
Seat 6: Amigo113 ($6.02 in chips) 
viggli: posts small blind $0.02
Dima4ka001: posts big blind $0.05
*** HOLE CARDS ***
Dealt to HubertusB [Ah Tc]
1kukla: folds 
AlexDeLargee: folds 
Amigo113: folds 
HubertusB: raises $0.05 to $0.10
viggli: folds 
Dima4ka001: folds 
Uncalled bet ($0.05) returned to HubertusB
HubertusB collected $0.12 from pot
HubertusB: doesn't show hand 
*** SUMMARY ***
Total pot $0.12 | Rake $0 
Seat 1: HubertusB (button) collected ($0.12)
Seat 2: viggli (small blind) folded before Flop
Seat 3: Dima4ka001 (big blind) folded before Flop
Seat 4: 1kukla folded before Flop (didn't bet)
Seat 5: AlexDeLargee folded before Flop (didn't bet)
Seat 6: Amigo113 folded before Flop (didn't bet)



PokerStars Zoom Hand #178481880152:  Hold'em No Limit ($0.02/$0.05) - 2017/11/20 20:51:29 CCT [2017/11/20 7:51:29 ET]
Table 'Donati' 6-max Seat #1 is the button
Seat 1: bassxsp ($7.74 in chips) 
Seat 2: vasilek263 ($5.82 in chips) 
Seat 3: pakintooo ($7.36 in chips) 
Seat 4: HubertusB ($2.62 in chips) 
Seat 5: Acedan1369 ($26.83 in chips) 
Seat 6: K.Kusto ($5.20 in chips) 
vasilek263: posts small blind $0.02
pakintooo: posts big blind $0.05
*** HOLE CARDS ***
Dealt to HubertusB [8c 4h]
HubertusB: folds 
Acedan1369: raises $0.07 to $0.12
K.Kusto: folds 
bassxsp: folds 
vasilek263: folds 
pakintooo: calls $0.07
*** FLOP *** [4s Js 9c]
pakintooo: bets $0.13
Acedan1369: folds 
Uncalled bet ($0.13) returned to pakintooo
pakintooo collected $0.25 from pot
pakintooo: doesn't show hand 
*** SUMMARY ***
Total pot $0.26 | Rake $0.01 
Board [4s Js 9c]
Seat 1: bassxsp (button) folded before Flop (didn't bet)
Seat 2: vasilek263 (small blind) folded before Flop
Seat 3: pakintooo (big blind) collected ($0.25)
Seat 4: HubertusB folded before Flop (didn't bet)
Seat 5: Acedan1369 folded on the Flop
Seat 6: K.Kusto folded before Flop (didn't bet)



PokerStars Zoom Hand #178481883768:  Hold'em No Limit ($0.02/$0.05) - 2017/11/20 20:51:37 CCT [2017/11/20 7:51:37 ET]
Table 'Donati' 6-max Seat #1 is the button
Seat 1: TsaturianAA ($6.01 in chips) 
Seat 2: ayhshhh ($30.74 in chips) 
Seat 3: HubertusB ($2.62 in chips) 
Seat 4: nvutincho ($1.77 in chips) 
Seat 5: hceyms ($6.33 in chips) 
Seat 6: crappyquads ($12.36 in chips) 
ayhshhh: posts small blind $0.02
HubertusB: posts big blind $0.05
*** HOLE CARDS ***
Dealt to HubertusB [9c 8h]
nvutincho: folds 
hceyms: folds 
crappyquads: folds 
TsaturianAA: raises $0.07 to $0.12
ayhshhh: folds 
HubertusB: folds 
Uncalled bet ($0.07) returned to TsaturianAA
TsaturianAA collected $0.12 from pot
TsaturianAA: doesn't show hand 
*** SUMMARY ***
Total pot $0.12 | Rake $0 
Seat 1: TsaturianAA (button) collected ($0.12)
Seat 2: ayhshhh (small blind) folded before Flop
Seat 3: HubertusB (big blind) folded before Flop
Seat 4: nvutincho folded before Flop (didn't bet)
Seat 5: hceyms folded before Flop (didn't bet)
Seat 6: crappyquads folded before Flop (didn't bet)



PokerStars Zoom Hand #178481893595:  Hold'em No Limit ($0.02/$0.05) - 2017/11/20 20:51:59 CCT [2017/11/20 7:51:59 ET]
Table 'Donati' 6-max Seat #1 is the button
Seat 1: Wrek86 ($2.75 in chips) 
Seat 2: alex7241183 ($5.22 in chips) 
Seat 3: Polypops ($13.27 in chips) 
Seat 4: HubertusB ($2.57 in chips) 
Seat 5: kaesspo ($6.63 in chips) 
Seat 6: jochenfratz ($8.36 in chips) 
alex7241183: posts small blind $0.02
Polypops: posts big blind $0.05
*** HOLE CARDS ***
Dealt to HubertusB [5c 4d]
HubertusB: folds 
kaesspo: folds 
jochenfratz: folds 
Wrek86: folds 
alex7241183: folds 
Uncalled bet ($0.03) returned to Polypops
Polypops collected $0.04 from pot
Polypops: doesn't show hand 
*** SUMMARY ***
Total pot $0.04 | Rake $0 
Seat 1: Wrek86 (button) folded before Flop (didn't bet)
Seat 2: alex7241183 (small blind) folded before Flop
Seat 3: Polypops (big blind) collected ($0.04)
Seat 4: HubertusB folded before Flop (didn't bet)
Seat 5: kaesspo folded before Flop (didn't bet)
Seat 6: jochenfratz folded before Flop (didn't bet)



PokerStars Zoom Hand #178481898040:  Hold'em No Limit ($0.02/$0.05) - 2017/11/20 20:52:09 CCT [2017/11/20 7:52:09 ET]
Table 'Donati' 6-max Seat #1 is the button
Seat 1: kram189 ($5.21 in chips) 
Seat 2: HubertusB ($2.57 in chips) 
Seat 3: OttoShtekker ($4.39 in chips) 
Seat 4: tias1974 ($9.13 in chips) 
Seat 5: svansong ($5.07 in chips) 
Seat 6: 3iourou ($5.22 in chips) 
HubertusB: posts small blind $0.02
OttoShtekker: posts big blind $0.05
*** HOLE CARDS ***
Dealt to HubertusB [8h 7c]
tias1974: folds 
svansong: folds 
3iourou: folds 
kram189: folds 
HubertusB: raises $0.05 to $0.10
OttoShtekker: folds 
Uncalled bet ($0.05) returned to HubertusB
HubertusB collected $0.10 from pot
HubertusB: doesn't show hand 
*** SUMMARY ***
Total pot $0.10 | Rake $0 
Seat 1: kram189 (button) folded before Flop (didn't bet)
Seat 2: HubertusB (small blind) collected ($0.10)
Seat 3: OttoShtekker (big blind) folded before Flop
Seat 4: tias1974 folded before Flop (didn't bet)
Seat 5: svansong folded before Flop (didn't bet)
Seat 6: 3iourou folded before Flop (didn't bet)



PokerStars Zoom Hand #178481904754:  Hold'em No Limit ($0.02/$0.05) - 2017/11/20 20:52:24 CCT [2017/11/20 7:52:24 ET]
Table 'Donati' 6-max Seat #1 is the button
Seat 1: HubertusB ($2.62 in chips) 
Seat 2: Kluch2017 ($15.52 in chips) 
Seat 3: C0!3r@ ($10.24 in chips) 
Seat 4: Anikin44 ($6.84 in chips) 
Seat 5: MomofMacey ($3.16 in chips) 
Seat 6: akazonae ($4.28 in chips) 
Kluch2017: posts small blind $0.02
C0!3r@: posts big blind $0.05
*** HOLE CARDS ***
Dealt to HubertusB [Ac 9c]
Anikin44: folds 
MomofMacey: folds 
akazonae: folds 
HubertusB: raises $0.05 to $0.10
Kluch2017: folds 
C0!3r@: raises $0.30 to $0.40
HubertusB: folds 
Uncalled bet ($0.30) returned to C0!3r@
C0!3r@ collected $0.22 from pot
C0!3r@: doesn't show hand 
*** SUMMARY ***
Total pot $0.22 | Rake $0 
Seat 1: HubertusB (button) folded before Flop
Seat 2: Kluch2017 (small blind) folded before Flop
Seat 3: C0!3r@ (big blind) collected ($0.22)
Seat 4: Anikin44 folded before Flop (didn't bet)
Seat 5: MomofMacey folded before Flop (didn't bet)
Seat 6: akazonae folded before Flop (didn't bet)



PokerStars Zoom Hand #178481916350:  Hold'em No Limit ($0.02/$0.05) - 2017/11/20 20:52:50 CCT [2017/11/20 7:52:50 ET]
Table 'Donati' 6-max Seat #1 is the button
Seat 1: VIT789 ($7.36 in chips) 
Seat 2: agatha179 ($4.80 in chips) 
Seat 3: HubertusB ($2.52 in chips) 
Seat 4: vanek-95all@ ($11.58 in chips) 
Seat 5: skychevsky ($5 in chips) 
Seat 6: safeeway ($5 in chips) 
agatha179: posts small blind $0.02
HubertusB: posts big blind $0.05
*** HOLE CARDS ***
Dealt to HubertusB [8c 9d]
vanek-95all@: folds 
skychevsky: folds 
safeeway: folds 
VIT789: folds 
agatha179: folds 
Uncalled bet ($0.03) returned to HubertusB
HubertusB collected $0.04 from pot
HubertusB: doesn't show hand 
*** SUMMARY ***
Total pot $0.04 | Rake $0 
Seat 1: VIT789 (button) folded before Flop (didn't bet)
Seat 2: agatha179 (small blind) folded before Flop
Seat 3: HubertusB (big blind) collected ($0.04)
Seat 4: vanek-95all@ folded before Flop (didn't bet)
Seat 5: skychevsky folded before Flop (didn't bet)
Seat 6: safeeway folded before Flop (didn't bet)



PokerStars Zoom Hand #178481921771:  Hold'em No Limit ($0.02/$0.05) - 2017/11/20 20:53:02 CCT [2017/11/20 7:53:02 ET]
Table 'Donati' 6-max Seat #1 is the button
Seat 1: kugulta72 ($6.68 in chips) 
Seat 2: psychowallst ($5.39 in chips) 
Seat 3: safeeway ($5 in chips) 
Seat 4: chilean777 ($11.31 in chips) 
Seat 5: KKrtva ($5.29 in chips) 
Seat 6: HubertusB ($2.54 in chips) 
psychowallst: posts small blind $0.02
safeeway: posts big blind $0.05
*** HOLE CARDS ***
Dealt to HubertusB [4h 9c]
chilean777: folds 
KKrtva: folds 
HubertusB: folds 
kugulta72: folds 
psychowallst: raises $0.10 to $0.15
safeeway: folds 
Uncalled bet ($0.10) returned to psychowallst
psychowallst collected $0.10 from pot
psychowallst: doesn't show hand 
*** SUMMARY ***
Total pot $0.10 | Rake $0 
Seat 1: kugulta72 (button) folded before Flop (didn't bet)
Seat 2: psychowallst (small blind) collected ($0.10)
Seat 3: safeeway (big blind) folded before Flop
Seat 4: chilean777 folded before Flop (didn't bet)
Seat 5: KKrtva folded before Flop (didn't bet)
Seat 6: HubertusB folded before Flop (didn't bet)



PokerStars Zoom Hand #178481913659:  Hold'em No Limit ($0.02/$0.05) - 2017/11/20 20:52:44 CCT [2017/11/20 7:52:44 ET]
Table 'Donati' 6-max Seat #1 is the button
Seat 1: sw11223 ($8.91 in chips) 
Seat 2: chip-runn474 ($5.59 in chips) 
Seat 3: Amigo113 ($5.54 in chips) 
Seat 4: djronalein ($13.59 in chips) 
Seat 5: HubertusB ($2.52 in chips) 
Seat 6: chilean777 ($11.31 in chips) 
chip-runn474: posts small blind $0.02
Amigo113: posts big blind $0.05
*** HOLE CARDS ***
Dealt to HubertusB [7s Jh]
djronalein: raises $0.10 to $0.15
HubertusB: folds 
chilean777: folds 
sw11223: calls $0.15
chip-runn474: calls $0.13
Amigo113: folds 
*** FLOP *** [9c 8s 3c]
chip-runn474: checks 
djronalein: checks 
sw11223: checks 
*** TURN *** [9c 8s 3c] [6s]
chip-runn474: checks 
djronalein: checks 
sw11223: checks 
*** RIVER *** [9c 8s 3c 6s] [9d]
chip-runn474: checks 
djronalein: checks 
sw11223: checks 
*** SHOW DOWN ***
chip-runn474: shows [Tc As] (a pair of Nines)
djronalein: mucks hand 
sw11223: shows [Qh Ah] (a pair of Nines - Ace+Queen kicker)
sw11223 collected $0.48 from pot
*** SUMMARY ***
Total pot $0.50 | Rake $0.02 
Board [9c 8s 3c 6s 9d]
Seat 1: sw11223 (button) showed [Qh Ah] and won ($0.48) with a pair of Nines
Seat 2: chip-runn474 (small blind) showed [Tc As] and lost with a pair of Nines
Seat 3: Amigo113 (big blind) folded before Flop
Seat 4: djronalein mucked [Qs Kd]
Seat 5: HubertusB folded before Flop (didn't bet)
Seat 6: chilean777 folded before Flop (didn't bet)



PokerStars Zoom Hand #178481924016:  Hold'em No Limit ($0.02/$0.05) - 2017/11/20 20:53:07 CCT [2017/11/20 7:53:07 ET]
Table 'Donati' 6-max Seat #1 is the button
Seat 1: Muurzik ($5.67 in chips) 
Seat 2: GFL-23 ($5.07 in chips) 
Seat 3: zetlife ($5.07 in chips) 
Seat 4: HubertusB ($2.54 in chips) 
Seat 5: Curtix1023 ($5.52 in chips) 
Seat 6: Dima4ka001 ($5.06 in chips) 
GFL-23: posts small blind $0.02
zetlife: posts big blind $0.05
*** HOLE CARDS ***
Dealt to HubertusB [Ac 9c]
HubertusB: raises $0.06 to $0.11
Curtix1023: folds 
Dima4ka001: calls $0.11
Muurzik: folds 
GFL-23: folds 
zetlife: calls $0.06
*** FLOP *** [Jd Tc 5h]
zetlife: checks 
HubertusB: checks 
Dima4ka001: checks 
*** TURN *** [Jd Tc 5h] [2c]
zetlife: checks 
HubertusB: bets $0.25
Dima4ka001: folds 
zetlife: folds 
Uncalled bet ($0.25) returned to HubertusB
HubertusB collected $0.34 from pot
HubertusB: doesn't show hand 
*** SUMMARY ***
Total pot $0.35 | Rake $0.01 
Board [Jd Tc 5h 2c]
Seat 1: Muurzik (button) folded before Flop (didn't bet)
Seat 2: GFL-23 (small blind) folded before Flop
Seat 3: zetlife (big blind) folded on the Turn
Seat 4: HubertusB collected ($0.34)
Seat 5: Curtix1023 folded before Flop (didn't bet)
Seat 6: Dima4ka001 folded on the Turn



PokerStars Zoom Hand #178481938926:  Hold'em No Limit ($0.02/$0.05) - 2017/11/20 20:53:40 CCT [2017/11/20 7:53:40 ET]
Table 'Donati' 6-max Seat #1 is the button
Seat 1: gbdie ($5.03 in chips) 
Seat 2: HubertusB ($2.77 in chips) 
Seat 3: C0!3r@ ($7.05 in chips) 
Seat 4: viggli ($5 in chips) 
Seat 5: vcf2013 ($5 in chips) 
Seat 6: Duboin ($6.70 in chips) 
HubertusB: posts small blind $0.02
C0!3r@: posts big blind $0.05
*** HOLE CARDS ***
Dealt to HubertusB [5s Js]
viggli: folds 
vcf2013: folds 
Duboin: folds 
gbdie: folds 
HubertusB: folds 
Uncalled bet ($0.03) returned to C0!3r@
C0!3r@ collected $0.04 from pot
C0!3r@: doesn't show hand 
*** SUMMARY ***
Total pot $0.04 | Rake $0 
Seat 1: gbdie (button) folded before Flop (didn't bet)
Seat 2: HubertusB (small blind) folded before Flop
Seat 3: C0!3r@ (big blind) collected ($0.04)
Seat 4: viggli folded before Flop (didn't bet)
Seat 5: vcf2013 folded before Flop (didn't bet)
Seat 6: Duboin folded before Flop (didn't bet)



PokerStars Zoom Hand #178481946469:  Hold'em No Limit ($0.02/$0.05) - 2017/11/20 20:53:57 CCT [2017/11/20 7:53:57 ET]
Table 'Donati' 6-max Seat #1 is the button
Seat 1: Amigo113 ($5 in chips) 
Seat 2: With_no_Pain ($5.81 in chips) 
Seat 3: zetlife ($5 in chips) 
Seat 4: bassxsp ($5.51 in chips) 
Seat 5: KindandBad77 ($5.06 in chips) 
Seat 6: HubertusB ($2.75 in chips) 
With_no_Pain: posts small blind $0.02
zetlife: posts big blind $0.05
*** HOLE CARDS ***
Dealt to HubertusB [Jd Ad]
bassxsp: folds 
KindandBad77: folds 
HubertusB: raises $0.07 to $0.12
Amigo113: folds 
With_no_Pain: folds 
zetlife: folds 
Uncalled bet ($0.07) returned to HubertusB
HubertusB collected $0.12 from pot
HubertusB: doesn't show hand 
*** SUMMARY ***
Total pot $0.12 | Rake $0 
Seat 1: Amigo113 (button) folded before Flop (didn't bet)
Seat 2: With_no_Pain (small blind) folded before Flop
Seat 3: zetlife (big blind) folded before Flop
Seat 4: bassxsp folded before Flop (didn't bet)
Seat 5: KindandBad77 folded before Flop (didn't bet)
Seat 6: HubertusB collected ($0.12)



PokerStars Zoom Hand #178481941631:  Hold'em No Limit ($0.02/$0.05) - 2017/11/20 20:53:46 CCT [2017/11/20 7:53:46 ET]
Table 'Donati' 6-max Seat #1 is the button
Seat 1: HubertusB ($2.75 in chips) 
Seat 2: Spartiat993 ($5.04 in chips) 
Seat 3: falcao991 ($5 in chips) 
Seat 4: Sanek19911 ($7.05 in chips) 
Seat 5: serhio77 ($5.99 in chips) 
Seat 6: Kluch2017 ($15.33 in chips) 
Spartiat993: posts small blind $0.02
falcao991: posts big blind $0.05
*** HOLE CARDS ***
Dealt to HubertusB [Js Kh]
Sanek19911: raises $0.10 to $0.15
serhio77: folds 
Kluch2017: calls $0.15
HubertusB: folds 
Spartiat993: folds 
falcao991: folds 
*** FLOP *** [4c 9s 5d]
Sanek19911: bets $0.26
Kluch2017: folds 
Uncalled bet ($0.26) returned to Sanek19911
Sanek19911 collected $0.35 from pot
Sanek19911: doesn't show hand 
*** SUMMARY ***
Total pot $0.37 | Rake $0.02 
Board [4c 9s 5d]
Seat 1: HubertusB (button) folded before Flop (didn't bet)
Seat 2: Spartiat993 (small blind) folded before Flop
Seat 3: falcao991 (big blind) folded before Flop
Seat 4: Sanek19911 collected ($0.35)
Seat 5: serhio77 folded before Flop (didn't bet)
Seat 6: Kluch2017 folded on the Flop



PokerStars Zoom Hand #178481936694:  Hold'em No Limit ($0.02/$0.05) - 2017/11/20 20:53:35 CCT [2017/11/20 7:53:35 ET]
Table 'Donati' 6-max Seat #1 is the button
Seat 1: djben2005 ($6.61 in chips) 
Seat 2: Marka555 ($4.95 in chips) 
Seat 3: vanek-95all@ ($7.35 in chips) 
Seat 4: HubertusB ($2.77 in chips) 
Seat 5: PsBadBluff ($5.44 in chips) 
Seat 6: Kileak99 ($3.91 in chips) 
Marka555: posts small blind $0.02
vanek-95all@: posts big blind $0.05
*** HOLE CARDS ***
Dealt to HubertusB [5h Kc]
HubertusB: folds 
PsBadBluff: folds 
Kileak99: folds 
djben2005: raises $0.07 to $0.12
Marka555: folds 
vanek-95all@: calls $0.07
*** FLOP *** [6d 3h 2d]
vanek-95all@: checks 
djben2005: checks 
*** TURN *** [6d 3h 2d] [2c]
vanek-95all@: checks 
djben2005: checks 
*** RIVER *** [6d 3h 2d 2c] [9d]
vanek-95all@: bets $0.15
djben2005: calls $0.15
*** SHOW DOWN ***
vanek-95all@: shows [As 9s] (two pair, Nines and Deuces)
djben2005: mucks hand 
vanek-95all@ collected $0.54 from pot
*** SUMMARY ***
Total pot $0.56 | Rake $0.02 
Board [6d 3h 2d 2c 9d]
Seat 1: djben2005 (button) mucked [Ac 7d]
Seat 2: Marka555 (small blind) folded before Flop
Seat 3: vanek-95all@ (big blind) showed [As 9s] and won ($0.54) with two pair, Nines and Deuces
Seat 4: HubertusB folded before Flop (didn't bet)
Seat 5: PsBadBluff folded before Flop (didn't bet)
Seat 6: Kileak99 folded before Flop (didn't bet)



PokerStars Zoom Hand #178481953398:  Hold'em No Limit ($0.02/$0.05) - 2017/11/20 20:54:12 CCT [2017/11/20 7:54:12 ET]
Table 'Donati' 6-max Seat #1 is the button
Seat 1: paxton2468 ($9.99 in chips) 
Seat 2: Party Fishy ($5.02 in chips) 
Seat 3: FBI 2014 ($21.94 in chips) 
Seat 4: Card_Sharp78 ($6.54 in chips) 
Seat 5: HubertusB ($2.82 in chips) 
Seat 6: simple s0o ($5.34 in chips) 
Party Fishy: posts small blind $0.02
FBI 2014: posts big blind $0.05
*** HOLE CARDS ***
Dealt to HubertusB [7c Ac]
Card_Sharp78: folds 
HubertusB: raises $0.05 to $0.10
simple s0o: folds 
paxton2468: folds 
Party Fishy: folds 
FBI 2014: calls $0.05
*** FLOP *** [4s 6d Jd]
FBI 2014: checks 
HubertusB: bets $0.12
FBI 2014: calls $0.12
*** TURN *** [4s 6d Jd] [Ah]
FBI 2014: checks 
HubertusB: bets $0.25
FBI 2014: folds 
Uncalled bet ($0.25) returned to HubertusB
HubertusB collected $0.44 from pot
HubertusB: doesn't show hand 
*** SUMMARY ***
Total pot $0.46 | Rake $0.02 
Board [4s 6d Jd Ah]
Seat 1: paxton2468 (button) folded before Flop (didn't bet)
Seat 2: Party Fishy (small blind) folded before Flop
Seat 3: FBI 2014 (big blind) folded on the Turn
Seat 4: Card_Sharp78 folded before Flop (didn't bet)
Seat 5: HubertusB collected ($0.44)
Seat 6: simple s0o folded before Flop (didn't bet)



PokerStars Zoom Hand #178481970110:  Hold'em No Limit ($0.02/$0.05) - 2017/11/20 20:54:49 CCT [2017/11/20 7:54:49 ET]
Table 'Donati' 6-max Seat #1 is the button
Seat 1: AlexDeLargee ($5 in chips) 
Seat 2: sinyong0709 ($4.60 in chips) 
Seat 3: HubertusB ($3.04 in chips) 
Seat 4: RenningStone ($11.44 in chips) 
Seat 5: kostya5410 ($9.83 in chips) 
Seat 6: sarychevss ($4.25 in chips) 
sinyong0709: posts small blind $0.02
HubertusB: posts big blind $0.05
*** HOLE CARDS ***
Dealt to HubertusB [4s 7d]
RenningStone: folds 
kostya5410: folds 
sarychevss: folds 
AlexDeLargee: folds 
sinyong0709: folds 
Uncalled bet ($0.03) returned to HubertusB
HubertusB collected $0.04 from pot
HubertusB: doesn't show hand 
*** SUMMARY ***
Total pot $0.04 | Rake $0 
Seat 1: AlexDeLargee (button) folded before Flop (didn't bet)
Seat 2: sinyong0709 (small blind) folded before Flop
Seat 3: HubertusB (big blind) collected ($0.04)
Seat 4: RenningStone folded before Flop (didn't bet)
Seat 5: kostya5410 folded before Flop (didn't bet)
Seat 6: sarychevss folded before Flop (didn't bet)



PokerStars Zoom Hand #178481974228:  Hold'em No Limit ($0.02/$0.05) - 2017/11/20 20:54:58 CCT [2017/11/20 7:54:58 ET]
Table 'Donati' 6-max Seat #1 is the button
Seat 1: botrobot777 ($5.27 in chips) 
Seat 2: Oberon63 ($5 in chips) 
Seat 3: grosman1409 ($4.79 in chips) 
Seat 4: andron-mx ($2.26 in chips) 
Seat 5: HubertusB ($3.06 in chips) 
Seat 6: ProTeamjan ($2.21 in chips) 
Oberon63: posts small blind $0.02
grosman1409: posts big blind $0.05
*** HOLE CARDS ***
Dealt to HubertusB [8h 5c]
andron-mx: folds 
HubertusB: folds 
ProTeamjan: folds 
botrobot777: folds 
Oberon63: folds 
Uncalled bet ($0.03) returned to grosman1409
grosman1409 collected $0.04 from pot
grosman1409: doesn't show hand 
*** SUMMARY ***
Total pot $0.04 | Rake $0 
Seat 1: botrobot777 (button) folded before Flop (didn't bet)
Seat 2: Oberon63 (small blind) folded before Flop
Seat 3: grosman1409 (big blind) collected ($0.04)
Seat 4: andron-mx folded before Flop (didn't bet)
Seat 5: HubertusB folded before Flop (didn't bet)
Seat 6: ProTeamjan folded before Flop (didn't bet)



PokerStars Zoom Hand #178481976865:  Hold'em No Limit ($0.02/$0.05) - 2017/11/20 20:55:04 CCT [2017/11/20 7:55:04 ET]
Table 'Donati' 6-max Seat #1 is the button
Seat 1: hceyms ($5.27 in chips) 
Seat 2: HubertusB ($3.06 in chips) 
Seat 3: Acedan1369 ($19.05 in chips) 
Seat 4: Djonoff ($3.46 in chips) 
Seat 5: popey1977 ($4.34 in chips) 
Seat 6: sahok677 ($3.37 in chips) 
HubertusB: posts small blind $0.02
Acedan1369: posts big blind $0.05
*** HOLE CARDS ***
Dealt to HubertusB [Jc 2c]
Djonoff: raises $0.05 to $0.10
popey1977: folds 
sahok677: folds 
hceyms: folds 
HubertusB: folds 
Acedan1369: folds 
Uncalled bet ($0.05) returned to Djonoff
Djonoff collected $0.12 from pot
Djonoff: doesn't show hand 
*** SUMMARY ***
Total pot $0.12 | Rake $0 
Seat 1: hceyms (button) folded before Flop (didn't bet)
Seat 2: HubertusB (small blind) folded before Flop
Seat 3: Acedan1369 (big blind) folded before Flop
Seat 4: Djonoff collected ($0.12)
Seat 5: popey1977 folded before Flop (didn't bet)
Seat 6: sahok677 folded before Flop (didn't bet)



PokerStars Zoom Hand #178481979298:  Hold'em No Limit ($0.02/$0.05) - 2017/11/20 20:55:10 CCT [2017/11/20 7:55:10 ET]
Table 'Donati' 6-max Seat #1 is the button
Seat 1: dark h0r$e ($10.14 in chips) 
Seat 2: SskyAngel ($8.62 in chips) 
Seat 3: Tamik05 ($10.42 in chips) 
Seat 4: p3rf3ct00 ($6.42 in chips) 
Seat 5: jochenfratz ($8.51 in chips) 
Seat 6: HubertusB ($3.04 in chips) 
SskyAngel: posts small blind $0.02
Tamik05: posts big blind $0.05
*** HOLE CARDS ***
Dealt to HubertusB [2d Ac]
p3rf3ct00: folds 
jochenfratz: folds 
HubertusB: folds 
dark h0r$e: folds 
SskyAngel: folds 
Uncalled bet ($0.03) returned to Tamik05
Tamik05 collected $0.04 from pot
Tamik05: doesn't show hand 
*** SUMMARY ***
Total pot $0.04 | Rake $0 
Seat 1: dark h0r$e (button) folded before Flop (didn't bet)
Seat 2: SskyAngel (small blind) folded before Flop
Seat 3: Tamik05 (big blind) collected ($0.04)
Seat 4: p3rf3ct00 folded before Flop (didn't bet)
Seat 5: jochenfratz folded before Flop (didn't bet)
Seat 6: HubertusB folded before Flop (didn't bet)



PokerStars Zoom Hand #178481981285:  Hold'em No Limit ($0.02/$0.05) - 2017/11/20 20:55:15 CCT [2017/11/20 7:55:15 ET]
Table 'Donati' 6-max Seat #1 is the button
Seat 1: HubertusB ($3.04 in chips) 
Seat 2: RinkoYamada ($11.10 in chips) 
Seat 3: Karat_BLR ($7.40 in chips) 
Seat 4: p3rf3ct00 ($9.24 in chips) 
Seat 5: Maxim55440 ($6.71 in chips) 
Seat 6: ev[gen1y]b ($7.11 in chips) 
RinkoYamada: posts small blind $0.02
Karat_BLR: posts big blind $0.05
*** HOLE CARDS ***
Dealt to HubertusB [Kd 9c]
p3rf3ct00: folds 
Maxim55440: calls $0.05
ev[gen1y]b: raises $0.11 to $0.16
HubertusB: folds 
RinkoYamada: folds 
Karat_BLR: folds 
Maxim55440: calls $0.11
*** FLOP *** [3c Ac 5s]
Maxim55440: checks 
ev[gen1y]b: bets $0.20
Maxim55440: calls $0.20
*** TURN *** [3c Ac 5s] [2s]
Maxim55440: checks 
ev[gen1y]b: checks 
*** RIVER *** [3c Ac 5s 2s] [6h]
Maxim55440: checks 
ev[gen1y]b: checks 
*** SHOW DOWN ***
Maxim55440: shows [2h 7h] (a pair of Deuces)
ev[gen1y]b: mucks hand 
Maxim55440 collected $0.76 from pot
*** SUMMARY ***
Total pot $0.79 | Rake $0.03 
Board [3c Ac 5s 2s 6h]
Seat 1: HubertusB (button) folded before Flop (didn't bet)
Seat 2: RinkoYamada (small blind) folded before Flop
Seat 3: Karat_BLR (big blind) folded before Flop
Seat 4: p3rf3ct00 folded before Flop (didn't bet)
Seat 5: Maxim55440 showed [2h 7h] and won ($0.76) with a pair of Deuces
Seat 6: ev[gen1y]b mucked [Jd Kc]



PokerStars Zoom Hand #178481986859:  Hold'em No Limit ($0.02/$0.05) - 2017/11/20 20:55:29 CCT [2017/11/20 7:55:29 ET]
Table 'Donati' 6-max Seat #1 is the button
Seat 1: Kileak99 ($3.91 in chips) 
Seat 2: crappyquads ($12.16 in chips) 
Seat 3: Muurzik ($5.75 in chips) 
Seat 4: HubertusB ($3.04 in chips) 
Seat 5: TsaturianAA ($5.55 in chips) 
Seat 6: richardvelp ($4.55 in chips) 
crappyquads: posts small blind $0.02
Muurzik: posts big blind $0.05
*** HOLE CARDS ***
Dealt to HubertusB [3d 7h]
HubertusB: folds 
TsaturianAA: folds 
richardvelp: calls $0.05
Kileak99: folds 
crappyquads: folds 
Muurzik: checks 
*** FLOP *** [7d 4c Jh]
Muurzik: checks 
richardvelp: checks 
*** TURN *** [7d 4c Jh] [5s]
Muurzik: checks 
richardvelp: checks 
*** RIVER *** [7d 4c Jh 5s] [Kd]
Muurzik: checks 
richardvelp: bets $0.30
Muurzik: folds 
Uncalled bet ($0.30) returned to richardvelp
richardvelp collected $0.12 from pot
richardvelp: doesn't show hand 
*** SUMMARY ***
Total pot $0.12 | Rake $0 
Board [7d 4c Jh 5s Kd]
Seat 1: Kileak99 (button) folded before Flop (didn't bet)
Seat 2: crappyquads (small blind) folded before Flop
Seat 3: Muurzik (big blind) folded on the River
Seat 4: HubertusB folded before Flop (didn't bet)
Seat 5: TsaturianAA folded before Flop (didn't bet)
Seat 6: richardvelp collected ($0.12)



PokerStars Zoom Hand #178481989341:  Hold'em No Limit ($0.02/$0.05) - 2017/11/20 20:55:35 CCT [2017/11/20 7:55:35 ET]
Table 'Donati' 6-max Seat #1 is the button
Seat 1: DROFNEBMAS ($5.34 in chips) 
Seat 2: Oberon63 ($5 in chips) 
Seat 3: Noen ($4.22 in chips) 
Seat 4: HubertusB ($3.04 in chips) 
Seat 5: 1841313 ($2.91 in chips) 
Seat 6: p3rf3ct00 ($5.27 in chips) 
Oberon63: posts small blind $0.02
Noen: posts big blind $0.05
*** HOLE CARDS ***
Dealt to HubertusB [As 7s]
HubertusB: raises $0.05 to $0.10
1841313: calls $0.10
p3rf3ct00: folds 
DROFNEBMAS: raises $0.40 to $0.50
Oberon63: folds 
Noen: folds 
HubertusB: folds 
1841313: folds 
Uncalled bet ($0.40) returned to DROFNEBMAS
DROFNEBMAS collected $0.37 from pot
DROFNEBMAS: doesn't show hand 
*** SUMMARY ***
Total pot $0.37 | Rake $0 
Seat 1: DROFNEBMAS (button) collected ($0.37)
Seat 2: Oberon63 (small blind) folded before Flop
Seat 3: Noen (big blind) folded before Flop
Seat 4: HubertusB folded before Flop
Seat 5: 1841313 folded before Flop
Seat 6: p3rf3ct00 folded before Flop (didn't bet)



PokerStars Zoom Hand #178482001754:  Hold'em No Limit ($0.02/$0.05) - 2017/11/20 20:56:06 CCT [2017/11/20 7:56:06 ET]
Table 'Donati' 6-max Seat #1 is the button
Seat 1: crappyquads ($5.40 in chips) 
Seat 2: FBI 2014 ($21.60 in chips) 
Seat 3: HubertusB ($2.94 in chips) 
Seat 4: Sanek19911 ($6.85 in chips) 
Seat 5: 3iourou ($5.73 in chips) 
Seat 6: Noen ($5.02 in chips) 
FBI 2014: posts small blind $0.02
HubertusB: posts big blind $0.05
*** HOLE CARDS ***
Dealt to HubertusB [3c Ad]
Sanek19911: folds 
3iourou: folds 
Noen: folds 
crappyquads: raises $0.06 to $0.11
FBI 2014: folds 
HubertusB: folds 
Uncalled bet ($0.06) returned to crappyquads
crappyquads collected $0.12 from pot
crappyquads: doesn't show hand 
*** SUMMARY ***
Total pot $0.12 | Rake $0 
Seat 1: crappyquads (button) collected ($0.12)
Seat 2: FBI 2014 (small blind) folded before Flop
Seat 3: HubertusB (big blind) folded before Flop
Seat 4: Sanek19911 folded before Flop (didn't bet)
Seat 5: 3iourou folded before Flop (didn't bet)
Seat 6: Noen folded before Flop (didn't bet)



PokerStars Zoom Hand #178482005808:  Hold'em No Limit ($0.02/$0.05) - 2017/11/20 20:56:16 CCT [2017/11/20 7:56:16 ET]
Table 'Donati' 6-max Seat #1 is the button
Seat 1: Oliana88 ($5 in chips) 
Seat 2: HubertusB ($2.89 in chips) 
Seat 3: Centurion7/1 ($6.83 in chips) 
Seat 4: agatha179 ($4.71 in chips) 
Seat 5: Noen ($5 in chips) 
Seat 6: Zire99 ($6.47 in chips) 
HubertusB: posts small blind $0.02
Centurion7/1: posts big blind $0.05
*** HOLE CARDS ***
Dealt to HubertusB [Ac 2h]
agatha179: folds 
Noen: raises $0.10 to $0.15
Zire99: folds 
Oliana88: folds 
HubertusB: folds 
Centurion7/1: folds 
Uncalled bet ($0.10) returned to Noen
Noen collected $0.12 from pot
Noen: doesn't show hand 
*** SUMMARY ***
Total pot $0.12 | Rake $0 
Seat 1: Oliana88 (button) folded before Flop (didn't bet)
Seat 2: HubertusB (small blind) folded before Flop
Seat 3: Centurion7/1 (big blind) folded before Flop
Seat 4: agatha179 folded before Flop (didn't bet)
Seat 5: Noen collected ($0.12)
Seat 6: Zire99 folded before Flop (didn't bet)



PokerStars Zoom Hand #178482009404:  Hold'em No Limit ($0.02/$0.05) - 2017/11/20 20:56:25 CCT [2017/11/20 7:56:25 ET]
Table 'Donati' 6-max Seat #1 is the button
Seat 1: HubertusB ($2.87 in chips) 
Seat 2: ayhshhh ($5.09 in chips) 
Seat 3: ALazarev157 ($9.40 in chips) 
Seat 4: AndreasAU79 ($5.60 in chips) 
Seat 5: sepik200 ($7.93 in chips) 
Seat 6: akazonae ($5.12 in chips) 
ayhshhh: posts small blind $0.02
ALazarev157: posts big blind $0.05
*** HOLE CARDS ***
Dealt to HubertusB [5h 4c]
AndreasAU79: folds 
sepik200: folds 
akazonae: folds 
HubertusB: raises $0.05 to $0.10
ayhshhh: folds 
ALazarev157: folds 
Uncalled bet ($0.05) returned to HubertusB
HubertusB collected $0.12 from pot
HubertusB: doesn't show hand 
*** SUMMARY ***
Total pot $0.12 | Rake $0 
Seat 1: HubertusB (button) collected ($0.12)
Seat 2: ayhshhh (small blind) folded before Flop
Seat 3: ALazarev157 (big blind) folded before Flop
Seat 4: AndreasAU79 folded before Flop (didn't bet)
Seat 5: sepik200 folded before Flop (didn't bet)
Seat 6: akazonae folded before Flop (didn't bet)



PokerStars Zoom Hand #178482015096:  Hold'em No Limit ($0.02/$0.05) - 2017/11/20 20:56:39 CCT [2017/11/20 7:56:39 ET]
Table 'Donati' 6-max Seat #1 is the button
Seat 1: dellefars ($5.35 in chips) 
Seat 2: ALazarev157 ($9.35 in chips) 
Seat 3: djronalein ($16.12 in chips) 
Seat 4: SskyAngel ($8.46 in chips) 
Seat 5: HubertusB ($2.94 in chips) 
Seat 6: 3iourou ($5.14 in chips) 
ALazarev157: posts small blind $0.02
djronalein: posts big blind $0.05
*** HOLE CARDS ***
Dealt to HubertusB [6c Kd]
SskyAngel: folds 
HubertusB: folds 
3iourou: folds 
dellefars: raises $0.10 to $0.15
ALazarev157: folds 
djronalein: folds 
Uncalled bet ($0.10) returned to dellefars
dellefars collected $0.12 from pot
dellefars: doesn't show hand 
*** SUMMARY ***
Total pot $0.12 | Rake $0 
Seat 1: dellefars (button) collected ($0.12)
Seat 2: ALazarev157 (small blind) folded before Flop
Seat 3: djronalein (big blind) folded before Flop
Seat 4: SskyAngel folded before Flop (didn't bet)
Seat 5: HubertusB folded before Flop (didn't bet)
Seat 6: 3iourou folded before Flop (didn't bet)



PokerStars Zoom Hand #178482020798:  Hold'em No Limit ($0.02/$0.05) - 2017/11/20 20:56:53 CCT [2017/11/20 7:56:53 ET]
Table 'Donati' 6-max Seat #1 is the button
Seat 1: gbdie ($5.81 in chips) 
Seat 2: Akutagawa ($5.43 in chips) 
Seat 3: tigerrrrli ($9.68 in chips) 
Seat 4: HubertusB ($2.94 in chips) 
Seat 5: kita8444 ($6.15 in chips) 
Seat 6: ayhshhh ($30.51 in chips) 
Akutagawa: posts small blind $0.02
tigerrrrli: posts big blind $0.05
*** HOLE CARDS ***
Dealt to HubertusB [3s 5h]
HubertusB: folds 
kita8444: folds 
ayhshhh: folds 
gbdie: raises $0.05 to $0.10
Akutagawa: folds 
tigerrrrli: folds 
Uncalled bet ($0.05) returned to gbdie
gbdie collected $0.12 from pot
gbdie: doesn't show hand 
*** SUMMARY ***
Total pot $0.12 | Rake $0 
Seat 1: gbdie (button) collected ($0.12)
Seat 2: Akutagawa (small blind) folded before Flop
Seat 3: tigerrrrli (big blind) folded before Flop
Seat 4: HubertusB folded before Flop (didn't bet)
Seat 5: kita8444 folded before Flop (didn't bet)
Seat 6: ayhshhh folded before Flop (didn't bet)



PokerStars Zoom Hand #178482017974:  Hold'em No Limit ($0.02/$0.05) - 2017/11/20 20:56:46 CCT [2017/11/20 7:56:46 ET]
Table 'Donati' 6-max Seat #1 is the button
Seat 1: PsBadBluff ($5 in chips) 
Seat 2: ayhshhh ($11.72 in chips) 
Seat 3: Polypops ($5.62 in chips) 
Seat 4: AverianovA ($5 in chips) 
Seat 5: FriskyBear ($5.26 in chips) 
Seat 6: HubertusB ($2.94 in chips) 
ayhshhh: posts small blind $0.02
Polypops: posts big blind $0.05
*** HOLE CARDS ***
Dealt to HubertusB [5c 8s]
AverianovA: raises $0.10 to $0.15
FriskyBear: calls $0.15
HubertusB: folds 
PsBadBluff: folds 
ayhshhh: folds 
Polypops: folds 
*** FLOP *** [5h 6d 7s]
AverianovA: checks 
FriskyBear: bets $0.20
AverianovA: folds 
Uncalled bet ($0.20) returned to FriskyBear
FriskyBear collected $0.35 from pot
FriskyBear: doesn't show hand 
*** SUMMARY ***
Total pot $0.37 | Rake $0.02 
Board [5h 6d 7s]
Seat 1: PsBadBluff (button) folded before Flop (didn't bet)
Seat 2: ayhshhh (small blind) folded before Flop
Seat 3: Polypops (big blind) folded before Flop
Seat 4: AverianovA folded on the Flop
Seat 5: FriskyBear collected ($0.35)
Seat 6: HubertusB folded before Flop (didn't bet)



PokerStars Zoom Hand #178482023993:  Hold'em No Limit ($0.02/$0.05) - 2017/11/20 20:57:01 CCT [2017/11/20 7:57:01 ET]
Table 'Donati' 6-max Seat #1 is the button
Seat 1: sharonstone8 ($6.90 in chips) 
Seat 2: zybopatolog ($3.70 in chips) 
Seat 3: HubertusB ($2.94 in chips) 
Seat 4: sidandrei ($2.67 in chips) 
Seat 5: sw11223 ($8.10 in chips) 
Seat 6: Le Bicois ($8.39 in chips) 
zybopatolog: posts small blind $0.02
HubertusB: posts big blind $0.05
*** HOLE CARDS ***
Dealt to HubertusB [Js Kh]
sidandrei: folds 
sw11223: folds 
Le Bicois: raises $0.10 to $0.15
sharonstone8: calls $0.15
zybopatolog: calls $0.13
HubertusB: calls $0.10
*** FLOP *** [Qd 3c 2h]
zybopatolog: checks 
HubertusB: checks 
Le Bicois: bets $0.29
sharonstone8: calls $0.29
zybopatolog: folds 
HubertusB: folds 
*** TURN *** [Qd 3c 2h] [Jc]
Le Bicois: checks 
sharonstone8: checks 
*** RIVER *** [Qd 3c 2h Jc] [Ks]
Le Bicois: checks 
sharonstone8: bets $0.15
Le Bicois: calls $0.15
*** SHOW DOWN ***
sharonstone8: shows [Qh 6h] (a pair of Queens)
Le Bicois: mucks hand 
sharonstone8 collected $1.42 from pot
*** SUMMARY ***
Total pot $1.48 | Rake $0.06 
Board [Qd 3c 2h Jc Ks]
Seat 1: sharonstone8 (button) showed [Qh 6h] and won ($1.42) with a pair of Queens
Seat 2: zybopatolog (small blind) folded on the Flop
Seat 3: HubertusB (big blind) folded on the Flop
Seat 4: sidandrei folded before Flop (didn't bet)
Seat 5: sw11223 folded before Flop (didn't bet)
Seat 6: Le Bicois mucked [7h Jd]



PokerStars Zoom Hand #178482045155:  Hold'em No Limit ($0.02/$0.05) - 2017/11/20 20:57:54 CCT [2017/11/20 7:57:54 ET]
Table 'Donati' 6-max Seat #1 is the button
Seat 1: HubertusB ($2.77 in chips) 
Seat 2: MAAXIIMUSS ($4.91 in chips) 
Seat 3: p3rf3ct00 ($5.13 in chips) 
Seat 4: kram189 ($5.32 in chips) 
Seat 5: Mikos108 ($5.07 in chips) 
Seat 6: nervss ($8.08 in chips) 
MAAXIIMUSS: posts small blind $0.02
p3rf3ct00: posts big blind $0.05
*** HOLE CARDS ***
Dealt to HubertusB [8c 3h]
kram189: folds 
Mikos108: folds 
nervss: folds 
HubertusB: folds 
MAAXIIMUSS: calls $0.03
p3rf3ct00: raises $0.15 to $0.20
MAAXIIMUSS: calls $0.15
*** FLOP *** [3d 6h 8s]
MAAXIIMUSS: checks 
p3rf3ct00: bets $0.16
MAAXIIMUSS: calls $0.16
*** TURN *** [3d 6h 8s] [Kd]
MAAXIIMUSS: checks 
p3rf3ct00: bets $0.42
MAAXIIMUSS: calls $0.42
*** RIVER *** [3d 6h 8s Kd] [2c]
MAAXIIMUSS: checks 
p3rf3ct00: bets $0.65
MAAXIIMUSS: calls $0.65
*** SHOW DOWN ***
p3rf3ct00: shows [As Ac] (a pair of Aces)
MAAXIIMUSS: mucks hand 
p3rf3ct00 collected $2.74 from pot
*** SUMMARY ***
Total pot $2.86 | Rake $0.12 
Board [3d 6h 8s Kd 2c]
Seat 1: HubertusB (button) folded before Flop (didn't bet)
Seat 2: MAAXIIMUSS (small blind) mucked [Qs Kh]
Seat 3: p3rf3ct00 (big blind) showed [As Ac] and won ($2.74) with a pair of Aces
Seat 4: kram189 folded before Flop (didn't bet)
Seat 5: Mikos108 folded before Flop (didn't bet)
Seat 6: nervss folded before Flop (didn't bet)



PokerStars Zoom Hand #178482039192:  Hold'em No Limit ($0.02/$0.05) - 2017/11/20 20:57:39 CCT [2017/11/20 7:57:39 ET]
Table 'Donati' 6-max Seat #1 is the button
Seat 1: Acedan1369 ($26.38 in chips) 
Seat 2: HubertusB ($2.79 in chips) 
Seat 3: seawolf111 ($4.83 in chips) 
Seat 4: D.Korz ($2.24 in chips) 
Seat 5: lexus00174 ($9.03 in chips) 
Seat 6: vcf2013 ($5 in chips) 
HubertusB: posts small blind $0.02
seawolf111: posts big blind $0.05
*** HOLE CARDS ***
Dealt to HubertusB [4s 8h]
D.Korz: raises $0.10 to $0.15
lexus00174: calls $0.15
vcf2013: folds 
Acedan1369: folds 
HubertusB: folds 
seawolf111: folds 
*** FLOP *** [3d 4c 6d]
D.Korz: bets $0.15
lexus00174: calls $0.15
*** TURN *** [3d 4c 6d] [2s]
D.Korz: bets $0.20
lexus00174: calls $0.20
*** RIVER *** [3d 4c 6d 2s] [Qc]
D.Korz: bets $0.40
lexus00174: folds 
Uncalled bet ($0.40) returned to D.Korz
D.Korz collected $1.03 from pot
D.Korz: doesn't show hand 
*** SUMMARY ***
Total pot $1.07 | Rake $0.04 
Board [3d 4c 6d 2s Qc]
Seat 1: Acedan1369 (button) folded before Flop (didn't bet)
Seat 2: HubertusB (small blind) folded before Flop
Seat 3: seawolf111 (big blind) folded before Flop
Seat 4: D.Korz collected ($1.03)
Seat 5: lexus00174 folded on the River
Seat 6: vcf2013 folded before Flop (didn't bet)



PokerStars Zoom Hand #178482041981:  Hold'em No Limit ($0.02/$0.05) - 2017/11/20 20:57:46 CCT [2017/11/20 7:57:46 ET]
Table 'Donati' 6-max Seat #1 is the button
Seat 1: 3p1i4 ($2.35 in chips) 
Seat 2: RiSk.Fortune ($5.91 in chips) 
Seat 3: chilean777 ($7.23 in chips) 
Seat 4: dellefars ($6.11 in chips) 
Seat 5: Roockie4Life ($6.72 in chips) 
Seat 6: HubertusB ($2.77 in chips) 
RiSk.Fortune: posts small blind $0.02
chilean777: posts big blind $0.05
*** HOLE CARDS ***
Dealt to HubertusB [Js 7s]
dellefars: folds 
Roockie4Life: folds 
HubertusB: folds 
3p1i4: folds 
RiSk.Fortune: raises $0.07 to $0.12
chilean777: calls $0.07
*** FLOP *** [6h 9s Jh]
RiSk.Fortune: bets $0.13
chilean777: calls $0.13
*** TURN *** [6h 9s Jh] [As]
RiSk.Fortune: checks 
chilean777: bets $0.22
RiSk.Fortune: folds 
Uncalled bet ($0.22) returned to chilean777
chilean777 collected $0.48 from pot
chilean777: doesn't show hand 
*** SUMMARY ***
Total pot $0.50 | Rake $0.02 
Board [6h 9s Jh As]
Seat 1: 3p1i4 (button) folded before Flop (didn't bet)
Seat 2: RiSk.Fortune (small blind) folded on the Turn
Seat 3: chilean777 (big blind) collected ($0.48)
Seat 4: dellefars folded before Flop (didn't bet)
Seat 5: Roockie4Life folded before Flop (didn't bet)
Seat 6: HubertusB folded before Flop (didn't bet)



PokerStars Zoom Hand #178482047562:  Hold'em No Limit ($0.02/$0.05) - 2017/11/20 20:58:00 CCT [2017/11/20 7:58:00 ET]
Table 'Donati' 6-max Seat #1 is the button
Seat 1: chester8676 ($4.78 in chips) 
Seat 2: ayhshhh ($12.55 in chips) 
Seat 3: HubertusB ($2.77 in chips) 
Seat 4: Loerus13 ($6.46 in chips) 
Seat 5: MrBigFish001 ($5 in chips) 
Seat 6: vcf2013 ($5.02 in chips) 
ayhshhh: posts small blind $0.02
HubertusB: posts big blind $0.05
*** HOLE CARDS ***
Dealt to HubertusB [7d 7c]
Loerus13: folds 
MrBigFish001: folds 
vcf2013: raises $0.05 to $0.10
chester8676: folds 
ayhshhh: folds 
HubertusB: calls $0.05
*** FLOP *** [6h 8c Jc]
HubertusB: checks 
vcf2013: bets $0.11
HubertusB: raises $0.24 to $0.35
vcf2013: calls $0.24
*** TURN *** [6h 8c Jc] [4h]
HubertusB: checks 
vcf2013: bets $0.29
HubertusB: raises $2.03 to $2.32 and is all-in
vcf2013: folds 
Uncalled bet ($2.03) returned to HubertusB
HubertusB collected $1.44 from pot
HubertusB: doesn't show hand 
*** SUMMARY ***
Total pot $1.50 | Rake $0.06 
Board [6h 8c Jc 4h]
Seat 1: chester8676 (button) folded before Flop (didn't bet)
Seat 2: ayhshhh (small blind) folded before Flop
Seat 3: HubertusB (big blind) collected ($1.44)
Seat 4: Loerus13 folded before Flop (didn't bet)
Seat 5: MrBigFish001 folded before Flop (didn't bet)
Seat 6: vcf2013 folded on the Turn



PokerStars Zoom Hand #178482075847:  Hold'em No Limit ($0.02/$0.05) - 2017/11/20 20:59:10 CCT [2017/11/20 7:59:10 ET]
Table 'Donati' 6-max Seat #1 is the button
Seat 1: YourTiltRush ($5 in chips) 
Seat 2: kostet100 ($5 in chips) 
Seat 3: bumbowski ($16.17 in chips) 
Seat 4: ev[gen1y]b ($5.22 in chips) 
Seat 5: IVANbI484 ($1.99 in chips) 
Seat 6: HubertusB ($3.47 in chips) 
kostet100: posts small blind $0.02
bumbowski: posts big blind $0.05
*** HOLE CARDS ***
Dealt to HubertusB [6d Ad]
ev[gen1y]b: folds 
IVANbI484: folds 
HubertusB: raises $0.05 to $0.10
YourTiltRush: folds 
kostet100: folds 
bumbowski: calls $0.05
*** FLOP *** [4s Ah 3c]
bumbowski: checks 
HubertusB: checks 
*** TURN *** [4s Ah 3c] [Ks]
bumbowski: bets $0.07
HubertusB: calls $0.07
*** RIVER *** [4s Ah 3c Ks] [7c]
bumbowski: bets $0.12
HubertusB: raises $0.23 to $0.35
bumbowski: folds 
Uncalled bet ($0.23) returned to HubertusB
HubertusB collected $0.58 from pot
HubertusB: doesn't show hand 
*** SUMMARY ***
Total pot $0.60 | Rake $0.02 
Board [4s Ah 3c Ks 7c]
Seat 1: YourTiltRush (button) folded before Flop (didn't bet)
Seat 2: kostet100 (small blind) folded before Flop
Seat 3: bumbowski (big blind) folded on the River
Seat 4: ev[gen1y]b folded before Flop (didn't bet)
Seat 5: IVANbI484 folded before Flop (didn't bet)
Seat 6: HubertusB collected ($0.58)



PokerStars Zoom Hand #178482073054:  Hold'em No Limit ($0.02/$0.05) - 2017/11/20 20:59:03 CCT [2017/11/20 7:59:03 ET]
Table 'Donati' 6-max Seat #1 is the button
Seat 1: super3min ($8.06 in chips) 
Seat 2: Le Bicois ($5.88 in chips) 
Seat 3: AndreasAU79 ($5.39 in chips) 
Seat 4: peposkitsos ($5.14 in chips) 
Seat 5: HubertusB ($3.47 in chips) 
Seat 6: Djonoff ($4.97 in chips) 
Le Bicois: posts small blind $0.02
AndreasAU79: posts big blind $0.05
*** HOLE CARDS ***
Dealt to HubertusB [Kd 9c]
peposkitsos: raises $0.10 to $0.15
HubertusB: folds 
Djonoff: calls $0.15
super3min: folds 
Le Bicois: folds 
AndreasAU79: calls $0.10
*** FLOP *** [Jd 7c 4d]
AndreasAU79: checks 
peposkitsos: checks 
Djonoff: checks 
*** TURN *** [Jd 7c 4d] [4h]
AndreasAU79: checks 
peposkitsos: checks 
Djonoff: checks 
*** RIVER *** [Jd 7c 4d 4h] [2s]
AndreasAU79: checks 
peposkitsos: bets $0.68
Djonoff: calls $0.68
AndreasAU79: folds 
*** SHOW DOWN ***
peposkitsos: shows [Qc Th] (a pair of Fours)
Djonoff: shows [Kh 2h] (two pair, Fours and Deuces)
Djonoff collected $1.75 from pot
*** SUMMARY ***
Total pot $1.83 | Rake $0.08 
Board [Jd 7c 4d 4h 2s]
Seat 1: super3min (button) folded before Flop (didn't bet)
Seat 2: Le Bicois (small blind) folded before Flop
Seat 3: AndreasAU79 (big blind) folded on the River
Seat 4: peposkitsos showed [Qc Th] and lost with a pair of Fours
Seat 5: HubertusB folded before Flop (didn't bet)
Seat 6: Djonoff showed [Kh 2h] and won ($1.75) with two pair, Fours and Deuces



PokerStars Zoom Hand #178482098700:  Hold'em No Limit ($0.02/$0.05) - 2017/11/20 21:00:06 CCT [2017/11/20 8:00:06 ET]
Table 'Donati' 6-max Seat #1 is the button
Seat 1: HubertusB ($3.74 in chips) 
Seat 2: mel1in ($13.49 in chips) 
Seat 3: atpwta ($5.94 in chips) 
Seat 4: samurai ume ($5.12 in chips) 
Seat 5: RenningStone ($11.54 in chips) 
Seat 6: alexaalealex ($7.57 in chips) 
mel1in: posts small blind $0.02
atpwta: posts big blind $0.05
*** HOLE CARDS ***
Dealt to HubertusB [3h 6h]
samurai ume: folds 
RenningStone: folds 
alexaalealex: folds 
HubertusB: folds 
mel1in: folds 
Uncalled bet ($0.03) returned to atpwta
atpwta collected $0.04 from pot
atpwta: doesn't show hand 
*** SUMMARY ***
Total pot $0.04 | Rake $0 
Seat 1: HubertusB (button) folded before Flop (didn't bet)
Seat 2: mel1in (small blind) folded before Flop
Seat 3: atpwta (big blind) collected ($0.04)
Seat 4: samurai ume folded before Flop (didn't bet)
Seat 5: RenningStone folded before Flop (didn't bet)
Seat 6: alexaalealex folded before Flop (didn't bet)



PokerStars Zoom Hand #178482103676:  Hold'em No Limit ($0.02/$0.05) - 2017/11/20 21:00:18 CCT [2017/11/20 8:00:18 ET]
Table 'Donati' 6-max Seat #1 is the button
Seat 1: rexrex932 ($6.72 in chips) 
Seat 2: AndreasAU79 ($5.24 in chips) 
Seat 3: Djonoff ($5.89 in chips) 
Seat 4: crappyquads ($6.37 in chips) 
Seat 5: HubertusB ($3.74 in chips) 
Seat 6: paxton2468 ($9.04 in chips) 
AndreasAU79: posts small blind $0.02
Djonoff: posts big blind $0.05
*** HOLE CARDS ***
Dealt to HubertusB [6d Ts]
crappyquads: folds 
HubertusB: folds 
paxton2468: folds 
rexrex932: folds 
AndreasAU79: folds 
Uncalled bet ($0.03) returned to Djonoff
Djonoff collected $0.04 from pot
Djonoff: doesn't show hand 
*** SUMMARY ***
Total pot $0.04 | Rake $0 
Seat 1: rexrex932 (button) folded before Flop (didn't bet)
Seat 2: AndreasAU79 (small blind) folded before Flop
Seat 3: Djonoff (big blind) collected ($0.04)
Seat 4: crappyquads folded before Flop (didn't bet)
Seat 5: HubertusB folded before Flop (didn't bet)
Seat 6: paxton2468 folded before Flop (didn't bet)



PokerStars Zoom Hand #178482101607:  Hold'em No Limit ($0.02/$0.05) - 2017/11/20 21:00:13 CCT [2017/11/20 8:00:13 ET]
Table 'Donati' 6-max Seat #1 is the button
Seat 1: Onlinedragon ($5.05 in chips) 
Seat 2: flatbelieve ($7.29 in chips) 
Seat 3: seawolf111 ($12.02 in chips) 
Seat 4: chilean777 ($9.26 in chips) 
Seat 5: HubertusB ($3.74 in chips) 
Seat 6: sshotokann ($10.90 in chips) 
flatbelieve: posts small blind $0.02
seawolf111: posts big blind $0.05
*** HOLE CARDS ***
Dealt to HubertusB [5h 4s]
chilean777: folds 
HubertusB: folds 
sshotokann: folds 
Onlinedragon: raises $0.07 to $0.12
flatbelieve: folds 
seawolf111: folds 
Uncalled bet ($0.07) returned to Onlinedragon
Onlinedragon collected $0.12 from pot
Onlinedragon: doesn't show hand 
*** SUMMARY ***
Total pot $0.12 | Rake $0 
Seat 1: Onlinedragon (button) collected ($0.12)
Seat 2: flatbelieve (small blind) folded before Flop
Seat 3: seawolf111 (big blind) folded before Flop
Seat 4: chilean777 folded before Flop (didn't bet)
Seat 5: HubertusB folded before Flop (didn't bet)
Seat 6: sshotokann folded before Flop (didn't bet)



PokerStars Zoom Hand #178482095741:  Hold'em No Limit ($0.02/$0.05) - 2017/11/20 20:59:59 CCT [2017/11/20 7:59:59 ET]
Table 'Donati' 6-max Seat #1 is the button
Seat 1: alex_xics ($2.47 in chips) 
Seat 2: HubertusB ($3.76 in chips) 
Seat 3: Restone99 ($2.16 in chips) 
Seat 4: Energetix12. ($1.75 in chips) 
Seat 5: With_no_Pain ($8.96 in chips) 
Seat 6: mikk2468 ($7.40 in chips) 
HubertusB: posts small blind $0.02
Restone99: posts big blind $0.05
*** HOLE CARDS ***
Dealt to HubertusB [Qs 8c]
Energetix12.: folds 
With_no_Pain: folds 
mikk2468: raises $0.11 to $0.16
alex_xics: calls $0.16
HubertusB: folds 
Restone99: folds 
*** FLOP *** [6d 8d Ad]
mikk2468: bets $0.30
alex_xics: raises $0.95 to $1.25
mikk2468: raises $3.59 to $4.84
alex_xics: calls $1.06 and is all-in
Uncalled bet ($2.53) returned to mikk2468
*** TURN *** [6d 8d Ad] [9s]
*** RIVER *** [6d 8d Ad 9s] [Jd]
*** SHOW DOWN ***
mikk2468: shows [Kd Qh] (a flush, Ace high)
alex_xics: shows [Ah 6h] (two pair, Aces and Sixes)
mikk2468 collected $4.80 from pot
*** SUMMARY ***
Total pot $5.01 | Rake $0.21 
Board [6d 8d Ad 9s Jd]
Seat 1: alex_xics (button) showed [Ah 6h] and lost with two pair, Aces and Sixes
Seat 2: HubertusB (small blind) folded before Flop
Seat 3: Restone99 (big blind) folded before Flop
Seat 4: Energetix12. folded before Flop (didn't bet)
Seat 5: With_no_Pain folded before Flop (didn't bet)
Seat 6: mikk2468 showed [Kd Qh] and won ($4.80) with a flush, Ace high



PokerStars Zoom Hand #178482106167:  Hold'em No Limit ($0.02/$0.05) - 2017/11/20 21:00:24 CCT [2017/11/20 8:00:24 ET]
Table 'Donati' 6-max Seat #1 is the button
Seat 1: nervss ($8.36 in chips) 
Seat 2: HubertusB ($3.74 in chips) 
Seat 3: denis313 86 ($4.79 in chips) 
Seat 4: KindandBad77 ($7.87 in chips) 
Seat 5: Steep oil ($4.52 in chips) 
Seat 6: grunge&punk ($5.60 in chips) 
HubertusB: posts small blind $0.02
denis313 86: posts big blind $0.05
*** HOLE CARDS ***
Dealt to HubertusB [8c Ac]
KindandBad77: folds 
Steep oil: folds 
grunge&punk: folds 
nervss: raises $0.07 to $0.12
HubertusB: calls $0.10
denis313 86: calls $0.07
*** FLOP *** [2s 3d Kh]
HubertusB: bets $0.20
denis313 86: folds 
nervss: calls $0.20
*** TURN *** [2s 3d Kh] [Td]
HubertusB: bets $0.45
nervss: raises $0.96 to $1.41
HubertusB: folds 
Uncalled bet ($0.96) returned to nervss
nervss collected $1.59 from pot
nervss: doesn't show hand 
*** SUMMARY ***
Total pot $1.66 | Rake $0.07 
Board [2s 3d Kh Td]
Seat 1: nervss (button) collected ($1.59)
Seat 2: HubertusB (small blind) folded on the Turn
Seat 3: denis313 86 (big blind) folded on the Flop
Seat 4: KindandBad77 folded before Flop (didn't bet)
Seat 5: Steep oil folded before Flop (didn't bet)
Seat 6: grunge&punk folded before Flop (didn't bet)



PokerStars Zoom Hand #178482125508:  Hold'em No Limit ($0.02/$0.05) - 2017/11/20 21:01:08 CCT [2017/11/20 8:01:08 ET]
Table 'Donati' 6-max Seat #1 is the button
Seat 1: tstf0705 ($2.88 in chips) 
Seat 2: dark h0r$e ($7.07 in chips) 
Seat 3: HubertusB ($2.97 in chips) 
Seat 4: Pyatka263363 ($4.72 in chips) 
Seat 5: xarichi ($5.38 in chips) 
Seat 6: Party Fishy ($6.39 in chips) 
dark h0r$e: posts small blind $0.02
HubertusB: posts big blind $0.05
*** HOLE CARDS ***
Dealt to HubertusB [8h As]
Pyatka263363: calls $0.05
xarichi: folds 
Party Fishy: folds 
tstf0705: folds 
dark h0r$e: folds 
HubertusB: checks 
*** FLOP *** [Qs Ah Ad]
HubertusB: checks 
Pyatka263363: bets $0.05
HubertusB: raises $0.15 to $0.20
Pyatka263363: calls $0.15
*** TURN *** [Qs Ah Ad] [6s]
HubertusB: checks 
Pyatka263363: bets $0.25
HubertusB: calls $0.25
*** RIVER *** [Qs Ah Ad 6s] [Kd]
HubertusB: checks 
Pyatka263363: bets $0.50
HubertusB: calls $0.50
*** SHOW DOWN ***
Pyatka263363: shows [Qc Td] (two pair, Aces and Queens)
HubertusB: shows [8h As] (three of a kind, Aces)
HubertusB collected $1.94 from pot
*** SUMMARY ***
Total pot $2.02 | Rake $0.08 
Board [Qs Ah Ad 6s Kd]
Seat 1: tstf0705 (button) folded before Flop (didn't bet)
Seat 2: dark h0r$e (small blind) folded before Flop
Seat 3: HubertusB (big blind) showed [8h As] and won ($1.94) with three of a kind, Aces
Seat 4: Pyatka263363 showed [Qc Td] and lost with two pair, Aces and Queens
Seat 5: xarichi folded before Flop (didn't bet)
Seat 6: Party Fishy folded before Flop (didn't bet)



PokerStars Zoom Hand #178482155444:  Hold'em No Limit ($0.02/$0.05) - 2017/11/20 21:02:15 CCT [2017/11/20 8:02:15 ET]
Table 'Donati' 6-max Seat #1 is the button
Seat 1: HubertusB ($3.91 in chips) 
Seat 2: mikk2468 ($5.80 in chips) 
Seat 3: Centurion7/1 ($8.98 in chips) 
Seat 4: Bol'tazar111 ($1.86 in chips) 
Seat 5: ZlayaMyxa ($5.51 in chips) 
Seat 6: dark h0r$e ($6.83 in chips) 
mikk2468: posts small blind $0.02
Centurion7/1: posts big blind $0.05
*** HOLE CARDS ***
Dealt to HubertusB [Kh 3d]
Bol'tazar111: calls $0.05
ZlayaMyxa: folds 
dark h0r$e: folds 
HubertusB: folds 
mikk2468: folds 
Centurion7/1: raises $0.15 to $0.20
Bol'tazar111: calls $0.15
*** FLOP *** [8c 5s 4s]
Centurion7/1: checks 
Bol'tazar111: bets $0.15
Centurion7/1: folds 
Uncalled bet ($0.15) returned to Bol'tazar111
Bol'tazar111 collected $0.40 from pot
Bol'tazar111: doesn't show hand 
*** SUMMARY ***
Total pot $0.42 | Rake $0.02 
Board [8c 5s 4s]
Seat 1: HubertusB (button) folded before Flop (didn't bet)
Seat 2: mikk2468 (small blind) folded before Flop
Seat 3: Centurion7/1 (big blind) folded on the Flop
Seat 4: Bol'tazar111 collected ($0.40)
Seat 5: ZlayaMyxa folded before Flop (didn't bet)
Seat 6: dark h0r$e folded before Flop (didn't bet)



PokerStars Zoom Hand #178482159016:  Hold'em No Limit ($0.02/$0.05) - 2017/11/20 21:02:23 CCT [2017/11/20 8:02:23 ET]
Table 'Donati' 6-max Seat #1 is the button
Seat 1: Lobos2102 ($8.12 in chips) 
Seat 2: Acedan1369 ($18.88 in chips) 
Seat 3: emilskrede ($5.06 in chips) 
Seat 4: Casteel92 ($5.23 in chips) 
Seat 5: =AnVit= ($4.43 in chips) 
Seat 6: HubertusB ($3.91 in chips) 
Acedan1369: posts small blind $0.02
emilskrede: posts big blind $0.05
*** HOLE CARDS ***
Dealt to HubertusB [Ks 7h]
Casteel92 has timed out
Casteel92: folds 
=AnVit=: raises $0.07 to $0.12
HubertusB: folds 
Lobos2102: folds 
Acedan1369: folds 
emilskrede: folds 
Uncalled bet ($0.07) returned to =AnVit=
=AnVit= collected $0.12 from pot
=AnVit=: doesn't show hand 
*** SUMMARY ***
Total pot $0.12 | Rake $0 
Seat 1: Lobos2102 (button) folded before Flop (didn't bet)
Seat 2: Acedan1369 (small blind) folded before Flop
Seat 3: emilskrede (big blind) folded before Flop
Seat 4: Casteel92 folded before Flop (didn't bet)
Seat 5: =AnVit= collected ($0.12)
Seat 6: HubertusB folded before Flop (didn't bet)



PokerStars Zoom Hand #178482164350:  Hold'em No Limit ($0.02/$0.05) - 2017/11/20 21:02:35 CCT [2017/11/20 8:02:35 ET]
Table 'Donati' 6-max Seat #1 is the button
Seat 1: vcf2013 ($6.56 in chips) 
Seat 2: DudinAndrey ($22.17 in chips) 
Seat 3: PsBadBluff ($5.26 in chips) 
Seat 4: HubertusB ($3.91 in chips) 
Seat 5: PRO_IGROK123 ($8.79 in chips) 
Seat 6: flatbelieve ($5 in chips) 
DudinAndrey: posts small blind $0.02
PsBadBluff: posts big blind $0.05
*** HOLE CARDS ***
Dealt to HubertusB [Td Js]
HubertusB: raises $0.05 to $0.10
PRO_IGROK123: calls $0.10
flatbelieve: folds 
vcf2013: folds 
DudinAndrey: folds 
PsBadBluff: calls $0.05
*** FLOP *** [4d 4s 9s]
PsBadBluff: checks 
HubertusB: bets $0.17
PRO_IGROK123: folds 
PsBadBluff: calls $0.17
*** TURN *** [4d 4s 9s] [5c]
PsBadBluff: checks 
HubertusB: checks 
*** RIVER *** [4d 4s 9s 5c] [7h]
PsBadBluff: checks 
HubertusB: checks 
*** SHOW DOWN ***
PsBadBluff: shows [Ks 5s] (two pair, Fives and Fours)
HubertusB: mucks hand 
PsBadBluff collected $0.63 from pot
*** SUMMARY ***
Total pot $0.66 | Rake $0.03 
Board [4d 4s 9s 5c 7h]
Seat 1: vcf2013 (button) folded before Flop (didn't bet)
Seat 2: DudinAndrey (small blind) folded before Flop
Seat 3: PsBadBluff (big blind) showed [Ks 5s] and won ($0.63) with two pair, Fives and Fours
Seat 4: HubertusB mucked [Td Js]
Seat 5: PRO_IGROK123 folded on the Flop
Seat 6: flatbelieve folded before Flop (didn't bet)



PokerStars Zoom Hand #178482189025:  Hold'em No Limit ($0.02/$0.05) - 2017/11/20 21:03:29 CCT [2017/11/20 8:03:29 ET]
Table 'Donati' 6-max Seat #1 is the button
Seat 1: Bossmanlee00 ($3.19 in chips) 
Seat 2: MoreRakePls1 ($5.48 in chips) 
Seat 3: azukimochi ($12.49 in chips) 
Seat 4: HubertusB ($3.64 in chips) 
Seat 5: BigNachuj ($5 in chips) 
Seat 6: sshotokann ($9.56 in chips) 
MoreRakePls1: posts small blind $0.02
azukimochi: posts big blind $0.05
*** HOLE CARDS ***
Dealt to HubertusB [2s 2c]
HubertusB: raises $0.05 to $0.10
BigNachuj: folds 
sshotokann: folds 
Bossmanlee00: calls $0.10
MoreRakePls1: raises $0.44 to $0.54
azukimochi: folds 
HubertusB: folds 
Bossmanlee00: calls $0.44
*** FLOP *** [5s Ts 7h]
MoreRakePls1: bets $0.56
Bossmanlee00: calls $0.56
*** TURN *** [5s Ts 7h] [8s]
MoreRakePls1: bets $2.16
Bossmanlee00: calls $2.09 and is all-in
Uncalled bet ($0.07) returned to MoreRakePls1
*** RIVER *** [5s Ts 7h 8s] [6c]
*** SHOW DOWN ***
MoreRakePls1: shows [Kc As] (high card Ace)
Bossmanlee00: shows [9d Jd] (a straight, Seven to Jack)
Bossmanlee00 collected $6.26 from pot
*** SUMMARY ***
Total pot $6.53 | Rake $0.27 
Board [5s Ts 7h 8s 6c]
Seat 1: Bossmanlee00 (button) showed [9d Jd] and won ($6.26) with a straight, Seven to Jack
Seat 2: MoreRakePls1 (small blind) showed [Kc As] and lost with high card Ace
Seat 3: azukimochi (big blind) folded before Flop
Seat 4: HubertusB folded before Flop
Seat 5: BigNachuj folded before Flop (didn't bet)
Seat 6: sshotokann folded before Flop (didn't bet)



PokerStars Zoom Hand #178482204877:  Hold'em No Limit ($0.02/$0.05) - 2017/11/20 21:04:04 CCT [2017/11/20 8:04:04 ET]
Table 'Donati' 6-max Seat #1 is the button
Seat 1: mikk2468 ($5.36 in chips) 
Seat 2: HubertusB ($3.54 in chips) 
Seat 3: Card_Sharp78 ($5.36 in chips) 
Seat 4: MrBigFish001 ($5.52 in chips) 
Seat 5: ProTeamjan ($5.98 in chips) 
Seat 6: zikin444 ($4.46 in chips) 
HubertusB: posts small blind $0.02
Card_Sharp78: posts big blind $0.05
*** HOLE CARDS ***
Dealt to HubertusB [Th 7d]
MrBigFish001: folds 
ProTeamjan: folds 
zikin444: folds 
mikk2468: raises $0.11 to $0.16
HubertusB: folds 
Card_Sharp78: raises $0.44 to $0.60
mikk2468: folds 
Uncalled bet ($0.44) returned to Card_Sharp78
Card_Sharp78 collected $0.34 from pot
Card_Sharp78: doesn't show hand 
*** SUMMARY ***
Total pot $0.34 | Rake $0 
Seat 1: mikk2468 (button) folded before Flop
Seat 2: HubertusB (small blind) folded before Flop
Seat 3: Card_Sharp78 (big blind) collected ($0.34)
Seat 4: MrBigFish001 folded before Flop (didn't bet)
Seat 5: ProTeamjan folded before Flop (didn't bet)
Seat 6: zikin444 folded before Flop (didn't bet)



PokerStars Zoom Hand #178482207128:  Hold'em No Limit ($0.02/$0.05) - 2017/11/20 21:04:09 CCT [2017/11/20 8:04:09 ET]
Table 'Donati' 6-max Seat #1 is the button
Seat 1: Party Fishy ($10.43 in chips) 
Seat 2: svansong ($5.08 in chips) 
Seat 3: HubertusB ($3.52 in chips) 
Seat 4: Marka555 ($7.10 in chips) 
Seat 5: Nessblr1 ($3.70 in chips) 
Seat 6: Dubok86 ($5 in chips) 
svansong: posts small blind $0.02
HubertusB: posts big blind $0.05
*** HOLE CARDS ***
Dealt to HubertusB [9d 6h]
Marka555: folds 
Nessblr1: calls $0.05
Dubok86: raises $0.10 to $0.15
Party Fishy: folds 
svansong: folds 
HubertusB: folds 
Nessblr1: calls $0.10
*** FLOP *** [Kd 9s Qh]
Nessblr1: checks 
Dubok86: checks 
*** TURN *** [Kd 9s Qh] [Ac]
Nessblr1: checks 
Dubok86: checks 
*** RIVER *** [Kd 9s Qh Ac] [Ts]
Nessblr1: checks 
Dubok86: checks 
*** SHOW DOWN ***
Nessblr1: shows [2h 2d] (a pair of Deuces)
Dubok86: shows [2s 2c] (a pair of Deuces)
Nessblr1 collected $0.18 from pot
Dubok86 collected $0.17 from pot
*** SUMMARY ***
Total pot $0.37 | Rake $0.02 
Board [Kd 9s Qh Ac Ts]
Seat 1: Party Fishy (button) folded before Flop (didn't bet)
Seat 2: svansong (small blind) folded before Flop
Seat 3: HubertusB (big blind) folded before Flop
Seat 4: Marka555 folded before Flop (didn't bet)
Seat 5: Nessblr1 showed [2h 2d] and won ($0.18) with a pair of Deuces
Seat 6: Dubok86 showed [2s 2c] and won ($0.17) with a pair of Deuces



PokerStars Zoom Hand #178482211674:  Hold'em No Limit ($0.02/$0.05) - 2017/11/20 21:04:19 CCT [2017/11/20 8:04:19 ET]
Table 'Donati' 6-max Seat #1 is the button
Seat 1: HubertusB ($3.47 in chips) 
Seat 2: Polypops ($6.98 in chips) 
Seat 3: Curtix1023 ($11.77 in chips) 
Seat 4: Oliana88 ($5 in chips) 
Seat 5: ZlayaMyxa ($5.25 in chips) 
Seat 6: Onlinedragon ($5.07 in chips) 
Polypops: posts small blind $0.02
Curtix1023: posts big blind $0.05
*** HOLE CARDS ***
Dealt to HubertusB [3s 6d]
Oliana88: folds 
ZlayaMyxa: folds 
Onlinedragon: folds 
HubertusB: folds 
Polypops: folds 
Uncalled bet ($0.03) returned to Curtix1023
Curtix1023 collected $0.04 from pot
Curtix1023: doesn't show hand 
*** SUMMARY ***
Total pot $0.04 | Rake $0 
Seat 1: HubertusB (button) folded before Flop (didn't bet)
Seat 2: Polypops (small blind) folded before Flop
Seat 3: Curtix1023 (big blind) collected ($0.04)
Seat 4: Oliana88 folded before Flop (didn't bet)
Seat 5: ZlayaMyxa folded before Flop (didn't bet)
Seat 6: Onlinedragon folded before Flop (didn't bet)



PokerStars Zoom Hand #178482186385:  Hold'em No Limit ($0.02/$0.05) - 2017/11/20 21:03:23 CCT [2017/11/20 8:03:23 ET]
Table 'Donati' 6-max Seat #1 is the button
Seat 1: agatha179 ($5.03 in chips) 
Seat 2: Nessblr1 ($2.45 in chips) 
Seat 3: zikin444 ($5.39 in chips) 
Seat 4: Marka555 ($14.09 in chips) 
Seat 5: HubertusB ($3.64 in chips) 
Seat 6: t1mka09367 ($13.23 in chips) 
Nessblr1: posts small blind $0.02
zikin444: posts big blind $0.05
*** HOLE CARDS ***
Dealt to HubertusB [7h Ad]
Marka555: raises $0.10 to $0.15
HubertusB: folds 
t1mka09367: calls $0.15
agatha179: raises $0.35 to $0.50
Nessblr1: folds 
zikin444: folds 
Marka555: folds 
t1mka09367: calls $0.35
*** FLOP *** [Qh 9h 3c]
t1mka09367: checks 
agatha179: bets $0.59
t1mka09367: raises $0.77 to $1.36
agatha179: folds 
Uncalled bet ($0.77) returned to t1mka09367
t1mka09367 collected $2.30 from pot
t1mka09367: doesn't show hand 
*** SUMMARY ***
Total pot $2.40 | Rake $0.10 
Board [Qh 9h 3c]
Seat 1: agatha179 (button) folded on the Flop
Seat 2: Nessblr1 (small blind) folded before Flop
Seat 3: zikin444 (big blind) folded before Flop
Seat 4: Marka555 folded before Flop
Seat 5: HubertusB folded before Flop (didn't bet)
Seat 6: t1mka09367 collected ($2.30)



PokerStars Zoom Hand #178482214424:  Hold'em No Limit ($0.02/$0.05) - 2017/11/20 21:04:25 CCT [2017/11/20 8:04:25 ET]
Table 'Donati' 6-max Seat #1 is the button
Seat 1: V-Nollan ($4.64 in chips) 
Seat 2: marisan45 ($9.60 in chips) 
Seat 3: Onlinedragon ($5.07 in chips) 
Seat 4: HubertusB ($3.47 in chips) 
Seat 5: K.Tyrrell ($5.26 in chips) 
Seat 6: alex7241183 ($6.12 in chips) 
marisan45: posts small blind $0.02
Onlinedragon: posts big blind $0.05
*** HOLE CARDS ***
Dealt to HubertusB [6h 9h]
HubertusB: raises $0.05 to $0.10
K.Tyrrell: folds 
alex7241183: folds 
V-Nollan: calls $0.10
marisan45: calls $0.08
Onlinedragon: folds 
*** FLOP *** [4c 7h Kc]
marisan45: checks 
HubertusB: bets $0.25
V-Nollan: calls $0.25
marisan45: folds 
*** TURN *** [4c 7h Kc] [Th]
HubertusB: bets $0.55
V-Nollan: calls $0.55
*** RIVER *** [4c 7h Kc Th] [5h]
HubertusB: bets $1.55
V-Nollan: calls $1.55
*** SHOW DOWN ***
HubertusB: shows [6h 9h] (a flush, Ten high)
V-Nollan: mucks hand 
HubertusB collected $4.84 from pot
*** SUMMARY ***
Total pot $5.05 | Rake $0.21 
Board [4c 7h Kc Th 5h]
Seat 1: V-Nollan (button) mucked [Jc Ks]
Seat 2: marisan45 (small blind) folded on the Flop
Seat 3: Onlinedragon (big blind) folded before Flop
Seat 4: HubertusB showed [6h 9h] and won ($4.84) with a flush, Ten high
Seat 5: K.Tyrrell folded before Flop (didn't bet)
Seat 6: alex7241183 folded before Flop (didn't bet)



PokerStars Zoom Hand #178482234376:  Hold'em No Limit ($0.02/$0.05) - 2017/11/20 21:05:09 CCT [2017/11/20 8:05:09 ET]
Table 'Donati' 6-max Seat #1 is the button
Seat 1: stray cat84 ($6.01 in chips) 
Seat 2: solmir ($5.91 in chips) 
Seat 3: ItWasDuke ($5 in chips) 
Seat 4: LumpyBadbeat ($7.95 in chips) 
Seat 5: viktor_KK ($5 in chips) 
Seat 6: HubertusB ($5.86 in chips) 
solmir: posts small blind $0.02
ItWasDuke: posts big blind $0.05
*** HOLE CARDS ***
Dealt to HubertusB [6h 3c]
LumpyBadbeat: folds 
viktor_KK: folds 
HubertusB: raises $0.05 to $0.10
stray cat84: folds 
solmir: raises $0.26 to $0.36
ItWasDuke: folds 
HubertusB: folds 
Uncalled bet ($0.26) returned to solmir
solmir collected $0.25 from pot
solmir: doesn't show hand 
*** SUMMARY ***
Total pot $0.25 | Rake $0 
Seat 1: stray cat84 (button) folded before Flop (didn't bet)
Seat 2: solmir (small blind) collected ($0.25)
Seat 3: ItWasDuke (big blind) folded before Flop
Seat 4: LumpyBadbeat folded before Flop (didn't bet)
Seat 5: viktor_KK folded before Flop (didn't bet)
Seat 6: HubertusB folded before Flop



PokerStars Zoom Hand #178482242096:  Hold'em No Limit ($0.02/$0.05) - 2017/11/20 21:05:26 CCT [2017/11/20 8:05:26 ET]
Table 'Donati' 6-max Seat #1 is the button
Seat 1: kidboss1990 ($11.14 in chips) 
Seat 2: Dorogoi57 ($6.63 in chips) 
Seat 3: tigerrrrli ($5.05 in chips) 
Seat 4: Party Fishy ($10.06 in chips) 
Seat 5: HubertusB ($5.76 in chips) 
Seat 6: Marka555 ($6.89 in chips) 
Dorogoi57: posts small blind $0.02
tigerrrrli: posts big blind $0.05
*** HOLE CARDS ***
Dealt to HubertusB [9c 7d]
Party Fishy: raises $0.10 to $0.15
HubertusB: folds 
Marka555: folds 
kidboss1990: calls $0.15
Dorogoi57: folds 
tigerrrrli: folds 
*** FLOP *** [7h Qh 7c]
Party Fishy: bets $0.18
kidboss1990: folds 
Uncalled bet ($0.18) returned to Party Fishy
Party Fishy collected $0.35 from pot
Party Fishy: doesn't show hand 
*** SUMMARY ***
Total pot $0.37 | Rake $0.02 
Board [7h Qh 7c]
Seat 1: kidboss1990 (button) folded on the Flop
Seat 2: Dorogoi57 (small blind) folded before Flop
Seat 3: tigerrrrli (big blind) folded before Flop
Seat 4: Party Fishy collected ($0.35)
Seat 5: HubertusB folded before Flop (didn't bet)
Seat 6: Marka555 folded before Flop (didn't bet)



PokerStars Zoom Hand #178482244322:  Hold'em No Limit ($0.02/$0.05) - 2017/11/20 21:05:31 CCT [2017/11/20 8:05:31 ET]
Table 'Donati' 6-max Seat #1 is the button
Seat 1: Loerus13 ($8.17 in chips) 
Seat 2: FriskyBear ($5.21 in chips) 
Seat 3: 1kukla ($4.52 in chips) 
Seat 4: HubertusB ($5.76 in chips) 
Seat 5: rimouse.lee ($4.93 in chips) 
Seat 6: olsekpoker ($5.19 in chips) 
FriskyBear: posts small blind $0.02
1kukla: posts big blind $0.05
*** HOLE CARDS ***
Dealt to HubertusB [Ah Kh]
HubertusB: raises $0.10 to $0.15
rimouse.lee: folds 
olsekpoker: folds 
Loerus13: folds 
FriskyBear: folds 
1kukla: calls $0.10
*** FLOP *** [Jc 3h 9c]
1kukla: checks 
HubertusB: bets $0.20
1kukla: calls $0.20
*** TURN *** [Jc 3h 9c] [Td]
1kukla: checks 
HubertusB: checks 
*** RIVER *** [Jc 3h 9c Td] [7c]
1kukla: bets $0.35
HubertusB: folds 
Uncalled bet ($0.35) returned to 1kukla
1kukla collected $0.69 from pot
1kukla: doesn't show hand 
*** SUMMARY ***
Total pot $0.72 | Rake $0.03 
Board [Jc 3h 9c Td 7c]
Seat 1: Loerus13 (button) folded before Flop (didn't bet)
Seat 2: FriskyBear (small blind) folded before Flop
Seat 3: 1kukla (big blind) collected ($0.69)
Seat 4: HubertusB folded on the River
Seat 5: rimouse.lee folded before Flop (didn't bet)
Seat 6: olsekpoker folded before Flop (didn't bet)



PokerStars Zoom Hand #178482262142:  Hold'em No Limit ($0.02/$0.05) - 2017/11/20 21:06:10 CCT [2017/11/20 8:06:10 ET]
Table 'Donati' 6-max Seat #1 is the button
Seat 1: Lobos2102 ($7.33 in chips) 
Seat 2: CaH4esskO ($7.18 in chips) 
Seat 3: HubertusB ($5.41 in chips) 
Seat 4: azukimochi ($12.29 in chips) 
Seat 5: NoName0321 ($5.53 in chips) 
Seat 6: Marka555 ($4.98 in chips) 
CaH4esskO: posts small blind $0.02
HubertusB: posts big blind $0.05
*** HOLE CARDS ***
Dealt to HubertusB [Qd 5c]
azukimochi: folds 
NoName0321: folds 
Marka555: raises $0.07 to $0.12
Lobos2102: folds 
CaH4esskO: folds 
HubertusB: folds 
Uncalled bet ($0.07) returned to Marka555
Marka555 collected $0.12 from pot
Marka555: doesn't show hand 
*** SUMMARY ***
Total pot $0.12 | Rake $0 
Seat 1: Lobos2102 (button) folded before Flop (didn't bet)
Seat 2: CaH4esskO (small blind) folded before Flop
Seat 3: HubertusB (big blind) folded before Flop
Seat 4: azukimochi folded before Flop (didn't bet)
Seat 5: NoName0321 folded before Flop (didn't bet)
Seat 6: Marka555 collected ($0.12)



PokerStars Zoom Hand #178482269979:  Hold'em No Limit ($0.02/$0.05) - 2017/11/20 21:06:27 CCT [2017/11/20 8:06:27 ET]
Table 'Donati' 6-max Seat #1 is the button
Seat 1: RinkoYamada ($8.18 in chips) 
Seat 2: HubertusB ($5.36 in chips) 
Seat 3: BCE bUDET ($13.59 in chips) 
Seat 4: rimouse.lee ($4.86 in chips) 
Seat 5: grunge&punk ($5.12 in chips) 
Seat 6: AverianovA ($5.93 in chips) 
HubertusB: posts small blind $0.02
BCE bUDET: posts big blind $0.05
*** HOLE CARDS ***
Dealt to HubertusB [Ad 8c]
rimouse.lee: raises $0.10 to $0.15
grunge&punk: folds 
AverianovA: folds 
RinkoYamada: folds 
HubertusB: folds 
BCE bUDET: folds 
Uncalled bet ($0.10) returned to rimouse.lee
rimouse.lee collected $0.12 from pot
rimouse.lee: doesn't show hand 
*** SUMMARY ***
Total pot $0.12 | Rake $0 
Seat 1: RinkoYamada (button) folded before Flop (didn't bet)
Seat 2: HubertusB (small blind) folded before Flop
Seat 3: BCE bUDET (big blind) folded before Flop
Seat 4: rimouse.lee collected ($0.12)
Seat 5: grunge&punk folded before Flop (didn't bet)
Seat 6: AverianovA folded before Flop (didn't bet)



PokerStars Zoom Hand #178482272650:  Hold'em No Limit ($0.02/$0.05) - 2017/11/20 21:06:33 CCT [2017/11/20 8:06:33 ET]
Table 'Donati' 6-max Seat #1 is the button
Seat 1: HubertusB ($5.34 in chips) 
Seat 2: TsaturianAA ($5 in chips) 
Seat 3: safeeway ($5.42 in chips) 
Seat 4: lehaara2 ($31.48 in chips) 
Seat 5: Duboin ($5.23 in chips) 
Seat 6: hceyms ($9.96 in chips) 
TsaturianAA: posts small blind $0.02
safeeway: posts big blind $0.05
*** HOLE CARDS ***
Dealt to HubertusB [5d 8d]
lehaara2: raises $0.05 to $0.10
Duboin: folds 
hceyms: folds 
HubertusB: folds 
TsaturianAA: folds 
safeeway: folds 
Uncalled bet ($0.05) returned to lehaara2
lehaara2 collected $0.12 from pot
lehaara2: doesn't show hand 
*** SUMMARY ***
Total pot $0.12 | Rake $0 
Seat 1: HubertusB (button) folded before Flop (didn't bet)
Seat 2: TsaturianAA (small blind) folded before Flop
Seat 3: safeeway (big blind) folded before Flop
Seat 4: lehaara2 collected ($0.12)
Seat 5: Duboin folded before Flop (didn't bet)
Seat 6: hceyms folded before Flop (didn't bet)



PokerStars Zoom Hand #178482276275:  Hold'em No Limit ($0.02/$0.05) - 2017/11/20 21:06:41 CCT [2017/11/20 8:06:41 ET]
Table 'Donati' 6-max Seat #1 is the button
Seat 1: BablenBablen ($4.23 in chips) 
Seat 2: dubbbbme ($6.71 in chips) 
Seat 3: hceyms ($9.96 in chips) 
Seat 4: Zire99 ($6.95 in chips) 
Seat 5: AverianovA ($5.38 in chips) 
Seat 6: HubertusB ($5.34 in chips) 
dubbbbme: posts small blind $0.02
hceyms: posts big blind $0.05
*** HOLE CARDS ***
Dealt to HubertusB [4s 9c]
Zire99: folds 
AverianovA: folds 
HubertusB: folds 
BablenBablen: raises $0.12 to $0.17
dubbbbme: raises $0.37 to $0.54
hceyms: folds 
BablenBablen: folds 
Uncalled bet ($0.37) returned to dubbbbme
dubbbbme collected $0.39 from pot
dubbbbme: doesn't show hand 
*** SUMMARY ***
Total pot $0.39 | Rake $0 
Seat 1: BablenBablen (button) folded before Flop
Seat 2: dubbbbme (small blind) collected ($0.39)
Seat 3: hceyms (big blind) folded before Flop
Seat 4: Zire99 folded before Flop (didn't bet)
Seat 5: AverianovA folded before Flop (didn't bet)
Seat 6: HubertusB folded before Flop (didn't bet)



PokerStars Zoom Hand #178482278575:  Hold'em No Limit ($0.02/$0.05) - 2017/11/20 21:06:46 CCT [2017/11/20 8:06:46 ET]
Table 'Donati' 6-max Seat #1 is the button
Seat 1: osho6 ($4 in chips) 
Seat 2: GizaGliwic ($5.50 in chips) 
Seat 3: matulinkk ($4.08 in chips) 
Seat 4: AverianovA ($6.30 in chips) 
Seat 5: HubertusB ($5.34 in chips) 
Seat 6: flatbelieve ($5.64 in chips) 
GizaGliwic: posts small blind $0.02
matulinkk: posts big blind $0.05
*** HOLE CARDS ***
Dealt to HubertusB [Th 7s]
AverianovA: folds 
HubertusB: folds 
flatbelieve: folds 
osho6: folds 
GizaGliwic: raises $0.10 to $0.15
matulinkk: folds 
Uncalled bet ($0.10) returned to GizaGliwic
GizaGliwic collected $0.10 from pot
GizaGliwic: doesn't show hand 
*** SUMMARY ***
Total pot $0.10 | Rake $0 
Seat 1: osho6 (button) folded before Flop (didn't bet)
Seat 2: GizaGliwic (small blind) collected ($0.10)
Seat 3: matulinkk (big blind) folded before Flop
Seat 4: AverianovA folded before Flop (didn't bet)
Seat 5: HubertusB folded before Flop (didn't bet)
Seat 6: flatbelieve folded before Flop (didn't bet)



PokerStars Zoom Hand #178482281302:  Hold'em No Limit ($0.02/$0.05) - 2017/11/20 21:06:52 CCT [2017/11/20 8:06:52 ET]
Table 'Donati' 6-max Seat #1 is the button
Seat 1: seawolf111 ($8.54 in chips) 
Seat 2: zyannsinn ($6.97 in chips) 
Seat 3: HubertusB ($5.34 in chips) 
Seat 4: Puha85 ($4.36 in chips) 
Seat 5: MukhamedMR ($2.02 in chips) 
Seat 6: zouzounos86 ($10.32 in chips) 
zyannsinn: posts small blind $0.02
HubertusB: posts big blind $0.05
*** HOLE CARDS ***
Dealt to HubertusB [As Td]
Puha85: folds 
MukhamedMR: calls $0.05
zouzounos86: folds 
seawolf111: folds 
zyannsinn: folds 
HubertusB: checks 
*** FLOP *** [Ah 5c 9s]
HubertusB: bets $0.10
MukhamedMR: folds 
Uncalled bet ($0.10) returned to HubertusB
HubertusB collected $0.12 from pot
HubertusB: doesn't show hand 
*** SUMMARY ***
Total pot $0.12 | Rake $0 
Board [Ah 5c 9s]
Seat 1: seawolf111 (button) folded before Flop (didn't bet)
Seat 2: zyannsinn (small blind) folded before Flop
Seat 3: HubertusB (big blind) collected ($0.12)
Seat 4: Puha85 folded before Flop (didn't bet)
Seat 5: MukhamedMR folded on the Flop
Seat 6: zouzounos86 folded before Flop (didn't bet)



PokerStars Zoom Hand #178482289852:  Hold'em No Limit ($0.02/$0.05) - 2017/11/20 21:07:11 CCT [2017/11/20 8:07:11 ET]
Table 'Donati' 6-max Seat #1 is the button
Seat 1: HubertusB ($5.41 in chips) 
Seat 2: Lelek868 ($5.59 in chips) 
Seat 3: feRaliX ($6.82 in chips) 
Seat 4: zyannsinn ($6.95 in chips) 
Seat 5: schumi8472 ($1.91 in chips) 
Seat 6: Lobos2102 ($5.02 in chips) 
Lelek868: posts small blind $0.02
feRaliX: posts big blind $0.05
*** HOLE CARDS ***
Dealt to HubertusB [8d Jc]
zyannsinn: folds 
schumi8472: calls $0.05
Lobos2102: folds 
HubertusB: folds 
Lelek868: raises $0.15 to $0.20
feRaliX: folds 
schumi8472: calls $0.15
*** FLOP *** [4c 5d 2d]
Lelek868: bets $0.25
schumi8472: calls $0.25
*** TURN *** [4c 5d 2d] [As]
Lelek868: bets $0.50
schumi8472: folds 
Uncalled bet ($0.50) returned to Lelek868
Lelek868 collected $0.91 from pot
Lelek868: doesn't show hand 
*** SUMMARY ***
Total pot $0.95 | Rake $0.04 
Board [4c 5d 2d As]
Seat 1: HubertusB (button) folded before Flop (didn't bet)
Seat 2: Lelek868 (small blind) collected ($0.91)
Seat 3: feRaliX (big blind) folded before Flop
Seat 4: zyannsinn folded before Flop (didn't bet)
Seat 5: schumi8472 folded on the Turn
Seat 6: Lobos2102 folded before Flop (didn't bet)



PokerStars Zoom Hand #178482308002:  Hold'em No Limit ($0.02/$0.05) - 2017/11/20 21:07:51 CCT [2017/11/20 8:07:51 ET]
Table 'Donati' 6-max Seat #1 is the button
Seat 1: 3iourou ($6.11 in chips) 
Seat 2: Akutagawa ($5.83 in chips) 
Seat 3: HubertusB ($5.39 in chips) 
Seat 4: 0201yuta ($4.51 in chips) 
Seat 5: mikk2468 ($9.80 in chips) 
Seat 6: RinkoYamada ($11.17 in chips) 
Akutagawa: posts small blind $0.02
HubertusB: posts big blind $0.05
*** HOLE CARDS ***
Dealt to HubertusB [4h 6c]
0201yuta: folds 
mikk2468: folds 
RinkoYamada: folds 
3iourou: raises $0.06 to $0.11
Akutagawa: folds 
HubertusB: folds 
Uncalled bet ($0.06) returned to 3iourou
3iourou collected $0.12 from pot
3iourou: doesn't show hand 
*** SUMMARY ***
Total pot $0.12 | Rake $0 
Seat 1: 3iourou (button) collected ($0.12)
Seat 2: Akutagawa (small blind) folded before Flop
Seat 3: HubertusB (big blind) folded before Flop
Seat 4: 0201yuta folded before Flop (didn't bet)
Seat 5: mikk2468 folded before Flop (didn't bet)
Seat 6: RinkoYamada folded before Flop (didn't bet)



PokerStars Zoom Hand #178482305227:  Hold'em No Limit ($0.02/$0.05) - 2017/11/20 21:07:45 CCT [2017/11/20 8:07:45 ET]
Table 'Donati' 6-max Seat #1 is the button
Seat 1: RiSk.Fortune ($6.47 in chips) 
Seat 2: LumpyBadbeat ($7.30 in chips) 
Seat 3: mel1in ($4.03 in chips) 
Seat 4: HubertusB ($5.39 in chips) 
Seat 5: igrokstar379 ($6.14 in chips) 
Seat 6: anna_vas_op ($4.98 in chips) 
LumpyBadbeat: posts small blind $0.02
mel1in: posts big blind $0.05
*** HOLE CARDS ***
Dealt to HubertusB [5s Kd]
HubertusB: folds 
igrokstar379: folds 
anna_vas_op: raises $0.05 to $0.10
RiSk.Fortune: raises $0.22 to $0.32
LumpyBadbeat: folds 
mel1in: folds 
anna_vas_op: folds 
Uncalled bet ($0.22) returned to RiSk.Fortune
RiSk.Fortune collected $0.27 from pot
RiSk.Fortune: doesn't show hand 
*** SUMMARY ***
Total pot $0.27 | Rake $0 
Seat 1: RiSk.Fortune (button) collected ($0.27)
Seat 2: LumpyBadbeat (small blind) folded before Flop
Seat 3: mel1in (big blind) folded before Flop
Seat 4: HubertusB folded before Flop (didn't bet)
Seat 5: igrokstar379 folded before Flop (didn't bet)
Seat 6: anna_vas_op folded before Flop



PokerStars Zoom Hand #178482294758:  Hold'em No Limit ($0.02/$0.05) - 2017/11/20 21:07:22 CCT [2017/11/20 8:07:22 ET]
Table 'Donati' 6-max Seat #1 is the button
Seat 1: artemka2508 ($4.87 in chips) 
Seat 2: HubertusB ($5.41 in chips) 
Seat 3: igrokstar379 ($5.97 in chips) 
Seat 4: GizaGliwic ($5.43 in chips) 
Seat 5: jochenfratz ($6.11 in chips) 
Seat 6: PurplePython ($7.16 in chips) 
HubertusB: posts small blind $0.02
igrokstar379: posts big blind $0.05
*** HOLE CARDS ***
Dealt to HubertusB [Qd 7h]
GizaGliwic: raises $0.07 to $0.12
jochenfratz: folds 
PurplePython: folds 
artemka2508: folds 
HubertusB: folds 
igrokstar379: calls $0.07
*** FLOP *** [8s 5s Tc]
igrokstar379: bets $0.08
GizaGliwic: calls $0.08
*** TURN *** [8s 5s Tc] [2c]
igrokstar379: bets $0.20
GizaGliwic: folds 
Uncalled bet ($0.20) returned to igrokstar379
igrokstar379 collected $0.40 from pot
igrokstar379: doesn't show hand 
*** SUMMARY ***
Total pot $0.42 | Rake $0.02 
Board [8s 5s Tc 2c]
Seat 1: artemka2508 (button) folded before Flop (didn't bet)
Seat 2: HubertusB (small blind) folded before Flop
Seat 3: igrokstar379 (big blind) collected ($0.40)
Seat 4: GizaGliwic folded on the Turn
Seat 5: jochenfratz folded before Flop (didn't bet)
Seat 6: PurplePython folded before Flop (didn't bet)



PokerStars Zoom Hand #178482301525:  Hold'em No Limit ($0.02/$0.05) - 2017/11/20 21:07:37 CCT [2017/11/20 8:07:37 ET]
Table 'Donati' 6-max Seat #1 is the button
Seat 1: vcf2013 ($5 in chips) 
Seat 2: Marka555 ($13.82 in chips) 
Seat 3: 1Cheeeers ($3.08 in chips) 
Seat 4: KindandBad77 ($14.77 in chips) 
Seat 5: Amigo113 ($5 in chips) 
Seat 6: HubertusB ($5.39 in chips) 
Marka555: posts small blind $0.02
1Cheeeers: posts big blind $0.05
*** HOLE CARDS ***
Dealt to HubertusB [4d 9s]
KindandBad77: folds 
Amigo113: folds 
HubertusB: folds 
vcf2013: folds 
Marka555: raises $0.07 to $0.12
1Cheeeers: calls $0.07
*** FLOP *** [2d 3s 5c]
Marka555: checks 
1Cheeeers: checks 
*** TURN *** [2d 3s 5c] [4h]
Marka555: checks 
1Cheeeers: bets $0.10
Marka555: folds 
Uncalled bet ($0.10) returned to 1Cheeeers
1Cheeeers collected $0.23 from pot
1Cheeeers: doesn't show hand 
*** SUMMARY ***
Total pot $0.24 | Rake $0.01 
Board [2d 3s 5c 4h]
Seat 1: vcf2013 (button) folded before Flop (didn't bet)
Seat 2: Marka555 (small blind) folded on the Turn
Seat 3: 1Cheeeers (big blind) collected ($0.23)
Seat 4: KindandBad77 folded before Flop (didn't bet)
Seat 5: Amigo113 folded before Flop (didn't bet)
Seat 6: HubertusB folded before Flop (didn't bet)



PokerStars Zoom Hand #178482313317:  Hold'em No Limit ($0.02/$0.05) - 2017/11/20 21:08:03 CCT [2017/11/20 8:08:03 ET]
Table 'Donati' 6-max Seat #1 is the button
Seat 1: Mochiyuki ($9.92 in chips) 
Seat 2: AlexDeLargee ($13.38 in chips) 
Seat 3: sinyong0709 ($5.03 in chips) 
Seat 4: HubertusB ($5.34 in chips) 
Seat 5: Oblindao ($4.48 in chips) 
Seat 6: ItWasDuke ($5 in chips) 
AlexDeLargee: posts small blind $0.02
sinyong0709: posts big blind $0.05
*** HOLE CARDS ***
Dealt to HubertusB [4s 9c]
HubertusB: folds 
Oblindao: folds 
ItWasDuke: raises $0.07 to $0.12
Mochiyuki: folds 
AlexDeLargee: folds 
sinyong0709: folds 
Uncalled bet ($0.07) returned to ItWasDuke
ItWasDuke collected $0.12 from pot
ItWasDuke: doesn't show hand 
*** SUMMARY ***
Total pot $0.12 | Rake $0 
Seat 1: Mochiyuki (button) folded before Flop (didn't bet)
Seat 2: AlexDeLargee (small blind) folded before Flop
Seat 3: sinyong0709 (big blind) folded before Flop
Seat 4: HubertusB folded before Flop (didn't bet)
Seat 5: Oblindao folded before Flop (didn't bet)
Seat 6: ItWasDuke collected ($0.12)



PokerStars Zoom Hand #178482316048:  Hold'em No Limit ($0.02/$0.05) - 2017/11/20 21:08:09 CCT [2017/11/20 8:08:09 ET]
Table 'Donati' 6-max Seat #1 is the button
Seat 1: HubertusB ($5.34 in chips) 
Seat 2: Karat_BLR ($4.15 in chips) 
Seat 3: RinkoYamada ($11.15 in chips) 
Seat 4: MoreRakePls1 ($6.94 in chips) 
Seat 5: CaH4esskO ($5 in chips) 
Seat 6: paxton2468 ($7.78 in chips) 
Karat_BLR: posts small blind $0.02
RinkoYamada: posts big blind $0.05
*** HOLE CARDS ***
Dealt to HubertusB [2d 8d]
MoreRakePls1: folds 
CaH4esskO: folds 
paxton2468: folds 
HubertusB: raises $0.05 to $0.10
Karat_BLR: folds 
RinkoYamada: calls $0.05
*** FLOP *** [8s 4c 5s]
RinkoYamada: checks 
HubertusB: bets $0.15
RinkoYamada: raises $0.26 to $0.41
HubertusB: folds 
Uncalled bet ($0.26) returned to RinkoYamada
RinkoYamada collected $0.50 from pot
RinkoYamada: doesn't show hand 
*** SUMMARY ***
Total pot $0.52 | Rake $0.02 
Board [8s 4c 5s]
Seat 1: HubertusB (button) folded on the Flop
Seat 2: Karat_BLR (small blind) folded before Flop
Seat 3: RinkoYamada (big blind) collected ($0.50)
Seat 4: MoreRakePls1 folded before Flop (didn't bet)
Seat 5: CaH4esskO folded before Flop (didn't bet)
Seat 6: paxton2468 folded before Flop (didn't bet)



PokerStars Zoom Hand #178482331356:  Hold'em No Limit ($0.02/$0.05) - 2017/11/20 21:08:43 CCT [2017/11/20 8:08:43 ET]
Table 'Donati' 6-max Seat #1 is the button
Seat 1: AverianovA ($6.23 in chips) 
Seat 2: veryfatjedi ($4.11 in chips) 
Seat 3: xGzusS ($5.03 in chips) 
Seat 4: HubertusB ($5.09 in chips) 
Seat 5: tavi111 ($5.12 in chips) 
Seat 6: wchivas ($2.50 in chips) 
veryfatjedi: posts small blind $0.02
xGzusS: posts big blind $0.05
*** HOLE CARDS ***
Dealt to HubertusB [4c Ac]
HubertusB: raises $0.05 to $0.10
tavi111: folds 
wchivas has timed out
wchivas: folds 
AverianovA: folds 
veryfatjedi: folds 
xGzusS: folds 
Uncalled bet ($0.05) returned to HubertusB
HubertusB collected $0.12 from pot
HubertusB: doesn't show hand 
*** SUMMARY ***
Total pot $0.12 | Rake $0 
Seat 1: AverianovA (button) folded before Flop (didn't bet)
Seat 2: veryfatjedi (small blind) folded before Flop
Seat 3: xGzusS (big blind) folded before Flop
Seat 4: HubertusB collected ($0.12)
Seat 5: tavi111 folded before Flop (didn't bet)
Seat 6: wchivas folded before Flop (didn't bet)



PokerStars Zoom Hand #178482343192:  Hold'em No Limit ($0.02/$0.05) - 2017/11/20 21:09:09 CCT [2017/11/20 8:09:09 ET]
Table 'Donati' 6-max Seat #1 is the button
Seat 1: 0201yuta ($6.52 in chips) 
Seat 2: HubertusB ($5.16 in chips) 
Seat 3: kram189 ($7.34 in chips) 
Seat 4: svansong ($5 in chips) 
Seat 5: suriel666 ($4.42 in chips) 
Seat 6: Duboin ($5.44 in chips) 
HubertusB: posts small blind $0.02
kram189: posts big blind $0.05
*** HOLE CARDS ***
Dealt to HubertusB [6d Td]
svansong: folds 
suriel666: folds 
Duboin: raises $0.07 to $0.12
0201yuta: folds 
HubertusB: folds 
kram189: folds 
Uncalled bet ($0.07) returned to Duboin
Duboin collected $0.12 from pot
Duboin: doesn't show hand 
*** SUMMARY ***
Total pot $0.12 | Rake $0 
Seat 1: 0201yuta (button) folded before Flop (didn't bet)
Seat 2: HubertusB (small blind) folded before Flop
Seat 3: kram189 (big blind) folded before Flop
Seat 4: svansong folded before Flop (didn't bet)
Seat 5: suriel666 folded before Flop (didn't bet)
Seat 6: Duboin collected ($0.12)



PokerStars Zoom Hand #178482345989:  Hold'em No Limit ($0.02/$0.05) - 2017/11/20 21:09:15 CCT [2017/11/20 8:09:15 ET]
Table 'Donati' 6-max Seat #1 is the button
Seat 1: bezmaz ($4.90 in chips) 
Seat 2: nazar778 ($6.18 in chips) 
Seat 3: jext ($6.25 in chips) 
Seat 4: doutsis ($3.87 in chips) 
Seat 5: p3rf3ct00 ($6.14 in chips) 
Seat 6: HubertusB ($5.14 in chips) 
nazar778: posts small blind $0.02
jext: posts big blind $0.05
*** HOLE CARDS ***
Dealt to HubertusB [8s As]
doutsis: folds 
p3rf3ct00: folds 
HubertusB: raises $0.05 to $0.10
bezmaz: folds 
nazar778: folds 
jext: raises $0.30 to $0.40
HubertusB: raises $0.65 to $1.05
jext: raises $5.20 to $6.25 and is all-in
HubertusB: folds 
Uncalled bet ($5.20) returned to jext
jext collected $2.12 from pot
jext: doesn't show hand 
*** SUMMARY ***
Total pot $2.12 | Rake $0 
Seat 1: bezmaz (button) folded before Flop (didn't bet)
Seat 2: nazar778 (small blind) folded before Flop
Seat 3: jext (big blind) collected ($2.12)
Seat 4: doutsis folded before Flop (didn't bet)
Seat 5: p3rf3ct00 folded before Flop (didn't bet)
Seat 6: HubertusB folded before Flop



PokerStars Zoom Hand #178482371290:  Hold'em No Limit ($0.02/$0.05) - 2017/11/20 21:10:10 CCT [2017/11/20 8:10:10 ET]
Table 'Donati' 6-max Seat #1 is the button
Seat 1: zikin444 ($4.87 in chips) 
Seat 2: SHUR43 ($6.04 in chips) 
Seat 3: HubertusB ($4.09 in chips) 
Seat 4: xarichi ($7.13 in chips) 
Seat 5: DROFNEBMAS ($7.46 in chips) 
Seat 6: kuansheng ($5.55 in chips) 
SHUR43: posts small blind $0.02
HubertusB: posts big blind $0.05
*** HOLE CARDS ***
Dealt to HubertusB [2h Qh]
xarichi: folds 
DROFNEBMAS: folds 
kuansheng: folds 
zikin444: folds 
SHUR43: raises $0.07 to $0.12
HubertusB: raises $0.23 to $0.35
SHUR43: folds 
Uncalled bet ($0.23) returned to HubertusB
HubertusB collected $0.24 from pot
HubertusB: doesn't show hand 
*** SUMMARY ***
Total pot $0.24 | Rake $0 
Seat 1: zikin444 (button) folded before Flop (didn't bet)
Seat 2: SHUR43 (small blind) folded before Flop
Seat 3: HubertusB (big blind) collected ($0.24)
Seat 4: xarichi folded before Flop (didn't bet)
Seat 5: DROFNEBMAS folded before Flop (didn't bet)
Seat 6: kuansheng folded before Flop (didn't bet)



PokerStars Zoom Hand #178482380114:  Hold'em No Limit ($0.02/$0.05) - 2017/11/20 21:10:29 CCT [2017/11/20 8:10:29 ET]
Table 'Donati' 6-max Seat #1 is the button
Seat 1: RenningStone ($10.70 in chips) 
Seat 2: Anikin44 ($11.49 in chips) 
Seat 3: DimanFlrrr ($2.35 in chips) 
Seat 4: ayhshhh ($6.78 in chips) 
Seat 5: HubertusB ($4.21 in chips) 
Seat 6: Bot1729 ($5 in chips) 
Anikin44: posts small blind $0.02
DimanFlrrr: posts big blind $0.05
*** HOLE CARDS ***
Dealt to HubertusB [6s 4d]
ayhshhh: raises $0.10 to $0.15
HubertusB: folds 
Bot1729: folds 
RenningStone: folds 
Anikin44: folds 
DimanFlrrr: folds 
Uncalled bet ($0.10) returned to ayhshhh
ayhshhh collected $0.12 from pot
ayhshhh: doesn't show hand 
*** SUMMARY ***
Total pot $0.12 | Rake $0 
Seat 1: RenningStone (button) folded before Flop (didn't bet)
Seat 2: Anikin44 (small blind) folded before Flop
Seat 3: DimanFlrrr (big blind) folded before Flop
Seat 4: ayhshhh collected ($0.12)
Seat 5: HubertusB folded before Flop (didn't bet)
Seat 6: Bot1729 folded before Flop (didn't bet)



PokerStars Zoom Hand #178482382822:  Hold'em No Limit ($0.02/$0.05) - 2017/11/20 21:10:35 CCT [2017/11/20 8:10:35 ET]
Table 'Donati' 6-max Seat #1 is the button
Seat 1: HubertusB ($4.21 in chips) 
Seat 2: spamec ($5 in chips) 
Seat 3: TsaturianAA ($8.84 in chips) 
Seat 4: oskican ($8.79 in chips) 
Seat 5: kuansheng ($5.73 in chips) 
Seat 6: collapse.n1 ($5.30 in chips) 
spamec: posts small blind $0.02
TsaturianAA: posts big blind $0.05
*** HOLE CARDS ***
Dealt to HubertusB [3c Th]
oskican: folds 
kuansheng: raises $0.10 to $0.15
collapse.n1: folds 
HubertusB: folds 
spamec: folds 
TsaturianAA: folds 
Uncalled bet ($0.10) returned to kuansheng
kuansheng collected $0.12 from pot
kuansheng: doesn't show hand 
*** SUMMARY ***
Total pot $0.12 | Rake $0 
Seat 1: HubertusB (button) folded before Flop (didn't bet)
Seat 2: spamec (small blind) folded before Flop
Seat 3: TsaturianAA (big blind) folded before Flop
Seat 4: oskican folded before Flop (didn't bet)
Seat 5: kuansheng collected ($0.12)
Seat 6: collapse.n1 folded before Flop (didn't bet)



PokerStars Zoom Hand #178482392024:  Hold'em No Limit ($0.02/$0.05) - 2017/11/20 21:10:55 CCT [2017/11/20 8:10:55 ET]
Table 'Donati' 6-max Seat #1 is the button
Seat 1: millay1114 ($5.09 in chips) 
Seat 2: MomofMacey ($4.79 in chips) 
Seat 3: TrickyJKF ($2.43 in chips) 
Seat 4: 1holodilnik ($3.31 in chips) 
Seat 5: lulu210910 ($4.57 in chips) 
Seat 6: HubertusB ($4.19 in chips) 
MomofMacey: posts small blind $0.02
TrickyJKF: posts big blind $0.05
*** HOLE CARDS ***
Dealt to HubertusB [5s 4h]
1holodilnik: folds 
lulu210910: folds 
HubertusB: folds 
millay1114: folds 
MomofMacey: folds 
Uncalled bet ($0.03) returned to TrickyJKF
TrickyJKF collected $0.04 from pot
TrickyJKF: doesn't show hand 
*** SUMMARY ***
Total pot $0.04 | Rake $0 
Seat 1: millay1114 (button) folded before Flop (didn't bet)
Seat 2: MomofMacey (small blind) folded before Flop
Seat 3: TrickyJKF (big blind) collected ($0.04)
Seat 4: 1holodilnik folded before Flop (didn't bet)
Seat 5: lulu210910 folded before Flop (didn't bet)
Seat 6: HubertusB folded before Flop (didn't bet)



PokerStars Zoom Hand #178482389800:  Hold'em No Limit ($0.02/$0.05) - 2017/11/20 21:10:50 CCT [2017/11/20 8:10:50 ET]
Table 'Donati' 6-max Seat #1 is the button
Seat 1: TrickyJKF ($2.43 in chips) 
Seat 2: HubertusB ($4.21 in chips) 
Seat 3: AAgenaWin ($4.27 in chips) 
Seat 4: WangHaoWei ($14.92 in chips) 
Seat 5: ALazarev157 ($5.58 in chips) 
Seat 6: Karat_BLR ($9.17 in chips) 
HubertusB: posts small blind $0.02
AAgenaWin: posts big blind $0.05
*** HOLE CARDS ***
Dealt to HubertusB [5s Jc]
WangHaoWei: folds 
ALazarev157: folds 
Karat_BLR: raises $0.10 to $0.15
TrickyJKF: folds 
HubertusB: folds 
AAgenaWin: folds 
Uncalled bet ($0.10) returned to Karat_BLR
Karat_BLR collected $0.12 from pot
Karat_BLR: doesn't show hand 
*** SUMMARY ***
Total pot $0.12 | Rake $0 
Seat 1: TrickyJKF (button) folded before Flop (didn't bet)
Seat 2: HubertusB (small blind) folded before Flop
Seat 3: AAgenaWin (big blind) folded before Flop
Seat 4: WangHaoWei folded before Flop (didn't bet)
Seat 5: ALazarev157 folded before Flop (didn't bet)
Seat 6: Karat_BLR collected ($0.12)



PokerStars Zoom Hand #178482394828:  Hold'em No Limit ($0.02/$0.05) - 2017/11/20 21:11:01 CCT [2017/11/20 8:11:01 ET]
Table 'Donati' 6-max Seat #1 is the button
Seat 1: Misterr Free ($4.82 in chips) 
Seat 2: maksimus 84 ($3.80 in chips) 
Seat 3: pogordaniel ($5 in chips) 
Seat 4: nervss ($5.76 in chips) 
Seat 5: HubertusB ($4.19 in chips) 
Seat 6: stason777 ($5.69 in chips) 
maksimus 84: posts small blind $0.02
pogordaniel: posts big blind $0.05
*** HOLE CARDS ***
Dealt to HubertusB [2c Ac]
nervss: folds 
HubertusB: raises $0.05 to $0.10
stason777: folds 
Misterr Free: raises $0.05 to $0.15
maksimus 84: folds 
pogordaniel: folds 
HubertusB: calls $0.05
*** FLOP *** [4s 8h 6d]
HubertusB: checks 
Misterr Free: bets $0.19
HubertusB: folds 
Uncalled bet ($0.19) returned to Misterr Free
Misterr Free collected $0.35 from pot
Misterr Free: doesn't show hand 
*** SUMMARY ***
Total pot $0.37 | Rake $0.02 
Board [4s 8h 6d]
Seat 1: Misterr Free (button) collected ($0.35)
Seat 2: maksimus 84 (small blind) folded before Flop
Seat 3: pogordaniel (big blind) folded before Flop
Seat 4: nervss folded before Flop (didn't bet)
Seat 5: HubertusB folded on the Flop
Seat 6: stason777 folded before Flop (didn't bet)



PokerStars Zoom Hand #178482405537:  Hold'em No Limit ($0.02/$0.05) - 2017/11/20 21:11:24 CCT [2017/11/20 8:11:24 ET]
Table 'Donati' 6-max Seat #1 is the button
Seat 1: Marka555 ($10.87 in chips) 
Seat 2: Bunnytrickz7 ($5.89 in chips) 
Seat 3: svansong ($5.80 in chips) 
Seat 4: HubertusB ($4.04 in chips) 
Seat 5: N1IL ($6.01 in chips) 
Seat 6: bumbowski ($19.33 in chips) 
Bunnytrickz7: posts small blind $0.02
svansong: posts big blind $0.05
*** HOLE CARDS ***
Dealt to HubertusB [5d Ah]
HubertusB: folds 
N1IL: raises $0.10 to $0.15
bumbowski: folds 
Marka555: calls $0.15
Bunnytrickz7: folds 
svansong: folds 
*** FLOP *** [9h 2d Tc]
N1IL: bets $0.25
Marka555: folds 
Uncalled bet ($0.25) returned to N1IL
N1IL collected $0.35 from pot
N1IL: doesn't show hand 
*** SUMMARY ***
Total pot $0.37 | Rake $0.02 
Board [9h 2d Tc]
Seat 1: Marka555 (button) folded on the Flop
Seat 2: Bunnytrickz7 (small blind) folded before Flop
Seat 3: svansong (big blind) folded before Flop
Seat 4: HubertusB folded before Flop (didn't bet)
Seat 5: N1IL collected ($0.35)
Seat 6: bumbowski folded before Flop (didn't bet)



PokerStars Zoom Hand #178482407849:  Hold'em No Limit ($0.02/$0.05) - 2017/11/20 21:11:29 CCT [2017/11/20 8:11:29 ET]
Table 'Donati' 6-max Seat #1 is the button
Seat 1: mikk2468 ($5.66 in chips) 
Seat 2: samurai ume ($5.23 in chips) 
Seat 3: HubertusB ($4.04 in chips) 
Seat 4: #Jang123# ($7.71 in chips) 
Seat 5: Dubok86 ($6.60 in chips) 
Seat 6: SHUR43 ($8.96 in chips) 
samurai ume: posts small blind $0.02
HubertusB: posts big blind $0.05
*** HOLE CARDS ***
Dealt to HubertusB [Ah Th]
#Jang123#: folds 
Dubok86: raises $0.10 to $0.15
SHUR43: folds 
mikk2468: folds 
samurai ume: folds 
HubertusB: calls $0.10
*** FLOP *** [3h Qd Ts]
HubertusB: checks 
Dubok86: checks 
*** TURN *** [3h Qd Ts] [5d]
HubertusB: checks 
Dubok86: checks 
*** RIVER *** [3h Qd Ts 5d] [Jd]
HubertusB: checks 
Dubok86: checks 
*** SHOW DOWN ***
HubertusB: shows [Ah Th] (a pair of Tens)
Dubok86: mucks hand 
HubertusB collected $0.31 from pot
*** SUMMARY ***
Total pot $0.32 | Rake $0.01 
Board [3h Qd Ts 5d Jd]
Seat 1: mikk2468 (button) folded before Flop (didn't bet)
Seat 2: samurai ume (small blind) folded before Flop
Seat 3: HubertusB (big blind) showed [Ah Th] and won ($0.31) with a pair of Tens
Seat 4: #Jang123# folded before Flop (didn't bet)
Seat 5: Dubok86 mucked [3s As]
Seat 6: SHUR43 folded before Flop (didn't bet)



PokerStars Zoom Hand #178482427699:  Hold'em No Limit ($0.02/$0.05) - 2017/11/20 21:12:12 CCT [2017/11/20 8:12:12 ET]
Table 'Donati' 6-max Seat #1 is the button
Seat 1: krzys19697 ($5 in chips) 
Seat 2: Bunnytrickz7 ($2.92 in chips) 
Seat 3: Nicosan.ru ($3.96 in chips) 
Seat 4: HubertusB ($4.20 in chips) 
Seat 5: m4ri4kky ($8.19 in chips) 
Seat 6: auesthete ($4.70 in chips) 
Bunnytrickz7: posts small blind $0.02
Nicosan.ru: posts big blind $0.05
*** HOLE CARDS ***
Dealt to HubertusB [8d 8c]
HubertusB: raises $0.05 to $0.10
m4ri4kky: folds 
auesthete: folds 
krzys19697: calls $0.10
Bunnytrickz7: folds 
Nicosan.ru: folds 
*** FLOP *** [8s 3c 8h]
HubertusB: bets $0.10
krzys19697: calls $0.10
*** TURN *** [8s 3c 8h] [4h]
HubertusB: bets $0.35
krzys19697: folds 
Uncalled bet ($0.35) returned to HubertusB
HubertusB collected $0.45 from pot
HubertusB: doesn't show hand 
*** SUMMARY ***
Total pot $0.47 | Rake $0.02 
Board [8s 3c 8h 4h]
Seat 1: krzys19697 (button) folded on the Turn
Seat 2: Bunnytrickz7 (small blind) folded before Flop
Seat 3: Nicosan.ru (big blind) folded before Flop
Seat 4: HubertusB collected ($0.45)
Seat 5: m4ri4kky folded before Flop (didn't bet)
Seat 6: auesthete folded before Flop (didn't bet)



PokerStars Zoom Hand #178482446193:  Hold'em No Limit ($0.02/$0.05) - 2017/11/20 21:12:52 CCT [2017/11/20 8:12:52 ET]
Table 'Donati' 6-max Seat #1 is the button
Seat 1: stason777 ($5.66 in chips) 
Seat 2: HubertusB ($4.45 in chips) 
Seat 3: p00ker_pl ($8.47 in chips) 
Seat 4: MoreRakePls1 ($5.68 in chips) 
Seat 5: t1mka09367 ($13.90 in chips) 
Seat 6: sQud_AK ($7.47 in chips) 
HubertusB: posts small blind $0.02
p00ker_pl: posts big blind $0.05
*** HOLE CARDS ***
Dealt to HubertusB [Ah 7h]
MoreRakePls1: folds 
t1mka09367: raises $0.10 to $0.15
sQud_AK: folds 
stason777: folds 
HubertusB: folds 
p00ker_pl: folds 
Uncalled bet ($0.10) returned to t1mka09367
t1mka09367 collected $0.12 from pot
t1mka09367: doesn't show hand 
*** SUMMARY ***
Total pot $0.12 | Rake $0 
Seat 1: stason777 (button) folded before Flop (didn't bet)
Seat 2: HubertusB (small blind) folded before Flop
Seat 3: p00ker_pl (big blind) folded before Flop
Seat 4: MoreRakePls1 folded before Flop (didn't bet)
Seat 5: t1mka09367 collected ($0.12)
Seat 6: sQud_AK folded before Flop (didn't bet)



PokerStars Zoom Hand #178482450313:  Hold'em No Limit ($0.02/$0.05) - 2017/11/20 21:13:01 CCT [2017/11/20 8:13:01 ET]
Table 'Donati' 6-max Seat #1 is the button
Seat 1: HubertusB ($4.43 in chips) 
Seat 2: folydr ($5.09 in chips) 
Seat 3: artem3660 ($3.50 in chips) 
Seat 4: richardvelp ($1.51 in chips) 
Seat 5: tavi111 ($4.71 in chips) 
Seat 6: tstf0705 ($2.28 in chips) 
folydr: posts small blind $0.02
artem3660: posts big blind $0.05
*** HOLE CARDS ***
Dealt to HubertusB [9c 3h]
richardvelp: calls $0.05
tavi111: raises $0.10 to $0.15
tstf0705: folds 
HubertusB: folds 
folydr: folds 
artem3660: folds 
richardvelp: folds 
Uncalled bet ($0.10) returned to tavi111
tavi111 collected $0.17 from pot
tavi111: doesn't show hand 
*** SUMMARY ***
Total pot $0.17 | Rake $0 
Seat 1: HubertusB (button) folded before Flop (didn't bet)
Seat 2: folydr (small blind) folded before Flop
Seat 3: artem3660 (big blind) folded before Flop
Seat 4: richardvelp folded before Flop
Seat 5: tavi111 collected ($0.17)
Seat 6: tstf0705 folded before Flop (didn't bet)



PokerStars Zoom Hand #178482453101:  Hold'em No Limit ($0.02/$0.05) - 2017/11/20 21:13:07 CCT [2017/11/20 8:13:07 ET]
Table 'Donati' 6-max Seat #1 is the button
Seat 1: AndreasAU79 ($9.37 in chips) 
Seat 2: WangHaoWei ($4.73 in chips) 
Seat 3: p3rf3ct00 ($11.59 in chips) 
Seat 4: lehaara2 ($29.75 in chips) 
Seat 5: hceyms ($5.05 in chips) 
Seat 6: HubertusB ($4.43 in chips) 
WangHaoWei: posts small blind $0.02
p3rf3ct00: posts big blind $0.05
*** HOLE CARDS ***
Dealt to HubertusB [Td 9h]
lehaara2: folds 
hceyms: folds 
HubertusB: raises $0.05 to $0.10
AndreasAU79: raises $0.26 to $0.36
WangHaoWei: folds 
p3rf3ct00: folds 
HubertusB: folds 
Uncalled bet ($0.26) returned to AndreasAU79
AndreasAU79 collected $0.27 from pot
AndreasAU79: doesn't show hand 
*** SUMMARY ***
Total pot $0.27 | Rake $0 
Seat 1: AndreasAU79 (button) collected ($0.27)
Seat 2: WangHaoWei (small blind) folded before Flop
Seat 3: p3rf3ct00 (big blind) folded before Flop
Seat 4: lehaara2 folded before Flop (didn't bet)
Seat 5: hceyms folded before Flop (didn't bet)
Seat 6: HubertusB folded before Flop



PokerStars Zoom Hand #178482463762:  Hold'em No Limit ($0.02/$0.05) - 2017/11/20 21:13:30 CCT [2017/11/20 8:13:30 ET]
Table 'Donati' 6-max Seat #1 is the button
Seat 1: Le Bicois ($7.80 in chips) 
Seat 2: millay1114 ($5.14 in chips) 
Seat 3: =AnVit= ($3.10 in chips) 
Seat 4: Sumow ($5 in chips) 
Seat 5: HubertusB ($4.33 in chips) 
Seat 6: edcrfvrtgb ($1.98 in chips) 
millay1114: posts small blind $0.02
=AnVit=: posts big blind $0.05
*** HOLE CARDS ***
Dealt to HubertusB [5d 9h]
Sumow: folds 
HubertusB: folds 
edcrfvrtgb: raises $0.25 to $0.30
Le Bicois: folds 
millay1114: folds 
=AnVit=: folds 
Uncalled bet ($0.25) returned to edcrfvrtgb
edcrfvrtgb collected $0.12 from pot
edcrfvrtgb: doesn't show hand 
*** SUMMARY ***
Total pot $0.12 | Rake $0 
Seat 1: Le Bicois (button) folded before Flop (didn't bet)
Seat 2: millay1114 (small blind) folded before Flop
Seat 3: =AnVit= (big blind) folded before Flop
Seat 4: Sumow folded before Flop (didn't bet)
Seat 5: HubertusB folded before Flop (didn't bet)
Seat 6: edcrfvrtgb collected ($0.12)



PokerStars Zoom Hand #178482466538:  Hold'em No Limit ($0.02/$0.05) - 2017/11/20 21:13:36 CCT [2017/11/20 8:13:36 ET]
Table 'Donati' 6-max Seat #1 is the button
Seat 1: SLuTxTReMe ($5 in chips) 
Seat 2: tailbasher ($5.11 in chips) 
Seat 3: HubertusB ($4.33 in chips) 
Seat 4: AbraRoy ($14.77 in chips) 
Seat 5: p3rf3ct00 ($5.64 in chips) 
Seat 6: collapse.n1 ($5 in chips) 
tailbasher: posts small blind $0.02
HubertusB: posts big blind $0.05
*** HOLE CARDS ***
Dealt to HubertusB [Qc Jd]
AbraRoy: folds 
p3rf3ct00: folds 
collapse.n1: folds 
SLuTxTReMe: raises $0.07 to $0.12
tailbasher: folds 
HubertusB: calls $0.07
*** FLOP *** [3d 6d Jh]
HubertusB: checks 
SLuTxTReMe: checks 
*** TURN *** [3d 6d Jh] [Ad]
HubertusB: checks 
SLuTxTReMe: checks 
*** RIVER *** [3d 6d Jh Ad] [9h]
HubertusB: bets $0.25
SLuTxTReMe: folds 
Uncalled bet ($0.25) returned to HubertusB
HubertusB collected $0.25 from pot
HubertusB: doesn't show hand 
*** SUMMARY ***
Total pot $0.26 | Rake $0.01 
Board [3d 6d Jh Ad 9h]
Seat 1: SLuTxTReMe (button) folded on the River
Seat 2: tailbasher (small blind) folded before Flop
Seat 3: HubertusB (big blind) collected ($0.25)
Seat 4: AbraRoy folded before Flop (didn't bet)
Seat 5: p3rf3ct00 folded before Flop (didn't bet)
Seat 6: collapse.n1 folded before Flop (didn't bet)



PokerStars Zoom Hand #178482486381:  Hold'em No Limit ($0.02/$0.05) - 2017/11/20 21:14:19 CCT [2017/11/20 8:14:19 ET]
Table 'Donati' 6-max Seat #1 is the button
Seat 1: viktor_KK ($5 in chips) 
Seat 2: hobbididence ($5.43 in chips) 
Seat 3: Danieljam17 ($2.50 in chips) 
Seat 4: djronalein ($6.55 in chips) 
Seat 5: Jetohunter ($6.40 in chips) 
Seat 6: HubertusB ($4.46 in chips) 
hobbididence: posts small blind $0.02
Danieljam17: posts big blind $0.05
*** HOLE CARDS ***
Dealt to HubertusB [8d 7s]
djronalein: folds 
Jetohunter: raises $0.10 to $0.15
HubertusB: raises $0.30 to $0.45
viktor_KK: folds 
hobbididence: folds 
Danieljam17: raises $2.05 to $2.50 and is all-in
Jetohunter: folds 
HubertusB: folds 
Uncalled bet ($2.05) returned to Danieljam17
Danieljam17 collected $1.07 from pot
Danieljam17: doesn't show hand 
*** SUMMARY ***
Total pot $1.07 | Rake $0 
Seat 1: viktor_KK (button) folded before Flop (didn't bet)
Seat 2: hobbididence (small blind) folded before Flop
Seat 3: Danieljam17 (big blind) collected ($1.07)
Seat 4: djronalein folded before Flop (didn't bet)
Seat 5: Jetohunter folded before Flop
Seat 6: HubertusB folded before Flop



PokerStars Zoom Hand #178482493362:  Hold'em No Limit ($0.02/$0.05) - 2017/11/20 21:14:34 CCT [2017/11/20 8:14:34 ET]
Table 'Donati' 6-max Seat #1 is the button
Seat 1: HubertusB ($4.01 in chips) 
Seat 2: denis313 86 ($3.24 in chips) 
Seat 3: WangHaoWei ($4.24 in chips) 
Seat 4: Polypops ($6.34 in chips) 
Seat 5: Alexandro670 ($2.58 in chips) 
Seat 6: zouzounos86 ($9.87 in chips) 
denis313 86: posts small blind $0.02
WangHaoWei: posts big blind $0.05
*** HOLE CARDS ***
Dealt to HubertusB [Jh Qs]
Polypops: folds 
Alexandro670: folds 
zouzounos86: calls $0.05
HubertusB: raises $0.15 to $0.20
denis313 86: calls $0.18
WangHaoWei: folds 
zouzounos86: calls $0.15
*** FLOP *** [6s 3s 6c]
denis313 86: bets $0.31
zouzounos86: calls $0.31
HubertusB: folds 
*** TURN *** [6s 3s 6c] [5d]
denis313 86: bets $0.61
zouzounos86: raises $8.75 to $9.36 and is all-in
denis313 86: folds 
Uncalled bet ($8.75) returned to zouzounos86
zouzounos86 collected $2.39 from pot
zouzounos86: doesn't show hand 
*** SUMMARY ***
Total pot $2.49 | Rake $0.10 
Board [6s 3s 6c 5d]
Seat 1: HubertusB (button) folded on the Flop
Seat 2: denis313 86 (small blind) folded on the Turn
Seat 3: WangHaoWei (big blind) folded before Flop
Seat 4: Polypops folded before Flop (didn't bet)
Seat 5: Alexandro670 folded before Flop (didn't bet)
Seat 6: zouzounos86 collected ($2.39)



PokerStars Zoom Hand #178482510946:  Hold'em No Limit ($0.02/$0.05) - 2017/11/20 21:15:12 CCT [2017/11/20 8:15:12 ET]
Table 'Donati' 6-max Seat #1 is the button
Seat 1: Bunnytrickz7 ($4.95 in chips) 
Seat 2: HubertusB ($3.81 in chips) 
Seat 3: AlexDeLargee ($13.54 in chips) 
Seat 4: MukhamedMR ($2.66 in chips) 
Seat 5: C0!3r@ ($10.14 in chips) 
Seat 6: seawolf111 ($13.16 in chips) 
HubertusB: posts small blind $0.02
AlexDeLargee: posts big blind $0.05
*** HOLE CARDS ***
Dealt to HubertusB [8d Ad]
MukhamedMR: calls $0.05
C0!3r@: raises $0.15 to $0.20
seawolf111: folds 
Bunnytrickz7: folds 
HubertusB: folds 
AlexDeLargee: folds 
MukhamedMR: calls $0.15
*** FLOP *** [Kc Kd 4s]
MukhamedMR: checks 
C0!3r@: checks 
*** TURN *** [Kc Kd 4s] [5h]
MukhamedMR: checks 
C0!3r@: bets $0.23
MukhamedMR: folds 
Uncalled bet ($0.23) returned to C0!3r@
C0!3r@ collected $0.45 from pot
C0!3r@: doesn't show hand 
*** SUMMARY ***
Total pot $0.47 | Rake $0.02 
Board [Kc Kd 4s 5h]
Seat 1: Bunnytrickz7 (button) folded before Flop (didn't bet)
Seat 2: HubertusB (small blind) folded before Flop
Seat 3: AlexDeLargee (big blind) folded before Flop
Seat 4: MukhamedMR folded on the Turn
Seat 5: C0!3r@ collected ($0.45)
Seat 6: seawolf111 folded before Flop (didn't bet)



PokerStars Zoom Hand #178482517911:  Hold'em No Limit ($0.02/$0.05) - 2017/11/20 21:15:27 CCT [2017/11/20 8:15:27 ET]
Table 'Donati' 6-max Seat #1 is the button
Seat 1: SLuTxTReMe ($5.50 in chips) 
Seat 2: keenakeena73 ($6.32 in chips) 
Seat 3: FriskyBear ($5 in chips) 
Seat 4: zikin444 ($4.93 in chips) 
Seat 5: HubertusB ($3.79 in chips) 
Seat 6: muttmcc ($4 in chips) 
keenakeena73: posts small blind $0.02
FriskyBear: posts big blind $0.05
*** HOLE CARDS ***
Dealt to HubertusB [5d 9d]
zikin444: folds 
HubertusB: raises $0.05 to $0.10
muttmcc: folds 
SLuTxTReMe: calls $0.10
keenakeena73: folds 
FriskyBear: raises $0.32 to $0.42
HubertusB: raises $0.63 to $1.05
SLuTxTReMe: folds 
FriskyBear: folds 
Uncalled bet ($0.63) returned to HubertusB
HubertusB collected $0.96 from pot
HubertusB: doesn't show hand 
*** SUMMARY ***
Total pot $0.96 | Rake $0 
Seat 1: SLuTxTReMe (button) folded before Flop
Seat 2: keenakeena73 (small blind) folded before Flop
Seat 3: FriskyBear (big blind) folded before Flop
Seat 4: zikin444 folded before Flop (didn't bet)
Seat 5: HubertusB collected ($0.96)
Seat 6: muttmcc folded before Flop (didn't bet)



PokerStars Zoom Hand #178482530425:  Hold'em No Limit ($0.02/$0.05) - 2017/11/20 21:15:54 CCT [2017/11/20 8:15:54 ET]
Table 'Donati' 6-max Seat #1 is the button
Seat 1: Marka555 ($13.51 in chips) 
Seat 2: lyntik311 ($11.67 in chips) 
Seat 3: HubertusB ($4.33 in chips) 
Seat 4: Clinmd ($3.41 in chips) 
Seat 5: #Jang123# ($9.16 in chips) 
Seat 6: Anjinsan777 ($6.38 in chips) 
lyntik311: posts small blind $0.02
HubertusB: posts big blind $0.05
*** HOLE CARDS ***
Dealt to HubertusB [3h Th]
Clinmd: folds 
#Jang123#: folds 
Anjinsan777: folds 
Marka555: folds 
lyntik311: folds 
Uncalled bet ($0.03) returned to HubertusB
HubertusB collected $0.04 from pot
HubertusB: doesn't show hand 
*** SUMMARY ***
Total pot $0.04 | Rake $0 
Seat 1: Marka555 (button) folded before Flop (didn't bet)
Seat 2: lyntik311 (small blind) folded before Flop
Seat 3: HubertusB (big blind) collected ($0.04)
Seat 4: Clinmd folded before Flop (didn't bet)
Seat 5: #Jang123# folded before Flop (didn't bet)
Seat 6: Anjinsan777 folded before Flop (didn't bet)



PokerStars Zoom Hand #178482515552:  Hold'em No Limit ($0.02/$0.05) - 2017/11/20 21:15:22 CCT [2017/11/20 8:15:22 ET]
Table 'Donati' 6-max Seat #1 is the button
Seat 1: collapse.n1 ($5.52 in chips) 
Seat 2: RinkoYamada ($10.02 in chips) 
Seat 3: oskican ($7.04 in chips) 
Seat 4: HubertusB ($3.79 in chips) 
Seat 5: denis313 86 ($2.12 in chips) 
Seat 6: zikin444 ($2.43 in chips) 
RinkoYamada: posts small blind $0.02
oskican: posts big blind $0.05
*** HOLE CARDS ***
Dealt to HubertusB [9s Qd]
HubertusB: folds 
denis313 86: folds 
zikin444: folds 
collapse.n1: folds 
RinkoYamada: raises $0.10 to $0.15
oskican: calls $0.10
*** FLOP *** [7d 4c Qs]
RinkoYamada: bets $0.11
oskican: calls $0.11
*** TURN *** [7d 4c Qs] [4d]
RinkoYamada: bets $0.25
oskican: raises $0.55 to $0.80
RinkoYamada: folds 
Uncalled bet ($0.55) returned to oskican
oskican collected $0.98 from pot
oskican: doesn't show hand 
*** SUMMARY ***
Total pot $1.02 | Rake $0.04 
Board [7d 4c Qs 4d]
Seat 1: collapse.n1 (button) folded before Flop (didn't bet)
Seat 2: RinkoYamada (small blind) folded on the Turn
Seat 3: oskican (big blind) collected ($0.98)
Seat 4: HubertusB folded before Flop (didn't bet)
Seat 5: denis313 86 folded before Flop (didn't bet)
Seat 6: zikin444 folded before Flop (didn't bet)



PokerStars Zoom Hand #178482534073:  Hold'em No Limit ($0.02/$0.05) - 2017/11/20 21:16:02 CCT [2017/11/20 8:16:02 ET]
Table 'Donati' 6-max Seat #1 is the button
Seat 1: Sanek19911 ($5 in chips) 
Seat 2: MrBigFish001 ($5.04 in chips) 
Seat 3: djuniorm ($5.05 in chips) 
Seat 4: keenakeena73 ($6.25 in chips) 
Seat 5: HubertusB ($4.35 in chips) 
Seat 6: pythonjava ($5.43 in chips) 
MrBigFish001: posts small blind $0.02
djuniorm: posts big blind $0.05
*** HOLE CARDS ***
Dealt to HubertusB [Kc Tc]
keenakeena73: raises $0.05 to $0.10
HubertusB: raises $0.20 to $0.30
pythonjava: folds 
Sanek19911: folds 
MrBigFish001: folds 
djuniorm: folds 
keenakeena73: calls $0.20
*** FLOP *** [Qc 7s 7c]
keenakeena73: checks 
HubertusB: bets $0.35
keenakeena73: folds 
Uncalled bet ($0.35) returned to HubertusB
HubertusB collected $0.64 from pot
HubertusB: doesn't show hand 
*** SUMMARY ***
Total pot $0.67 | Rake $0.03 
Board [Qc 7s 7c]
Seat 1: Sanek19911 (button) folded before Flop (didn't bet)
Seat 2: MrBigFish001 (small blind) folded before Flop
Seat 3: djuniorm (big blind) folded before Flop
Seat 4: keenakeena73 folded on the Flop
Seat 5: HubertusB collected ($0.64)
Seat 6: pythonjava folded before Flop (didn't bet)



PokerStars Zoom Hand #178482555185:  Hold'em No Limit ($0.02/$0.05) - 2017/11/20 21:16:47 CCT [2017/11/20 8:16:47 ET]
Table 'Donati' 6-max Seat #1 is the button
Seat 1: HubertusB ($4.69 in chips) 
Seat 2: Onlinedragon ($5 in chips) 
Seat 3: TitanX1 ($2.83 in chips) 
Seat 4: maksimus 84 ($7.52 in chips) 
Seat 5: talbotrich ($13.10 in chips) 
Seat 6: maruika ($10.09 in chips) 
Onlinedragon: posts small blind $0.02
TitanX1: posts big blind $0.05
*** HOLE CARDS ***
Dealt to HubertusB [Kh 9c]
maksimus 84: folds 
talbotrich: folds 
maruika: folds 
HubertusB: raises $0.05 to $0.10
Onlinedragon: folds 
TitanX1: calls $0.05
*** FLOP *** [5s Jd Kd]
TitanX1: checks 
HubertusB: checks 
*** TURN *** [5s Jd Kd] [3h]
TitanX1: checks 
HubertusB: bets $0.15
TitanX1: folds 
Uncalled bet ($0.15) returned to HubertusB
HubertusB collected $0.21 from pot
HubertusB: doesn't show hand 
*** SUMMARY ***
Total pot $0.22 | Rake $0.01 
Board [5s Jd Kd 3h]
Seat 1: HubertusB (button) collected ($0.21)
Seat 2: Onlinedragon (small blind) folded before Flop
Seat 3: TitanX1 (big blind) folded on the Turn
Seat 4: maksimus 84 folded before Flop (didn't bet)
Seat 5: talbotrich folded before Flop (didn't bet)
Seat 6: maruika folded before Flop (didn't bet)



PokerStars Zoom Hand #178482570061:  Hold'em No Limit ($0.02/$0.05) - 2017/11/20 21:17:19 CCT [2017/11/20 8:17:19 ET]
Table 'Donati' 6-max Seat #1 is the button
Seat 1: Bonch241 ($6.05 in chips) 
Seat 2: HubertusB ($4.80 in chips) 
Seat 3: fatinio914 ($5 in chips) 
Seat 4: San4i$ ($5.22 in chips) 
Seat 5: Dolyann ($4.88 in chips) 
Seat 6: alemoum ($9.66 in chips) 
HubertusB: posts small blind $0.02
fatinio914: posts big blind $0.05
*** HOLE CARDS ***
Dealt to HubertusB [8h 2c]
San4i$: folds 
Dolyann: folds 
alemoum: folds 
Bonch241: folds 
HubertusB: folds 
Uncalled bet ($0.03) returned to fatinio914
fatinio914 collected $0.04 from pot
fatinio914: doesn't show hand 
*** SUMMARY ***
Total pot $0.04 | Rake $0 
Seat 1: Bonch241 (button) folded before Flop (didn't bet)
Seat 2: HubertusB (small blind) folded before Flop
Seat 3: fatinio914 (big blind) collected ($0.04)
Seat 4: San4i$ folded before Flop (didn't bet)
Seat 5: Dolyann folded before Flop (didn't bet)
Seat 6: alemoum folded before Flop (didn't bet)



PokerStars Zoom Hand #178482572435:  Hold'em No Limit ($0.02/$0.05) - 2017/11/20 21:17:24 CCT [2017/11/20 8:17:24 ET]
Table 'Donati' 6-max Seat #1 is the button
Seat 1: 1kukla ($6.14 in chips) 
Seat 2: FriskyBear ($5 in chips) 
Seat 3: viggli ($5 in chips) 
Seat 4: HubertusB ($4.78 in chips) 
Seat 5: paradiseg174 ($12.70 in chips) 
Seat 6: AbraRoy ($13.14 in chips) 
FriskyBear: posts small blind $0.02
viggli: posts big blind $0.05
*** HOLE CARDS ***
Dealt to HubertusB [2h 8h]
HubertusB: raises $0.05 to $0.10
paradiseg174: folds 
AbraRoy: folds 
1kukla: folds 
FriskyBear: folds 
viggli: folds 
Uncalled bet ($0.05) returned to HubertusB
HubertusB collected $0.12 from pot
HubertusB: doesn't show hand 
*** SUMMARY ***
Total pot $0.12 | Rake $0 
Seat 1: 1kukla (button) folded before Flop (didn't bet)
Seat 2: FriskyBear (small blind) folded before Flop
Seat 3: viggli (big blind) folded before Flop
Seat 4: HubertusB collected ($0.12)
Seat 5: paradiseg174 folded before Flop (didn't bet)
Seat 6: AbraRoy folded before Flop (didn't bet)



PokerStars Zoom Hand #178482581337:  Hold'em No Limit ($0.02/$0.05) - 2017/11/20 21:17:43 CCT [2017/11/20 8:17:43 ET]
Table 'Donati' 6-max Seat #1 is the button
Seat 1: viggli ($5 in chips) 
Seat 2: paradiseg174 ($13.66 in chips) 
Seat 3: Ronny88278 ($5.22 in chips) 
Seat 4: Lexion 1983 ($2.50 in chips) 
Seat 5: HubertusB ($4.85 in chips) 
Seat 6: Weafar ($7.06 in chips) 
paradiseg174: posts small blind $0.02
Ronny88278: posts big blind $0.05
*** HOLE CARDS ***
Dealt to HubertusB [2c Jd]
Lexion 1983: raises $0.15 to $0.20
HubertusB: folds 
Weafar: folds 
viggli: folds 
paradiseg174: folds 
Ronny88278: folds 
Uncalled bet ($0.15) returned to Lexion 1983
Lexion 1983 collected $0.12 from pot
Lexion 1983: doesn't show hand 
*** SUMMARY ***
Total pot $0.12 | Rake $0 
Seat 1: viggli (button) folded before Flop (didn't bet)
Seat 2: paradiseg174 (small blind) folded before Flop
Seat 3: Ronny88278 (big blind) folded before Flop
Seat 4: Lexion 1983 collected ($0.12)
Seat 5: HubertusB folded before Flop (didn't bet)
Seat 6: Weafar folded before Flop (didn't bet)



PokerStars Zoom Hand #178482583682:  Hold'em No Limit ($0.02/$0.05) - 2017/11/20 21:17:48 CCT [2017/11/20 8:17:48 ET]
Table 'Donati' 6-max Seat #1 is the button
Seat 1: the_Joker'83 ($5.02 in chips) 
Seat 2: Acedan1369 ($32.14 in chips) 
Seat 3: FriskyBear ($5 in chips) 
Seat 4: HubertusB ($4.85 in chips) 
Seat 5: Pro7Gin ($2.28 in chips) 
Seat 6: Dokerokk23 ($4.92 in chips) 
Acedan1369: posts small blind $0.02
FriskyBear: posts big blind $0.05
*** HOLE CARDS ***
Dealt to HubertusB [5c 7h]
HubertusB: folds 
Pro7Gin: raises $0.05 to $0.10
Dokerokk23: folds 
the_Joker'83: folds 
Acedan1369: folds 
FriskyBear: folds 
Uncalled bet ($0.05) returned to Pro7Gin
Pro7Gin collected $0.12 from pot
Pro7Gin: doesn't show hand 
*** SUMMARY ***
Total pot $0.12 | Rake $0 
Seat 1: the_Joker'83 (button) folded before Flop (didn't bet)
Seat 2: Acedan1369 (small blind) folded before Flop
Seat 3: FriskyBear (big blind) folded before Flop
Seat 4: HubertusB folded before Flop (didn't bet)
Seat 5: Pro7Gin collected ($0.12)
Seat 6: Dokerokk23 folded before Flop (didn't bet)



PokerStars Zoom Hand #178482567250:  Hold'em No Limit ($0.02/$0.05) - 2017/11/20 21:17:13 CCT [2017/11/20 8:17:13 ET]
Table 'Donati' 6-max Seat #1 is the button
Seat 1: millay1114 ($5.69 in chips) 
Seat 2: Al3Goulart ($7.04 in chips) 
Seat 3: BCE bUDET ($7.01 in chips) 
Seat 4: alemoum ($5 in chips) 
Seat 5: Duboin ($5.87 in chips) 
Seat 6: HubertusB ($4.80 in chips) 
Al3Goulart: posts small blind $0.02
BCE bUDET: posts big blind $0.05
*** HOLE CARDS ***
Dealt to HubertusB [3d 8s]
alemoum: folds 
Duboin: folds 
HubertusB: folds 
millay1114: raises $0.10 to $0.15
Al3Goulart: raises $0.27 to $0.42
BCE bUDET: folds 
millay1114: folds 
Uncalled bet ($0.27) returned to Al3Goulart
Al3Goulart collected $0.35 from pot
Al3Goulart: doesn't show hand 
*** SUMMARY ***
Total pot $0.35 | Rake $0 
Seat 1: millay1114 (button) folded before Flop
Seat 2: Al3Goulart (small blind) collected ($0.35)
Seat 3: BCE bUDET (big blind) folded before Flop
Seat 4: alemoum folded before Flop (didn't bet)
Seat 5: Duboin folded before Flop (didn't bet)
Seat 6: HubertusB folded before Flop (didn't bet)



PokerStars Zoom Hand #178482595288:  Hold'em No Limit ($0.02/$0.05) - 2017/11/20 21:18:13 CCT [2017/11/20 8:18:13 ET]
Table 'Donati' 6-max Seat #1 is the button
Seat 1: HubertusB ($4.80 in chips) 
Seat 2: Zire99 ($6.46 in chips) 
Seat 3: Cruzivey ($6.58 in chips) 
Seat 4: Kutis33 ($11.12 in chips) 
Seat 5: AlexDeLargee ($5.21 in chips) 
Seat 6: srvanhell ($2.93 in chips) 
Zire99: posts small blind $0.02
Cruzivey: posts big blind $0.05
*** HOLE CARDS ***
Dealt to HubertusB [3c Ad]
Kutis33: folds 
AlexDeLargee: raises $0.10 to $0.15
srvanhell: folds 
HubertusB: folds 
Zire99: folds 
Cruzivey: folds 
Uncalled bet ($0.10) returned to AlexDeLargee
AlexDeLargee collected $0.12 from pot
AlexDeLargee: doesn't show hand 
*** SUMMARY ***
Total pot $0.12 | Rake $0 
Seat 1: HubertusB (button) folded before Flop (didn't bet)
Seat 2: Zire99 (small blind) folded before Flop
Seat 3: Cruzivey (big blind) folded before Flop
Seat 4: Kutis33 folded before Flop (didn't bet)
Seat 5: AlexDeLargee collected ($0.12)
Seat 6: srvanhell folded before Flop (didn't bet)



PokerStars Zoom Hand #178482586037:  Hold'em No Limit ($0.02/$0.05) - 2017/11/20 21:17:53 CCT [2017/11/20 8:17:53 ET]
Table 'Donati' 6-max Seat #1 is the button
Seat 1: klajdishehu1 ($4.83 in chips) 
Seat 2: 3iourou ($5.45 in chips) 
Seat 3: HubertusB ($4.85 in chips) 
Seat 4: Schwabe02 ($5.58 in chips) 
Seat 5: IanMalique9 ($24.26 in chips) 
Seat 6: kidboss1990 ($8.81 in chips) 
3iourou: posts small blind $0.02
HubertusB: posts big blind $0.05
*** HOLE CARDS ***
Dealt to HubertusB [Th 6s]
Schwabe02: folds 
IanMalique9: folds 
kidboss1990: raises $0.10 to $0.15
klajdishehu1: calls $0.15
3iourou: folds 
HubertusB: folds 
*** FLOP *** [Kc 4d 5h]
kidboss1990: checks 
klajdishehu1: checks 
*** TURN *** [Kc 4d 5h] [Ac]
kidboss1990: checks 
klajdishehu1: checks 
*** RIVER *** [Kc 4d 5h Ac] [6h]
kidboss1990: checks 
klajdishehu1: bets $0.05
kidboss1990: calls $0.05
*** SHOW DOWN ***
klajdishehu1: shows [Tc 5d] (a pair of Fives)
kidboss1990: shows [8d 8c] (a pair of Eights)
kidboss1990 collected $0.45 from pot
*** SUMMARY ***
Total pot $0.47 | Rake $0.02 
Board [Kc 4d 5h Ac 6h]
Seat 1: klajdishehu1 (button) showed [Tc 5d] and lost with a pair of Fives
Seat 2: 3iourou (small blind) folded before Flop
Seat 3: HubertusB (big blind) folded before Flop
Seat 4: Schwabe02 folded before Flop (didn't bet)
Seat 5: IanMalique9 folded before Flop (didn't bet)
Seat 6: kidboss1990 showed [8d 8c] and won ($0.45) with a pair of Eights



PokerStars Zoom Hand #178482600416:  Hold'em No Limit ($0.02/$0.05) - 2017/11/20 21:18:24 CCT [2017/11/20 8:18:24 ET]
Table 'Donati' 6-max Seat #1 is the button
Seat 1: Ravaas ($4.33 in chips) 
Seat 2: HubertusB ($4.80 in chips) 
Seat 3: serega55reg ($5 in chips) 
Seat 4: ZlayaMyxa ($5.70 in chips) 
Seat 5: baggelisdr1 ($8.60 in chips) 
Seat 6: viggli ($5 in chips) 
HubertusB: posts small blind $0.02
serega55reg: posts big blind $0.05
*** HOLE CARDS ***
Dealt to HubertusB [2h 2s]
ZlayaMyxa: folds 
baggelisdr1: folds 
viggli: raises $0.10 to $0.15
Ravaas: raises $0.41 to $0.56
HubertusB: folds 
serega55reg: folds 
viggli: folds 
Uncalled bet ($0.41) returned to Ravaas
Ravaas collected $0.37 from pot
Ravaas: doesn't show hand 
*** SUMMARY ***
Total pot $0.37 | Rake $0 
Seat 1: Ravaas (button) collected ($0.37)
Seat 2: HubertusB (small blind) folded before Flop
Seat 3: serega55reg (big blind) folded before Flop
Seat 4: ZlayaMyxa folded before Flop (didn't bet)
Seat 5: baggelisdr1 folded before Flop (didn't bet)
Seat 6: viggli folded before Flop



PokerStars Zoom Hand #178482606085:  Hold'em No Limit ($0.02/$0.05) - 2017/11/20 21:18:36 CCT [2017/11/20 8:18:36 ET]
Table 'Donati' 6-max Seat #1 is the button
Seat 1: PsBadBluff ($7.66 in chips) 
Seat 2: Duboin ($5.66 in chips) 
Seat 3: Leshchik ($7.25 in chips) 
Seat 4: hobbididence ($5.98 in chips) 
Seat 5: djuniorm ($5 in chips) 
Seat 6: HubertusB ($4.78 in chips) 
Duboin: posts small blind $0.02
Leshchik: posts big blind $0.05
*** HOLE CARDS ***
Dealt to HubertusB [4c Ac]
hobbididence: folds 
djuniorm: folds 
HubertusB: raises $0.05 to $0.10
PsBadBluff: calls $0.10
Duboin: calls $0.08
Leshchik: folds 
*** FLOP *** [7d Ts Ad]
Duboin: checks 
HubertusB: bets $0.25
PsBadBluff: folds 
Duboin: calls $0.25
*** TURN *** [7d Ts Ad] [5d]
Duboin: checks 
HubertusB: checks 
*** RIVER *** [7d Ts Ad 5d] [Jd]
Duboin: checks 
HubertusB: checks 
*** SHOW DOWN ***
Duboin: shows [Js Qs] (a pair of Jacks)
HubertusB: shows [4c Ac] (a pair of Aces)
HubertusB collected $0.81 from pot
*** SUMMARY ***
Total pot $0.85 | Rake $0.04 
Board [7d Ts Ad 5d Jd]
Seat 1: PsBadBluff (button) folded on the Flop
Seat 2: Duboin (small blind) showed [Js Qs] and lost with a pair of Jacks
Seat 3: Leshchik (big blind) folded before Flop
Seat 4: hobbididence folded before Flop (didn't bet)
Seat 5: djuniorm folded before Flop (didn't bet)
Seat 6: HubertusB showed [4c Ac] and won ($0.81) with a pair of Aces



PokerStars Zoom Hand #178482624623:  Hold'em No Limit ($0.02/$0.05) - 2017/11/20 21:19:16 CCT [2017/11/20 8:19:16 ET]
Table 'Donati' 6-max Seat #1 is the button
Seat 1: vikandr03 ($11.02 in chips) 
Seat 2: e.sergeevna ($6.15 in chips) 
Seat 3: HubertusB ($5.24 in chips) 
Seat 4: MomofMacey ($2.01 in chips) 
Seat 5: Anjinsan777 ($6.68 in chips) 
Seat 6: AYE_RUSSIAN ($5 in chips) 
e.sergeevna: posts small blind $0.02
HubertusB: posts big blind $0.05
*** HOLE CARDS ***
Dealt to HubertusB [7s Qc]
MomofMacey: folds 
Anjinsan777: folds 
AYE_RUSSIAN: folds 
vikandr03: folds 
e.sergeevna: folds 
Uncalled bet ($0.03) returned to HubertusB
HubertusB collected $0.04 from pot
HubertusB: doesn't show hand 
*** SUMMARY ***
Total pot $0.04 | Rake $0 
Seat 1: vikandr03 (button) folded before Flop (didn't bet)
Seat 2: e.sergeevna (small blind) folded before Flop
Seat 3: HubertusB (big blind) collected ($0.04)
Seat 4: MomofMacey folded before Flop (didn't bet)
Seat 5: Anjinsan777 folded before Flop (didn't bet)
Seat 6: AYE_RUSSIAN folded before Flop (didn't bet)



PokerStars Zoom Hand #178482628439:  Hold'em No Limit ($0.02/$0.05) - 2017/11/20 21:19:24 CCT [2017/11/20 8:19:24 ET]
Table 'Donati' 6-max Seat #1 is the button
Seat 1: HubertusB ($5.26 in chips) 
Seat 2: walakos ($9.57 in chips) 
Seat 3: dasluca00 ($4 in chips) 
Seat 4: matulinkk ($4.48 in chips) 
Seat 5: VelosNM ($8.72 in chips) 
Seat 6: Duboin ($5.31 in chips) 
walakos: posts small blind $0.02
dasluca00: posts big blind $0.05
*** HOLE CARDS ***
Dealt to HubertusB [3h Ah]
matulinkk: calls $0.05
VelosNM: raises $0.15 to $0.20
Duboin: folds 
HubertusB: raises $0.40 to $0.60
walakos: folds 
dasluca00: folds 
matulinkk: folds 
VelosNM: folds 
Uncalled bet ($0.40) returned to HubertusB
HubertusB collected $0.52 from pot
HubertusB: doesn't show hand 
*** SUMMARY ***
Total pot $0.52 | Rake $0 
Seat 1: HubertusB (button) collected ($0.52)
Seat 2: walakos (small blind) folded before Flop
Seat 3: dasluca00 (big blind) folded before Flop
Seat 4: matulinkk folded before Flop
Seat 5: VelosNM folded before Flop
Seat 6: Duboin folded before Flop (didn't bet)



PokerStars Zoom Hand #178482653225:  Hold'em No Limit ($0.02/$0.05) - 2017/11/20 21:20:17 CCT [2017/11/20 8:20:17 ET]
Table 'Donati' 6-max Seat #1 is the button
Seat 1: yumi2003 ($6.80 in chips) 
Seat 2: Mixail2411 ($6.56 in chips) 
Seat 3: ellfo ($5.41 in chips) 
Seat 4: xex_serg ($6.63 in chips) 
Seat 5: HubertusB ($5.58 in chips) 
Seat 6: rimouse.lee ($6.48 in chips) 
Mixail2411: posts small blind $0.02
ellfo: posts big blind $0.05
*** HOLE CARDS ***
Dealt to HubertusB [7d Qc]
xex_serg: folds 
HubertusB: raises $0.05 to $0.10
rimouse.lee: calls $0.10
yumi2003: folds 
Mixail2411: calls $0.08
ellfo: folds 
*** FLOP *** [Ks 5s Js]
Mixail2411: checks 
HubertusB: bets $0.25
rimouse.lee: folds 
Mixail2411: folds 
Uncalled bet ($0.25) returned to HubertusB
HubertusB collected $0.34 from pot
HubertusB: doesn't show hand 
*** SUMMARY ***
Total pot $0.35 | Rake $0.01 
Board [Ks 5s Js]
Seat 1: yumi2003 (button) folded before Flop (didn't bet)
Seat 2: Mixail2411 (small blind) folded on the Flop
Seat 3: ellfo (big blind) folded before Flop
Seat 4: xex_serg folded before Flop (didn't bet)
Seat 5: HubertusB collected ($0.34)
Seat 6: rimouse.lee folded on the Flop



PokerStars Zoom Hand #178482665425:  Hold'em No Limit ($0.02/$0.05) - 2017/11/20 21:20:43 CCT [2017/11/20 8:20:43 ET]
Table 'Donati' 6-max Seat #1 is the button
Seat 1: Leshchik ($9.26 in chips) 
Seat 2: AYE_RUSSIAN ($5.07 in chips) 
Seat 3: Predator1447 ($9.64 in chips) 
Seat 4: A-Hsien ($5 in chips) 
Seat 5: Oberon63 ($10.62 in chips) 
Seat 6: HubertusB ($5.82 in chips) 
AYE_RUSSIAN: posts small blind $0.02
Predator1447: posts big blind $0.05
*** HOLE CARDS ***
Dealt to HubertusB [Ts Kc]
A-Hsien: folds 
Oberon63: folds 
HubertusB: raises $0.05 to $0.10
Leshchik: folds 
AYE_RUSSIAN: folds 
Predator1447: folds 
Uncalled bet ($0.05) returned to HubertusB
HubertusB collected $0.12 from pot
HubertusB: doesn't show hand 
*** SUMMARY ***
Total pot $0.12 | Rake $0 
Seat 1: Leshchik (button) folded before Flop (didn't bet)
Seat 2: AYE_RUSSIAN (small blind) folded before Flop
Seat 3: Predator1447 (big blind) folded before Flop
Seat 4: A-Hsien folded before Flop (didn't bet)
Seat 5: Oberon63 folded before Flop (didn't bet)
Seat 6: HubertusB collected ($0.12)



PokerStars Zoom Hand #178482678392:  Hold'em No Limit ($0.02/$0.05) - 2017/11/20 21:21:11 CCT [2017/11/20 8:21:11 ET]
Table 'Donati' 6-max Seat #1 is the button
Seat 1: GizaGliwic ($8.69 in chips) 
Seat 2: clutch6115 ($4.43 in chips) 
Seat 3: vickolay ($5.20 in chips) 
Seat 4: HardVanTT ($8.73 in chips) 
Seat 5: HubertusB ($5.87 in chips) 
Seat 6: IvanStarMan ($3.47 in chips) 
clutch6115: posts small blind $0.02
vickolay: posts big blind $0.05
*** HOLE CARDS ***
Dealt to HubertusB [5d 7s]
HardVanTT: raises $0.07 to $0.12
HubertusB: folds 
IvanStarMan: folds 
GizaGliwic: raises $0.24 to $0.36
clutch6115: folds 
vickolay: folds 
HardVanTT: folds 
Uncalled bet ($0.24) returned to GizaGliwic
GizaGliwic collected $0.31 from pot
GizaGliwic: doesn't show hand 
*** SUMMARY ***
Total pot $0.31 | Rake $0 
Seat 1: GizaGliwic (button) collected ($0.31)
Seat 2: clutch6115 (small blind) folded before Flop
Seat 3: vickolay (big blind) folded before Flop
Seat 4: HardVanTT folded before Flop
Seat 5: HubertusB folded before Flop (didn't bet)
Seat 6: IvanStarMan folded before Flop (didn't bet)



PokerStars Zoom Hand #178482676055:  Hold'em No Limit ($0.02/$0.05) - 2017/11/20 21:21:06 CCT [2017/11/20 8:21:06 ET]
Table 'Donati' 6-max Seat #1 is the button
Seat 1: mi_20_mi ($1.94 in chips) 
Seat 2: HubertusB ($5.89 in chips) 
Seat 3: pakintooo ($2.51 in chips) 
Seat 4: paradiseg174 ($12.10 in chips) 
Seat 5: Al3Goulart ($5.67 in chips) 
Seat 6: kuansheng ($5.58 in chips) 
HubertusB: posts small blind $0.02
pakintooo: posts big blind $0.05
*** HOLE CARDS ***
Dealt to HubertusB [8h Kh]
paradiseg174: folds 
Al3Goulart: folds 
kuansheng: folds 
mi_20_mi: raises $0.10 to $0.15
HubertusB: folds 
pakintooo: calls $0.10
*** FLOP *** [Kd Qd 8c]
pakintooo: checks 
mi_20_mi: checks 
*** TURN *** [Kd Qd 8c] [Ah]
pakintooo: checks 
mi_20_mi: checks 
*** RIVER *** [Kd Qd 8c Ah] [3s]
pakintooo: checks 
mi_20_mi: checks 
*** SHOW DOWN ***
pakintooo: shows [Qs 2d] (a pair of Queens)
mi_20_mi: shows [Jc Qc] (a pair of Queens - Ace+King+Jack kicker)
mi_20_mi collected $0.31 from pot
*** SUMMARY ***
Total pot $0.32 | Rake $0.01 
Board [Kd Qd 8c Ah 3s]
Seat 1: mi_20_mi (button) showed [Jc Qc] and won ($0.31) with a pair of Queens
Seat 2: HubertusB (small blind) folded before Flop
Seat 3: pakintooo (big blind) showed [Qs 2d] and lost with a pair of Queens
Seat 4: paradiseg174 folded before Flop (didn't bet)
Seat 5: Al3Goulart folded before Flop (didn't bet)
Seat 6: kuansheng folded before Flop (didn't bet)



PokerStars Zoom Hand #178482681697:  Hold'em No Limit ($0.02/$0.05) - 2017/11/20 21:21:18 CCT [2017/11/20 8:21:18 ET]
Table 'Donati' 6-max Seat #1 is the button
Seat 1: mischa10 ($2.72 in chips) 
Seat 2: AK@KK@AK ($17.96 in chips) 
Seat 3: sakharova ($4.74 in chips) 
Seat 4: HubertusB ($5.87 in chips) 
Seat 5: LetsGrindIt ($5.44 in chips) 
Seat 6: ALazarev157 ($12.67 in chips) 
AK@KK@AK: posts small blind $0.02
sakharova: posts big blind $0.05
*** HOLE CARDS ***
Dealt to HubertusB [4c 3c]
HubertusB: raises $0.05 to $0.10
LetsGrindIt: folds 
ALazarev157: folds 
mischa10: folds 
AK@KK@AK: folds 
sakharova: folds 
Uncalled bet ($0.05) returned to HubertusB
HubertusB collected $0.12 from pot
HubertusB: doesn't show hand 
*** SUMMARY ***
Total pot $0.12 | Rake $0 
Seat 1: mischa10 (button) folded before Flop (didn't bet)
Seat 2: AK@KK@AK (small blind) folded before Flop
Seat 3: sakharova (big blind) folded before Flop
Seat 4: HubertusB collected ($0.12)
Seat 5: LetsGrindIt folded before Flop (didn't bet)
Seat 6: ALazarev157 folded before Flop (didn't bet)



PokerStars Zoom Hand #178482693280:  Hold'em No Limit ($0.02/$0.05) - 2017/11/20 21:21:43 CCT [2017/11/20 8:21:43 ET]
Table 'Donati' 6-max Seat #1 is the button
Seat 1: behappy989 ($11.98 in chips) 
Seat 2: kuansheng ($5 in chips) 
Seat 3: HubertusB ($5.94 in chips) 
Seat 4: mikk2468 ($6.40 in chips) 
Seat 5: fatinio914 ($5.88 in chips) 
Seat 6: nefelim21 ($7.95 in chips) 
kuansheng: posts small blind $0.02
HubertusB: posts big blind $0.05
*** HOLE CARDS ***
Dealt to HubertusB [7d 9c]
mikk2468: folds 
fatinio914: folds 
nefelim21: raises $0.15 to $0.20
behappy989: folds 
kuansheng: folds 
HubertusB: folds 
Uncalled bet ($0.15) returned to nefelim21
nefelim21 collected $0.12 from pot
nefelim21: doesn't show hand 
*** SUMMARY ***
Total pot $0.12 | Rake $0 
Seat 1: behappy989 (button) folded before Flop (didn't bet)
Seat 2: kuansheng (small blind) folded before Flop
Seat 3: HubertusB (big blind) folded before Flop
Seat 4: mikk2468 folded before Flop (didn't bet)
Seat 5: fatinio914 folded before Flop (didn't bet)
Seat 6: nefelim21 collected ($0.12)



PokerStars Zoom Hand #178482700829:  Hold'em No Limit ($0.02/$0.05) - 2017/11/20 21:21:59 CCT [2017/11/20 8:21:59 ET]
Table 'Donati' 6-max Seat #1 is the button
Seat 1: nervss ($5.92 in chips) 
Seat 2: HubertusB ($5.89 in chips) 
Seat 3: xarichi ($9.54 in chips) 
Seat 4: HSGVB81 ($5.88 in chips) 
Seat 5: SHUR43 ($5 in chips) 
Seat 6: Marka555 ($10.37 in chips) 
HubertusB: posts small blind $0.02
xarichi: posts big blind $0.05
*** HOLE CARDS ***
Dealt to HubertusB [Ac 3s]
HSGVB81: folds 
SHUR43: folds 
Marka555: folds 
nervss: folds 
HubertusB: folds 
Uncalled bet ($0.03) returned to xarichi
xarichi collected $0.04 from pot
xarichi: doesn't show hand 
*** SUMMARY ***
Total pot $0.04 | Rake $0 
Seat 1: nervss (button) folded before Flop (didn't bet)
Seat 2: HubertusB (small blind) folded before Flop
Seat 3: xarichi (big blind) collected ($0.04)
Seat 4: HSGVB81 folded before Flop (didn't bet)
Seat 5: SHUR43 folded before Flop (didn't bet)
Seat 6: Marka555 folded before Flop (didn't bet)



PokerStars Zoom Hand #178482706449:  Hold'em No Limit ($0.02/$0.05) - 2017/11/20 21:22:11 CCT [2017/11/20 8:22:11 ET]
Table 'Donati' 6-max Seat #1 is the button
Seat 1: ellfo ($5.48 in chips) 
Seat 2: M.Govorkov ($5.07 in chips) 
Seat 3: hobbididence ($7.21 in chips) 
Seat 4: Fearless_men ($5 in chips) 
Seat 5: PurplePython ($8.16 in chips) 
Seat 6: HubertusB ($5.87 in chips) 
M.Govorkov: posts small blind $0.02
hobbididence: posts big blind $0.05
*** HOLE CARDS ***
Dealt to HubertusB [7h Qc]
Fearless_men: folds 
PurplePython: folds 
HubertusB: raises $0.05 to $0.10
ellfo: folds 
M.Govorkov: raises $0.30 to $0.40
hobbididence: folds 
HubertusB: folds 
Uncalled bet ($0.30) returned to M.Govorkov
M.Govorkov collected $0.25 from pot
M.Govorkov: doesn't show hand 
*** SUMMARY ***
Total pot $0.25 | Rake $0 
Seat 1: ellfo (button) folded before Flop (didn't bet)
Seat 2: M.Govorkov (small blind) collected ($0.25)
Seat 3: hobbididence (big blind) folded before Flop
Seat 4: Fearless_men folded before Flop (didn't bet)
Seat 5: PurplePython folded before Flop (didn't bet)
Seat 6: HubertusB folded before Flop



PokerStars Zoom Hand #178482703655:  Hold'em No Limit ($0.02/$0.05) - 2017/11/20 21:22:05 CCT [2017/11/20 8:22:05 ET]
Table 'Donati' 6-max Seat #1 is the button
Seat 1: HubertusB ($5.87 in chips) 
Seat 2: Roockie4Life ($6.29 in chips) 
Seat 3: savvas009 ($5.92 in chips) 
Seat 4: PsBadBluff ($8.49 in chips) 
Seat 5: salomone29 ($4.32 in chips) 
Seat 6: corny111 ($1.72 in chips) 
Roockie4Life: posts small blind $0.02
savvas009: posts big blind $0.05
*** HOLE CARDS ***
Dealt to HubertusB [3c 5d]
PsBadBluff: folds 
salomone29: folds 
corny111: folds 
HubertusB: folds 
Roockie4Life: raises $0.10 to $0.15
savvas009: calls $0.10
*** FLOP *** [2d 3d 8d]
Roockie4Life: bets $0.22
savvas009: folds 
Uncalled bet ($0.22) returned to Roockie4Life
Roockie4Life collected $0.29 from pot
Roockie4Life: doesn't show hand 
*** SUMMARY ***
Total pot $0.30 | Rake $0.01 
Board [2d 3d 8d]
Seat 1: HubertusB (button) folded before Flop (didn't bet)
Seat 2: Roockie4Life (small blind) collected ($0.29)
Seat 3: savvas009 (big blind) folded on the Flop
Seat 4: PsBadBluff folded before Flop (didn't bet)
Seat 5: salomone29 folded before Flop (didn't bet)
Seat 6: corny111 folded before Flop (didn't bet)



PokerStars Zoom Hand #178482713126:  Hold'em No Limit ($0.02/$0.05) - 2017/11/20 21:22:25 CCT [2017/11/20 8:22:25 ET]
Table 'Donati' 6-max Seat #1 is the button
Seat 1: chester8676 ($4.89 in chips) 
Seat 2: SBL 76 ($4.55 in chips) 
Seat 3: KONUNG26rus ($4.98 in chips) 
Seat 4: HubertusB ($5.77 in chips) 
Seat 5: Kolya210691 ($5.66 in chips) 
Seat 6: Bonch241 ($10.02 in chips) 
SBL 76: posts small blind $0.02
KONUNG26rus: posts big blind $0.05
*** HOLE CARDS ***
Dealt to HubertusB [5s Kc]
HubertusB: folds 
Kolya210691: folds 
Bonch241: folds 
chester8676: raises $0.07 to $0.12
SBL 76: folds 
KONUNG26rus: folds 
Uncalled bet ($0.07) returned to chester8676
chester8676 collected $0.12 from pot
chester8676: doesn't show hand 
*** SUMMARY ***
Total pot $0.12 | Rake $0 
Seat 1: chester8676 (button) collected ($0.12)
Seat 2: SBL 76 (small blind) folded before Flop
Seat 3: KONUNG26rus (big blind) folded before Flop
Seat 4: HubertusB folded before Flop (didn't bet)
Seat 5: Kolya210691 folded before Flop (didn't bet)
Seat 6: Bonch241 folded before Flop (didn't bet)



PokerStars Zoom Hand #178482697607:  Hold'em No Limit ($0.02/$0.05) - 2017/11/20 21:21:52 CCT [2017/11/20 8:21:52 ET]
Table 'Donati' 6-max Seat #1 is the button
Seat 1: LetsGrindIt ($6.34 in chips) 
Seat 2: 1kukla ($4.63 in chips) 
Seat 3: FriskyBear ($5.17 in chips) 
Seat 4: HubertusB ($5.89 in chips) 
Seat 5: behappy989 ($11.98 in chips) 
Seat 6: MoreRakePls1 ($5.94 in chips) 
1kukla: posts small blind $0.02
FriskyBear: posts big blind $0.05
*** HOLE CARDS ***
Dealt to HubertusB [4c Qc]
HubertusB: folds 
behappy989: raises $0.09 to $0.14
MoreRakePls1: folds 
LetsGrindIt: folds 
1kukla: calls $0.12
FriskyBear: folds 
*** FLOP *** [5d 5c 8s]
1kukla: checks 
behappy989: bets $0.15
1kukla: calls $0.15
*** TURN *** [5d 5c 8s] [As]
1kukla: checks 
behappy989: bets $0.28
1kukla: calls $0.28
*** RIVER *** [5d 5c 8s As] [9c]
1kukla: checks 
behappy989: bets $1.14
1kukla: calls $1.14
*** SHOW DOWN ***
behappy989: shows [Ah 9h] (two pair, Aces and Nines)
1kukla: mucks hand 
behappy989 collected $3.33 from pot
*** SUMMARY ***
Total pot $3.47 | Rake $0.14 
Board [5d 5c 8s As 9c]
Seat 1: LetsGrindIt (button) folded before Flop (didn't bet)
Seat 2: 1kukla (small blind) mucked [Th Ts]
Seat 3: FriskyBear (big blind) folded before Flop
Seat 4: HubertusB folded before Flop (didn't bet)
Seat 5: behappy989 showed [Ah 9h] and won ($3.33) with two pair, Aces and Nines
Seat 6: MoreRakePls1 folded before Flop (didn't bet)



PokerStars Zoom Hand #178482715388:  Hold'em No Limit ($0.02/$0.05) - 2017/11/20 21:22:30 CCT [2017/11/20 8:22:30 ET]
Table 'Donati' 6-max Seat #1 is the button
Seat 1: kaesspo ($8.80 in chips) 
Seat 2: Agent007_025 ($2.66 in chips) 
Seat 3: BCE bUDET ($5.05 in chips) 
Seat 4: HubertusB ($5.77 in chips) 
Seat 5: Duboin ($5.82 in chips) 
Seat 6: Leshchik ($5.27 in chips) 
Agent007_025: posts small blind $0.02
BCE bUDET: posts big blind $0.05
*** HOLE CARDS ***
Dealt to HubertusB [Th Ts]
HubertusB: raises $0.05 to $0.10
Duboin: folds 
Leshchik: folds 
kaesspo: calls $0.10
Agent007_025: folds 
BCE bUDET: folds 
*** FLOP *** [7c 7h Qc]
HubertusB: checks 
kaesspo: bets $0.15
HubertusB: calls $0.15
*** TURN *** [7c 7h Qc] [Qh]
HubertusB: checks 
kaesspo: checks 
*** RIVER *** [7c 7h Qc Qh] [Jd]
HubertusB: checks 
kaesspo: checks 
*** SHOW DOWN ***
HubertusB: shows [Th Ts] (two pair, Queens and Tens)
kaesspo: mucks hand 
HubertusB collected $0.55 from pot
*** SUMMARY ***
Total pot $0.57 | Rake $0.02 
Board [7c 7h Qc Qh Jd]
Seat 1: kaesspo (button) mucked [Td 9c]
Seat 2: Agent007_025 (small blind) folded before Flop
Seat 3: BCE bUDET (big blind) folded before Flop
Seat 4: HubertusB showed [Th Ts] and won ($0.55) with two pair, Queens and Tens
Seat 5: Duboin folded before Flop (didn't bet)
Seat 6: Leshchik folded before Flop (didn't bet)



PokerStars Zoom Hand #178482737487:  Hold'em No Limit ($0.02/$0.05) - 2017/11/20 21:23:17 CCT [2017/11/20 8:23:17 ET]
Table 'Donati' 6-max Seat #1 is the button
Seat 1: baggelisdr1 ($10.13 in chips) 
Seat 2: fatinio914 ($5.22 in chips) 
Seat 3: HubertusB ($6.07 in chips) 
Seat 4: d(-_-)bSzebi ($8.77 in chips) 
Seat 5: jama2701 ($2.85 in chips) 
Seat 6: maksimus 84 ($2.48 in chips) 
fatinio914: posts small blind $0.02
HubertusB: posts big blind $0.05
*** HOLE CARDS ***
Dealt to HubertusB [3d Qs]
d(-_-)bSzebi: folds 
jama2701: folds 
maksimus 84: raises $0.10 to $0.15
baggelisdr1: folds 
fatinio914: folds 
HubertusB: folds 
Uncalled bet ($0.10) returned to maksimus 84
maksimus 84 collected $0.12 from pot
maksimus 84: doesn't show hand 
*** SUMMARY ***
Total pot $0.12 | Rake $0 
Seat 1: baggelisdr1 (button) folded before Flop (didn't bet)
Seat 2: fatinio914 (small blind) folded before Flop
Seat 3: HubertusB (big blind) folded before Flop
Seat 4: d(-_-)bSzebi folded before Flop (didn't bet)
Seat 5: jama2701 folded before Flop (didn't bet)
Seat 6: maksimus 84 collected ($0.12)



PokerStars Zoom Hand #178482741795:  Hold'em No Limit ($0.02/$0.05) - 2017/11/20 21:23:26 CCT [2017/11/20 8:23:26 ET]
Table 'Donati' 6-max Seat #1 is the button
Seat 1: behappy989 ($13.60 in chips) 
Seat 2: HubertusB ($6.02 in chips) 
Seat 3: HSGVB81 ($6 in chips) 
Seat 4: Kutis33 ($7.36 in chips) 
Seat 5: MoreRakePls1 ($7.90 in chips) 
Seat 6: krzys19697 ($3.80 in chips) 
HubertusB: posts small blind $0.02
HSGVB81: posts big blind $0.05
*** HOLE CARDS ***
Dealt to HubertusB [4c Ac]
Kutis33: folds 
MoreRakePls1: folds 
krzys19697: folds 
behappy989: folds 
HubertusB: raises $0.05 to $0.10
HSGVB81: calls $0.05
*** FLOP *** [9d Jc 4s]
HubertusB: bets $0.10
HSGVB81: folds 
Uncalled bet ($0.10) returned to HubertusB
HubertusB collected $0.19 from pot
HubertusB: doesn't show hand 
*** SUMMARY ***
Total pot $0.20 | Rake $0.01 
Board [9d Jc 4s]
Seat 1: behappy989 (button) folded before Flop (didn't bet)
Seat 2: HubertusB (small blind) collected ($0.19)
Seat 3: HSGVB81 (big blind) folded on the Flop
Seat 4: Kutis33 folded before Flop (didn't bet)
Seat 5: MoreRakePls1 folded before Flop (didn't bet)
Seat 6: krzys19697 folded before Flop (didn't bet)



PokerStars Zoom Hand #178482753100:  Hold'em No Limit ($0.02/$0.05) - 2017/11/20 21:23:50 CCT [2017/11/20 8:23:50 ET]
Table 'Donati' 6-max Seat #1 is the button
Seat 1: HubertusB ($6.11 in chips) 
Seat 2: kuansheng ($9.44 in chips) 
Seat 3: BCE bUDET ($5 in chips) 
Seat 4: seawolf111 ($5.89 in chips) 
Seat 5: Fearless_men ($5.15 in chips) 
Seat 6: Zire99 ($8.07 in chips) 
kuansheng: posts small blind $0.02
BCE bUDET: posts big blind $0.05
*** HOLE CARDS ***
Dealt to HubertusB [8h Ad]
seawolf111: folds 
Fearless_men: folds 
Zire99: folds 
HubertusB: raises $0.05 to $0.10
kuansheng: folds 
BCE bUDET: folds 
Uncalled bet ($0.05) returned to HubertusB
HubertusB collected $0.12 from pot
HubertusB: doesn't show hand 
*** SUMMARY ***
Total pot $0.12 | Rake $0 
Seat 1: HubertusB (button) collected ($0.12)
Seat 2: kuansheng (small blind) folded before Flop
Seat 3: BCE bUDET (big blind) folded before Flop
Seat 4: seawolf111 folded before Flop (didn't bet)
Seat 5: Fearless_men folded before Flop (didn't bet)
Seat 6: Zire99 folded before Flop (didn't bet)



PokerStars Zoom Hand #178482760599:  Hold'em No Limit ($0.02/$0.05) - 2017/11/20 21:24:06 CCT [2017/11/20 8:24:06 ET]
Table 'Donati' 6-max Seat #1 is the button
Seat 1: schumi8472 ($5.74 in chips) 
Seat 2: GFL-23 ($5.10 in chips) 
Seat 3: Smigiel83 ($12.72 in chips) 
Seat 4: Sumow ($5.20 in chips) 
Seat 5: Vagabond000 ($5.74 in chips) 
Seat 6: HubertusB ($6.18 in chips) 
GFL-23: posts small blind $0.02
Smigiel83: posts big blind $0.05
*** HOLE CARDS ***
Dealt to HubertusB [Ah Kh]
Sumow: folds 
Vagabond000: folds 
HubertusB: raises $0.05 to $0.10
schumi8472: calls $0.10
GFL-23: raises $0.48 to $0.58
Smigiel83: folds 
HubertusB: raises $0.87 to $1.45
schumi8472: calls $1.35
GFL-23: folds 
*** FLOP *** [6s 4c 5d]
HubertusB: bets $1.05
schumi8472: calls $1.05
*** TURN *** [6s 4c 5d] [8h]
HubertusB: checks 
schumi8472: checks 
*** RIVER *** [6s 4c 5d 8h] [Ks]
HubertusB: bets $3.68 and is all-in
schumi8472: calls $3.24 and is all-in
Uncalled bet ($0.44) returned to HubertusB
*** SHOW DOWN ***
HubertusB: shows [Ah Kh] (a pair of Kings)
schumi8472: shows [5c Kc] (two pair, Kings and Fives)
schumi8472 collected $11.61 from pot
*** SUMMARY ***
Total pot $12.11 | Rake $0.50 
Board [6s 4c 5d 8h Ks]
Seat 1: schumi8472 (button) showed [5c Kc] and won ($11.61) with two pair, Kings and Fives
Seat 2: GFL-23 (small blind) folded before Flop
Seat 3: Smigiel83 (big blind) folded before Flop
Seat 4: Sumow folded before Flop (didn't bet)
Seat 5: Vagabond000 folded before Flop (didn't bet)
Seat 6: HubertusB showed [Ah Kh] and lost with a pair of Kings



PokerStars Zoom Hand #178482805479:  Hold'em No Limit ($0.02/$0.05) - 2017/11/20 21:25:41 CCT [2017/11/20 8:25:41 ET]
Table 'Donati' 6-max Seat #1 is the button
Seat 1: mitek008 ($3.68 in chips) 
Seat 2: Cruzivey ($5.30 in chips) 
Seat 3: HubertusB ($0.44 in chips) 
Seat 4: alex7241183 ($8.06 in chips) 
Seat 5: InFlames86 ($5.37 in chips) 
Seat 6: baggelisdr1 ($8.68 in chips) 
Cruzivey: posts small blind $0.02
HubertusB: posts big blind $0.05
*** HOLE CARDS ***
Dealt to HubertusB [9c 3h]
alex7241183: folds 
InFlames86: folds 
baggelisdr1: folds 
mitek008: folds 
Cruzivey: folds 
Uncalled bet ($0.03) returned to HubertusB
HubertusB collected $0.04 from pot
HubertusB: doesn't show hand 
*** SUMMARY ***
Total pot $0.04 | Rake $0 
Seat 1: mitek008 (button) folded before Flop (didn't bet)
Seat 2: Cruzivey (small blind) folded before Flop
Seat 3: HubertusB (big blind) collected ($0.04)
Seat 4: alex7241183 folded before Flop (didn't bet)
Seat 5: InFlames86 folded before Flop (didn't bet)
Seat 6: baggelisdr1 folded before Flop (didn't bet)



PokerStars Zoom Hand #178482810230:  Hold'em No Limit ($0.02/$0.05) - 2017/11/20 21:25:51 CCT [2017/11/20 8:25:51 ET]
Table 'Donati' 6-max Seat #1 is the button
Seat 1: Yolff ($6.30 in chips) 
Seat 2: Blubberchen7 ($7.21 in chips) 
Seat 3: azukimochi ($5.13 in chips) 
Seat 4: viggli ($5.26 in chips) 
Seat 5: HubertusB ($0.46 in chips) 
Seat 6: doutsis ($7.32 in chips) 
Blubberchen7: posts small blind $0.02
azukimochi: posts big blind $0.05
*** HOLE CARDS ***
Dealt to HubertusB [4d 7d]
viggli: raises $0.10 to $0.15
HubertusB: raises $0.31 to $0.46 and is all-in
doutsis: folds 
Yolff: folds 
Blubberchen7: folds 
azukimochi: folds 
viggli: calls $0.31
*** FLOP *** [6c 3h Ts]
*** TURN *** [6c 3h Ts] [8h]
*** RIVER *** [6c 3h Ts 8h] [6d]
*** SHOW DOWN ***
viggli: shows [Ac Kd] (a pair of Sixes)
HubertusB: shows [4d 7d] (a pair of Sixes - lower kicker)
viggli collected $0.95 from pot
*** SUMMARY ***
Total pot $0.99 | Rake $0.04 
Board [6c 3h Ts 8h 6d]
Seat 1: Yolff (button) folded before Flop (didn't bet)
Seat 2: Blubberchen7 (small blind) folded before Flop
Seat 3: azukimochi (big blind) folded before Flop
Seat 4: viggli showed [Ac Kd] and won ($0.95) with a pair of Sixes
Seat 5: HubertusB showed [4d 7d] and lost with a pair of Sixes
Seat 6: doutsis folded before Flop (didn't bet)



PokerStars Zoom Hand #178482913501:  Hold'em No Limit ($0.02/$0.05) - 2017/11/20 21:29:28 CCT [2017/11/20 8:29:28 ET]
Table 'Donati' 6-max Seat #1 is the button
Seat 1: HubertusB ($5 in chips) 
Seat 2: greyk1n ($5.97 in chips) 
Seat 3: tias1974 ($7.38 in chips) 
Seat 4: Nicole473 ($4.16 in chips) 
Seat 5: Hyena777210 ($5.18 in chips) 
Seat 6: Duboin ($5 in chips) 
greyk1n: posts small blind $0.02
tias1974: posts big blind $0.05
*** HOLE CARDS ***
Dealt to HubertusB [Qc 8h]
Nicole473: folds 
Hyena777210: folds 
Duboin: folds 
HubertusB: raises $0.05 to $0.10
greyk1n: folds 
tias1974: folds 
Uncalled bet ($0.05) returned to HubertusB
HubertusB collected $0.12 from pot
HubertusB: doesn't show hand 
*** SUMMARY ***
Total pot $0.12 | Rake $0 
Seat 1: HubertusB (button) collected ($0.12)
Seat 2: greyk1n (small blind) folded before Flop
Seat 3: tias1974 (big blind) folded before Flop
Seat 4: Nicole473 folded before Flop (didn't bet)
Seat 5: Hyena777210 folded before Flop (didn't bet)
Seat 6: Duboin folded before Flop (didn't bet)



PokerStars Zoom Hand #178482919711:  Hold'em No Limit ($0.02/$0.05) - 2017/11/20 21:29:41 CCT [2017/11/20 8:29:41 ET]
Table 'Donati' 6-max Seat #1 is the button
Seat 1: PepeSmith ($9.53 in chips) 
Seat 2: HubertusB ($5.07 in chips) 
Seat 3: Fearless_men ($6.96 in chips) 
Seat 4: Sumow ($5.34 in chips) 
Seat 5: HenoBarista ($7.46 in chips) 
Seat 6: Bossmanlee00 ($4.31 in chips) 
HubertusB: posts small blind $0.02
Fearless_men: posts big blind $0.05
*** HOLE CARDS ***
Dealt to HubertusB [7h 4h]
Sumow: folds 
HenoBarista: folds 
Bossmanlee00: raises $0.12 to $0.17
PepeSmith: folds 
HubertusB: folds 
Fearless_men: folds 
Uncalled bet ($0.12) returned to Bossmanlee00
Bossmanlee00 collected $0.12 from pot
Bossmanlee00: doesn't show hand 
*** SUMMARY ***
Total pot $0.12 | Rake $0 
Seat 1: PepeSmith (button) folded before Flop (didn't bet)
Seat 2: HubertusB (small blind) folded before Flop
Seat 3: Fearless_men (big blind) folded before Flop
Seat 4: Sumow folded before Flop (didn't bet)
Seat 5: HenoBarista folded before Flop (didn't bet)
Seat 6: Bossmanlee00 collected ($0.12)



PokerStars Zoom Hand #178482925416:  Hold'em No Limit ($0.02/$0.05) - 2017/11/20 21:29:53 CCT [2017/11/20 8:29:53 ET]
Table 'Donati' 6-max Seat #1 is the button
Seat 1: A-Hsien ($5.76 in chips) 
Seat 2: suriel666 ($9.38 in chips) 
Seat 3: With_no_Pain ($6.61 in chips) 
Seat 4: HubertusB ($5.05 in chips) 
Seat 5: FriskyBear ($6.58 in chips) 
Seat 6: Oluukk ($7.62 in chips) 
suriel666: posts small blind $0.02
With_no_Pain: posts big blind $0.05
*** HOLE CARDS ***
Dealt to HubertusB [Ts 3h]
HubertusB: folds 
FriskyBear: folds 
Oluukk: raises $0.10 to $0.15
A-Hsien: folds 
suriel666: folds 
With_no_Pain: folds 
Uncalled bet ($0.10) returned to Oluukk
Oluukk collected $0.12 from pot
Oluukk: doesn't show hand 
*** SUMMARY ***
Total pot $0.12 | Rake $0 
Seat 1: A-Hsien (button) folded before Flop (didn't bet)
Seat 2: suriel666 (small blind) folded before Flop
Seat 3: With_no_Pain (big blind) folded before Flop
Seat 4: HubertusB folded before Flop (didn't bet)
Seat 5: FriskyBear folded before Flop (didn't bet)
Seat 6: Oluukk collected ($0.12)



PokerStars Zoom Hand #178482930711:  Hold'em No Limit ($0.02/$0.05) - 2017/11/20 21:30:04 CCT [2017/11/20 8:30:04 ET]
Table 'Donati' 6-max Seat #1 is the button
Seat 1: Shuitian ($9.98 in chips) 
Seat 2: 1kukla ($1.94 in chips) 
Seat 3: MVVSjeng ($5.99 in chips) 
Seat 4: blondin4uk74 ($5 in chips) 
Seat 5: HubertusB ($5.05 in chips) 
Seat 6: kuansheng ($6.51 in chips) 
1kukla: posts small blind $0.02
MVVSjeng: posts big blind $0.05
*** HOLE CARDS ***
Dealt to HubertusB [Js 5c]
blondin4uk74: folds 
HubertusB: folds 
kuansheng: folds 
Shuitian: folds 
1kukla: folds 
Uncalled bet ($0.03) returned to MVVSjeng
MVVSjeng collected $0.04 from pot
MVVSjeng: doesn't show hand 
*** SUMMARY ***
Total pot $0.04 | Rake $0 
Seat 1: Shuitian (button) folded before Flop (didn't bet)
Seat 2: 1kukla (small blind) folded before Flop
Seat 3: MVVSjeng (big blind) collected ($0.04)
Seat 4: blondin4uk74 folded before Flop (didn't bet)
Seat 5: HubertusB folded before Flop (didn't bet)
Seat 6: kuansheng folded before Flop (didn't bet)



PokerStars Zoom Hand #178482927835:  Hold'em No Limit ($0.02/$0.05) - 2017/11/20 21:29:58 CCT [2017/11/20 8:29:58 ET]
Table 'Donati' 6-max Seat #1 is the button
Seat 1: paradiseg174 ($13.22 in chips) 
Seat 2: WahaBeat ($9.38 in chips) 
Seat 3: t1mka09367 ($17.91 in chips) 
Seat 4: FriskyBear ($5.41 in chips) 
Seat 5: zouzounos86 ($13.12 in chips) 
Seat 6: HubertusB ($5.05 in chips) 
WahaBeat: posts small blind $0.02
t1mka09367: posts big blind $0.05
*** HOLE CARDS ***
Dealt to HubertusB [6h 9h]
FriskyBear: folds 
zouzounos86: calls $0.05
HubertusB: folds 
paradiseg174: folds 
WahaBeat: folds 
t1mka09367: raises $0.15 to $0.20
zouzounos86: calls $0.15
*** FLOP *** [8s 3c 4c]
t1mka09367: bets $0.26
zouzounos86: calls $0.26
*** TURN *** [8s 3c 4c] [6s]
t1mka09367: checks 
zouzounos86: checks 
*** RIVER *** [8s 3c 4c 6s] [4h]
t1mka09367: bets $0.67
zouzounos86: calls $0.67
*** SHOW DOWN ***
t1mka09367: shows [Kc Kh] (two pair, Kings and Fours)
zouzounos86: mucks hand 
t1mka09367 collected $2.19 from pot
*** SUMMARY ***
Total pot $2.28 | Rake $0.09 
Board [8s 3c 4c 6s 4h]
Seat 1: paradiseg174 (button) folded before Flop (didn't bet)
Seat 2: WahaBeat (small blind) folded before Flop
Seat 3: t1mka09367 (big blind) showed [Kc Kh] and won ($2.19) with two pair, Kings and Fours
Seat 4: FriskyBear folded before Flop (didn't bet)
Seat 5: zouzounos86 mucked [Ts Th]
Seat 6: HubertusB folded before Flop (didn't bet)



PokerStars Zoom Hand #178482934501:  Hold'em No Limit ($0.02/$0.05) - 2017/11/20 21:30:12 CCT [2017/11/20 8:30:12 ET]
Table 'Donati' 6-max Seat #1 is the button
Seat 1: blondin4uk74 ($5 in chips) 
Seat 2: ilyhaha ($6.24 in chips) 
Seat 3: Bot1729 ($5.56 in chips) 
Seat 4: HubertusB ($5.05 in chips) 
Seat 5: mefisnt ($9.64 in chips) 
Seat 6: Nicole473 ($4.16 in chips) 
ilyhaha: posts small blind $0.02
Bot1729: posts big blind $0.05
*** HOLE CARDS ***
Dealt to HubertusB [4c Kc]
HubertusB: raises $0.05 to $0.10
mefisnt: folds 
Nicole473: calls $0.10
blondin4uk74: folds 
ilyhaha: folds 
Bot1729: folds 
*** FLOP *** [2c 6h Ks]
HubertusB: bets $0.15
Nicole473: raises $0.28 to $0.43
HubertusB: folds 
Uncalled bet ($0.28) returned to Nicole473
Nicole473 collected $0.55 from pot
Nicole473: doesn't show hand 
*** SUMMARY ***
Total pot $0.57 | Rake $0.02 
Board [2c 6h Ks]
Seat 1: blondin4uk74 (button) folded before Flop (didn't bet)
Seat 2: ilyhaha (small blind) folded before Flop
Seat 3: Bot1729 (big blind) folded before Flop
Seat 4: HubertusB folded on the Flop
Seat 5: mefisnt folded before Flop (didn't bet)
Seat 6: Nicole473 collected ($0.55)



PokerStars Zoom Hand #178482951389:  Hold'em No Limit ($0.02/$0.05) - 2017/11/20 21:30:47 CCT [2017/11/20 8:30:47 ET]
Table 'Donati' 6-max Seat #1 is the button
Seat 1: WangHaoWei ($3.34 in chips) 
Seat 2: rasinruby ($9.07 in chips) 
Seat 3: HubertusB ($4.80 in chips) 
Seat 4: Bonch241 ($5.05 in chips) 
Seat 5: tomszl ($0.74 in chips) 
Seat 6: mikk2468 ($6.67 in chips) 
rasinruby: posts small blind $0.02
HubertusB: posts big blind $0.05
*** HOLE CARDS ***
Dealt to HubertusB [3d Ac]
Bonch241: folds 
tomszl: folds 
mikk2468: folds 
WangHaoWei: folds 
rasinruby: folds 
Uncalled bet ($0.03) returned to HubertusB
HubertusB collected $0.04 from pot
HubertusB: doesn't show hand 
*** SUMMARY ***
Total pot $0.04 | Rake $0 
Seat 1: WangHaoWei (button) folded before Flop (didn't bet)
Seat 2: rasinruby (small blind) folded before Flop
Seat 3: HubertusB (big blind) collected ($0.04)
Seat 4: Bonch241 folded before Flop (didn't bet)
Seat 5: tomszl folded before Flop (didn't bet)
Seat 6: mikk2468 folded before Flop (didn't bet)



PokerStars Zoom Hand #178482956648:  Hold'em No Limit ($0.02/$0.05) - 2017/11/20 21:30:58 CCT [2017/11/20 8:30:58 ET]
Table 'Donati' 6-max Seat #1 is the button
Seat 1: FriskyBear ($5.52 in chips) 
Seat 2: HubertusB ($4.82 in chips) 
Seat 3: CAAMi ($5 in chips) 
Seat 4: dimarik_nur1 ($5.10 in chips) 
Seat 5: pogordaniel ($5.63 in chips) 
Seat 6: xxxdaro ($7.14 in chips) 
HubertusB: posts small blind $0.02
CAAMi: posts big blind $0.05
*** HOLE CARDS ***
Dealt to HubertusB [6h Kh]
dimarik_nur1: folds 
pogordaniel: folds 
xxxdaro: folds 
FriskyBear: folds 
HubertusB: raises $0.07 to $0.12
CAAMi: folds 
Uncalled bet ($0.07) returned to HubertusB
HubertusB collected $0.10 from pot
HubertusB: doesn't show hand 
*** SUMMARY ***
Total pot $0.10 | Rake $0 
Seat 1: FriskyBear (button) folded before Flop (didn't bet)
Seat 2: HubertusB (small blind) collected ($0.10)
Seat 3: CAAMi (big blind) folded before Flop
Seat 4: dimarik_nur1 folded before Flop (didn't bet)
Seat 5: pogordaniel folded before Flop (didn't bet)
Seat 6: xxxdaro folded before Flop (didn't bet)



PokerStars Zoom Hand #178482964337:  Hold'em No Limit ($0.02/$0.05) - 2017/11/20 21:31:14 CCT [2017/11/20 8:31:14 ET]
Table 'Donati' 6-max Seat #1 is the button
Seat 1: HubertusB ($4.87 in chips) 
Seat 2: Acedan1369 ($29.82 in chips) 
Seat 3: Roockie4Life ($6.68 in chips) 
Seat 4: e.sergeevna ($6.42 in chips) 
Seat 5: Vagabond000 ($5.31 in chips) 
Seat 6: serj.zp ($5 in chips) 
Acedan1369: posts small blind $0.02
Roockie4Life: posts big blind $0.05
*** HOLE CARDS ***
Dealt to HubertusB [7h 7s]
e.sergeevna: folds 
Vagabond000: folds 
serj.zp: folds 
HubertusB: raises $0.05 to $0.10
Acedan1369: folds 
Roockie4Life: calls $0.05
*** FLOP *** [Qs Kd 2d]
Roockie4Life: checks 
HubertusB: checks 
*** TURN *** [Qs Kd 2d] [5h]
Roockie4Life: bets $0.15
HubertusB: calls $0.15
*** RIVER *** [Qs Kd 2d 5h] [8d]
Roockie4Life: bets $0.40
HubertusB: folds 
Uncalled bet ($0.40) returned to Roockie4Life
Roockie4Life collected $0.50 from pot
Roockie4Life: doesn't show hand 
*** SUMMARY ***
Total pot $0.52 | Rake $0.02 
Board [Qs Kd 2d 5h 8d]
Seat 1: HubertusB (button) folded on the River
Seat 2: Acedan1369 (small blind) folded before Flop
Seat 3: Roockie4Life (big blind) collected ($0.50)
Seat 4: e.sergeevna folded before Flop (didn't bet)
Seat 5: Vagabond000 folded before Flop (didn't bet)
Seat 6: serj.zp folded before Flop (didn't bet)



PokerStars Zoom Hand #178482997581:  Hold'em No Limit ($0.02/$0.05) - 2017/11/20 21:32:23 CCT [2017/11/20 8:32:23 ET]
Table 'Donati' 6-max Seat #1 is the button
Seat 1: SHUR43 ($5.31 in chips) 
Seat 2: MomofMacey ($2.68 in chips) 
Seat 3: acidcider ($2.49 in chips) 
Seat 4: HubertusB ($4.62 in chips) 
Seat 5: marcioadrs ($5 in chips) 
Seat 6: the_Joker'83 ($6.12 in chips) 
MomofMacey: posts small blind $0.02
acidcider: posts big blind $0.05
*** HOLE CARDS ***
Dealt to HubertusB [Kd 2h]
HubertusB: folds 
marcioadrs: folds 
the_Joker'83: folds 
SHUR43: raises $0.05 to $0.10
MomofMacey: folds 
acidcider: folds 
Uncalled bet ($0.05) returned to SHUR43
SHUR43 collected $0.12 from pot
SHUR43: doesn't show hand 
*** SUMMARY ***
Total pot $0.12 | Rake $0 
Seat 1: SHUR43 (button) collected ($0.12)
Seat 2: MomofMacey (small blind) folded before Flop
Seat 3: acidcider (big blind) folded before Flop
Seat 4: HubertusB folded before Flop (didn't bet)
Seat 5: marcioadrs folded before Flop (didn't bet)
Seat 6: the_Joker'83 folded before Flop (didn't bet)



PokerStars Zoom Hand #178482999940:  Hold'em No Limit ($0.02/$0.05) - 2017/11/20 21:32:28 CCT [2017/11/20 8:32:28 ET]
Table 'Donati' 6-max Seat #1 is the button
Seat 1: pythonjava ($3.61 in chips) 
Seat 2: InFlames86 ($7.14 in chips) 
Seat 3: nervss ($8.66 in chips) 
Seat 4: super3min ($8.56 in chips) 
Seat 5: mikk2468 ($8.93 in chips) 
Seat 6: HubertusB ($4.62 in chips) 
InFlames86: posts small blind $0.02
nervss: posts big blind $0.05
*** HOLE CARDS ***
Dealt to HubertusB [6h Ad]
super3min: folds 
mikk2468: folds 
HubertusB: folds 
pythonjava: raises $0.10 to $0.15
InFlames86: folds 
nervss: folds 
Uncalled bet ($0.10) returned to pythonjava
pythonjava collected $0.12 from pot
pythonjava: doesn't show hand 
*** SUMMARY ***
Total pot $0.12 | Rake $0 
Seat 1: pythonjava (button) collected ($0.12)
Seat 2: InFlames86 (small blind) folded before Flop
Seat 3: nervss (big blind) folded before Flop
Seat 4: super3min folded before Flop (didn't bet)
Seat 5: mikk2468 folded before Flop (didn't bet)
Seat 6: HubertusB folded before Flop (didn't bet)



PokerStars Zoom Hand #178483004198:  Hold'em No Limit ($0.02/$0.05) - 2017/11/20 21:32:37 CCT [2017/11/20 8:32:37 ET]
Table 'Donati' 6-max Seat #1 is the button
Seat 1: zetlife ($6.20 in chips) 
Seat 2: HubertusB ($4.62 in chips) 
Seat 3: kaesspo ($8.77 in chips) 
Seat 4: tomsal0157 ($5.34 in chips) 
Seat 5: Bot1729 ($5.12 in chips) 
Seat 6: LetsGrindIt ($5.05 in chips) 
HubertusB: posts small blind $0.02
kaesspo: posts big blind $0.05
*** HOLE CARDS ***
Dealt to HubertusB [5h 6d]
tomsal0157: folds 
Bot1729: folds 
LetsGrindIt: folds 
zetlife: folds 
HubertusB: folds 
Uncalled bet ($0.03) returned to kaesspo
kaesspo collected $0.04 from pot
kaesspo: doesn't show hand 
*** SUMMARY ***
Total pot $0.04 | Rake $0 
Seat 1: zetlife (button) folded before Flop (didn't bet)
Seat 2: HubertusB (small blind) folded before Flop
Seat 3: kaesspo (big blind) collected ($0.04)
Seat 4: tomsal0157 folded before Flop (didn't bet)
Seat 5: Bot1729 folded before Flop (didn't bet)
Seat 6: LetsGrindIt folded before Flop (didn't bet)



PokerStars Zoom Hand #178483006527:  Hold'em No Limit ($0.02/$0.05) - 2017/11/20 21:32:42 CCT [2017/11/20 8:32:42 ET]
Table 'Donati' 6-max Seat #1 is the button
Seat 1: t1mka09367 ($18.90 in chips) 
Seat 2: hobbididence ($10.24 in chips) 
Seat 3: HubertusB ($4.60 in chips) 
Seat 4: tjindar44 ($5.55 in chips) 
Seat 5: zouzounos86 ($11.96 in chips) 
Seat 6: InFlames86 ($5 in chips) 
hobbididence: posts small blind $0.02
HubertusB: posts big blind $0.05
*** HOLE CARDS ***
Dealt to HubertusB [Qs 4c]
tjindar44: folds 
zouzounos86: folds 
InFlames86: folds 
t1mka09367: raises $0.10 to $0.15
hobbididence: folds 
HubertusB: folds 
Uncalled bet ($0.10) returned to t1mka09367
t1mka09367 collected $0.12 from pot
t1mka09367: doesn't show hand 
*** SUMMARY ***
Total pot $0.12 | Rake $0 
Seat 1: t1mka09367 (button) collected ($0.12)
Seat 2: hobbididence (small blind) folded before Flop
Seat 3: HubertusB (big blind) folded before Flop
Seat 4: tjindar44 folded before Flop (didn't bet)
Seat 5: zouzounos86 folded before Flop (didn't bet)
Seat 6: InFlames86 folded before Flop (didn't bet)



PokerStars Zoom Hand #178483010392:  Hold'em No Limit ($0.02/$0.05) - 2017/11/20 21:32:50 CCT [2017/11/20 8:32:50 ET]
Table 'Donati' 6-max Seat #1 is the button
Seat 1: ZlayaMyxa ($5.29 in chips) 
Seat 2: Cruzivey ($7.01 in chips) 
Seat 3: serega55reg ($5.87 in chips) 
Seat 4: hancockkas ($7.91 in chips) 
Seat 5: suriel666 ($4.59 in chips) 
Seat 6: HubertusB ($4.55 in chips) 
Cruzivey: posts small blind $0.02
serega55reg: posts big blind $0.05
*** HOLE CARDS ***
Dealt to HubertusB [7d 4s]
hancockkas: folds 
suriel666: folds 
HubertusB: folds 
ZlayaMyxa: folds 
Cruzivey: folds 
Uncalled bet ($0.03) returned to serega55reg
serega55reg collected $0.04 from pot
serega55reg: doesn't show hand 
*** SUMMARY ***
Total pot $0.04 | Rake $0 
Seat 1: ZlayaMyxa (button) folded before Flop (didn't bet)
Seat 2: Cruzivey (small blind) folded before Flop
Seat 3: serega55reg (big blind) collected ($0.04)
Seat 4: hancockkas folded before Flop (didn't bet)
Seat 5: suriel666 folded before Flop (didn't bet)
Seat 6: HubertusB folded before Flop (didn't bet)



PokerStars Zoom Hand #178483012814:  Hold'em No Limit ($0.02/$0.05) - 2017/11/20 21:32:55 CCT [2017/11/20 8:32:55 ET]
Table 'Donati' 6-max Seat #1 is the button
Seat 1: HubertusB ($4.55 in chips) 
Seat 2: collapse.n1 ($5.66 in chips) 
Seat 3: ole.2304 ($5.90 in chips) 
Seat 4: yuuuu69 ($5.56 in chips) 
Seat 5: Fearless_men ($7.11 in chips) 
Seat 6: t1mka09367 ($7.11 in chips) 
collapse.n1: posts small blind $0.02
ole.2304: posts big blind $0.05
*** HOLE CARDS ***
Dealt to HubertusB [Td Ad]
yuuuu69: folds 
Fearless_men: raises $0.10 to $0.15
t1mka09367: folds 
HubertusB: calls $0.15
collapse.n1: folds 
ole.2304: calls $0.10
*** FLOP *** [Js 3s 7h]
ole.2304: checks 
Fearless_men: checks 
HubertusB: bets $0.30
ole.2304: folds 
Fearless_men: folds 
Uncalled bet ($0.30) returned to HubertusB
HubertusB collected $0.45 from pot
HubertusB: doesn't show hand 
*** SUMMARY ***
Total pot $0.47 | Rake $0.02 
Board [Js 3s 7h]
Seat 1: HubertusB (button) collected ($0.45)
Seat 2: collapse.n1 (small blind) folded before Flop
Seat 3: ole.2304 (big blind) folded on the Flop
Seat 4: yuuuu69 folded before Flop (didn't bet)
Seat 5: Fearless_men folded on the Flop
Seat 6: t1mka09367 folded before Flop (didn't bet)



PokerStars Zoom Hand #178483033067:  Hold'em No Limit ($0.02/$0.05) - 2017/11/20 21:33:37 CCT [2017/11/20 8:33:37 ET]
Table 'Donati' 6-max Seat #1 is the button
Seat 1: Fearless_men ($5 in chips) 
Seat 2: skychevsky ($6.35 in chips) 
Seat 3: amatiorche ($11.62 in chips) 
Seat 4: serj.zp ($5.65 in chips) 
Seat 5: HubertusB ($4.85 in chips) 
Seat 6: the_Joker'83 ($5.11 in chips) 
skychevsky: posts small blind $0.02
amatiorche: posts big blind $0.05
*** HOLE CARDS ***
Dealt to HubertusB [As Kh]
serj.zp: folds 
HubertusB: raises $0.07 to $0.12
the_Joker'83: folds 
Fearless_men: folds 
skychevsky: folds 
amatiorche: folds 
Uncalled bet ($0.07) returned to HubertusB
HubertusB collected $0.12 from pot
HubertusB: doesn't show hand 
*** SUMMARY ***
Total pot $0.12 | Rake $0 
Seat 1: Fearless_men (button) folded before Flop (didn't bet)
Seat 2: skychevsky (small blind) folded before Flop
Seat 3: amatiorche (big blind) folded before Flop
Seat 4: serj.zp folded before Flop (didn't bet)
Seat 5: HubertusB collected ($0.12)
Seat 6: the_Joker'83 folded before Flop (didn't bet)



PokerStars Zoom Hand #178483038872:  Hold'em No Limit ($0.02/$0.05) - 2017/11/20 21:33:49 CCT [2017/11/20 8:33:49 ET]
Table 'Donati' 6-max Seat #1 is the button
Seat 1: patrickbocsa ($5.73 in chips) 
Seat 2: Acedan1369 ($21.37 in chips) 
Seat 3: C3TN1K ($5.72 in chips) 
Seat 4: Thedams04 ($5 in chips) 
Seat 5: HubertusB ($4.92 in chips) 
Seat 6: stray cat84 ($5 in chips) 
Acedan1369: posts small blind $0.02
C3TN1K: posts big blind $0.05
*** HOLE CARDS ***
Dealt to HubertusB [9c Ts]
Thedams04: folds 
HubertusB: folds 
stray cat84: folds 
patrickbocsa: raises $0.10 to $0.15
Acedan1369: folds 
C3TN1K: folds 
Uncalled bet ($0.10) returned to patrickbocsa
patrickbocsa collected $0.12 from pot
patrickbocsa: doesn't show hand 
*** SUMMARY ***
Total pot $0.12 | Rake $0 
Seat 1: patrickbocsa (button) collected ($0.12)
Seat 2: Acedan1369 (small blind) folded before Flop
Seat 3: C3TN1K (big blind) folded before Flop
Seat 4: Thedams04 folded before Flop (didn't bet)
Seat 5: HubertusB folded before Flop (didn't bet)
Seat 6: stray cat84 folded before Flop (didn't bet)



PokerStars Zoom Hand #178483053226:  Hold'em No Limit ($0.02/$0.05) - 2017/11/20 21:34:19 CCT [2017/11/20 8:34:19 ET]
Table 'Donati' 6-max Seat #1 is the button
Seat 1: t1mka09367 ($5 in chips) 
Seat 2: buberman ($5.60 in chips) 
Seat 3: valuebet888 ($5.99 in chips) 
Seat 4: zetlife ($6.39 in chips) 
Seat 5: HubertusB ($4.87 in chips) 
Seat 6: Acedan1369 ($21.35 in chips) 
buberman: posts small blind $0.02
valuebet888: posts big blind $0.05
*** HOLE CARDS ***
Dealt to HubertusB [5h Kh]
zetlife: folds 
HubertusB: folds 
Acedan1369: folds 
t1mka09367: folds 
buberman: folds 
Uncalled bet ($0.03) returned to valuebet888
valuebet888 collected $0.04 from pot
valuebet888: doesn't show hand 
*** SUMMARY ***
Total pot $0.04 | Rake $0 
Seat 1: t1mka09367 (button) folded before Flop (didn't bet)
Seat 2: buberman (small blind) folded before Flop
Seat 3: valuebet888 (big blind) collected ($0.04)
Seat 4: zetlife folded before Flop (didn't bet)
Seat 5: HubertusB folded before Flop (didn't bet)
Seat 6: Acedan1369 folded before Flop (didn't bet)



PokerStars Zoom Hand #178483048511:  Hold'em No Limit ($0.02/$0.05) - 2017/11/20 21:34:09 CCT [2017/11/20 8:34:09 ET]
Table 'Donati' 6-max Seat #1 is the button
Seat 1: HubertusB ($4.87 in chips) 
Seat 2: Dorogoi57 ($5.89 in chips) 
Seat 3: AzoXzo ($5.74 in chips) 
Seat 4: hobbididence ($6.80 in chips) 
Seat 5: Thedams04 ($5 in chips) 
Seat 6: zodiakfish ($4.30 in chips) 
Dorogoi57: posts small blind $0.02
AzoXzo: posts big blind $0.05
*** HOLE CARDS ***
Dealt to HubertusB [3c Js]
hobbididence: folds 
Thedams04: raises $0.10 to $0.15
zodiakfish: calls $0.15
HubertusB: folds 
Dorogoi57: folds 
AzoXzo: folds 
*** FLOP *** [5d 9h 7d]
Thedams04: checks 
zodiakfish: bets $0.15
Thedams04: folds 
Uncalled bet ($0.15) returned to zodiakfish
zodiakfish collected $0.35 from pot
zodiakfish: doesn't show hand 
*** SUMMARY ***
Total pot $0.37 | Rake $0.02 
Board [5d 9h 7d]
Seat 1: HubertusB (button) folded before Flop (didn't bet)
Seat 2: Dorogoi57 (small blind) folded before Flop
Seat 3: AzoXzo (big blind) folded before Flop
Seat 4: hobbididence folded before Flop (didn't bet)
Seat 5: Thedams04 folded on the Flop
Seat 6: zodiakfish collected ($0.35)



PokerStars Zoom Hand #178483041743:  Hold'em No Limit ($0.02/$0.05) - 2017/11/20 21:33:55 CCT [2017/11/20 8:33:55 ET]
Table 'Donati' 6-max Seat #1 is the button
Seat 1: Oliana88 ($5.93 in chips) 
Seat 2: kuansheng ($5 in chips) 
Seat 3: HubertusB ($4.92 in chips) 
Seat 4: serega55reg ($5.11 in chips) 
Seat 5: xarichi ($7.68 in chips) 
Seat 6: Blubberchen7 ($6.32 in chips) 
kuansheng: posts small blind $0.02
HubertusB: posts big blind $0.05
*** HOLE CARDS ***
Dealt to HubertusB [2s 5s]
serega55reg: folds 
xarichi: folds 
Blubberchen7: folds 
Oliana88: raises $0.07 to $0.12
kuansheng: raises $0.33 to $0.45
HubertusB: folds 
Oliana88: calls $0.33
*** FLOP *** [9h 8c 5d]
kuansheng: bets $0.55
Oliana88: calls $0.55
*** TURN *** [9h 8c 5d] [4s]
kuansheng: bets $1.38
Oliana88: folds 
Uncalled bet ($1.38) returned to kuansheng
kuansheng collected $1.97 from pot
kuansheng: doesn't show hand 
*** SUMMARY ***
Total pot $2.05 | Rake $0.08 
Board [9h 8c 5d 4s]
Seat 1: Oliana88 (button) folded on the Turn
Seat 2: kuansheng (small blind) collected ($1.97)
Seat 3: HubertusB (big blind) folded before Flop
Seat 4: serega55reg folded before Flop (didn't bet)
Seat 5: xarichi folded before Flop (didn't bet)
Seat 6: Blubberchen7 folded before Flop (didn't bet)



PokerStars Zoom Hand #178483056129:  Hold'em No Limit ($0.02/$0.05) - 2017/11/20 21:34:25 CCT [2017/11/20 8:34:25 ET]
Table 'Donati' 6-max Seat #1 is the button
Seat 1: Peauker123 ($8.13 in chips) 
Seat 2: HubertusB ($4.87 in chips) 
Seat 3: vickolay ($5 in chips) 
Seat 4: C3TN1K ($4.76 in chips) 
Seat 5: kaesspo ($12.34 in chips) 
Seat 6: invincibl345 ($4.84 in chips) 
HubertusB: posts small blind $0.02
vickolay: posts big blind $0.05
*** HOLE CARDS ***
Dealt to HubertusB [3s Qd]
C3TN1K: folds 
kaesspo: folds 
invincibl345: folds 
Peauker123: raises $0.07 to $0.12
HubertusB: folds 
vickolay: folds 
Uncalled bet ($0.07) returned to Peauker123
Peauker123 collected $0.12 from pot
Peauker123: doesn't show hand 
*** SUMMARY ***
Total pot $0.12 | Rake $0 
Seat 1: Peauker123 (button) collected ($0.12)
Seat 2: HubertusB (small blind) folded before Flop
Seat 3: vickolay (big blind) folded before Flop
Seat 4: C3TN1K folded before Flop (didn't bet)
Seat 5: kaesspo folded before Flop (didn't bet)
Seat 6: invincibl345 folded before Flop (didn't bet)



PokerStars Zoom Hand #178483059054:  Hold'em No Limit ($0.02/$0.05) - 2017/11/20 21:34:31 CCT [2017/11/20 8:34:31 ET]
Table 'Donati' 6-max Seat #1 is the button
Seat 1: Polypops ($5.38 in chips) 
Seat 2: 17edm ($4.93 in chips) 
Seat 3: procenko777 ($3.25 in chips) 
Seat 4: InFlames86 ($10.49 in chips) 
Seat 5: greyk1n ($6 in chips) 
Seat 6: HubertusB ($4.85 in chips) 
17edm: posts small blind $0.02
procenko777: posts big blind $0.05
*** HOLE CARDS ***
Dealt to HubertusB [Ts Kd]
InFlames86: folds 
greyk1n: folds 
HubertusB: raises $0.05 to $0.10
Polypops: raises $0.25 to $0.35
17edm: folds 
procenko777: folds 
HubertusB: folds 
Uncalled bet ($0.25) returned to Polypops
Polypops collected $0.27 from pot
Polypops: doesn't show hand 
*** SUMMARY ***
Total pot $0.27 | Rake $0 
Seat 1: Polypops (button) collected ($0.27)
Seat 2: 17edm (small blind) folded before Flop
Seat 3: procenko777 (big blind) folded before Flop
Seat 4: InFlames86 folded before Flop (didn't bet)
Seat 5: greyk1n folded before Flop (didn't bet)
Seat 6: HubertusB folded before Flop



PokerStars Zoom Hand #178483071711:  Hold'em No Limit ($0.02/$0.05) - 2017/11/20 21:34:57 CCT [2017/11/20 8:34:57 ET]
Table 'Donati' 6-max Seat #1 is the button
Seat 1: d(-_-)bSzebi ($7.26 in chips) 
Seat 2: serega55reg ($9.69 in chips) 
Seat 3: VemPyra ($7.51 in chips) 
Seat 4: HubertusB ($4.75 in chips) 
Seat 5: MomofMacey ($1.13 in chips) 
Seat 6: Kevin120497 ($1.19 in chips) 
serega55reg: posts small blind $0.02
VemPyra: posts big blind $0.05
*** HOLE CARDS ***
Dealt to HubertusB [8s 8d]
HubertusB: raises $0.05 to $0.10
MomofMacey: folds 
Kevin120497: folds 
d(-_-)bSzebi: folds 
serega55reg: folds 
VemPyra: folds 
Uncalled bet ($0.05) returned to HubertusB
HubertusB collected $0.12 from pot
HubertusB: doesn't show hand 
*** SUMMARY ***
Total pot $0.12 | Rake $0 
Seat 1: d(-_-)bSzebi (button) folded before Flop (didn't bet)
Seat 2: serega55reg (small blind) folded before Flop
Seat 3: VemPyra (big blind) folded before Flop
Seat 4: HubertusB collected ($0.12)
Seat 5: MomofMacey folded before Flop (didn't bet)
Seat 6: Kevin120497 folded before Flop (didn't bet)



PokerStars Zoom Hand #178483078509:  Hold'em No Limit ($0.02/$0.05) - 2017/11/20 21:35:11 CCT [2017/11/20 8:35:11 ET]
Table 'Donati' 6-max Seat #1 is the button
Seat 1: kidsonik ($5.09 in chips) 
Seat 2: ole.2304 ($8.51 in chips) 
Seat 3: HubertusB ($4.82 in chips) 
Seat 4: PsBadBluff ($10.23 in chips) 
Seat 5: vcf2013 ($7.19 in chips) 
Seat 6: Bonch241 ($5.35 in chips) 
ole.2304: posts small blind $0.02
HubertusB: posts big blind $0.05
*** HOLE CARDS ***
Dealt to HubertusB [7h 7d]
PsBadBluff: folds 
vcf2013: folds 
Bonch241: folds 
kidsonik: folds 
ole.2304: raises $0.07 to $0.12
HubertusB: calls $0.07
*** FLOP *** [3s 8d 4h]
ole.2304: checks 
HubertusB: bets $0.13
ole.2304: calls $0.13
*** TURN *** [3s 8d 4h] [3c]
ole.2304: checks 
HubertusB: bets $0.30
ole.2304: folds 
Uncalled bet ($0.30) returned to HubertusB
HubertusB collected $0.48 from pot
HubertusB: doesn't show hand 
*** SUMMARY ***
Total pot $0.50 | Rake $0.02 
Board [3s 8d 4h 3c]
Seat 1: kidsonik (button) folded before Flop (didn't bet)
Seat 2: ole.2304 (small blind) folded on the Turn
Seat 3: HubertusB (big blind) collected ($0.48)
Seat 4: PsBadBluff folded before Flop (didn't bet)
Seat 5: vcf2013 folded before Flop (didn't bet)
Seat 6: Bonch241 folded before Flop (didn't bet)



PokerStars Zoom Hand #178483103007:  Hold'em No Limit ($0.02/$0.05) - 2017/11/20 21:36:02 CCT [2017/11/20 8:36:02 ET]
Table 'Donati' 6-max Seat #1 is the button
Seat 1: AYE_RUSSIAN ($9.95 in chips) 
Seat 2: Vynnypoker ($7.24 in chips) 
Seat 3: TeMaGic ($5.16 in chips) 
Seat 4: HubertusB ($5.05 in chips) 
Seat 5: baggelisdr1 ($5.65 in chips) 
Seat 6: FriskyBear ($5.67 in chips) 
Vynnypoker: posts small blind $0.02
TeMaGic: posts big blind $0.05
*** HOLE CARDS ***
Dealt to HubertusB [4d Th]
HubertusB: folds 
baggelisdr1: folds 
FriskyBear: folds 
AYE_RUSSIAN: raises $0.06 to $0.11
Vynnypoker: folds 
TeMaGic: folds 
Uncalled bet ($0.06) returned to AYE_RUSSIAN
AYE_RUSSIAN collected $0.12 from pot
AYE_RUSSIAN: doesn't show hand 
*** SUMMARY ***
Total pot $0.12 | Rake $0 
Seat 1: AYE_RUSSIAN (button) collected ($0.12)
Seat 2: Vynnypoker (small blind) folded before Flop
Seat 3: TeMaGic (big blind) folded before Flop
Seat 4: HubertusB folded before Flop (didn't bet)
Seat 5: baggelisdr1 folded before Flop (didn't bet)
Seat 6: FriskyBear folded before Flop (didn't bet)



PokerStars Zoom Hand #178483115609:  Hold'em No Limit ($0.02/$0.05) - 2017/11/20 21:36:17 CCT [2017/11/20 8:36:17 ET]
Table 'Donati' 6-max Seat #1 is the button
Seat 1: super3min ($8.55 in chips) 
Seat 2: HubertusB ($5.05 in chips) 
Seat 3: Bonch241 ($12.06 in chips) 
Seat 4: kaesspo ($15.90 in chips) 
Seat 5: yumi2003 ($5.37 in chips) 
Seat 6: greyk1n ($6.02 in chips) 
HubertusB: posts small blind $0.02
Bonch241: posts big blind $0.05
*** HOLE CARDS ***
Dealt to HubertusB [9d Jd]
kaesspo: folds 
yumi2003: folds 
greyk1n: folds 
super3min: raises $0.08 to $0.13
HubertusB: calls $0.11
Bonch241: folds 
*** FLOP *** [6c 9c 7h]
HubertusB: bets $0.17
super3min: calls $0.17
*** TURN *** [6c 9c 7h] [Td]
HubertusB: checks 
super3min: checks 
*** RIVER *** [6c 9c 7h Td] [Qh]
HubertusB: checks 
super3min: checks 
*** SHOW DOWN ***
HubertusB: shows [9d Jd] (a pair of Nines)
super3min: mucks hand 
HubertusB collected $0.62 from pot
*** SUMMARY ***
Total pot $0.65 | Rake $0.03 
Board [6c 9c 7h Td Qh]
Seat 1: super3min (button) mucked [Ah Ks]
Seat 2: HubertusB (small blind) showed [9d Jd] and won ($0.62) with a pair of Nines
Seat 3: Bonch241 (big blind) folded before Flop
Seat 4: kaesspo folded before Flop (didn't bet)
Seat 5: yumi2003 folded before Flop (didn't bet)
Seat 6: greyk1n folded before Flop (didn't bet)



PokerStars Zoom Hand #178483155175:  Hold'em No Limit ($0.02/$0.05) - 2017/11/20 21:37:38 CCT [2017/11/20 8:37:38 ET]
Table 'Donati' 6-max Seat #1 is the button
Seat 1: HubertusB ($5.37 in chips) 
Seat 2: Marka555 ($5.16 in chips) 
Seat 3: serhio77 ($8.57 in chips) 
Seat 4: aspik2k ($5.17 in chips) 
Seat 5: GizaGliwic ($8.55 in chips) 
Seat 6: Oliana88 ($5.07 in chips) 
Marka555: posts small blind $0.02
serhio77: posts big blind $0.05
*** HOLE CARDS ***
Dealt to HubertusB [2s 8h]
aspik2k: folds 
GizaGliwic: folds 
Oliana88: folds 
HubertusB: raises $0.05 to $0.10
Marka555: folds 
serhio77: folds 
Uncalled bet ($0.05) returned to HubertusB
HubertusB collected $0.12 from pot
HubertusB: doesn't show hand 
*** SUMMARY ***
Total pot $0.12 | Rake $0 
Seat 1: HubertusB (button) collected ($0.12)
Seat 2: Marka555 (small blind) folded before Flop
Seat 3: serhio77 (big blind) folded before Flop
Seat 4: aspik2k folded before Flop (didn't bet)
Seat 5: GizaGliwic folded before Flop (didn't bet)
Seat 6: Oliana88 folded before Flop (didn't bet)



PokerStars Zoom Hand #178483163025:  Hold'em No Limit ($0.02/$0.05) - 2017/11/20 21:37:54 CCT [2017/11/20 8:37:54 ET]
Table 'Donati' 6-max Seat #1 is the button
Seat 1: paradiseg174 ($6.82 in chips) 
Seat 2: MoreRakePls1 ($5 in chips) 
Seat 3: Fearless_men ($12.50 in chips) 
Seat 4: WangHaoWei ($20.76 in chips) 
Seat 5: walhalla48 ($5 in chips) 
Seat 6: HubertusB ($5.44 in chips) 
MoreRakePls1: posts small blind $0.02
Fearless_men: posts big blind $0.05
*** HOLE CARDS ***
Dealt to HubertusB [2d 8s]
WangHaoWei: folds 
walhalla48: folds 
HubertusB: folds 
paradiseg174: raises $0.07 to $0.12
MoreRakePls1: folds 
Fearless_men: calls $0.07
*** FLOP *** [Ad Ah 5h]
Fearless_men: checks 
paradiseg174: checks 
*** TURN *** [Ad Ah 5h] [8d]
Fearless_men: bets $0.15
paradiseg174: folds 
Uncalled bet ($0.15) returned to Fearless_men
Fearless_men collected $0.25 from pot
Fearless_men: doesn't show hand 
*** SUMMARY ***
Total pot $0.26 | Rake $0.01 
Board [Ad Ah 5h 8d]
Seat 1: paradiseg174 (button) folded on the Turn
Seat 2: MoreRakePls1 (small blind) folded before Flop
Seat 3: Fearless_men (big blind) collected ($0.25)
Seat 4: WangHaoWei folded before Flop (didn't bet)
Seat 5: walhalla48 folded before Flop (didn't bet)
Seat 6: HubertusB folded before Flop (didn't bet)



PokerStars Zoom Hand #178483167930:  Hold'em No Limit ($0.02/$0.05) - 2017/11/20 21:38:04 CCT [2017/11/20 8:38:04 ET]
Table 'Donati' 6-max Seat #1 is the button
Seat 1: tael1973 ($5.07 in chips) 
Seat 2: invincibl345 ($4.14 in chips) 
Seat 3: HubertusB ($5.44 in chips) 
Seat 4: suriel666 ($5.23 in chips) 
Seat 5: AzoXzo ($5.13 in chips) 
Seat 6: Fearless_men ($8.21 in chips) 
invincibl345: posts small blind $0.02
HubertusB: posts big blind $0.05
*** HOLE CARDS ***
Dealt to HubertusB [3h 5h]
suriel666: raises $0.15 to $0.20
AzoXzo: folds 
Fearless_men: folds 
tael1973: folds 
invincibl345: calls $0.18
HubertusB: folds 
*** FLOP *** [Kh 9s 7c]
invincibl345: checks 
suriel666: bets $0.20
invincibl345: calls $0.20
*** TURN *** [Kh 9s 7c] [6d]
invincibl345: checks 
suriel666: checks 
*** RIVER *** [Kh 9s 7c 6d] [6s]
invincibl345: checks 
suriel666: checks 
*** SHOW DOWN ***
invincibl345: shows [8d 8h] (two pair, Eights and Sixes)
suriel666: mucks hand 
invincibl345 collected $0.81 from pot
*** SUMMARY ***
Total pot $0.85 | Rake $0.04 
Board [Kh 9s 7c 6d 6s]
Seat 1: tael1973 (button) folded before Flop (didn't bet)
Seat 2: invincibl345 (small blind) showed [8d 8h] and won ($0.81) with two pair, Eights and Sixes
Seat 3: HubertusB (big blind) folded before Flop
Seat 4: suriel666 mucked [Ac Qc]
Seat 5: AzoXzo folded before Flop (didn't bet)
Seat 6: Fearless_men folded before Flop (didn't bet)



PokerStars Zoom Hand #178483172844:  Hold'em No Limit ($0.02/$0.05) - 2017/11/20 21:38:14 CCT [2017/11/20 8:38:14 ET]
Table 'Donati' 6-max Seat #1 is the button
Seat 1: oleg777886 ($5 in chips) 
Seat 2: xGzusS ($5.21 in chips) 
Seat 3: Acedan1369 ($21.23 in chips) 
Seat 4: Sukretny ($2.70 in chips) 
Seat 5: HubertusB ($5.39 in chips) 
Seat 6: Vynnypoker ($5.92 in chips) 
xGzusS: posts small blind $0.02
Acedan1369: posts big blind $0.05
*** HOLE CARDS ***
Dealt to HubertusB [9d 9c]
Sukretny: folds 
HubertusB: raises $0.05 to $0.10
Vynnypoker: raises $0.25 to $0.35
oleg777886: folds 
xGzusS: folds 
Acedan1369: folds 
HubertusB: folds 
Uncalled bet ($0.25) returned to Vynnypoker
Vynnypoker collected $0.27 from pot
Vynnypoker: doesn't show hand 
*** SUMMARY ***
Total pot $0.27 | Rake $0 
Seat 1: oleg777886 (button) folded before Flop (didn't bet)
Seat 2: xGzusS (small blind) folded before Flop
Seat 3: Acedan1369 (big blind) folded before Flop
Seat 4: Sukretny folded before Flop (didn't bet)
Seat 5: HubertusB folded before Flop
Seat 6: Vynnypoker collected ($0.27)



PokerStars Zoom Hand #178483187542:  Hold'em No Limit ($0.02/$0.05) - 2017/11/20 21:38:44 CCT [2017/11/20 8:38:44 ET]
Table 'Donati' 6-max Seat #1 is the button
Seat 1: GizaGliwic ($8.39 in chips) 
Seat 2: KONUNG26rus ($8.13 in chips) 
Seat 3: Min.D.REN ($2.35 in chips) 
Seat 4: HubertusB ($5.29 in chips) 
Seat 5: MPMTL ($3.73 in chips) 
Seat 6: FriskyBear ($5.95 in chips) 
KONUNG26rus: posts small blind $0.02
Min.D.REN: posts big blind $0.05
*** HOLE CARDS ***
Dealt to HubertusB [Js Qc]
HubertusB: folds 
MPMTL: folds 
FriskyBear: folds 
GizaGliwic: raises $0.07 to $0.12
KONUNG26rus: folds 
Min.D.REN: calls $0.07
*** FLOP *** [8s 4d 7h]
Min.D.REN: checks 
GizaGliwic: bets $0.13
Min.D.REN: calls $0.13
*** TURN *** [8s 4d 7h] [5d]
Min.D.REN: checks 
GizaGliwic: checks 
*** RIVER *** [8s 4d 7h 5d] [8h]
Min.D.REN: checks 
GizaGliwic: bets $0.17
Min.D.REN: folds 
Uncalled bet ($0.17) returned to GizaGliwic
GizaGliwic collected $0.50 from pot
GizaGliwic: doesn't show hand 
*** SUMMARY ***
Total pot $0.52 | Rake $0.02 
Board [8s 4d 7h 5d 8h]
Seat 1: GizaGliwic (button) collected ($0.50)
Seat 2: KONUNG26rus (small blind) folded before Flop
Seat 3: Min.D.REN (big blind) folded on the River
Seat 4: HubertusB folded before Flop (didn't bet)
Seat 5: MPMTL folded before Flop (didn't bet)
Seat 6: FriskyBear folded before Flop (didn't bet)



PokerStars Zoom Hand #178483190531:  Hold'em No Limit ($0.02/$0.05) - 2017/11/20 21:38:50 CCT [2017/11/20 8:38:50 ET]
Table 'Donati' 6-max Seat #1 is the button
Seat 1: HubertusB ($5.29 in chips) 
Seat 2: Polypops ($5.68 in chips) 
Seat 3: annita44 ($5.05 in chips) 
Seat 4: Sukretny ($2.63 in chips) 
Seat 5: sw11223 ($4.93 in chips) 
Seat 6: oleg777886 ($5 in chips) 
Polypops: posts small blind $0.02
annita44: posts big blind $0.05
*** HOLE CARDS ***
Dealt to HubertusB [9s 3d]
Sukretny: raises $0.11 to $0.16
sw11223: folds 
oleg777886: calls $0.16
HubertusB: folds 
Polypops: folds 
annita44: folds 
*** FLOP *** [6c 9c 5d]
Sukretny: bets $0.19
oleg777886: raises $0.36 to $0.55
Sukretny: folds 
Uncalled bet ($0.36) returned to oleg777886
oleg777886 collected $0.74 from pot
oleg777886: doesn't show hand 
*** SUMMARY ***
Total pot $0.77 | Rake $0.03 
Board [6c 9c 5d]
Seat 1: HubertusB (button) folded before Flop (didn't bet)
Seat 2: Polypops (small blind) folded before Flop
Seat 3: annita44 (big blind) folded before Flop
Seat 4: Sukretny folded on the Flop
Seat 5: sw11223 folded before Flop (didn't bet)
Seat 6: oleg777886 collected ($0.74)



PokerStars Zoom Hand #178483193454:  Hold'em No Limit ($0.02/$0.05) - 2017/11/20 21:38:56 CCT [2017/11/20 8:38:56 ET]
Table 'Donati' 6-max Seat #1 is the button
Seat 1: botrobot777 ($5 in chips) 
Seat 2: HubertusB ($5.29 in chips) 
Seat 3: ludaslol ($5.69 in chips) 
Seat 4: RiSk.Fortune ($5.07 in chips) 
Seat 5: vickolay ($5 in chips) 
Seat 6: papakulikov ($11.21 in chips) 
HubertusB: posts small blind $0.02
ludaslol: posts big blind $0.05
*** HOLE CARDS ***
Dealt to HubertusB [Ah Kd]
RiSk.Fortune: folds 
vickolay: raises $0.05 to $0.10
papakulikov: folds 
botrobot777: folds 
HubertusB: raises $0.30 to $0.40
ludaslol: folds 
vickolay: folds 
Uncalled bet ($0.30) returned to HubertusB
HubertusB collected $0.25 from pot
HubertusB: doesn't show hand 
*** SUMMARY ***
Total pot $0.25 | Rake $0 
Seat 1: botrobot777 (button) folded before Flop (didn't bet)
Seat 2: HubertusB (small blind) collected ($0.25)
Seat 3: ludaslol (big blind) folded before Flop
Seat 4: RiSk.Fortune folded before Flop (didn't bet)
Seat 5: vickolay folded before Flop
Seat 6: papakulikov folded before Flop (didn't bet)



PokerStars Zoom Hand #178483219930:  Hold'em No Limit ($0.02/$0.05) - 2017/11/20 21:39:50 CCT [2017/11/20 8:39:50 ET]
Table 'Donati' 6-max Seat #1 is the button
Seat 1: Nicole473 ($5.90 in chips) 
Seat 2: WahaBeat ($12.16 in chips) 
Seat 3: HubertusB ($5.44 in chips) 
Seat 4: Centurion7/1 ($5.37 in chips) 
Seat 5: eagle2030 ($5.41 in chips) 
Seat 6: SelenaSolis ($5.43 in chips) 
WahaBeat: posts small blind $0.02
HubertusB: posts big blind $0.05
*** HOLE CARDS ***
Dealt to HubertusB [As 6h]
Centurion7/1: folds 
eagle2030: raises $0.05 to $0.10
SelenaSolis: folds 
Nicole473: folds 
WahaBeat: folds 
HubertusB: folds 
Uncalled bet ($0.05) returned to eagle2030
eagle2030 collected $0.12 from pot
eagle2030: doesn't show hand 
*** SUMMARY ***
Total pot $0.12 | Rake $0 
Seat 1: Nicole473 (button) folded before Flop (didn't bet)
Seat 2: WahaBeat (small blind) folded before Flop
Seat 3: HubertusB (big blind) folded before Flop
Seat 4: Centurion7/1 folded before Flop (didn't bet)
Seat 5: eagle2030 collected ($0.12)
Seat 6: SelenaSolis folded before Flop (didn't bet)



PokerStars Zoom Hand #178483217003:  Hold'em No Limit ($0.02/$0.05) - 2017/11/20 21:39:44 CCT [2017/11/20 8:39:44 ET]
Table 'Donati' 6-max Seat #1 is the button
Seat 1: svansong ($5 in chips) 
Seat 2: collapse.n1 ($7.04 in chips) 
Seat 3: Tedlop ($6.67 in chips) 
Seat 4: HubertusB ($5.44 in chips) 
Seat 5: Vynnypoker ($6.62 in chips) 
Seat 6: Marka555 ($4.94 in chips) 
collapse.n1: posts small blind $0.02
Tedlop: posts big blind $0.05
*** HOLE CARDS ***
Dealt to HubertusB [2h Th]
HubertusB: folds 
Vynnypoker: folds 
Marka555: folds 
svansong: raises $0.05 to $0.10
collapse.n1: folds 
Tedlop: folds 
Uncalled bet ($0.05) returned to svansong
svansong collected $0.12 from pot
svansong: doesn't show hand 
*** SUMMARY ***
Total pot $0.12 | Rake $0 
Seat 1: svansong (button) collected ($0.12)
Seat 2: collapse.n1 (small blind) folded before Flop
Seat 3: Tedlop (big blind) folded before Flop
Seat 4: HubertusB folded before Flop (didn't bet)
Seat 5: Vynnypoker folded before Flop (didn't bet)
Seat 6: Marka555 folded before Flop (didn't bet)



PokerStars Zoom Hand #178483210589:  Hold'em No Limit ($0.02/$0.05) - 2017/11/20 21:39:31 CCT [2017/11/20 8:39:31 ET]
Table 'Donati' 6-max Seat #1 is the button
Seat 1: SVG7777 ($1.81 in chips) 
Seat 2: samurai ume ($8.60 in chips) 
Seat 3: collapse.n1 ($5 in chips) 
Seat 4: pimposhkius ($4.26 in chips) 
Seat 5: HubertusB ($5.44 in chips) 
Seat 6: torneo.t ($3.78 in chips) 
samurai ume: posts small blind $0.02
collapse.n1: posts big blind $0.05
*** HOLE CARDS ***
Dealt to HubertusB [Kd 6s]
pimposhkius: raises $0.10 to $0.15
HubertusB: folds 
torneo.t: folds 
SVG7777: folds 
samurai ume: calls $0.13
collapse.n1: folds 
*** FLOP *** [4h 3h 9c]
samurai ume: checks 
pimposhkius: bets $0.15
samurai ume: calls $0.15
*** TURN *** [4h 3h 9c] [Jh]
samurai ume: checks 
pimposhkius: checks 
*** RIVER *** [4h 3h 9c Jh] [7c]
samurai ume: checks 
pimposhkius: checks 
*** SHOW DOWN ***
samurai ume: shows [Ac Qc] (high card Ace)
pimposhkius: shows [As Qd] (high card Ace)
samurai ume collected $0.31 from pot
pimposhkius collected $0.31 from pot
*** SUMMARY ***
Total pot $0.65 | Rake $0.03 
Board [4h 3h 9c Jh 7c]
Seat 1: SVG7777 (button) folded before Flop (didn't bet)
Seat 2: samurai ume (small blind) showed [Ac Qc] and won ($0.31) with high card Ace
Seat 3: collapse.n1 (big blind) folded before Flop
Seat 4: pimposhkius showed [As Qd] and won ($0.31) with high card Ace
Seat 5: HubertusB folded before Flop (didn't bet)
Seat 6: torneo.t folded before Flop (didn't bet)



PokerStars Zoom Hand #178483213570:  Hold'em No Limit ($0.02/$0.05) - 2017/11/20 21:39:37 CCT [2017/11/20 8:39:37 ET]
Table 'Donati' 6-max Seat #1 is the button
Seat 1: baggelisdr1 ($7.90 in chips) 
Seat 2: zikin444 ($5.86 in chips) 
Seat 3: Sukretny ($2.28 in chips) 
Seat 4: iskander575 ($8.33 in chips) 
Seat 5: Vagabond000 ($6.24 in chips) 
Seat 6: HubertusB ($5.44 in chips) 
zikin444: posts small blind $0.02
Sukretny: posts big blind $0.05
*** HOLE CARDS ***
Dealt to HubertusB [9h 2d]
iskander575: folds 
Vagabond000: folds 
HubertusB: folds 
baggelisdr1: raises $0.07 to $0.12
zikin444: folds 
Sukretny: calls $0.07
*** FLOP *** [Ts 5h 7c]
Sukretny: bets $0.13
baggelisdr1: calls $0.13
*** TURN *** [Ts 5h 7c] [8s]
Sukretny: bets $0.25
baggelisdr1: raises $7.40 to $7.65 and is all-in
Sukretny: folds 
Uncalled bet ($7.40) returned to baggelisdr1
baggelisdr1 collected $0.98 from pot
baggelisdr1: doesn't show hand 
*** SUMMARY ***
Total pot $1.02 | Rake $0.04 
Board [Ts 5h 7c 8s]
Seat 1: baggelisdr1 (button) collected ($0.98)
Seat 2: zikin444 (small blind) folded before Flop
Seat 3: Sukretny (big blind) folded on the Turn
Seat 4: iskander575 folded before Flop (didn't bet)
Seat 5: Vagabond000 folded before Flop (didn't bet)
Seat 6: HubertusB folded before Flop (didn't bet)



PokerStars Zoom Hand #178483227276:  Hold'em No Limit ($0.02/$0.05) - 2017/11/20 21:40:05 CCT [2017/11/20 8:40:05 ET]
Table 'Donati' 6-max Seat #1 is the button
Seat 1: NikKram ($6.68 in chips) 
Seat 2: sixxxpac ($5.47 in chips) 
Seat 3: skychevsky ($6.99 in chips) 
Seat 4: t1mka09367 ($24.70 in chips) 
Seat 5: HubertusB ($5.39 in chips) 
Seat 6: Peca87 ($2.52 in chips) 
sixxxpac: posts small blind $0.02
skychevsky: posts big blind $0.05
*** HOLE CARDS ***
Dealt to HubertusB [As Js]
t1mka09367: folds 
HubertusB: raises $0.05 to $0.10
Peca87: folds 
NikKram: folds 
sixxxpac: folds 
skychevsky: calls $0.05
*** FLOP *** [Jd 4c 8c]
skychevsky: checks 
HubertusB: bets $0.12
skychevsky: raises $0.33 to $0.45
HubertusB: calls $0.33
*** TURN *** [Jd 4c 8c] [Th]
skychevsky: bets $1.05
HubertusB: folds 
Uncalled bet ($1.05) returned to skychevsky
skychevsky collected $1.07 from pot
skychevsky: doesn't show hand 
*** SUMMARY ***
Total pot $1.12 | Rake $0.05 
Board [Jd 4c 8c Th]
Seat 1: NikKram (button) folded before Flop (didn't bet)
Seat 2: sixxxpac (small blind) folded before Flop
Seat 3: skychevsky (big blind) collected ($1.07)
Seat 4: t1mka09367 folded before Flop (didn't bet)
Seat 5: HubertusB folded on the Turn
Seat 6: Peca87 folded before Flop (didn't bet)



PokerStars Zoom Hand #178483286329:  Hold'em No Limit ($0.02/$0.05) - 2017/11/20 21:42:06 CCT [2017/11/20 8:42:06 ET]
Table 'Donati' 6-max Seat #1 is the button
Seat 1: collapse.n1 ($5.05 in chips) 
Seat 2: HubertusB ($4.84 in chips) 
Seat 3: C3TN1K ($5.56 in chips) 
Seat 4: NikKram ($6.87 in chips) 
Seat 5: HSGVB81 ($5.40 in chips) 
Seat 6: Ebleco ($1.91 in chips) 
HubertusB: posts small blind $0.02
C3TN1K: posts big blind $0.05
*** HOLE CARDS ***
Dealt to HubertusB [5c 6s]
NikKram: folds 
HSGVB81: folds 
Ebleco: folds 
collapse.n1: folds 
HubertusB: folds 
Uncalled bet ($0.03) returned to C3TN1K
C3TN1K collected $0.04 from pot
C3TN1K: doesn't show hand 
*** SUMMARY ***
Total pot $0.04 | Rake $0 
Seat 1: collapse.n1 (button) folded before Flop (didn't bet)
Seat 2: HubertusB (small blind) folded before Flop
Seat 3: C3TN1K (big blind) collected ($0.04)
Seat 4: NikKram folded before Flop (didn't bet)
Seat 5: HSGVB81 folded before Flop (didn't bet)
Seat 6: Ebleco folded before Flop (didn't bet)



PokerStars Zoom Hand #178483294599:  Hold'em No Limit ($0.02/$0.05) - 2017/11/20 21:42:23 CCT [2017/11/20 8:42:23 ET]
Table 'Donati' 6-max Seat #1 is the button
Seat 1: HubertusB ($4.82 in chips) 
Seat 2: Mr. Roquim ($5.13 in chips) 
Seat 3: sw11223 ($5.86 in chips) 
Seat 4: medallo486 ($6.64 in chips) 
Seat 5: ole.2304 ($8.99 in chips) 
Seat 6: Knaix ($5.07 in chips) 
Mr. Roquim: posts small blind $0.02
sw11223: posts big blind $0.05
*** HOLE CARDS ***
Dealt to HubertusB [7s As]
medallo486: folds 
ole.2304: folds 
Knaix: folds 
HubertusB: raises $0.05 to $0.10
Mr. Roquim: folds 
sw11223: folds 
Uncalled bet ($0.05) returned to HubertusB
HubertusB collected $0.12 from pot
HubertusB: doesn't show hand 
*** SUMMARY ***
Total pot $0.12 | Rake $0 
Seat 1: HubertusB (button) collected ($0.12)
Seat 2: Mr. Roquim (small blind) folded before Flop
Seat 3: sw11223 (big blind) folded before Flop
Seat 4: medallo486 folded before Flop (didn't bet)
Seat 5: ole.2304 folded before Flop (didn't bet)
Seat 6: Knaix folded before Flop (didn't bet)



PokerStars Zoom Hand #178483309395:  Hold'em No Limit ($0.02/$0.05) - 2017/11/20 21:42:53 CCT [2017/11/20 8:42:53 ET]
Table 'Donati' 6-max Seat #1 is the button
Seat 1: blondin4uk74 ($5.07 in chips) 
Seat 2: Sukretny ($1.56 in chips) 
Seat 3: lexa654 ($3.78 in chips) 
Seat 4: Loser_Koki ($9.04 in chips) 
Seat 5: eyadoker ($11.47 in chips) 
Seat 6: HubertusB ($4.89 in chips) 
Sukretny: posts small blind $0.02
lexa654: posts big blind $0.05
*** HOLE CARDS ***
Dealt to HubertusB [2h 7s]
Loser_Koki: folds 
eyadoker: folds 
HubertusB: folds 
blondin4uk74: raises $0.07 to $0.12
Sukretny: calls $0.10
lexa654: folds 
*** FLOP *** [As Ac 8d]
Sukretny: bets $0.14
blondin4uk74: folds 
Uncalled bet ($0.14) returned to Sukretny
Sukretny collected $0.28 from pot
Sukretny: doesn't show hand 
*** SUMMARY ***
Total pot $0.29 | Rake $0.01 
Board [As Ac 8d]
Seat 1: blondin4uk74 (button) folded on the Flop
Seat 2: Sukretny (small blind) collected ($0.28)
Seat 3: lexa654 (big blind) folded before Flop
Seat 4: Loser_Koki folded before Flop (didn't bet)
Seat 5: eyadoker folded before Flop (didn't bet)
Seat 6: HubertusB folded before Flop (didn't bet)



PokerStars Zoom Hand #178483318678:  Hold'em No Limit ($0.02/$0.05) - 2017/11/20 21:43:12 CCT [2017/11/20 8:43:12 ET]
Table 'Donati' 6-max Seat #1 is the button
Seat 1: tael1973 ($5.05 in chips) 
Seat 2: wchivas ($5.98 in chips) 
Seat 3: HubertusB ($4.89 in chips) 
Seat 4: InFlames86 ($5 in chips) 
Seat 5: PsBadBluff ($7.20 in chips) 
Seat 6: edcrfvrtgb ($7.01 in chips) 
wchivas: posts small blind $0.02
HubertusB: posts big blind $0.05
*** HOLE CARDS ***
Dealt to HubertusB [4c 6d]
InFlames86: raises $0.08 to $0.13
PsBadBluff: folds 
edcrfvrtgb: folds 
tael1973: calls $0.13
wchivas: folds 
HubertusB: folds 
*** FLOP *** [8c 2c Kd]
InFlames86: bets $0.22
tael1973: folds 
Uncalled bet ($0.22) returned to InFlames86
InFlames86 collected $0.32 from pot
InFlames86: doesn't show hand 
*** SUMMARY ***
Total pot $0.33 | Rake $0.01 
Board [8c 2c Kd]
Seat 1: tael1973 (button) folded on the Flop
Seat 2: wchivas (small blind) folded before Flop
Seat 3: HubertusB (big blind) folded before Flop
Seat 4: InFlames86 collected ($0.32)
Seat 5: PsBadBluff folded before Flop (didn't bet)
Seat 6: edcrfvrtgb folded before Flop (didn't bet)



PokerStars Zoom Hand #178483323497:  Hold'em No Limit ($0.02/$0.05) - 2017/11/20 21:43:22 CCT [2017/11/20 8:43:22 ET]
Table 'Donati' 6-max Seat #1 is the button
Seat 1: xarichi ($8.32 in chips) 
Seat 2: toby20121 ($5.77 in chips) 
Seat 3: rexrex932 ($5.38 in chips) 
Seat 4: HubertusB ($4.84 in chips) 
Seat 5: Polypops ($14.24 in chips) 
Seat 6: leo08238118 ($5 in chips) 
toby20121: posts small blind $0.02
rexrex932: posts big blind $0.05
*** HOLE CARDS ***
Dealt to HubertusB [9h 6d]
HubertusB: folds 
Polypops: folds 
leo08238118: folds 
xarichi: folds 
toby20121: folds 
Uncalled bet ($0.03) returned to rexrex932
rexrex932 collected $0.04 from pot
rexrex932: doesn't show hand 
*** SUMMARY ***
Total pot $0.04 | Rake $0 
Seat 1: xarichi (button) folded before Flop (didn't bet)
Seat 2: toby20121 (small blind) folded before Flop
Seat 3: rexrex932 (big blind) collected ($0.04)
Seat 4: HubertusB folded before Flop (didn't bet)
Seat 5: Polypops folded before Flop (didn't bet)
Seat 6: leo08238118 folded before Flop (didn't bet)



PokerStars Zoom Hand #178483326428:  Hold'em No Limit ($0.02/$0.05) - 2017/11/20 21:43:28 CCT [2017/11/20 8:43:28 ET]
Table 'Donati' 6-max Seat #1 is the button
Seat 1: HubertusB ($4.84 in chips) 
Seat 2: PsBadBluff ($11.55 in chips) 
Seat 3: collapse.n1 ($5 in chips) 
Seat 4: Pokerjeka999 ($6.41 in chips) 
Seat 5: InFlames86 ($5 in chips) 
Seat 6: oleg777886 ($5.31 in chips) 
PsBadBluff: posts small blind $0.02
collapse.n1: posts big blind $0.05
*** HOLE CARDS ***
Dealt to HubertusB [Qd 4s]
Pokerjeka999: folds 
InFlames86: folds 
oleg777886: folds 
HubertusB: raises $0.05 to $0.10
PsBadBluff: folds 
collapse.n1: folds 
Uncalled bet ($0.05) returned to HubertusB
HubertusB collected $0.12 from pot
HubertusB: doesn't show hand 
*** SUMMARY ***
Total pot $0.12 | Rake $0 
Seat 1: HubertusB (button) collected ($0.12)
Seat 2: PsBadBluff (small blind) folded before Flop
Seat 3: collapse.n1 (big blind) folded before Flop
Seat 4: Pokerjeka999 folded before Flop (didn't bet)
Seat 5: InFlames86 folded before Flop (didn't bet)
Seat 6: oleg777886 folded before Flop (didn't bet)



PokerStars Zoom Hand #178483337733:  Hold'em No Limit ($0.02/$0.05) - 2017/11/20 21:43:51 CCT [2017/11/20 8:43:51 ET]
Table 'Donati' 6-max Seat #1 is the button
Seat 1: sw11223 ($5.79 in chips) 
Seat 2: MrLegionCZ ($4.79 in chips) 
Seat 3: misara78 ($3.47 in chips) 
Seat 4: TIAGO-NATANA ($4.95 in chips) 
Seat 5: eg1775 ($7.25 in chips) 
Seat 6: HubertusB ($4.89 in chips) 
MrLegionCZ: posts small blind $0.02
misara78: posts big blind $0.05
*** HOLE CARDS ***
Dealt to HubertusB [6h Js]
TIAGO-NATANA: folds 
eg1775: folds 
HubertusB: folds 
sw11223: raises $0.10 to $0.15
MrLegionCZ: folds 
misara78: folds 
Uncalled bet ($0.10) returned to sw11223
sw11223 collected $0.12 from pot
sw11223: doesn't show hand 
*** SUMMARY ***
Total pot $0.12 | Rake $0 
Seat 1: sw11223 (button) collected ($0.12)
Seat 2: MrLegionCZ (small blind) folded before Flop
Seat 3: misara78 (big blind) folded before Flop
Seat 4: TIAGO-NATANA folded before Flop (didn't bet)
Seat 5: eg1775 folded before Flop (didn't bet)
Seat 6: HubertusB folded before Flop (didn't bet)



PokerStars Zoom Hand #178483334218:  Hold'em No Limit ($0.02/$0.05) - 2017/11/20 21:43:44 CCT [2017/11/20 8:43:44 ET]
Table 'Donati' 6-max Seat #1 is the button
Seat 1: IrenVasya ($12.30 in chips) 
Seat 2: HubertusB ($4.91 in chips) 
Seat 3: Malinka8663 ($1.60 in chips) 
Seat 4: KKrtva ($5 in chips) 
Seat 5: bob185 ($4.91 in chips) 
Seat 6: leo08238118 ($5.02 in chips) 
HubertusB: posts small blind $0.02
Malinka8663: posts big blind $0.05
*** HOLE CARDS ***
Dealt to HubertusB [2d Qc]
KKrtva: folds 
bob185: raises $0.10 to $0.15
leo08238118: folds 
IrenVasya: calls $0.15
HubertusB: folds 
Malinka8663: folds 
*** FLOP *** [8c 4s 6d]
bob185: bets $0.25
IrenVasya: calls $0.25
*** TURN *** [8c 4s 6d] [6s]
bob185: bets $0.58
IrenVasya: folds 
Uncalled bet ($0.58) returned to bob185
bob185 collected $0.83 from pot
bob185: doesn't show hand 
*** SUMMARY ***
Total pot $0.87 | Rake $0.04 
Board [8c 4s 6d 6s]
Seat 1: IrenVasya (button) folded on the Turn
Seat 2: HubertusB (small blind) folded before Flop
Seat 3: Malinka8663 (big blind) folded before Flop
Seat 4: KKrtva folded before Flop (didn't bet)
Seat 5: bob185 collected ($0.83)
Seat 6: leo08238118 folded before Flop (didn't bet)



PokerStars Zoom Hand #178483311798:  Hold'em No Limit ($0.02/$0.05) - 2017/11/20 21:42:58 CCT [2017/11/20 8:42:58 ET]
Table 'Donati' 6-max Seat #1 is the button
Seat 1: Hyena777210 ($6.17 in chips) 
Seat 2: DimanFlrrr ($2.11 in chips) 
Seat 3: acidwav ($2.50 in chips) 
Seat 4: HubertusB ($4.89 in chips) 
Seat 5: Nicosan.ru ($1.05 in chips) 
Seat 6: SLuTxTReMe ($6.05 in chips) 
DimanFlrrr: posts small blind $0.02
acidwav: posts big blind $0.05
*** HOLE CARDS ***
Dealt to HubertusB [Td 8d]
HubertusB: folds 
Nicosan.ru: folds 
SLuTxTReMe: folds 
Hyena777210: folds 
DimanFlrrr: calls $0.03
acidwav: checks 
*** FLOP *** [Jc Qc 7h]
DimanFlrrr: bets $0.05
acidwav: calls $0.05
*** TURN *** [Jc Qc 7h] [Jh]
DimanFlrrr: checks 
acidwav: checks 
*** RIVER *** [Jc Qc 7h Jh] [6d]
DimanFlrrr: checks 
acidwav: checks 
*** SHOW DOWN ***
DimanFlrrr: shows [9d Kd] (a pair of Jacks)
acidwav: mucks hand 
DimanFlrrr collected $0.19 from pot
*** SUMMARY ***
Total pot $0.20 | Rake $0.01 
Board [Jc Qc 7h Jh 6d]
Seat 1: Hyena777210 (button) folded before Flop (didn't bet)
Seat 2: DimanFlrrr (small blind) showed [9d Kd] and won ($0.19) with a pair of Jacks
Seat 3: acidwav (big blind) mucked [8h 9c]
Seat 4: HubertusB folded before Flop (didn't bet)
Seat 5: Nicosan.ru folded before Flop (didn't bet)
Seat 6: SLuTxTReMe folded before Flop (didn't bet)



PokerStars Zoom Hand #178483340697:  Hold'em No Limit ($0.02/$0.05) - 2017/11/20 21:43:57 CCT [2017/11/20 8:43:57 ET]
Table 'Donati' 6-max Seat #1 is the button
Seat 1: averzia ($5 in chips) 
Seat 2: DonBorleone7 ($7.78 in chips) 
Seat 3: eagle2030 ($5.16 in chips) 
Seat 4: AYE_RUSSIAN ($5 in chips) 
Seat 5: HubertusB ($4.89 in chips) 
Seat 6: wchivas ($5.20 in chips) 
DonBorleone7: posts small blind $0.02
eagle2030: posts big blind $0.05
*** HOLE CARDS ***
Dealt to HubertusB [7h Kc]
AYE_RUSSIAN: folds 
HubertusB: folds 
wchivas: raises $0.10 to $0.15
averzia: folds 
DonBorleone7: folds 
eagle2030: calls $0.10
*** FLOP *** [5h Qs Ks]
eagle2030: checks 
wchivas: bets $0.18
eagle2030: folds 
Uncalled bet ($0.18) returned to wchivas
wchivas collected $0.31 from pot
wchivas: doesn't show hand 
*** SUMMARY ***
Total pot $0.32 | Rake $0.01 
Board [5h Qs Ks]
Seat 1: averzia (button) folded before Flop (didn't bet)
Seat 2: DonBorleone7 (small blind) folded before Flop
Seat 3: eagle2030 (big blind) folded on the Flop
Seat 4: AYE_RUSSIAN folded before Flop (didn't bet)
Seat 5: HubertusB folded before Flop (didn't bet)
Seat 6: wchivas collected ($0.31)



PokerStars Zoom Hand #178483343112:  Hold'em No Limit ($0.02/$0.05) - 2017/11/20 21:44:02 CCT [2017/11/20 8:44:02 ET]
Table 'Donati' 6-max Seat #1 is the button
Seat 1: svansong ($5.24 in chips) 
Seat 2: Anikin44 ($16.23 in chips) 
Seat 3: konstantinma ($2.50 in chips) 
Seat 4: HubertusB ($4.89 in chips) 
Seat 5: MrNobody346 ($5.16 in chips) 
Seat 6: MPMTL ($3.92 in chips) 
Anikin44: posts small blind $0.02
konstantinma: posts big blind $0.05
*** HOLE CARDS ***
Dealt to HubertusB [Kd Qc]
HubertusB: raises $0.05 to $0.10
MrNobody346: folds 
MPMTL: folds 
svansong: calls $0.10
Anikin44: calls $0.08
konstantinma: calls $0.05
*** FLOP *** [Qs 8h 2s]
Anikin44: checks 
konstantinma: checks 
HubertusB: bets $0.25
svansong: calls $0.25
Anikin44: folds 
konstantinma: folds 
*** TURN *** [Qs 8h 2s] [3d]
HubertusB: bets $0.75
svansong: calls $0.75
*** RIVER *** [Qs 8h 2s 3d] [Ac]
HubertusB: checks 
svansong: checks 
*** SHOW DOWN ***
HubertusB: shows [Kd Qc] (a pair of Queens)
svansong: mucks hand 
HubertusB collected $2.30 from pot
*** SUMMARY ***
Total pot $2.40 | Rake $0.10 
Board [Qs 8h 2s 3d Ac]
Seat 1: svansong (button) mucked [8s 7s]
Seat 2: Anikin44 (small blind) folded on the Flop
Seat 3: konstantinma (big blind) folded on the Flop
Seat 4: HubertusB showed [Kd Qc] and won ($2.30) with a pair of Queens
Seat 5: MrNobody346 folded before Flop (didn't bet)
Seat 6: MPMTL folded before Flop (didn't bet)



PokerStars Zoom Hand #178483375843:  Hold'em No Limit ($0.02/$0.05) - 2017/11/20 21:45:09 CCT [2017/11/20 8:45:09 ET]
Table 'Donati' 6-max Seat #1 is the button
Seat 1: HubertusB ($6.04 in chips) 
Seat 2: Clinmd ($4.92 in chips) 
Seat 3: eyadoker ($10.62 in chips) 
Seat 4: TENEBRIS 666 ($4.50 in chips) 
Seat 5: Bot1729 ($5.19 in chips) 
Seat 6: TheRoyalFlush ($5.92 in chips) 
Clinmd: posts small blind $0.02
eyadoker: posts big blind $0.05
*** HOLE CARDS ***
Dealt to HubertusB [Ah 4s]
TENEBRIS 666: folds 
Bot1729: folds 
TheRoyalFlush: raises $0.10 to $0.15
HubertusB: folds 
Clinmd: folds 
eyadoker: folds 
Uncalled bet ($0.10) returned to TheRoyalFlush
TheRoyalFlush collected $0.12 from pot
TheRoyalFlush: doesn't show hand 
*** SUMMARY ***
Total pot $0.12 | Rake $0 
Seat 1: HubertusB (button) folded before Flop (didn't bet)
Seat 2: Clinmd (small blind) folded before Flop
Seat 3: eyadoker (big blind) folded before Flop
Seat 4: TENEBRIS 666 folded before Flop (didn't bet)
Seat 5: Bot1729 folded before Flop (didn't bet)
Seat 6: TheRoyalFlush collected ($0.12)



PokerStars Zoom Hand #178483381235:  Hold'em No Limit ($0.02/$0.05) - 2017/11/20 21:45:20 CCT [2017/11/20 8:45:20 ET]
Table 'Donati' 6-max Seat #1 is the button
Seat 1: falcao991 ($4.96 in chips) 
Seat 2: HubertusB ($6.04 in chips) 
Seat 3: PsBadBluff ($9.13 in chips) 
Seat 4: baggelisdr1 ($7.11 in chips) 
Seat 5: reeqar ($5.15 in chips) 
Seat 6: Valdis1978 ($6.10 in chips) 
HubertusB: posts small blind $0.02
PsBadBluff: posts big blind $0.05
*** HOLE CARDS ***
Dealt to HubertusB [3s 2s]
baggelisdr1: folds 
reeqar: folds 
Valdis1978: raises $0.10 to $0.15
falcao991: folds 
HubertusB: folds 
PsBadBluff: calls $0.10
*** FLOP *** [Ad 2c 6d]
PsBadBluff: checks 
Valdis1978: bets $0.20
PsBadBluff: folds 
Uncalled bet ($0.20) returned to Valdis1978
Valdis1978 collected $0.31 from pot
Valdis1978: doesn't show hand 
*** SUMMARY ***
Total pot $0.32 | Rake $0.01 
Board [Ad 2c 6d]
Seat 1: falcao991 (button) folded before Flop (didn't bet)
Seat 2: HubertusB (small blind) folded before Flop
Seat 3: PsBadBluff (big blind) folded on the Flop
Seat 4: baggelisdr1 folded before Flop (didn't bet)
Seat 5: reeqar folded before Flop (didn't bet)
Seat 6: Valdis1978 collected ($0.31)



PokerStars Zoom Hand #178483370393:  Hold'em No Limit ($0.02/$0.05) - 2017/11/20 21:44:58 CCT [2017/11/20 8:44:58 ET]
Table 'Donati' 6-max Seat #1 is the button
Seat 1: xex_serg ($10.21 in chips) 
Seat 2: RiSk.Fortune ($5 in chips) 
Seat 3: HubertusB ($6.09 in chips) 
Seat 4: Knaix ($7.89 in chips) 
Seat 5: SLuTxTReMe ($6.11 in chips) 
Seat 6: kaesspo ($17.09 in chips) 
RiSk.Fortune: posts small blind $0.02
HubertusB: posts big blind $0.05
*** HOLE CARDS ***
Dealt to HubertusB [4c 7h]
Knaix: folds 
SLuTxTReMe: folds 
kaesspo: folds 
xex_serg: raises $0.06 to $0.11
RiSk.Fortune: calls $0.09
HubertusB: folds 
*** FLOP *** [2d 9s Kh]
RiSk.Fortune: checks 
xex_serg: bets $0.14
RiSk.Fortune: calls $0.14
*** TURN *** [2d 9s Kh] [Qc]
RiSk.Fortune: bets $0.30
xex_serg: calls $0.30
*** RIVER *** [2d 9s Kh Qc] [Js]
RiSk.Fortune: checks 
xex_serg: bets $0.60
RiSk.Fortune: folds 
Uncalled bet ($0.60) returned to xex_serg
xex_serg collected $1.10 from pot
xex_serg: doesn't show hand 
*** SUMMARY ***
Total pot $1.15 | Rake $0.05 
Board [2d 9s Kh Qc Js]
Seat 1: xex_serg (button) collected ($1.10)
Seat 2: RiSk.Fortune (small blind) folded on the River
Seat 3: HubertusB (big blind) folded before Flop
Seat 4: Knaix folded before Flop (didn't bet)
Seat 5: SLuTxTReMe folded before Flop (didn't bet)
Seat 6: kaesspo folded before Flop (didn't bet)



PokerStars Zoom Hand #178483384630:  Hold'em No Limit ($0.02/$0.05) - 2017/11/20 21:45:27 CCT [2017/11/20 8:45:27 ET]
Table 'Donati' 6-max Seat #1 is the button
Seat 1: leo08238118 ($9.67 in chips) 
Seat 2: 500Ang ($5 in chips) 
Seat 3: FriskyBear ($5.71 in chips) 
Seat 4: reeqar ($5.15 in chips) 
Seat 5: HubertusB ($6.02 in chips) 
Seat 6: Milka222 ($4.62 in chips) 
500Ang: posts small blind $0.02
FriskyBear: posts big blind $0.05
*** HOLE CARDS ***
Dealt to HubertusB [4h Qd]
reeqar: folds 
HubertusB has timed out
HubertusB: folds 
Milka222: raises $0.05 to $0.10
leo08238118: raises $0.30 to $0.40
500Ang: folds 
FriskyBear: folds 
Milka222: folds 
Uncalled bet ($0.30) returned to leo08238118
leo08238118 collected $0.27 from pot
leo08238118: doesn't show hand 
*** SUMMARY ***
Total pot $0.27 | Rake $0 
Seat 1: leo08238118 (button) collected ($0.27)
Seat 2: 500Ang (small blind) folded before Flop
Seat 3: FriskyBear (big blind) folded before Flop
Seat 4: reeqar folded before Flop (didn't bet)
Seat 5: HubertusB folded before Flop (didn't bet)
Seat 6: Milka222 folded before Flop



PokerStars Zoom Hand #178483397049:  Hold'em No Limit ($0.02/$0.05) - 2017/11/20 21:45:52 CCT [2017/11/20 8:45:52 ET]
Table 'Donati' 6-max Seat #1 is the button
Seat 1: HubertusB ($6.02 in chips) 
Seat 2: ItWasDuke ($10.05 in chips) 
Seat 3: Sumow ($5.21 in chips) 
Seat 4: Valentine40 ($0.77 in chips) 
Seat 5: Bossnia007 ($7.03 in chips) 
Seat 6: falcao991 ($4.98 in chips) 
ItWasDuke: posts small blind $0.02
Sumow: posts big blind $0.05
*** HOLE CARDS ***
Dealt to HubertusB [6c Ah]
Valentine40: folds 
Bossnia007: raises $0.10 to $0.15
falcao991: folds 
HubertusB: folds 
ItWasDuke: raises $0.35 to $0.50
Sumow: folds 
Bossnia007: folds 
Uncalled bet ($0.35) returned to ItWasDuke
ItWasDuke collected $0.35 from pot
ItWasDuke: doesn't show hand 
*** SUMMARY ***
Total pot $0.35 | Rake $0 
Seat 1: HubertusB (button) folded before Flop (didn't bet)
Seat 2: ItWasDuke (small blind) collected ($0.35)
Seat 3: Sumow (big blind) folded before Flop
Seat 4: Valentine40 folded before Flop (didn't bet)
Seat 5: Bossnia007 folded before Flop
Seat 6: falcao991 folded before Flop (didn't bet)



PokerStars Zoom Hand #178483412026:  Hold'em No Limit ($0.02/$0.05) - 2017/11/20 21:46:23 CCT [2017/11/20 8:46:23 ET]
Table 'Donati' 6-max Seat #1 is the button
Seat 1: piets ($9.09 in chips) 
Seat 2: HubertusB ($5.97 in chips) 
Seat 3: Anikin44 ($16 in chips) 
Seat 4: Poker sta705 ($5.13 in chips) 
Seat 5: fatinio914 ($10.44 in chips) 
Seat 6: InFlames86 ($6.78 in chips) 
HubertusB: posts small blind $0.02
Anikin44: posts big blind $0.05
*** HOLE CARDS ***
Dealt to HubertusB [2c 7c]
Poker sta705: folds 
fatinio914: raises $0.10 to $0.15
InFlames86: folds 
piets: folds 
HubertusB: folds 
Anikin44: folds 
Uncalled bet ($0.10) returned to fatinio914
fatinio914 collected $0.12 from pot
fatinio914: doesn't show hand 
*** SUMMARY ***
Total pot $0.12 | Rake $0 
Seat 1: piets (button) folded before Flop (didn't bet)
Seat 2: HubertusB (small blind) folded before Flop
Seat 3: Anikin44 (big blind) folded before Flop
Seat 4: Poker sta705 folded before Flop (didn't bet)
Seat 5: fatinio914 collected ($0.12)
Seat 6: InFlames86 folded before Flop (didn't bet)



PokerStars Zoom Hand #178483409624:  Hold'em No Limit ($0.02/$0.05) - 2017/11/20 21:46:18 CCT [2017/11/20 8:46:18 ET]
Table 'Donati' 6-max Seat #1 is the button
Seat 1: WangHaoWei ($5.83 in chips) 
Seat 2: spirtus81 ($5.62 in chips) 
Seat 3: Brunazza8$8 ($3.96 in chips) 
Seat 4: HubertusB ($5.97 in chips) 
Seat 5: botrobot777 ($6.19 in chips) 
Seat 6: Kutis33 ($13.83 in chips) 
spirtus81: posts small blind $0.02
Brunazza8$8: posts big blind $0.05
*** HOLE CARDS ***
Dealt to HubertusB [6c Jd]
HubertusB: folds 
botrobot777: folds 
Kutis33: raises $0.10 to $0.15
WangHaoWei: folds 
spirtus81: folds 
Brunazza8$8: calls $0.10
*** FLOP *** [9d 3c Qd]
Brunazza8$8: checks 
Kutis33: bets $0.20
Brunazza8$8: folds 
Uncalled bet ($0.20) returned to Kutis33
Kutis33 collected $0.31 from pot
Kutis33: doesn't show hand 
*** SUMMARY ***
Total pot $0.32 | Rake $0.01 
Board [9d 3c Qd]
Seat 1: WangHaoWei (button) folded before Flop (didn't bet)
Seat 2: spirtus81 (small blind) folded before Flop
Seat 3: Brunazza8$8 (big blind) folded on the Flop
Seat 4: HubertusB folded before Flop (didn't bet)
Seat 5: botrobot777 folded before Flop (didn't bet)
Seat 6: Kutis33 collected ($0.31)



PokerStars Zoom Hand #178483406696:  Hold'em No Limit ($0.02/$0.05) - 2017/11/20 21:46:12 CCT [2017/11/20 8:46:12 ET]
Table 'Donati' 6-max Seat #1 is the button
Seat 1: kostet100 ($5 in chips) 
Seat 2: raiden1998 ($5.65 in chips) 
Seat 3: yumi2003 ($4.27 in chips) 
Seat 4: M.Govorkov ($5.51 in chips) 
Seat 5: kaesspo ($17.09 in chips) 
Seat 6: HubertusB ($5.97 in chips) 
raiden1998: posts small blind $0.02
yumi2003: posts big blind $0.05
*** HOLE CARDS ***
Dealt to HubertusB [4c 8h]
M.Govorkov: folds 
kaesspo: folds 
HubertusB: folds 
kostet100: raises $0.05 to $0.10
raiden1998: folds 
yumi2003: calls $0.05
*** FLOP *** [3s Qd 7d]
yumi2003: checks 
kostet100: checks 
*** TURN *** [3s Qd 7d] [4d]
yumi2003: checks 
kostet100: bets $0.05
yumi2003: calls $0.05
*** RIVER *** [3s Qd 7d 4d] [Ts]
yumi2003: checks 
kostet100: checks 
*** SHOW DOWN ***
yumi2003: shows [6h 6d] (a pair of Sixes)
kostet100: shows [9c Td] (a pair of Tens)
kostet100 collected $0.31 from pot
*** SUMMARY ***
Total pot $0.32 | Rake $0.01 
Board [3s Qd 7d 4d Ts]
Seat 1: kostet100 (button) showed [9c Td] and won ($0.31) with a pair of Tens
Seat 2: raiden1998 (small blind) folded before Flop
Seat 3: yumi2003 (big blind) showed [6h 6d] and lost with a pair of Sixes
Seat 4: M.Govorkov folded before Flop (didn't bet)
Seat 5: kaesspo folded before Flop (didn't bet)
Seat 6: HubertusB folded before Flop (didn't bet)



PokerStars Zoom Hand #178483403797:  Hold'em No Limit ($0.02/$0.05) - 2017/11/20 21:46:06 CCT [2017/11/20 8:46:06 ET]
Table 'Donati' 6-max Seat #1 is the button
Seat 1: Bot1729 ($5.19 in chips) 
Seat 2: FriskyBear ($5.93 in chips) 
Seat 3: HubertusB ($6.02 in chips) 
Seat 4: RenningStone ($15 in chips) 
Seat 5: annita44 ($5.10 in chips) 
Seat 6: zzpotter ($6.06 in chips) 
FriskyBear: posts small blind $0.02
HubertusB: posts big blind $0.05
*** HOLE CARDS ***
Dealt to HubertusB [7s 5c]
RenningStone: raises $0.10 to $0.15
annita44: folds 
zzpotter: raises $0.30 to $0.45
Bot1729: folds 
FriskyBear: folds 
HubertusB: folds 
RenningStone: calls $0.30
*** FLOP *** [9h 3s 6c]
RenningStone: checks 
zzpotter: bets $0.51
RenningStone: calls $0.51
*** TURN *** [9h 3s 6c] [4d]
RenningStone: checks 
zzpotter: bets $1.05
RenningStone: calls $1.05
*** RIVER *** [9h 3s 6c 4d] [Kc]
RenningStone: checks 
zzpotter: bets $4.05 and is all-in
RenningStone: calls $4.05
*** SHOW DOWN ***
zzpotter: shows [Ac Qc] (high card Ace)
RenningStone: shows [Qh As] (high card Ace)
RenningStone collected $5.84 from pot
zzpotter collected $5.84 from pot
*** SUMMARY ***
Total pot $12.19 | Rake $0.51 
Board [9h 3s 6c 4d Kc]
Seat 1: Bot1729 (button) folded before Flop (didn't bet)
Seat 2: FriskyBear (small blind) folded before Flop
Seat 3: HubertusB (big blind) folded before Flop
Seat 4: RenningStone showed [Qh As] and won ($5.84) with high card Ace
Seat 5: annita44 folded before Flop (didn't bet)
Seat 6: zzpotter showed [Ac Qc] and won ($5.84) with high card Ace



PokerStars Zoom Hand #178483417401:  Hold'em No Limit ($0.02/$0.05) - 2017/11/20 21:46:34 CCT [2017/11/20 8:46:34 ET]
Table 'Donati' 6-max Seat #1 is the button
Seat 1: Ericxd1988 ($4.55 in chips) 
Seat 2: greyk1n ($5 in chips) 
Seat 3: HubertusB ($5.95 in chips) 
Seat 4: Mike3stakana ($5.14 in chips) 
Seat 5: KKrtva ($5.13 in chips) 
Seat 6: YABALAK ($2.91 in chips) 
greyk1n: posts small blind $0.02
HubertusB: posts big blind $0.05
*** HOLE CARDS ***
Dealt to HubertusB [Jc Qc]
Mike3stakana: raises $0.10 to $0.15
KKrtva: folds 
YABALAK: folds 
Ericxd1988: folds 
greyk1n: folds 
HubertusB: folds 
Uncalled bet ($0.10) returned to Mike3stakana
Mike3stakana collected $0.12 from pot
Mike3stakana: doesn't show hand 
*** SUMMARY ***
Total pot $0.12 | Rake $0 
Seat 1: Ericxd1988 (button) folded before Flop (didn't bet)
Seat 2: greyk1n (small blind) folded before Flop
Seat 3: HubertusB (big blind) folded before Flop
Seat 4: Mike3stakana collected ($0.12)
Seat 5: KKrtva folded before Flop (didn't bet)
Seat 6: YABALAK folded before Flop (didn't bet)



PokerStars Zoom Hand #178483414943:  Hold'em No Limit ($0.02/$0.05) - 2017/11/20 21:46:29 CCT [2017/11/20 8:46:29 ET]
Table 'Donati' 6-max Seat #1 is the button
Seat 1: SLuTxTReMe ($5.32 in chips) 
Seat 2: maruika ($5.19 in chips) 
Seat 3: 1ncognito88 ($5.14 in chips) 
Seat 4: Predator1447 ($9.70 in chips) 
Seat 5: alemoum ($5 in chips) 
Seat 6: HubertusB ($5.95 in chips) 
maruika: posts small blind $0.02
1ncognito88: posts big blind $0.05
*** HOLE CARDS ***
Dealt to HubertusB [8s 2h]
Predator1447: folds 
alemoum: folds 
HubertusB: folds 
SLuTxTReMe: raises $0.07 to $0.12
maruika: folds 
1ncognito88: calls $0.07
*** FLOP *** [Ac 5c Kc]
1ncognito88: bets $0.30
SLuTxTReMe: calls $0.30
*** TURN *** [Ac 5c Kc] [2d]
1ncognito88: checks 
SLuTxTReMe: checks 
*** RIVER *** [Ac 5c Kc 2d] [Jh]
1ncognito88: bets $0.45
SLuTxTReMe: calls $0.45
*** SHOW DOWN ***
1ncognito88: shows [Kh Td] (a pair of Kings)
SLuTxTReMe: shows [Ks Jc] (two pair, Kings and Jacks)
SLuTxTReMe collected $1.69 from pot
*** SUMMARY ***
Total pot $1.76 | Rake $0.07 
Board [Ac 5c Kc 2d Jh]
Seat 1: SLuTxTReMe (button) showed [Ks Jc] and won ($1.69) with two pair, Kings and Jacks
Seat 2: maruika (small blind) folded before Flop
Seat 3: 1ncognito88 (big blind) showed [Kh Td] and lost with a pair of Kings
Seat 4: Predator1447 folded before Flop (didn't bet)
Seat 5: alemoum folded before Flop (didn't bet)
Seat 6: HubertusB folded before Flop (didn't bet)



PokerStars Zoom Hand #178483425297:  Hold'em No Limit ($0.02/$0.05) - 2017/11/20 21:46:50 CCT [2017/11/20 8:46:50 ET]
Table 'Donati' 6-max Seat #1 is the button
Seat 1: chester8676 ($7.08 in chips) 
Seat 2: Casteel92 ($6.51 in chips) 
Seat 3: eagle2030 ($5.38 in chips) 
Seat 4: cobzon35 ($3.21 in chips) 
Seat 5: HubertusB ($5.90 in chips) 
Seat 6: DudinAndrey ($5 in chips) 
Casteel92: posts small blind $0.02
eagle2030: posts big blind $0.05
*** HOLE CARDS ***
Dealt to HubertusB [Tc Th]
cobzon35: folds 
HubertusB: raises $0.05 to $0.10
DudinAndrey: folds 
chester8676: folds 
Casteel92: folds 
eagle2030: calls $0.05
*** FLOP *** [Ac Kh 8d]
eagle2030: checks 
HubertusB: bets $0.15
eagle2030: calls $0.15
*** TURN *** [Ac Kh 8d] [7d]
eagle2030: checks 
HubertusB: checks 
*** RIVER *** [Ac Kh 8d 7d] [Qc]
eagle2030: checks 
HubertusB: checks 
*** SHOW DOWN ***
eagle2030: shows [Jc Qd] (a pair of Queens)
HubertusB: mucks hand 
eagle2030 collected $0.50 from pot
*** SUMMARY ***
Total pot $0.52 | Rake $0.02 
Board [Ac Kh 8d 7d Qc]
Seat 1: chester8676 (button) folded before Flop (didn't bet)
Seat 2: Casteel92 (small blind) folded before Flop
Seat 3: eagle2030 (big blind) showed [Jc Qd] and won ($0.50) with a pair of Queens
Seat 4: cobzon35 folded before Flop (didn't bet)
Seat 5: HubertusB mucked [Tc Th]
Seat 6: DudinAndrey folded before Flop (didn't bet)



PokerStars Zoom Hand #178483446392:  Hold'em No Limit ($0.02/$0.05) - 2017/11/20 21:47:33 CCT [2017/11/20 8:47:33 ET]
Table 'Donati' 6-max Seat #1 is the button
Seat 1: HubertusB ($5.65 in chips) 
Seat 2: StealSteeler ($5.07 in chips) 
Seat 3: tomsal0157 ($5.54 in chips) 
Seat 4: MoreRakePls1 ($8 in chips) 
Seat 5: SskyAngel ($16.14 in chips) 
Seat 6: rack1777 ($5 in chips) 
StealSteeler: posts small blind $0.02
tomsal0157: posts big blind $0.05
*** HOLE CARDS ***
Dealt to HubertusB [8h Kd]
MoreRakePls1: folds 
SskyAngel: folds 
rack1777: folds 
HubertusB: folds 
StealSteeler: folds 
Uncalled bet ($0.03) returned to tomsal0157
tomsal0157 collected $0.04 from pot
tomsal0157: doesn't show hand 
*** SUMMARY ***
Total pot $0.04 | Rake $0 
Seat 1: HubertusB (button) folded before Flop (didn't bet)
Seat 2: StealSteeler (small blind) folded before Flop
Seat 3: tomsal0157 (big blind) collected ($0.04)
Seat 4: MoreRakePls1 folded before Flop (didn't bet)
Seat 5: SskyAngel folded before Flop (didn't bet)
Seat 6: rack1777 folded before Flop (didn't bet)



PokerStars Zoom Hand #178483454699:  Hold'em No Limit ($0.02/$0.05) - 2017/11/20 21:47:50 CCT [2017/11/20 8:47:50 ET]
Table 'Donati' 6-max Seat #1 is the button
Seat 1: eagle2030 ($5.63 in chips) 
Seat 2: HubertusB ($5.65 in chips) 
Seat 3: nckvrbk ($5.13 in chips) 
Seat 4: Ebleco ($1.72 in chips) 
Seat 5: serhio77 ($8.29 in chips) 
Seat 6: nappiperse ($7.56 in chips) 
HubertusB: posts small blind $0.02
nckvrbk: posts big blind $0.05
*** HOLE CARDS ***
Dealt to HubertusB [Qh 5c]
Ebleco: folds 
serhio77: folds 
nappiperse: folds 
eagle2030: folds 
HubertusB: folds 
Uncalled bet ($0.03) returned to nckvrbk
nckvrbk collected $0.04 from pot
nckvrbk: doesn't show hand 
*** SUMMARY ***
Total pot $0.04 | Rake $0 
Seat 1: eagle2030 (button) folded before Flop (didn't bet)
Seat 2: HubertusB (small blind) folded before Flop
Seat 3: nckvrbk (big blind) collected ($0.04)
Seat 4: Ebleco folded before Flop (didn't bet)
Seat 5: serhio77 folded before Flop (didn't bet)
Seat 6: nappiperse folded before Flop (didn't bet)



PokerStars Zoom Hand #178483460546:  Hold'em No Limit ($0.02/$0.05) - 2017/11/20 21:48:02 CCT [2017/11/20 8:48:02 ET]
Table 'Donati' 6-max Seat #1 is the button
Seat 1: quest2k ($10.84 in chips) 
Seat 2: Bossmanlee00 ($5.69 in chips) 
Seat 3: chester8676 ($5.19 in chips) 
Seat 4: DimanFlrrr ($2.33 in chips) 
Seat 5: Bot1729 ($7.71 in chips) 
Seat 6: HubertusB ($5.63 in chips) 
Bossmanlee00: posts small blind $0.02
chester8676: posts big blind $0.05
*** HOLE CARDS ***
Dealt to HubertusB [Ts 7s]
DimanFlrrr: folds 
Bot1729: folds 
HubertusB: raises $0.05 to $0.10
quest2k: folds 
Bossmanlee00: folds 
chester8676: folds 
Uncalled bet ($0.05) returned to HubertusB
HubertusB collected $0.12 from pot
HubertusB: doesn't show hand 
*** SUMMARY ***
Total pot $0.12 | Rake $0 
Seat 1: quest2k (button) folded before Flop (didn't bet)
Seat 2: Bossmanlee00 (small blind) folded before Flop
Seat 3: chester8676 (big blind) folded before Flop
Seat 4: DimanFlrrr folded before Flop (didn't bet)
Seat 5: Bot1729 folded before Flop (didn't bet)
Seat 6: HubertusB collected ($0.12)



PokerStars Zoom Hand #178483468762:  Hold'em No Limit ($0.02/$0.05) - 2017/11/20 21:48:19 CCT [2017/11/20 8:48:19 ET]
Table 'Donati' 6-max Seat #1 is the button
Seat 1: RiSk.Fortune ($5.57 in chips) 
Seat 2: Ericxd1988 ($4.97 in chips) 
Seat 3: Bot1729 ($7.71 in chips) 
Seat 4: bob185 ($4.01 in chips) 
Seat 5: HubertusB ($5.70 in chips) 
Seat 6: danjmekeru ($5.20 in chips) 
Ericxd1988: posts small blind $0.02
Bot1729: posts big blind $0.05
*** HOLE CARDS ***
Dealt to HubertusB [Ad 9h]
bob185: folds 
HubertusB: folds 
danjmekeru: folds 
RiSk.Fortune: folds 
Ericxd1988: raises $0.10 to $0.15
Bot1729: folds 
Uncalled bet ($0.10) returned to Ericxd1988
Ericxd1988 collected $0.10 from pot
Ericxd1988: doesn't show hand 
*** SUMMARY ***
Total pot $0.10 | Rake $0 
Seat 1: RiSk.Fortune (button) folded before Flop (didn't bet)
Seat 2: Ericxd1988 (small blind) collected ($0.10)
Seat 3: Bot1729 (big blind) folded before Flop
Seat 4: bob185 folded before Flop (didn't bet)
Seat 5: HubertusB folded before Flop (didn't bet)
Seat 6: danjmekeru folded before Flop (didn't bet)



PokerStars Zoom Hand #178483476752:  Hold'em No Limit ($0.02/$0.05) - 2017/11/20 21:48:35 CCT [2017/11/20 8:48:35 ET]
Table 'Donati' 6-max Seat #1 is the button
Seat 1: maxniger007 ($1.76 in chips) 
Seat 2: spirtus81 ($6.26 in chips) 
Seat 3: HubertusB ($5.70 in chips) 
Seat 4: claudiu783 ($3.78 in chips) 
Seat 5: IanMalique9 ($17.68 in chips) 
Seat 6: akazonae ($4.56 in chips) 
spirtus81: posts small blind $0.02
HubertusB: posts big blind $0.05
*** HOLE CARDS ***
Dealt to HubertusB [Ad Qs]
claudiu783: folds 
IanMalique9: folds 
akazonae: folds 
maxniger007: folds 
spirtus81: folds 
Uncalled bet ($0.03) returned to HubertusB
HubertusB collected $0.04 from pot
HubertusB: doesn't show hand 
*** SUMMARY ***
Total pot $0.04 | Rake $0 
Seat 1: maxniger007 (button) folded before Flop (didn't bet)
Seat 2: spirtus81 (small blind) folded before Flop
Seat 3: HubertusB (big blind) collected ($0.04)
Seat 4: claudiu783 folded before Flop (didn't bet)
Seat 5: IanMalique9 folded before Flop (didn't bet)
Seat 6: akazonae folded before Flop (didn't bet)



PokerStars Zoom Hand #178483474282:  Hold'em No Limit ($0.02/$0.05) - 2017/11/20 21:48:30 CCT [2017/11/20 8:48:30 ET]
Table 'Donati' 6-max Seat #1 is the button
Seat 1: danjmekeru ($5.20 in chips) 
Seat 2: zetlife ($5.86 in chips) 
Seat 3: djronalein ($5.12 in chips) 
Seat 4: HubertusB ($5.70 in chips) 
Seat 5: axeldada ($7.19 in chips) 
Seat 6: Vynnypoker ($8.34 in chips) 
zetlife: posts small blind $0.02
djronalein: posts big blind $0.05
*** HOLE CARDS ***
Dealt to HubertusB [4d 9h]
HubertusB: folds 
axeldada: folds 
Vynnypoker: folds 
danjmekeru: raises $0.07 to $0.12
zetlife: folds 
djronalein: folds 
Uncalled bet ($0.07) returned to danjmekeru
danjmekeru collected $0.12 from pot
danjmekeru: doesn't show hand 
*** SUMMARY ***
Total pot $0.12 | Rake $0 
Seat 1: danjmekeru (button) collected ($0.12)
Seat 2: zetlife (small blind) folded before Flop
Seat 3: djronalein (big blind) folded before Flop
Seat 4: HubertusB folded before Flop (didn't bet)
Seat 5: axeldada folded before Flop (didn't bet)
Seat 6: Vynnypoker folded before Flop (didn't bet)



PokerStars Zoom Hand #178483480256:  Hold'em No Limit ($0.02/$0.05) - 2017/11/20 21:48:42 CCT [2017/11/20 8:48:42 ET]
Table 'Donati' 6-max Seat #1 is the button
Seat 1: HubertusB ($5.72 in chips) 
Seat 2: Oliana88 ($6.95 in chips) 
Seat 3: malle09 ($5.20 in chips) 
Seat 4: shisanjin ($5.83 in chips) 
Seat 5: tomsal0157 ($7.31 in chips) 
Seat 6: Acedan1369 ($15.44 in chips) 
Oliana88: posts small blind $0.02
malle09: posts big blind $0.05
*** HOLE CARDS ***
Dealt to HubertusB [Qd 5c]
shisanjin: folds 
tomsal0157: folds 
Acedan1369: folds 
HubertusB: folds 
Oliana88: folds 
Uncalled bet ($0.03) returned to malle09
malle09 collected $0.04 from pot
malle09: doesn't show hand 
*** SUMMARY ***
Total pot $0.04 | Rake $0 
Seat 1: HubertusB (button) folded before Flop (didn't bet)
Seat 2: Oliana88 (small blind) folded before Flop
Seat 3: malle09 (big blind) collected ($0.04)
Seat 4: shisanjin folded before Flop (didn't bet)
Seat 5: tomsal0157 folded before Flop (didn't bet)
Seat 6: Acedan1369 folded before Flop (didn't bet)



PokerStars Zoom Hand #178483484721:  Hold'em No Limit ($0.02/$0.05) - 2017/11/20 21:48:51 CCT [2017/11/20 8:48:51 ET]
Table 'Donati' 6-max Seat #1 is the button
Seat 1: ProTeamjan ($2.41 in chips) 
Seat 2: HubertusB ($5.72 in chips) 
Seat 3: feRaliX ($5 in chips) 
Seat 4: baggelisdr1 ($5.46 in chips) 
Seat 5: IanMalique9 ($27.74 in chips) 
Seat 6: MrNobody346 ($9.98 in chips) 
HubertusB: posts small blind $0.02
feRaliX: posts big blind $0.05
*** HOLE CARDS ***
Dealt to HubertusB [6d Td]
baggelisdr1: raises $0.10 to $0.15
IanMalique9: folds 
MrNobody346: folds 
ProTeamjan: folds 
HubertusB: folds 
feRaliX: folds 
Uncalled bet ($0.10) returned to baggelisdr1
baggelisdr1 collected $0.12 from pot
baggelisdr1: doesn't show hand 
*** SUMMARY ***
Total pot $0.12 | Rake $0 
Seat 1: ProTeamjan (button) folded before Flop (didn't bet)
Seat 2: HubertusB (small blind) folded before Flop
Seat 3: feRaliX (big blind) folded before Flop
Seat 4: baggelisdr1 collected ($0.12)
Seat 5: IanMalique9 folded before Flop (didn't bet)
Seat 6: MrNobody346 folded before Flop (didn't bet)



PokerStars Zoom Hand #178483488167:  Hold'em No Limit ($0.02/$0.05) - 2017/11/20 21:48:58 CCT [2017/11/20 8:48:58 ET]
Table 'Donati' 6-max Seat #1 is the button
Seat 1: zikin444 ($8.89 in chips) 
Seat 2: bob185 ($3.96 in chips) 
Seat 3: PsBadBluff ($9.37 in chips) 
Seat 4: tomsal0157 ($7.31 in chips) 
Seat 5: professor375 ($1.41 in chips) 
Seat 6: HubertusB ($5.70 in chips) 
bob185: posts small blind $0.02
PsBadBluff: posts big blind $0.05
*** HOLE CARDS ***
Dealt to HubertusB [2c 3s]
tomsal0157: folds 
professor375: folds 
HubertusB: folds 
zikin444: raises $0.10 to $0.15
bob185: folds 
PsBadBluff: folds 
Uncalled bet ($0.10) returned to zikin444
zikin444 collected $0.12 from pot
zikin444: doesn't show hand 
*** SUMMARY ***
Total pot $0.12 | Rake $0 
Seat 1: zikin444 (button) collected ($0.12)
Seat 2: bob185 (small blind) folded before Flop
Seat 3: PsBadBluff (big blind) folded before Flop
Seat 4: tomsal0157 folded before Flop (didn't bet)
Seat 5: professor375 folded before Flop (didn't bet)
Seat 6: HubertusB folded before Flop (didn't bet)



PokerStars Zoom Hand #178483496105:  Hold'em No Limit ($0.02/$0.05) - 2017/11/20 21:49:14 CCT [2017/11/20 8:49:14 ET]
Table 'Donati' 6-max Seat #1 is the button
Seat 1: HubertusB ($5.65 in chips) 
Seat 2: Felix UA777 ($5.02 in chips) 
Seat 3: Terry_Ryan88 ($3.63 in chips) 
Seat 4: the_Joker'83 ($6.99 in chips) 
Seat 5: seawolf111 ($13.21 in chips) 
Seat 6: PsBadBluff ($11.47 in chips) 
Felix UA777: posts small blind $0.02
Terry_Ryan88: posts big blind $0.05
*** HOLE CARDS ***
Dealt to HubertusB [9d Qs]
the_Joker'83: folds 
seawolf111: folds 
PsBadBluff: folds 
HubertusB: raises $0.05 to $0.10
Felix UA777: folds 
Terry_Ryan88: raises $0.22 to $0.32
HubertusB: folds 
Uncalled bet ($0.22) returned to Terry_Ryan88
Terry_Ryan88 collected $0.22 from pot
Terry_Ryan88: doesn't show hand 
*** SUMMARY ***
Total pot $0.22 | Rake $0 
Seat 1: HubertusB (button) folded before Flop
Seat 2: Felix UA777 (small blind) folded before Flop
Seat 3: Terry_Ryan88 (big blind) collected ($0.22)
Seat 4: the_Joker'83 folded before Flop (didn't bet)
Seat 5: seawolf111 folded before Flop (didn't bet)
Seat 6: PsBadBluff folded before Flop (didn't bet)



PokerStars Zoom Hand #178483471795:  Hold'em No Limit ($0.02/$0.05) - 2017/11/20 21:48:25 CCT [2017/11/20 8:48:25 ET]
Table 'Donati' 6-max Seat #1 is the button
Seat 1: fatinio914 ($11.26 in chips) 
Seat 2: MakCalm ($6.99 in chips) 
Seat 3: valuebet888 ($12.85 in chips) 
Seat 4: HubertusB ($5.70 in chips) 
Seat 5: safeeway ($5 in chips) 
Seat 6: falcao991 ($5.40 in chips) 
MakCalm: posts small blind $0.02
valuebet888: posts big blind $0.05
*** HOLE CARDS ***
Dealt to HubertusB [Qd 3s]
HubertusB: folds 
safeeway has timed out
safeeway: folds 
falcao991 is disconnected 
falcao991 has timed out while disconnected
falcao991: folds 
fatinio914: folds 
MakCalm: raises $0.05 to $0.10
valuebet888: raises $0.25 to $0.35
MakCalm: calls $0.25
*** FLOP *** [Qs Jd Js]
MakCalm: checks 
valuebet888: bets $0.37
MakCalm: folds 
Uncalled bet ($0.37) returned to valuebet888
valuebet888 collected $0.67 from pot
valuebet888: doesn't show hand 
*** SUMMARY ***
Total pot $0.70 | Rake $0.03 
Board [Qs Jd Js]
Seat 1: fatinio914 (button) folded before Flop (didn't bet)
Seat 2: MakCalm (small blind) folded on the Flop
Seat 3: valuebet888 (big blind) collected ($0.67)
Seat 4: HubertusB folded before Flop (didn't bet)
Seat 5: safeeway folded before Flop (didn't bet)
Seat 6: falcao991 folded before Flop (didn't bet)



PokerStars Zoom Hand #178483491141:  Hold'em No Limit ($0.02/$0.05) - 2017/11/20 21:49:04 CCT [2017/11/20 8:49:04 ET]
Table 'Donati' 6-max Seat #1 is the button
Seat 1: SV_Mangol ($5.55 in chips) 
Seat 2: xN3burz ($5.96 in chips) 
Seat 3: HubertusB ($5.70 in chips) 
Seat 4: yumi2003 ($4.61 in chips) 
Seat 5: reeqar ($5.12 in chips) 
Seat 6: mrs. Burger ($2.91 in chips) 
xN3burz: posts small blind $0.02
HubertusB: posts big blind $0.05
*** HOLE CARDS ***
Dealt to HubertusB [4d 7h]
yumi2003: folds 
reeqar: raises $0.09 to $0.14
mrs. Burger: calls $0.14
SV_Mangol: folds 
xN3burz: folds 
HubertusB: folds 
*** FLOP *** [5s 9c Qs]
reeqar: bets $0.22
mrs. Burger: calls $0.22
*** TURN *** [5s 9c Qs] [6c]
reeqar: checks 
mrs. Burger: bets $0.25
reeqar: calls $0.25
*** RIVER *** [5s 9c Qs 6c] [9h]
reeqar: checks 
mrs. Burger: bets $0.25
reeqar: folds 
Uncalled bet ($0.25) returned to mrs. Burger
mrs. Burger collected $1.24 from pot
mrs. Burger: doesn't show hand 
*** SUMMARY ***
Total pot $1.29 | Rake $0.05 
Board [5s 9c Qs 6c 9h]
Seat 1: SV_Mangol (button) folded before Flop (didn't bet)
Seat 2: xN3burz (small blind) folded before Flop
Seat 3: HubertusB (big blind) folded before Flop
Seat 4: yumi2003 folded before Flop (didn't bet)
Seat 5: reeqar folded on the River
Seat 6: mrs. Burger collected ($1.24)



PokerStars Zoom Hand #178483503532:  Hold'em No Limit ($0.02/$0.05) - 2017/11/20 21:49:29 CCT [2017/11/20 8:49:29 ET]
Table 'Donati' 6-max Seat #1 is the button
Seat 1: Sumow ($10.16 in chips) 
Seat 2: leo08238118 ($9.32 in chips) 
Seat 3: kaktak223 ($8.45 in chips) 
Seat 4: professor375 ($1.57 in chips) 
Seat 5: timon901901 ($5 in chips) 
Seat 6: HubertusB ($5.55 in chips) 
leo08238118: posts small blind $0.02
kaktak223: posts big blind $0.05
*** HOLE CARDS ***
Dealt to HubertusB [Ah Tc]
professor375: folds 
timon901901: folds 
HubertusB: raises $0.05 to $0.10
Sumow: calls $0.10
leo08238118: folds 
kaktak223: calls $0.05
*** FLOP *** [Jc Jh 4h]
kaktak223: checks 
HubertusB: checks 
Sumow: bets $0.17
kaktak223: folds 
HubertusB: folds 
Uncalled bet ($0.17) returned to Sumow
Sumow collected $0.31 from pot
Sumow: doesn't show hand 
*** SUMMARY ***
Total pot $0.32 | Rake $0.01 
Board [Jc Jh 4h]
Seat 1: Sumow (button) collected ($0.31)
Seat 2: leo08238118 (small blind) folded before Flop
Seat 3: kaktak223 (big blind) folded on the Flop
Seat 4: professor375 folded before Flop (didn't bet)
Seat 5: timon901901 folded before Flop (didn't bet)
Seat 6: HubertusB folded on the Flop



PokerStars Zoom Hand #178483522357:  Hold'em No Limit ($0.02/$0.05) - 2017/11/20 21:50:07 CCT [2017/11/20 8:50:07 ET]
Table 'Donati' 6-max Seat #1 is the button
Seat 1: PepeSmith ($9.74 in chips) 
Seat 2: gbdie ($6.38 in chips) 
Seat 3: Al3Goulart ($5 in chips) 
Seat 4: Thedams04 ($5.12 in chips) 
Seat 5: HubertusB ($5.45 in chips) 
Seat 6: ProAnastasia ($2 in chips) 
gbdie: posts small blind $0.02
Al3Goulart: posts big blind $0.05
*** HOLE CARDS ***
Dealt to HubertusB [6h 3d]
Thedams04: folds 
HubertusB: folds 
ProAnastasia: folds 
PepeSmith: folds 
gbdie: raises $0.10 to $0.15
Al3Goulart: folds 
Uncalled bet ($0.10) returned to gbdie
gbdie collected $0.10 from pot
gbdie: doesn't show hand 
*** SUMMARY ***
Total pot $0.10 | Rake $0 
Seat 1: PepeSmith (button) folded before Flop (didn't bet)
Seat 2: gbdie (small blind) collected ($0.10)
Seat 3: Al3Goulart (big blind) folded before Flop
Seat 4: Thedams04 folded before Flop (didn't bet)
Seat 5: HubertusB folded before Flop (didn't bet)
Seat 6: ProAnastasia folded before Flop (didn't bet)



PokerStars Zoom Hand #178483525227:  Hold'em No Limit ($0.02/$0.05) - 2017/11/20 21:50:13 CCT [2017/11/20 8:50:13 ET]
Table 'Donati' 6-max Seat #1 is the button
Seat 1: Clinmd ($3.75 in chips) 
Seat 2: HubertusB ($5.45 in chips) 
Seat 3: claudiu783 ($3.68 in chips) 
Seat 4: vmorgenstein ($5 in chips) 
Seat 5: With_no_Pain ($11.71 in chips) 
Seat 6: MakCalm ($6.57 in chips) 
HubertusB: posts small blind $0.02
claudiu783: posts big blind $0.05
*** HOLE CARDS ***
Dealt to HubertusB [7c Ac]
vmorgenstein: folds 
With_no_Pain: folds 
MakCalm: folds 
Clinmd: folds 
HubertusB: calls $0.03
claudiu783: checks 
*** FLOP *** [Kc Kd 9c]
HubertusB: checks 
claudiu783: bets $0.05
HubertusB: calls $0.05
*** TURN *** [Kc Kd 9c] [4h]
HubertusB: checks 
claudiu783: bets $0.15
HubertusB: calls $0.15
*** RIVER *** [Kc Kd 9c 4h] [Js]
HubertusB: checks 
claudiu783: bets $0.40
HubertusB: folds 
Uncalled bet ($0.40) returned to claudiu783
claudiu783 collected $0.48 from pot
claudiu783: doesn't show hand 
*** SUMMARY ***
Total pot $0.50 | Rake $0.02 
Board [Kc Kd 9c 4h Js]
Seat 1: Clinmd (button) folded before Flop (didn't bet)
Seat 2: HubertusB (small blind) folded on the River
Seat 3: claudiu783 (big blind) collected ($0.48)
Seat 4: vmorgenstein folded before Flop (didn't bet)
Seat 5: With_no_Pain folded before Flop (didn't bet)
Seat 6: MakCalm folded before Flop (didn't bet)



PokerStars Zoom Hand #178483556780:  Hold'em No Limit ($0.02/$0.05) - 2017/11/20 21:51:17 CCT [2017/11/20 8:51:17 ET]
Table 'Donati' 6-max Seat #1 is the button
Seat 1: NoOutsToCall ($5 in chips) 
Seat 2: joker_121909 ($4.95 in chips) 
Seat 3: HubertusB ($5.20 in chips) 
Seat 4: djuniorm ($6.56 in chips) 
Seat 5: eagle2030 ($5.59 in chips) 
Seat 6: brazerOK ($10.24 in chips) 
joker_121909: posts small blind $0.02
HubertusB: posts big blind $0.05
*** HOLE CARDS ***
Dealt to HubertusB [3d 8s]
djuniorm: folds 
eagle2030: folds 
brazerOK: folds 
NoOutsToCall: raises $0.07 to $0.12
joker_121909: folds 
HubertusB: folds 
Uncalled bet ($0.07) returned to NoOutsToCall
NoOutsToCall collected $0.12 from pot
NoOutsToCall: doesn't show hand 
*** SUMMARY ***
Total pot $0.12 | Rake $0 
Seat 1: NoOutsToCall (button) collected ($0.12)
Seat 2: joker_121909 (small blind) folded before Flop
Seat 3: HubertusB (big blind) folded before Flop
Seat 4: djuniorm folded before Flop (didn't bet)
Seat 5: eagle2030 folded before Flop (didn't bet)
Seat 6: brazerOK folded before Flop (didn't bet)



PokerStars Zoom Hand #178483569059:  Hold'em No Limit ($0.02/$0.05) - 2017/11/20 21:51:42 CCT [2017/11/20 8:51:42 ET]
Table 'Donati' 6-max Seat #1 is the button
Seat 1: HubertusB ($5.15 in chips) 
Seat 2: PepeSmith ($9.92 in chips) 
Seat 3: IrenVasya ($13.39 in chips) 
Seat 4: azukimochi ($5.67 in chips) 
Seat 5: Tedlop ($9.91 in chips) 
Seat 6: XtZ1 ($5 in chips) 
PepeSmith: posts small blind $0.02
IrenVasya: posts big blind $0.05
*** HOLE CARDS ***
Dealt to HubertusB [5h 9s]
azukimochi: raises $0.10 to $0.15
Tedlop: folds 
XtZ1: folds 
HubertusB: folds 
PepeSmith: folds 
IrenVasya: folds 
Uncalled bet ($0.10) returned to azukimochi
azukimochi collected $0.12 from pot
azukimochi: doesn't show hand 
*** SUMMARY ***
Total pot $0.12 | Rake $0 
Seat 1: HubertusB (button) folded before Flop (didn't bet)
Seat 2: PepeSmith (small blind) folded before Flop
Seat 3: IrenVasya (big blind) folded before Flop
Seat 4: azukimochi collected ($0.12)
Seat 5: Tedlop folded before Flop (didn't bet)
Seat 6: XtZ1 folded before Flop (didn't bet)



PokerStars Zoom Hand #178483573054:  Hold'em No Limit ($0.02/$0.05) - 2017/11/20 21:51:50 CCT [2017/11/20 8:51:50 ET]
Table 'Donati' 6-max Seat #1 is the button
Seat 1: quest2k ($9.09 in chips) 
Seat 2: HubertusB ($5.15 in chips) 
Seat 3: kowaL491 ($5 in chips) 
Seat 4: SVG7777 ($3.77 in chips) 
Seat 5: tael1973 ($5.07 in chips) 
Seat 6: FriskyBear ($5 in chips) 
HubertusB: posts small blind $0.02
kowaL491: posts big blind $0.05
*** HOLE CARDS ***
Dealt to HubertusB [Jh 3h]
SVG7777: folds 
tael1973: folds 
FriskyBear: raises $0.07 to $0.12
quest2k: folds 
HubertusB: folds 
kowaL491: folds 
Uncalled bet ($0.07) returned to FriskyBear
FriskyBear collected $0.12 from pot
FriskyBear: doesn't show hand 
*** SUMMARY ***
Total pot $0.12 | Rake $0 
Seat 1: quest2k (button) folded before Flop (didn't bet)
Seat 2: HubertusB (small blind) folded before Flop
Seat 3: kowaL491 (big blind) folded before Flop
Seat 4: SVG7777 folded before Flop (didn't bet)
Seat 5: tael1973 folded before Flop (didn't bet)
Seat 6: FriskyBear collected ($0.12)



PokerStars Zoom Hand #178483565579:  Hold'em No Limit ($0.02/$0.05) - 2017/11/20 21:51:35 CCT [2017/11/20 8:51:35 ET]
Table 'Donati' 6-max Seat #1 is the button
Seat 1: C3TN1K ($4.87 in chips) 
Seat 2: caleblee.gl ($9.08 in chips) 
Seat 3: collapse.n1 ($6.66 in chips) 
Seat 4: mikk2468 ($8.71 in chips) 
Seat 5: HubertusB ($5.15 in chips) 
Seat 6: HangarAces ($2.24 in chips) 
caleblee.gl: posts small blind $0.02
collapse.n1: posts big blind $0.05
*** HOLE CARDS ***
Dealt to HubertusB [4h Ad]
mikk2468: raises $0.11 to $0.16
HubertusB: folds 
HangarAces: calls $0.16
C3TN1K: folds 
caleblee.gl: folds 
collapse.n1: calls $0.11
*** FLOP *** [2d Qs 3c]
collapse.n1: checks 
mikk2468: bets $0.29
HangarAces: folds 
collapse.n1: folds 
Uncalled bet ($0.29) returned to mikk2468
mikk2468 collected $0.48 from pot
mikk2468: doesn't show hand 
*** SUMMARY ***
Total pot $0.50 | Rake $0.02 
Board [2d Qs 3c]
Seat 1: C3TN1K (button) folded before Flop (didn't bet)
Seat 2: caleblee.gl (small blind) folded before Flop
Seat 3: collapse.n1 (big blind) folded on the Flop
Seat 4: mikk2468 collected ($0.48)
Seat 5: HubertusB folded before Flop (didn't bet)
Seat 6: HangarAces folded on the Flop



PokerStars Zoom Hand #178483586820:  Hold'em No Limit ($0.02/$0.05) - 2017/11/20 21:52:18 CCT [2017/11/20 8:52:18 ET]
Table 'Donati' 6-max Seat #1 is the button
Seat 1: blondin4uk74 ($5.32 in chips) 
Seat 2: dark h0r$e ($5.02 in chips) 
Seat 3: HubertusB ($5.13 in chips) 
Seat 4: nenadhebiv ($5.14 in chips) 
Seat 5: croissantje ($5 in chips) 
Seat 6: SskyAngel ($18.02 in chips) 
dark h0r$e: posts small blind $0.02
HubertusB: posts big blind $0.05
*** HOLE CARDS ***
Dealt to HubertusB [Qh Kh]
nenadhebiv: folds 
croissantje: folds 
SskyAngel: folds 
blondin4uk74: raises $0.07 to $0.12
dark h0r$e: folds 
HubertusB: raises $0.23 to $0.35
blondin4uk74: folds 
Uncalled bet ($0.23) returned to HubertusB
HubertusB collected $0.26 from pot
HubertusB: doesn't show hand 
*** SUMMARY ***
Total pot $0.26 | Rake $0 
Seat 1: blondin4uk74 (button) folded before Flop
Seat 2: dark h0r$e (small blind) folded before Flop
Seat 3: HubertusB (big blind) collected ($0.26)
Seat 4: nenadhebiv folded before Flop (didn't bet)
Seat 5: croissantje folded before Flop (didn't bet)
Seat 6: SskyAngel folded before Flop (didn't bet)



PokerStars Zoom Hand #178483583812:  Hold'em No Limit ($0.02/$0.05) - 2017/11/20 21:52:12 CCT [2017/11/20 8:52:12 ET]
Table 'Donati' 6-max Seat #1 is the button
Seat 1: ivomargu ($6.74 in chips) 
Seat 2: buberman ($5.51 in chips) 
Seat 3: YABALAK ($0.99 in chips) 
Seat 4: HubertusB ($5.13 in chips) 
Seat 5: AchiKouros ($5 in chips) 
Seat 6: jjdns ($3 in chips) 
buberman: posts small blind $0.02
YABALAK: posts big blind $0.05
*** HOLE CARDS ***
Dealt to HubertusB [Ts 3h]
HubertusB: folds 
AchiKouros: folds 
jjdns: raises $0.10 to $0.15
ivomargu has timed out
ivomargu: folds 
buberman: folds 
YABALAK: folds 
Uncalled bet ($0.10) returned to jjdns
jjdns collected $0.12 from pot
jjdns: doesn't show hand 
*** SUMMARY ***
Total pot $0.12 | Rake $0 
Seat 1: ivomargu (button) folded before Flop (didn't bet)
Seat 2: buberman (small blind) folded before Flop
Seat 3: YABALAK (big blind) folded before Flop
Seat 4: HubertusB folded before Flop (didn't bet)
Seat 5: AchiKouros folded before Flop (didn't bet)
Seat 6: jjdns collected ($0.12)



PokerStars Zoom Hand #178483578974:  Hold'em No Limit ($0.02/$0.05) - 2017/11/20 21:52:02 CCT [2017/11/20 8:52:02 ET]
Table 'Donati' 6-max Seat #1 is the button
Seat 1: Acedan1369 ($15.85 in chips) 
Seat 2: DollaMagn3t ($4.23 in chips) 
Seat 3: chester8676 ($4.73 in chips) 
Seat 4: HubertusB ($5.13 in chips) 
Seat 5: 3iourou ($5.19 in chips) 
Seat 6: osho6 ($4.36 in chips) 
DollaMagn3t: posts small blind $0.02
chester8676: posts big blind $0.05
*** HOLE CARDS ***
Dealt to HubertusB [Kc 5d]
HubertusB: folds 
3iourou: folds 
osho6: folds 
Acedan1369 has timed out
Acedan1369: folds 
DollaMagn3t: raises $0.10 to $0.15
chester8676: calls $0.10
*** FLOP *** [Jd Qd Qs]
DollaMagn3t: bets $0.12
chester8676: calls $0.12
*** TURN *** [Jd Qd Qs] [Js]
DollaMagn3t: checks 
chester8676: bets $0.27
DollaMagn3t: folds 
Uncalled bet ($0.27) returned to chester8676
chester8676 collected $0.52 from pot
chester8676: doesn't show hand 
*** SUMMARY ***
Total pot $0.54 | Rake $0.02 
Board [Jd Qd Qs Js]
Seat 1: Acedan1369 (button) folded before Flop (didn't bet)
Seat 2: DollaMagn3t (small blind) folded on the Turn
Seat 3: chester8676 (big blind) collected ($0.52)
Seat 4: HubertusB folded before Flop (didn't bet)
Seat 5: 3iourou folded before Flop (didn't bet)
Seat 6: osho6 folded before Flop (didn't bet)



PokerStars Zoom Hand #178483596116:  Hold'em No Limit ($0.02/$0.05) - 2017/11/20 21:52:37 CCT [2017/11/20 8:52:37 ET]
Table 'Donati' 6-max Seat #1 is the button
Seat 1: HubertusB ($5.27 in chips) 
Seat 2: AK@KK@AK ($16.65 in chips) 
Seat 3: kidsonik ($5.38 in chips) 
Seat 4: aC4dima ($5.18 in chips) 
Seat 5: RoyalTobyJ ($5.90 in chips) 
Seat 6: leo08238118 ($9.20 in chips) 
AK@KK@AK: posts small blind $0.02
kidsonik: posts big blind $0.05
*** HOLE CARDS ***
Dealt to HubertusB [3h Th]
aC4dima: folds 
RoyalTobyJ: folds 
leo08238118: folds 
HubertusB: raises $0.05 to $0.10
AK@KK@AK: folds 
kidsonik: folds 
Uncalled bet ($0.05) returned to HubertusB
HubertusB collected $0.12 from pot
HubertusB: doesn't show hand 
*** SUMMARY ***
Total pot $0.12 | Rake $0 
Seat 1: HubertusB (button) collected ($0.12)
Seat 2: AK@KK@AK (small blind) folded before Flop
Seat 3: kidsonik (big blind) folded before Flop
Seat 4: aC4dima folded before Flop (didn't bet)
Seat 5: RoyalTobyJ folded before Flop (didn't bet)
Seat 6: leo08238118 folded before Flop (didn't bet)



PokerStars Zoom Hand #178483581400:  Hold'em No Limit ($0.02/$0.05) - 2017/11/20 21:52:07 CCT [2017/11/20 8:52:07 ET]
Table 'Donati' 6-max Seat #1 is the button
Seat 1: SBL 76 ($9.83 in chips) 
Seat 2: lulu210910 ($7.39 in chips) 
Seat 3: Mr. Roquim ($6.96 in chips) 
Seat 4: zzpotter ($5.07 in chips) 
Seat 5: PepeSmith ($9.85 in chips) 
Seat 6: HubertusB ($5.13 in chips) 
lulu210910: posts small blind $0.02
Mr. Roquim: posts big blind $0.05
*** HOLE CARDS ***
Dealt to HubertusB [4c Kd]
zzpotter: folds 
PepeSmith: folds 
HubertusB: folds 
SBL 76: raises $0.05 to $0.10
lulu210910: calls $0.08
Mr. Roquim: folds 
*** FLOP *** [Jh 5c 2d]
lulu210910: bets $0.10
SBL 76: calls $0.10
*** TURN *** [Jh 5c 2d] [9h]
lulu210910: bets $0.10
SBL 76: calls $0.10
*** RIVER *** [Jh 5c 2d 9h] [Tc]
lulu210910: bets $0.10
SBL 76: calls $0.10
*** SHOW DOWN ***
lulu210910: shows [Ah Jd] (a pair of Jacks)
SBL 76: mucks hand 
lulu210910 collected $0.81 from pot
*** SUMMARY ***
Total pot $0.85 | Rake $0.04 
Board [Jh 5c 2d 9h Tc]
Seat 1: SBL 76 (button) mucked [6h 5h]
Seat 2: lulu210910 (small blind) showed [Ah Jd] and won ($0.81) with a pair of Jacks
Seat 3: Mr. Roquim (big blind) folded before Flop
Seat 4: zzpotter folded before Flop (didn't bet)
Seat 5: PepeSmith folded before Flop (didn't bet)
Seat 6: HubertusB folded before Flop (didn't bet)



PokerStars Zoom Hand #178483601465:  Hold'em No Limit ($0.02/$0.05) - 2017/11/20 21:52:48 CCT [2017/11/20 8:52:48 ET]
Table 'Donati' 6-max Seat #1 is the button
Seat 1: SelenaSolis ($8.68 in chips) 
Seat 2: halesc19 ($2.73 in chips) 
Seat 3: oleg777886 ($5.12 in chips) 
Seat 4: MoreRakePls1 ($5.26 in chips) 
Seat 5: HubertusB ($5.34 in chips) 
Seat 6: yvahero87 ($4.24 in chips) 
halesc19: posts small blind $0.02
oleg777886: posts big blind $0.05
*** HOLE CARDS ***
Dealt to HubertusB [7d 3h]
MoreRakePls1: folds 
HubertusB: folds 
yvahero87: raises $0.10 to $0.15
SelenaSolis: folds 
halesc19: folds 
oleg777886: folds 
Uncalled bet ($0.10) returned to yvahero87
yvahero87 collected $0.12 from pot
yvahero87: doesn't show hand 
*** SUMMARY ***
Total pot $0.12 | Rake $0 
Seat 1: SelenaSolis (button) folded before Flop (didn't bet)
Seat 2: halesc19 (small blind) folded before Flop
Seat 3: oleg777886 (big blind) folded before Flop
Seat 4: MoreRakePls1 folded before Flop (didn't bet)
Seat 5: HubertusB folded before Flop (didn't bet)
Seat 6: yvahero87 collected ($0.12)



PokerStars Zoom Hand #178483604354:  Hold'em No Limit ($0.02/$0.05) - 2017/11/20 21:52:54 CCT [2017/11/20 8:52:54 ET]
Table 'Donati' 6-max Seat #1 is the button
Seat 1: Vynnypoker ($8.67 in chips) 
Seat 2: HubertusB ($5.34 in chips) 
Seat 3: Poker sta705 ($6.15 in chips) 
Seat 4: MoreRakePls1 ($7.68 in chips) 
Seat 5: kylebic ($29.73 in chips) 
Seat 6: Bonch241 ($5.02 in chips) 
HubertusB: posts small blind $0.02
Poker sta705: posts big blind $0.05
*** HOLE CARDS ***
Dealt to HubertusB [5c 3d]
MoreRakePls1: folds 
kylebic: folds 
Bonch241: folds 
Vynnypoker: raises $0.08 to $0.13
HubertusB: folds 
Poker sta705: folds 
Uncalled bet ($0.08) returned to Vynnypoker
Vynnypoker collected $0.12 from pot
Vynnypoker: doesn't show hand 
*** SUMMARY ***
Total pot $0.12 | Rake $0 
Seat 1: Vynnypoker (button) collected ($0.12)
Seat 2: HubertusB (small blind) folded before Flop
Seat 3: Poker sta705 (big blind) folded before Flop
Seat 4: MoreRakePls1 folded before Flop (didn't bet)
Seat 5: kylebic folded before Flop (didn't bet)
Seat 6: Bonch241 folded before Flop (didn't bet)



PokerStars Zoom Hand #178483617306:  Hold'em No Limit ($0.02/$0.05) - 2017/11/20 21:53:20 CCT [2017/11/20 8:53:20 ET]
Table 'Donati' 6-max Seat #1 is the button
Seat 1: RenningStone ($16.13 in chips) 
Seat 2: SskyAngel ($17.97 in chips) 
Seat 3: HubertusB ($5.32 in chips) 
Seat 4: kidboss1990 ($12.46 in chips) 
Seat 5: aibolit66677 ($5.77 in chips) 
Seat 6: RiSk.Fortune ($5 in chips) 
SskyAngel: posts small blind $0.02
HubertusB: posts big blind $0.05
*** HOLE CARDS ***
Dealt to HubertusB [2h Ad]
kidboss1990: folds 
aibolit66677: folds 
RiSk.Fortune: folds 
RenningStone: raises $0.08 to $0.13
SskyAngel: folds 
HubertusB: folds 
Uncalled bet ($0.08) returned to RenningStone
RenningStone collected $0.12 from pot
RenningStone: doesn't show hand 
*** SUMMARY ***
Total pot $0.12 | Rake $0 
Seat 1: RenningStone (button) collected ($0.12)
Seat 2: SskyAngel (small blind) folded before Flop
Seat 3: HubertusB (big blind) folded before Flop
Seat 4: kidboss1990 folded before Flop (didn't bet)
Seat 5: aibolit66677 folded before Flop (didn't bet)
Seat 6: RiSk.Fortune folded before Flop (didn't bet)



PokerStars Zoom Hand #178483614347:  Hold'em No Limit ($0.02/$0.05) - 2017/11/20 21:53:14 CCT [2017/11/20 8:53:14 ET]
Table 'Donati' 6-max Seat #1 is the button
Seat 1: Bonch241 ($5.02 in chips) 
Seat 2: xarichi ($7.16 in chips) 
Seat 3: Guzeev1980 ($2.66 in chips) 
Seat 4: svansong ($5.02 in chips) 
Seat 5: HubertusB ($5.32 in chips) 
Seat 6: McFischer87 ($5 in chips) 
xarichi: posts small blind $0.02
Guzeev1980: posts big blind $0.05
*** HOLE CARDS ***
Dealt to HubertusB [3c 9s]
svansong: folds 
HubertusB: folds 
McFischer87: raises $0.10 to $0.15
Bonch241: folds 
xarichi: folds 
Guzeev1980: folds 
Uncalled bet ($0.10) returned to McFischer87
McFischer87 collected $0.12 from pot
McFischer87: doesn't show hand 
*** SUMMARY ***
Total pot $0.12 | Rake $0 
Seat 1: Bonch241 (button) folded before Flop (didn't bet)
Seat 2: xarichi (small blind) folded before Flop
Seat 3: Guzeev1980 (big blind) folded before Flop
Seat 4: svansong folded before Flop (didn't bet)
Seat 5: HubertusB folded before Flop (didn't bet)
Seat 6: McFischer87 collected ($0.12)



PokerStars Zoom Hand #178483607402:  Hold'em No Limit ($0.02/$0.05) - 2017/11/20 21:53:00 CCT [2017/11/20 8:53:00 ET]
Table 'Donati' 6-max Seat #1 is the button
Seat 1: Anrs23 ($5 in chips) 
Seat 2: oleg777886 ($5.07 in chips) 
Seat 3: dem912 ($5 in chips) 
Seat 4: baggelisdr1 ($7.21 in chips) 
Seat 5: croissantje ($5.07 in chips) 
Seat 6: HubertusB ($5.32 in chips) 
oleg777886: posts small blind $0.02
dem912: posts big blind $0.05
*** HOLE CARDS ***
Dealt to HubertusB [Ts Qh]
baggelisdr1: folds 
croissantje: folds 
HubertusB: folds 
Anrs23: raises $0.10 to $0.15
oleg777886: folds 
dem912: raises $0.32 to $0.47
Anrs23: raises $4.53 to $5 and is all-in
dem912: folds 
Uncalled bet ($4.53) returned to Anrs23
Anrs23 collected $0.96 from pot
Anrs23: doesn't show hand 
*** SUMMARY ***
Total pot $0.96 | Rake $0 
Seat 1: Anrs23 (button) collected ($0.96)
Seat 2: oleg777886 (small blind) folded before Flop
Seat 3: dem912 (big blind) folded before Flop
Seat 4: baggelisdr1 folded before Flop (didn't bet)
Seat 5: croissantje folded before Flop (didn't bet)
Seat 6: HubertusB folded before Flop (didn't bet)



PokerStars Zoom Hand #178483611377:  Hold'em No Limit ($0.02/$0.05) - 2017/11/20 21:53:08 CCT [2017/11/20 8:53:08 ET]
Table 'Donati' 6-max Seat #1 is the button
Seat 1: despot17 ($4.60 in chips) 
Seat 2: chester8676 ($5.08 in chips) 
Seat 3: Fi$hAndChipz ($8.45 in chips) 
Seat 4: HubertusB ($5.32 in chips) 
Seat 5: alexey9210a ($5.71 in chips) 
Seat 6: nesimeshok ($6.61 in chips) 
chester8676: posts small blind $0.02
Fi$hAndChipz: posts big blind $0.05
*** HOLE CARDS ***
Dealt to HubertusB [9d Ac]
HubertusB: folds 
alexey9210a: folds 
nesimeshok: folds 
despot17: raises $0.05 to $0.10
chester8676: folds 
Fi$hAndChipz: calls $0.05
*** FLOP *** [As 3d 8d]
Fi$hAndChipz: checks 
despot17: checks 
*** TURN *** [As 3d 8d] [4s]
Fi$hAndChipz: bets $0.13
despot17: folds 
Uncalled bet ($0.13) returned to Fi$hAndChipz
Fi$hAndChipz collected $0.21 from pot
Fi$hAndChipz: doesn't show hand 
*** SUMMARY ***
Total pot $0.22 | Rake $0.01 
Board [As 3d 8d 4s]
Seat 1: despot17 (button) folded on the Turn
Seat 2: chester8676 (small blind) folded before Flop
Seat 3: Fi$hAndChipz (big blind) collected ($0.21)
Seat 4: HubertusB folded before Flop (didn't bet)
Seat 5: alexey9210a folded before Flop (didn't bet)
Seat 6: nesimeshok folded before Flop (didn't bet)



PokerStars Zoom Hand #178483620685:  Hold'em No Limit ($0.02/$0.05) - 2017/11/20 21:53:27 CCT [2017/11/20 8:53:27 ET]
Table 'Donati' 6-max Seat #1 is the button
Seat 1: HubertusB ($5.27 in chips) 
Seat 2: pimposhkius ($7.86 in chips) 
Seat 3: nenadhebiv ($5 in chips) 
Seat 4: Muurzik ($5.16 in chips) 
Seat 5: FriskyBear ($5.40 in chips) 
Seat 6: Yolff ($9.52 in chips) 
pimposhkius: posts small blind $0.02
nenadhebiv: posts big blind $0.05
*** HOLE CARDS ***
Dealt to HubertusB [Kc Ac]
Muurzik: folds 
FriskyBear: folds 
Yolff: folds 
HubertusB: raises $0.05 to $0.10
pimposhkius: calls $0.08
nenadhebiv: calls $0.05
*** FLOP *** [Qh Jd 4s]
pimposhkius: checks 
nenadhebiv: checks 
HubertusB: bets $0.16
pimposhkius: calls $0.16
nenadhebiv: calls $0.16
*** TURN *** [Qh Jd 4s] [Kd]
pimposhkius: checks 
nenadhebiv: checks 
HubertusB: checks 
*** RIVER *** [Qh Jd 4s Kd] [Js]
pimposhkius: checks 
nenadhebiv: bets $0.65
HubertusB: calls $0.65
pimposhkius: folds 
*** SHOW DOWN ***
nenadhebiv: shows [Jh Th] (three of a kind, Jacks)
HubertusB: mucks hand 
nenadhebiv collected $1.99 from pot
*** SUMMARY ***
Total pot $2.08 | Rake $0.09 
Board [Qh Jd 4s Kd Js]
Seat 1: HubertusB (button) mucked [Kc Ac]
Seat 2: pimposhkius (small blind) folded on the River
Seat 3: nenadhebiv (big blind) showed [Jh Th] and won ($1.99) with three of a kind, Jacks
Seat 4: Muurzik folded before Flop (didn't bet)
Seat 5: FriskyBear folded before Flop (didn't bet)
Seat 6: Yolff folded before Flop (didn't bet)



PokerStars Zoom Hand #178483651053:  Hold'em No Limit ($0.02/$0.05) - 2017/11/20 21:54:29 CCT [2017/11/20 8:54:29 ET]
Table 'Donati' 6-max Seat #1 is the button
Seat 1: yumi2003 ($3.88 in chips) 
Seat 2: HubertusB ($4.36 in chips) 
Seat 3: makis146 ($4.45 in chips) 
Seat 4: VoSKeSeNSK ($5 in chips) 
Seat 5: tomsal0157 ($5.93 in chips) 
Seat 6: russkiiiiiii ($3.88 in chips) 
HubertusB: posts small blind $0.02
makis146: posts big blind $0.05
*** HOLE CARDS ***
Dealt to HubertusB [Kd Qh]
VoSKeSeNSK: folds 
tomsal0157: folds 
russkiiiiiii: folds 
yumi2003: raises $0.07 to $0.12
HubertusB: calls $0.10
makis146: folds 
*** FLOP *** [Qs 2s Jc]
HubertusB: bets $0.15
yumi2003: calls $0.15
*** TURN *** [Qs 2s Jc] [Ks]
HubertusB: bets $0.35
yumi2003: folds 
Uncalled bet ($0.35) returned to HubertusB
HubertusB collected $0.57 from pot
HubertusB: doesn't show hand 
*** SUMMARY ***
Total pot $0.59 | Rake $0.02 
Board [Qs 2s Jc Ks]
Seat 1: yumi2003 (button) folded on the Turn
Seat 2: HubertusB (small blind) collected ($0.57)
Seat 3: makis146 (big blind) folded before Flop
Seat 4: VoSKeSeNSK folded before Flop (didn't bet)
Seat 5: tomsal0157 folded before Flop (didn't bet)
Seat 6: russkiiiiiii folded before Flop (didn't bet)



PokerStars Zoom Hand #178483668201:  Hold'em No Limit ($0.02/$0.05) - 2017/11/20 21:55:04 CCT [2017/11/20 8:55:04 ET]
Table 'Donati' 6-max Seat #1 is the button
Seat 1: Marka555 ($5 in chips) 
Seat 2: VIOLA 27120 ($3.43 in chips) 
Seat 3: McFischer87 ($5 in chips) 
Seat 4: KLAREN5 ($3.50 in chips) 
Seat 5: HubertusB ($4.66 in chips) 
Seat 6: diggydix123 ($4.67 in chips) 
VIOLA 27120: posts small blind $0.02
McFischer87: posts big blind $0.05
*** HOLE CARDS ***
Dealt to HubertusB [9d 3h]
KLAREN5: raises $0.05 to $0.10
HubertusB: folds 
diggydix123: folds 
Marka555: folds 
VIOLA 27120: folds 
McFischer87: folds 
Uncalled bet ($0.05) returned to KLAREN5
KLAREN5 collected $0.12 from pot
KLAREN5: doesn't show hand 
*** SUMMARY ***
Total pot $0.12 | Rake $0 
Seat 1: Marka555 (button) folded before Flop (didn't bet)
Seat 2: VIOLA 27120 (small blind) folded before Flop
Seat 3: McFischer87 (big blind) folded before Flop
Seat 4: KLAREN5 collected ($0.12)
Seat 5: HubertusB folded before Flop (didn't bet)
Seat 6: diggydix123 folded before Flop (didn't bet)



PokerStars Zoom Hand #178483670760:  Hold'em No Limit ($0.02/$0.05) - 2017/11/20 21:55:10 CCT [2017/11/20 8:55:10 ET]
Table 'Donati' 6-max Seat #1 is the button
Seat 1: RenningStone ($14.48 in chips) 
Seat 2: AlChrph ($5.74 in chips) 
Seat 3: artemka2508 ($5.30 in chips) 
Seat 4: HubertusB ($4.66 in chips) 
Seat 5: blondin4uk74 ($9.65 in chips) 
Seat 6: yvahero87 ($5.05 in chips) 
AlChrph: posts small blind $0.02
artemka2508: posts big blind $0.05
*** HOLE CARDS ***
Dealt to HubertusB [2s 6s]
HubertusB: folds 
blondin4uk74: folds 
yvahero87: folds 
RenningStone: folds 
AlChrph: folds 
Uncalled bet ($0.03) returned to artemka2508
artemka2508 collected $0.04 from pot
artemka2508: doesn't show hand 
*** SUMMARY ***
Total pot $0.04 | Rake $0 
Seat 1: RenningStone (button) folded before Flop (didn't bet)
Seat 2: AlChrph (small blind) folded before Flop
Seat 3: artemka2508 (big blind) collected ($0.04)
Seat 4: HubertusB folded before Flop (didn't bet)
Seat 5: blondin4uk74 folded before Flop (didn't bet)
Seat 6: yvahero87 folded before Flop (didn't bet)



PokerStars Zoom Hand #178483673372:  Hold'em No Limit ($0.02/$0.05) - 2017/11/20 21:55:16 CCT [2017/11/20 8:55:16 ET]
Table 'Donati' 6-max Seat #1 is the button
Seat 1: Dorogoi57 ($5.32 in chips) 
Seat 2: BatishtaBolt ($5 in chips) 
Seat 3: chester8676 ($5 in chips) 
Seat 4: SLuTxTReMe ($8.24 in chips) 
Seat 5: TENEBRIS 666 ($3.31 in chips) 
Seat 6: HubertusB ($4.66 in chips) 
BatishtaBolt: posts small blind $0.02
chester8676: posts big blind $0.05
*** HOLE CARDS ***
Dealt to HubertusB [7c Kc]
SLuTxTReMe: folds 
TENEBRIS 666: calls $0.05
HubertusB: calls $0.05
Dorogoi57: folds 
BatishtaBolt: folds 
chester8676: checks 
*** FLOP *** [As Kd 2d]
chester8676: checks 
TENEBRIS 666: checks 
HubertusB: bets $0.09
chester8676: calls $0.09
TENEBRIS 666: calls $0.09
*** TURN *** [As Kd 2d] [8d]
chester8676: checks 
TENEBRIS 666: checks 
HubertusB: checks 
*** RIVER *** [As Kd 2d 8d] [Qd]
chester8676: checks 
TENEBRIS 666: checks 
HubertusB: checks 
*** SHOW DOWN ***
chester8676: shows [7s Ah] (a pair of Aces)
TENEBRIS 666: mucks hand 
HubertusB: mucks hand 
chester8676 collected $0.42 from pot
*** SUMMARY ***
Total pot $0.44 | Rake $0.02 
Board [As Kd 2d 8d Qd]
Seat 1: Dorogoi57 (button) folded before Flop (didn't bet)
Seat 2: BatishtaBolt (small blind) folded before Flop
Seat 3: chester8676 (big blind) showed [7s Ah] and won ($0.42) with a pair of Aces
Seat 4: SLuTxTReMe folded before Flop (didn't bet)
Seat 5: TENEBRIS 666 mucked [Jh Qc]
Seat 6: HubertusB mucked [7c Kc]



PokerStars Zoom Hand #178483698446:  Hold'em No Limit ($0.02/$0.05) - 2017/11/20 21:56:14 CCT [2017/11/20 8:56:14 ET]
Table 'Donati' 6-max Seat #1 is the button
Seat 1: svansong ($5 in chips) 
Seat 2: paradiseg174 ($6.90 in chips) 
Seat 3: HubertusB ($4.52 in chips) 
Seat 4: VadnaiG ($6.13 in chips) 
Seat 5: gbdie ($5 in chips) 
Seat 6: SANICH950 ($9.99 in chips) 
paradiseg174: posts small blind $0.02
HubertusB: posts big blind $0.05
*** HOLE CARDS ***
Dealt to HubertusB [Ks 9h]
VadnaiG: folds 
gbdie: folds 
SANICH950: folds 
svansong: raises $0.10 to $0.15
paradiseg174: folds 
HubertusB: folds 
Uncalled bet ($0.10) returned to svansong
svansong collected $0.12 from pot
svansong: doesn't show hand 
*** SUMMARY ***
Total pot $0.12 | Rake $0 
Seat 1: svansong (button) collected ($0.12)
Seat 2: paradiseg174 (small blind) folded before Flop
Seat 3: HubertusB (big blind) folded before Flop
Seat 4: VadnaiG folded before Flop (didn't bet)
Seat 5: gbdie folded before Flop (didn't bet)
Seat 6: SANICH950 folded before Flop (didn't bet)



PokerStars Zoom Hand #178483707974:  Hold'em No Limit ($0.02/$0.05) - 2017/11/20 21:56:36 CCT [2017/11/20 8:56:36 ET]
Table 'Donati' 6-max Seat #1 is the button
Seat 1: HubertusB ($4.47 in chips) 
Seat 2: Poker sta705 ($5.02 in chips) 
Seat 3: cikacikacika ($4.99 in chips) 
Seat 4: sw11223 ($4.90 in chips) 
Seat 5: nappiperse ($7.70 in chips) 
Seat 6: Bsgmz ($17.83 in chips) 
Poker sta705: posts small blind $0.02
cikacikacika: posts big blind $0.05
*** HOLE CARDS ***
Dealt to HubertusB [Kc Ac]
sw11223: folds 
nappiperse: folds 
Bsgmz: folds 
HubertusB: raises $0.07 to $0.12
Poker sta705: calls $0.10
cikacikacika: folds 
*** FLOP *** [3s 2c Ad]
Poker sta705: checks 
HubertusB: bets $0.15
Poker sta705: folds 
Uncalled bet ($0.15) returned to HubertusB
HubertusB collected $0.28 from pot
HubertusB: doesn't show hand 
*** SUMMARY ***
Total pot $0.29 | Rake $0.01 
Board [3s 2c Ad]
Seat 1: HubertusB (button) collected ($0.28)
Seat 2: Poker sta705 (small blind) folded on the Flop
Seat 3: cikacikacika (big blind) folded before Flop
Seat 4: sw11223 folded before Flop (didn't bet)
Seat 5: nappiperse folded before Flop (didn't bet)
Seat 6: Bsgmz folded before Flop (didn't bet)



PokerStars Zoom Hand #178483703205:  Hold'em No Limit ($0.02/$0.05) - 2017/11/20 21:56:25 CCT [2017/11/20 8:56:25 ET]
Table 'Donati' 6-max Seat #1 is the button
Seat 1: 13argentina ($4.60 in chips) 
Seat 2: artemka2508 ($5.32 in chips) 
Seat 3: hancockkas ($10.45 in chips) 
Seat 4: HubertusB ($4.47 in chips) 
Seat 5: vcf2013 ($7.19 in chips) 
Seat 6: Polypops ($12.42 in chips) 
artemka2508: posts small blind $0.02
hancockkas: posts big blind $0.05
*** HOLE CARDS ***
Dealt to HubertusB [2d Kc]
HubertusB: folds 
vcf2013: folds 
Polypops: folds 
13argentina: calls $0.05
artemka2508: folds 
hancockkas: raises $0.10 to $0.15
13argentina: calls $0.10
*** FLOP *** [4c Td As]
hancockkas: checks 
13argentina: bets $0.05
hancockkas: calls $0.05
*** TURN *** [4c Td As] [Qh]
hancockkas: checks 
13argentina: checks 
*** RIVER *** [4c Td As Qh] [9s]
hancockkas: bets $0.20
13argentina: folds 
Uncalled bet ($0.20) returned to hancockkas
hancockkas collected $0.40 from pot
hancockkas: doesn't show hand 
*** SUMMARY ***
Total pot $0.42 | Rake $0.02 
Board [4c Td As Qh 9s]
Seat 1: 13argentina (button) folded on the River
Seat 2: artemka2508 (small blind) folded before Flop
Seat 3: hancockkas (big blind) collected ($0.40)
Seat 4: HubertusB folded before Flop (didn't bet)
Seat 5: vcf2013 folded before Flop (didn't bet)
Seat 6: Polypops folded before Flop (didn't bet)



PokerStars Zoom Hand #178483705401:  Hold'em No Limit ($0.02/$0.05) - 2017/11/20 21:56:30 CCT [2017/11/20 8:56:30 ET]
Table 'Donati' 6-max Seat #1 is the button
Seat 1: janos123456 ($5.05 in chips) 
Seat 2: Predator1447 ($5.52 in chips) 
Seat 3: Mike3stakana ($5.14 in chips) 
Seat 4: HubertusB ($4.47 in chips) 
Seat 5: walhalla48 ($5 in chips) 
Seat 6: kidboss1990 ($10.72 in chips) 
Predator1447: posts small blind $0.02
Mike3stakana: posts big blind $0.05
*** HOLE CARDS ***
Dealt to HubertusB [2h Ks]
HubertusB: folds 
walhalla48: folds 
kidboss1990: raises $0.10 to $0.15
janos123456: calls $0.15
Predator1447: folds 
Mike3stakana: calls $0.10
*** FLOP *** [5h 9d 2s]
Mike3stakana: bets $0.30
kidboss1990: calls $0.30
janos123456: raises $1.35 to $1.65
Mike3stakana: folds 
kidboss1990: folds 
Uncalled bet ($1.35) returned to janos123456
janos123456 collected $1.31 from pot
janos123456: doesn't show hand 
*** SUMMARY ***
Total pot $1.37 | Rake $0.06 
Board [5h 9d 2s]
Seat 1: janos123456 (button) collected ($1.31)
Seat 2: Predator1447 (small blind) folded before Flop
Seat 3: Mike3stakana (big blind) folded on the Flop
Seat 4: HubertusB folded before Flop (didn't bet)
Seat 5: walhalla48 folded before Flop (didn't bet)
Seat 6: kidboss1990 folded on the Flop



PokerStars Zoom Hand #178483718832:  Hold'em No Limit ($0.02/$0.05) - 2017/11/20 21:57:01 CCT [2017/11/20 8:57:01 ET]
Table 'Donati' 6-max Seat #1 is the button
Seat 1: Predator1447 ($5.76 in chips) 
Seat 2: oskican ($4.85 in chips) 
Seat 3: HubertusB ($4.63 in chips) 
Seat 4: VoSKeSeNSK ($5.15 in chips) 
Seat 5: port083 ($1.81 in chips) 
Seat 6: Dorogoi57 ($5 in chips) 
oskican: posts small blind $0.02
HubertusB: posts big blind $0.05
*** HOLE CARDS ***
Dealt to HubertusB [Ks Ad]
VoSKeSeNSK: folds 
port083: folds 
Dorogoi57: raises $0.08 to $0.13
Predator1447: folds 
oskican: folds 
HubertusB: calls $0.08
*** FLOP *** [Qs 9h Qd]
HubertusB: checks 
Dorogoi57: checks 
*** TURN *** [Qs 9h Qd] [7h]
HubertusB: checks 
Dorogoi57: checks 
*** RIVER *** [Qs 9h Qd 7h] [Th]
HubertusB: checks 
Dorogoi57: checks 
*** SHOW DOWN ***
HubertusB: shows [Ks Ad] (a pair of Queens)
Dorogoi57: shows [5c 5s] (two pair, Queens and Fives)
Dorogoi57 collected $0.27 from pot
*** SUMMARY ***
Total pot $0.28 | Rake $0.01 
Board [Qs 9h Qd 7h Th]
Seat 1: Predator1447 (button) folded before Flop (didn't bet)
Seat 2: oskican (small blind) folded before Flop
Seat 3: HubertusB (big blind) showed [Ks Ad] and lost with a pair of Queens
Seat 4: VoSKeSeNSK folded before Flop (didn't bet)
Seat 5: port083 folded before Flop (didn't bet)
Seat 6: Dorogoi57 showed [5c 5s] and won ($0.27) with two pair, Queens and Fives



PokerStars Zoom Hand #178483734643:  Hold'em No Limit ($0.02/$0.05) - 2017/11/20 21:57:37 CCT [2017/11/20 8:57:37 ET]
Table 'Donati' 6-max Seat #1 is the button
Seat 1: StealSteeler ($5 in chips) 
Seat 2: HubertusB ($4.50 in chips) 
Seat 3: KRAWA101 ($5 in chips) 
Seat 4: 3iourou ($5 in chips) 
Seat 5: folydr ($6.03 in chips) 
Seat 6: Yolff ($5.02 in chips) 
HubertusB: posts small blind $0.02
KRAWA101: posts big blind $0.05
*** HOLE CARDS ***
Dealt to HubertusB [5c 8d]
3iourou: folds 
folydr: folds 
Yolff: folds 
StealSteeler: raises $0.10 to $0.15
HubertusB: folds 
KRAWA101: folds 
Uncalled bet ($0.10) returned to StealSteeler
StealSteeler collected $0.12 from pot
StealSteeler: doesn't show hand 
*** SUMMARY ***
Total pot $0.12 | Rake $0 
Seat 1: StealSteeler (button) collected ($0.12)
Seat 2: HubertusB (small blind) folded before Flop
Seat 3: KRAWA101 (big blind) folded before Flop
Seat 4: 3iourou folded before Flop (didn't bet)
Seat 5: folydr folded before Flop (didn't bet)
Seat 6: Yolff folded before Flop (didn't bet)



PokerStars Zoom Hand #178483738131:  Hold'em No Limit ($0.02/$0.05) - 2017/11/20 21:57:45 CCT [2017/11/20 8:57:45 ET]
Table 'Donati' 6-max Seat #1 is the button
Seat 1: HubertusB ($4.48 in chips) 
Seat 2: Muurzik ($5.70 in chips) 
Seat 3: AverianovA ($5.92 in chips) 
Seat 4: nenadhebiv ($6.01 in chips) 
Seat 5: Brunazza8$8 ($4.78 in chips) 
Seat 6: Polypops ($5 in chips) 
Muurzik: posts small blind $0.02
AverianovA: posts big blind $0.05
*** HOLE CARDS ***
Dealt to HubertusB [6s 9s]
nenadhebiv: folds 
Brunazza8$8: raises $0.10 to $0.15
Polypops: folds 
HubertusB: folds 
Muurzik: folds 
AverianovA: folds 
Uncalled bet ($0.10) returned to Brunazza8$8
Brunazza8$8 collected $0.12 from pot
Brunazza8$8: doesn't show hand 
*** SUMMARY ***
Total pot $0.12 | Rake $0 
Seat 1: HubertusB (button) folded before Flop (didn't bet)
Seat 2: Muurzik (small blind) folded before Flop
Seat 3: AverianovA (big blind) folded before Flop
Seat 4: nenadhebiv folded before Flop (didn't bet)
Seat 5: Brunazza8$8 collected ($0.12)
Seat 6: Polypops folded before Flop (didn't bet)



PokerStars Zoom Hand #178483742980:  Hold'em No Limit ($0.02/$0.05) - 2017/11/20 21:57:56 CCT [2017/11/20 8:57:56 ET]
Table 'Donati' 6-max Seat #1 is the button
Seat 1: Sheitan2911 ($5.03 in chips) 
Seat 2: djuniorm ($6.28 in chips) 
Seat 3: jase28 ($4.93 in chips) 
Seat 4: ProAnastasia ($2.42 in chips) 
Seat 5: paradiseg174 ($7.65 in chips) 
Seat 6: HubertusB ($4.48 in chips) 
djuniorm: posts small blind $0.02
jase28: posts big blind $0.05
*** HOLE CARDS ***
Dealt to HubertusB [Ad 5s]
ProAnastasia: folds 
paradiseg174: folds 
HubertusB: folds 
Sheitan2911: folds 
djuniorm: folds 
Uncalled bet ($0.03) returned to jase28
jase28 collected $0.04 from pot
jase28: doesn't show hand 
*** SUMMARY ***
Total pot $0.04 | Rake $0 
Seat 1: Sheitan2911 (button) folded before Flop (didn't bet)
Seat 2: djuniorm (small blind) folded before Flop
Seat 3: jase28 (big blind) collected ($0.04)
Seat 4: ProAnastasia folded before Flop (didn't bet)
Seat 5: paradiseg174 folded before Flop (didn't bet)
Seat 6: HubertusB folded before Flop (didn't bet)



PokerStars Zoom Hand #178483746937:  Hold'em No Limit ($0.02/$0.05) - 2017/11/20 21:58:05 CCT [2017/11/20 8:58:05 ET]
Table 'Donati' 6-max Seat #1 is the button
Seat 1: JacksonSpbRu ($9.01 in chips) 
Seat 2: KKrtva ($5 in chips) 
Seat 3: Yolff ($9.54 in chips) 
Seat 4: 13argentina ($4.61 in chips) 
Seat 5: HubertusB ($4.48 in chips) 
Seat 6: paxton2468 ($7.79 in chips) 
KKrtva: posts small blind $0.02
Yolff: posts big blind $0.05
*** HOLE CARDS ***
Dealt to HubertusB [Qd Kd]
13argentina: calls $0.05
HubertusB: raises $0.20 to $0.25
paxton2468: folds 
JacksonSpbRu: folds 
KKrtva: calls $0.23
Yolff: folds 
13argentina: calls $0.20
*** FLOP *** [Ks 7c 8s]
KKrtva: checks 
13argentina: bets $0.05
HubertusB: raises $0.48 to $0.53
KKrtva: folds 
13argentina: calls $0.48
*** TURN *** [Ks 7c 8s] [9c]
13argentina: checks 
HubertusB: bets $0.98
13argentina: calls $0.98
*** RIVER *** [Ks 7c 8s 9c] [4d]
13argentina: checks 
HubertusB: checks 
*** SHOW DOWN ***
13argentina: shows [Js 3s] (high card King)
HubertusB: shows [Qd Kd] (a pair of Kings)
HubertusB collected $3.66 from pot
*** SUMMARY ***
Total pot $3.82 | Rake $0.16 
Board [Ks 7c 8s 9c 4d]
Seat 1: JacksonSpbRu (button) folded before Flop (didn't bet)
Seat 2: KKrtva (small blind) folded on the Flop
Seat 3: Yolff (big blind) folded before Flop
Seat 4: 13argentina showed [Js 3s] and lost with high card King
Seat 5: HubertusB showed [Qd Kd] and won ($3.66) with a pair of Kings
Seat 6: paxton2468 folded before Flop (didn't bet)



PokerStars Zoom Hand #178483784461:  Hold'em No Limit ($0.02/$0.05) - 2017/11/20 21:59:30 CCT [2017/11/20 8:59:30 ET]
Table 'Donati' 6-max Seat #1 is the button
Seat 1: kaktak223 ($9.14 in chips) 
Seat 2: HubertusB ($6.38 in chips) 
Seat 3: winsstorm ($5.71 in chips) 
Seat 4: With_no_Pain ($5 in chips) 
Seat 5: Puha85 ($8.66 in chips) 
Seat 6: nenadhebiv ($5.15 in chips) 
HubertusB: posts small blind $0.02
winsstorm: posts big blind $0.05
*** HOLE CARDS ***
Dealt to HubertusB [Qd 5h]
With_no_Pain: folds 
Puha85: folds 
nenadhebiv: folds 
kaktak223: folds 
HubertusB: folds 
Uncalled bet ($0.03) returned to winsstorm
winsstorm collected $0.04 from pot
winsstorm: doesn't show hand 
*** SUMMARY ***
Total pot $0.04 | Rake $0 
Seat 1: kaktak223 (button) folded before Flop (didn't bet)
Seat 2: HubertusB (small blind) folded before Flop
Seat 3: winsstorm (big blind) collected ($0.04)
Seat 4: With_no_Pain folded before Flop (didn't bet)
Seat 5: Puha85 folded before Flop (didn't bet)
Seat 6: nenadhebiv folded before Flop (didn't bet)



PokerStars Zoom Hand #178483780485:  Hold'em No Limit ($0.02/$0.05) - 2017/11/20 21:59:21 CCT [2017/11/20 8:59:21 ET]
Table 'Donati' 6-max Seat #1 is the button
Seat 1: alexey9210a ($5.04 in chips) 
Seat 2: luckyjim vd ($5.09 in chips) 
Seat 3: igrokstar379 ($7.64 in chips) 
Seat 4: Brunazza8$8 ($5.07 in chips) 
Seat 5: HubertusB ($6.38 in chips) 
Seat 6: iskander575 ($1.39 in chips) 
luckyjim vd: posts small blind $0.02
igrokstar379: posts big blind $0.05
*** HOLE CARDS ***
Dealt to HubertusB [8d 9h]
Brunazza8$8: folds 
HubertusB: folds 
iskander575: folds 
alexey9210a: raises $0.07 to $0.12
luckyjim vd: calls $0.10
igrokstar379: folds 
*** FLOP *** [3c Th 6h]
luckyjim vd: checks 
alexey9210a: bets $0.19
luckyjim vd: raises $0.19 to $0.38
alexey9210a: folds 
Uncalled bet ($0.19) returned to luckyjim vd
luckyjim vd collected $0.64 from pot
luckyjim vd: doesn't show hand 
*** SUMMARY ***
Total pot $0.67 | Rake $0.03 
Board [3c Th 6h]
Seat 1: alexey9210a (button) folded on the Flop
Seat 2: luckyjim vd (small blind) collected ($0.64)
Seat 3: igrokstar379 (big blind) folded before Flop
Seat 4: Brunazza8$8 folded before Flop (didn't bet)
Seat 5: HubertusB folded before Flop (didn't bet)
Seat 6: iskander575 folded before Flop (didn't bet)



PokerStars Zoom Hand #178483789313:  Hold'em No Limit ($0.02/$0.05) - 2017/11/20 21:59:41 CCT [2017/11/20 8:59:41 ET]
Table 'Donati' 6-max Seat #1 is the button
Seat 1: Acedan1369 ($5 in chips) 
Seat 2: JoelCrisp ($5.05 in chips) 
Seat 3: Knaix ($6.34 in chips) 
Seat 4: HubertusB ($6.36 in chips) 
Seat 5: GizaGliwic ($8.83 in chips) 
Seat 6: metalblack ($8.74 in chips) 
JoelCrisp: posts small blind $0.02
Knaix: posts big blind $0.05
*** HOLE CARDS ***
Dealt to HubertusB [6s 2c]
HubertusB: folds 
GizaGliwic: folds 
metalblack: folds 
Acedan1369: folds 
JoelCrisp: raises $0.05 to $0.10
Knaix: calls $0.05
*** FLOP *** [6h Kh 4h]
JoelCrisp: bets $0.15
Knaix: folds 
Uncalled bet ($0.15) returned to JoelCrisp
JoelCrisp collected $0.19 from pot
JoelCrisp: doesn't show hand 
*** SUMMARY ***
Total pot $0.20 | Rake $0.01 
Board [6h Kh 4h]
Seat 1: Acedan1369 (button) folded before Flop (didn't bet)
Seat 2: JoelCrisp (small blind) collected ($0.19)
Seat 3: Knaix (big blind) folded on the Flop
Seat 4: HubertusB folded before Flop (didn't bet)
Seat 5: GizaGliwic folded before Flop (didn't bet)
Seat 6: metalblack folded before Flop (didn't bet)



PokerStars Zoom Hand #178483791489:  Hold'em No Limit ($0.02/$0.05) - 2017/11/20 21:59:46 CCT [2017/11/20 8:59:46 ET]
Table 'Donati' 6-max Seat #1 is the button
Seat 1: KRAWA101 ($5.07 in chips) 
Seat 2: Sizing5 ($4.86 in chips) 
Seat 3: HubertusB ($6.36 in chips) 
Seat 4: MalCriado47 ($4.80 in chips) 
Seat 5: Predator1447 ($5.23 in chips) 
Seat 6: fmo01 ($7.07 in chips) 
Sizing5: posts small blind $0.02
HubertusB: posts big blind $0.05
*** HOLE CARDS ***
Dealt to HubertusB [Kh 4c]
MalCriado47: folds 
Predator1447: folds 
fmo01: folds 
KRAWA101: folds 
Sizing5: folds 
Uncalled bet ($0.03) returned to HubertusB
HubertusB collected $0.04 from pot
HubertusB: doesn't show hand 
*** SUMMARY ***
Total pot $0.04 | Rake $0 
Seat 1: KRAWA101 (button) folded before Flop (didn't bet)
Seat 2: Sizing5 (small blind) folded before Flop
Seat 3: HubertusB (big blind) collected ($0.04)
Seat 4: MalCriado47 folded before Flop (didn't bet)
Seat 5: Predator1447 folded before Flop (didn't bet)
Seat 6: fmo01 folded before Flop (didn't bet)



PokerStars Zoom Hand #178483817628:  Hold'em No Limit ($0.02/$0.05) - 2017/11/20 22:00:44 CCT [2017/11/20 9:00:44 ET]
Table 'Donati' 6-max Seat #1 is the button
Seat 1: HubertusB ($6.38 in chips) 
Seat 2: kiitek ($5.01 in chips) 
Seat 3: fdmsabrndv ($6.31 in chips) 
Seat 4: Kasabian961 ($5.07 in chips) 
Seat 5: dark h0r$e ($5.16 in chips) 
Seat 6: archerv13 ($5 in chips) 
kiitek: posts small blind $0.02
fdmsabrndv: posts big blind $0.05
*** HOLE CARDS ***
Dealt to HubertusB [5c 9s]
Kasabian961: folds 
dark h0r$e: folds 
archerv13: folds 
HubertusB: folds 
kiitek: folds 
Uncalled bet ($0.03) returned to fdmsabrndv
fdmsabrndv collected $0.04 from pot
fdmsabrndv: doesn't show hand 
*** SUMMARY ***
Total pot $0.04 | Rake $0 
Seat 1: HubertusB (button) folded before Flop (didn't bet)
Seat 2: kiitek (small blind) folded before Flop
Seat 3: fdmsabrndv (big blind) collected ($0.04)
Seat 4: Kasabian961 folded before Flop (didn't bet)
Seat 5: dark h0r$e folded before Flop (didn't bet)
Seat 6: archerv13 folded before Flop (didn't bet)



PokerStars Zoom Hand #178483806695:  Hold'em No Limit ($0.02/$0.05) - 2017/11/20 22:00:20 CCT [2017/11/20 9:00:20 ET]
Table 'Donati' 6-max Seat #1 is the button
Seat 1: kodi00 ($4.56 in chips) 
Seat 2: bob185 ($6.39 in chips) 
Seat 3: kaktak223 ($8.94 in chips) 
Seat 4: Oliana88 ($5 in chips) 
Seat 5: wade3214 ($5.56 in chips) 
Seat 6: HubertusB ($6.38 in chips) 
bob185: posts small blind $0.02
kaktak223: posts big blind $0.05
*** HOLE CARDS ***
Dealt to HubertusB [Qs Jh]
Oliana88: folds 
wade3214: raises $0.10 to $0.15
HubertusB: folds 
kodi00: folds 
bob185: folds 
kaktak223: raises $0.30 to $0.45
wade3214: calls $0.30
*** FLOP *** [Tc Ah 4c]
kaktak223: bets $0.65
wade3214: folds 
Uncalled bet ($0.65) returned to kaktak223
kaktak223 collected $0.88 from pot
kaktak223: doesn't show hand 
*** SUMMARY ***
Total pot $0.92 | Rake $0.04 
Board [Tc Ah 4c]
Seat 1: kodi00 (button) folded before Flop (didn't bet)
Seat 2: bob185 (small blind) folded before Flop
Seat 3: kaktak223 (big blind) collected ($0.88)
Seat 4: Oliana88 folded before Flop (didn't bet)
Seat 5: wade3214 folded on the Flop
Seat 6: HubertusB folded before Flop (didn't bet)



PokerStars Zoom Hand #178483821287:  Hold'em No Limit ($0.02/$0.05) - 2017/11/20 22:00:52 CCT [2017/11/20 9:00:52 ET]
Table 'Donati' 6-max Seat #1 is the button
Seat 1: EatBatteries ($4.79 in chips) 
Seat 2: CdT94 ($5 in chips) 
Seat 3: Fi$hAndChipz ($8.62 in chips) 
Seat 4: HubertusB ($6.38 in chips) 
Seat 5: croissantje ($5 in chips) 
Seat 6: Kpaxa6op2 ($2.66 in chips) 
CdT94: posts small blind $0.02
Fi$hAndChipz: posts big blind $0.05
*** HOLE CARDS ***
Dealt to HubertusB [5h 2h]
HubertusB: folds 
croissantje: folds 
Kpaxa6op2: folds 
EatBatteries: folds 
CdT94: folds 
Uncalled bet ($0.03) returned to Fi$hAndChipz
Fi$hAndChipz collected $0.04 from pot
Fi$hAndChipz: doesn't show hand 
*** SUMMARY ***
Total pot $0.04 | Rake $0 
Seat 1: EatBatteries (button) folded before Flop (didn't bet)
Seat 2: CdT94 (small blind) folded before Flop
Seat 3: Fi$hAndChipz (big blind) collected ($0.04)
Seat 4: HubertusB folded before Flop (didn't bet)
Seat 5: croissantje folded before Flop (didn't bet)
Seat 6: Kpaxa6op2 folded before Flop (didn't bet)



PokerStars Zoom Hand #178483814404:  Hold'em No Limit ($0.02/$0.05) - 2017/11/20 22:00:37 CCT [2017/11/20 9:00:37 ET]
Table 'Donati' 6-max Seat #1 is the button
Seat 1: Poker sta705 ($7.24 in chips) 
Seat 2: Carlostibu94 ($5.93 in chips) 
Seat 3: nefelim21 ($5 in chips) 
Seat 4: HubertusB ($6.38 in chips) 
Seat 5: kirtsy244 ($6.37 in chips) 
Seat 6: dem912 ($5.59 in chips) 
Carlostibu94: posts small blind $0.02
nefelim21: posts big blind $0.05
*** HOLE CARDS ***
Dealt to HubertusB [7h 9h]
HubertusB: folds 
kirtsy244: folds 
dem912: folds 
Poker sta705: folds 
Carlostibu94: raises $0.10 to $0.15
nefelim21: raises $0.30 to $0.45
Carlostibu94: calls $0.30
*** FLOP *** [4s 9c Kh]
Carlostibu94: checks 
nefelim21: bets $0.45
Carlostibu94: folds 
Uncalled bet ($0.45) returned to nefelim21
nefelim21 collected $0.86 from pot
nefelim21: doesn't show hand 
*** SUMMARY ***
Total pot $0.90 | Rake $0.04 
Board [4s 9c Kh]
Seat 1: Poker sta705 (button) folded before Flop (didn't bet)
Seat 2: Carlostibu94 (small blind) folded on the Flop
Seat 3: nefelim21 (big blind) collected ($0.86)
Seat 4: HubertusB folded before Flop (didn't bet)
Seat 5: kirtsy244 folded before Flop (didn't bet)
Seat 6: dem912 folded before Flop (didn't bet)



PokerStars Zoom Hand #178483823657:  Hold'em No Limit ($0.02/$0.05) - 2017/11/20 22:00:57 CCT [2017/11/20 9:00:57 ET]
Table 'Donati' 6-max Seat #1 is the button
Seat 1: judy2222 ($10.65 in chips) 
Seat 2: reeqar ($5.52 in chips) 
Seat 3: HubertusB ($6.38 in chips) 
Seat 4: Bonch241 ($8.26 in chips) 
Seat 5: collapse.n1 ($6.64 in chips) 
Seat 6: pogordaniel ($5.25 in chips) 
reeqar: posts small blind $0.02
HubertusB: posts big blind $0.05
*** HOLE CARDS ***
Dealt to HubertusB [2h Tc]
Bonch241: folds 
collapse.n1: folds 
pogordaniel: folds 
judy2222: raises $0.10 to $0.15
reeqar: folds 
HubertusB: folds 
Uncalled bet ($0.10) returned to judy2222
judy2222 collected $0.12 from pot
judy2222: doesn't show hand 
*** SUMMARY ***
Total pot $0.12 | Rake $0 
Seat 1: judy2222 (button) collected ($0.12)
Seat 2: reeqar (small blind) folded before Flop
Seat 3: HubertusB (big blind) folded before Flop
Seat 4: Bonch241 folded before Flop (didn't bet)
Seat 5: collapse.n1 folded before Flop (didn't bet)
Seat 6: pogordaniel folded before Flop (didn't bet)



PokerStars Zoom Hand #178483831515:  Hold'em No Limit ($0.02/$0.05) - 2017/11/20 22:01:13 CCT [2017/11/20 9:01:13 ET]
Table 'Donati' 6-max Seat #1 is the button
Seat 1: bob185 ($4.85 in chips) 
Seat 2: fmo01 ($5.72 in chips) 
Seat 3: NikKram ($5 in chips) 
Seat 4: JCG22222 ($10.67 in chips) 
Seat 5: p00ker_pl ($5 in chips) 
Seat 6: HubertusB ($6.31 in chips) 
fmo01: posts small blind $0.02
NikKram: posts big blind $0.05
*** HOLE CARDS ***
Dealt to HubertusB [4h 3c]
JCG22222: folds 
p00ker_pl: folds 
HubertusB: folds 
bob185: folds 
fmo01: folds 
Uncalled bet ($0.03) returned to NikKram
NikKram collected $0.04 from pot
NikKram: doesn't show hand 
*** SUMMARY ***
Total pot $0.04 | Rake $0 
Seat 1: bob185 (button) folded before Flop (didn't bet)
Seat 2: fmo01 (small blind) folded before Flop
Seat 3: NikKram (big blind) collected ($0.04)
Seat 4: JCG22222 folded before Flop (didn't bet)
Seat 5: p00ker_pl folded before Flop (didn't bet)
Seat 6: HubertusB folded before Flop (didn't bet)



PokerStars Zoom Hand #178483828598:  Hold'em No Limit ($0.02/$0.05) - 2017/11/20 22:01:07 CCT [2017/11/20 9:01:07 ET]
Table 'Donati' 6-max Seat #1 is the button
Seat 1: dark h0r$e ($5.61 in chips) 
Seat 2: HubertusB ($6.33 in chips) 
Seat 3: GizaGliwic ($9.05 in chips) 
Seat 4: coolgrays ($4.69 in chips) 
Seat 5: archerv13 ($5 in chips) 
Seat 6: AchiKouros ($5 in chips) 
HubertusB: posts small blind $0.02
GizaGliwic: posts big blind $0.05
*** HOLE CARDS ***
Dealt to HubertusB [Kh 4h]
coolgrays: folds 
archerv13: folds 
AchiKouros: folds 
dark h0r$e: raises $0.10 to $0.15
HubertusB: folds 
GizaGliwic: calls $0.10
*** FLOP *** [8h 6h 5s]
GizaGliwic: checks 
dark h0r$e: bets $0.20
GizaGliwic: calls $0.20
*** TURN *** [8h 6h 5s] [Th]
GizaGliwic: bets $0.37
dark h0r$e: calls $0.37
*** RIVER *** [8h 6h 5s Th] [Qc]
GizaGliwic: checks 
dark h0r$e: checks 
*** SHOW DOWN ***
GizaGliwic: shows [Qs 9s] (a pair of Queens)
dark h0r$e: shows [6c 6d] (three of a kind, Sixes)
dark h0r$e collected $1.40 from pot
*** SUMMARY ***
Total pot $1.46 | Rake $0.06 
Board [8h 6h 5s Th Qc]
Seat 1: dark h0r$e (button) showed [6c 6d] and won ($1.40) with three of a kind, Sixes
Seat 2: HubertusB (small blind) folded before Flop
Seat 3: GizaGliwic (big blind) showed [Qs 9s] and lost with a pair of Queens
Seat 4: coolgrays folded before Flop (didn't bet)
Seat 5: archerv13 folded before Flop (didn't bet)
Seat 6: AchiKouros folded before Flop (didn't bet)



PokerStars Zoom Hand #178483841161:  Hold'em No Limit ($0.02/$0.05) - 2017/11/20 22:01:33 CCT [2017/11/20 9:01:33 ET]
Table 'Donati' 6-max Seat #1 is the button
Seat 1: HubertusB ($6.31 in chips) 
Seat 2: folydr ($7.28 in chips) 
Seat 3: AK@KK@AK ($10.88 in chips) 
Seat 4: Fi$hAndChipz ($11.30 in chips) 
Seat 5: Noen ($9.11 in chips) 
Seat 6: botrobot777 ($5.71 in chips) 
folydr: posts small blind $0.02
AK@KK@AK: posts big blind $0.05
*** HOLE CARDS ***
Dealt to HubertusB [Qc Jd]
Fi$hAndChipz: raises $0.10 to $0.15
Noen: folds 
botrobot777: calls $0.15
HubertusB: folds 
folydr: folds 
AK@KK@AK: folds 
*** FLOP *** [2d 5s 9c]
Fi$hAndChipz: bets $0.20
botrobot777: folds 
Uncalled bet ($0.20) returned to Fi$hAndChipz
Fi$hAndChipz collected $0.35 from pot
Fi$hAndChipz: doesn't show hand 
*** SUMMARY ***
Total pot $0.37 | Rake $0.02 
Board [2d 5s 9c]
Seat 1: HubertusB (button) folded before Flop (didn't bet)
Seat 2: folydr (small blind) folded before Flop
Seat 3: AK@KK@AK (big blind) folded before Flop
Seat 4: Fi$hAndChipz collected ($0.35)
Seat 5: Noen folded before Flop (didn't bet)
Seat 6: botrobot777 folded on the Flop



PokerStars Zoom Hand #178483847026:  Hold'em No Limit ($0.02/$0.05) - 2017/11/20 22:01:45 CCT [2017/11/20 9:01:45 ET]
Table 'Donati' 6-max Seat #1 is the button
Seat 1: RomalloFox ($7.52 in chips) 
Seat 2: Nicosan.ru ($8.28 in chips) 
Seat 3: IrenVasya ($5 in chips) 
Seat 4: KLAREN5 ($5.12 in chips) 
Seat 5: SHUR43 ($5.02 in chips) 
Seat 6: HubertusB ($6.31 in chips) 
Nicosan.ru: posts small blind $0.02
IrenVasya: posts big blind $0.05
*** HOLE CARDS ***
Dealt to HubertusB [2d Js]
KLAREN5: calls $0.05
SHUR43: folds 
HubertusB: folds 
RomalloFox: folds 
Nicosan.ru: raises $0.15 to $0.20
IrenVasya: folds 
KLAREN5: calls $0.15
*** FLOP *** [6c 5s 9c]
Nicosan.ru: bets $0.45
KLAREN5: folds 
Uncalled bet ($0.45) returned to Nicosan.ru
Nicosan.ru collected $0.43 from pot
Nicosan.ru: doesn't show hand 
*** SUMMARY ***
Total pot $0.45 | Rake $0.02 
Board [6c 5s 9c]
Seat 1: RomalloFox (button) folded before Flop (didn't bet)
Seat 2: Nicosan.ru (small blind) collected ($0.43)
Seat 3: IrenVasya (big blind) folded before Flop
Seat 4: KLAREN5 folded on the Flop
Seat 5: SHUR43 folded before Flop (didn't bet)
Seat 6: HubertusB folded before Flop (didn't bet)



PokerStars Zoom Hand #178483849635:  Hold'em No Limit ($0.02/$0.05) - 2017/11/20 22:01:50 CCT [2017/11/20 9:01:50 ET]
Table 'Donati' 6-max Seat #1 is the button
Seat 1: vcf2013 ($10.81 in chips) 
Seat 2: HubertusB ($6.31 in chips) 
Seat 3: ALazarev157 ($21.49 in chips) 
Seat 4: ckob731 ($5.09 in chips) 
Seat 5: cikacikacika ($4.65 in chips) 
Seat 6: PeterPoker21 ($5.28 in chips) 
HubertusB: posts small blind $0.02
ALazarev157: posts big blind $0.05
*** HOLE CARDS ***
Dealt to HubertusB [2d Tc]
ckob731: folds 
cikacikacika: folds 
PeterPoker21: raises $0.08 to $0.13
vcf2013: folds 
HubertusB: folds 
ALazarev157: folds 
Uncalled bet ($0.08) returned to PeterPoker21
PeterPoker21 collected $0.12 from pot
PeterPoker21: doesn't show hand 
*** SUMMARY ***
Total pot $0.12 | Rake $0 
Seat 1: vcf2013 (button) folded before Flop (didn't bet)
Seat 2: HubertusB (small blind) folded before Flop
Seat 3: ALazarev157 (big blind) folded before Flop
Seat 4: ckob731 folded before Flop (didn't bet)
Seat 5: cikacikacika folded before Flop (didn't bet)
Seat 6: PeterPoker21 collected ($0.12)



PokerStars Zoom Hand #178483852112:  Hold'em No Limit ($0.02/$0.05) - 2017/11/20 22:01:55 CCT [2017/11/20 9:01:55 ET]
Table 'Donati' 6-max Seat #1 is the button
Seat 1: Acedan1369 ($14.75 in chips) 
Seat 2: collapse.n1 ($5.27 in chips) 
Seat 3: HubertusB ($6.29 in chips) 
Seat 4: SLuTxTReMe ($7.71 in chips) 
Seat 5: ItWasDuke ($9.15 in chips) 
Seat 6: vcf2013 ($10.81 in chips) 
collapse.n1: posts small blind $0.02
HubertusB: posts big blind $0.05
*** HOLE CARDS ***
Dealt to HubertusB [3h 9h]
SLuTxTReMe: folds 
ItWasDuke: folds 
vcf2013: folds 
Acedan1369: folds 
collapse.n1: raises $0.10 to $0.15
HubertusB: folds 
Uncalled bet ($0.10) returned to collapse.n1
collapse.n1 collected $0.10 from pot
collapse.n1: doesn't show hand 
*** SUMMARY ***
Total pot $0.10 | Rake $0 
Seat 1: Acedan1369 (button) folded before Flop (didn't bet)
Seat 2: collapse.n1 (small blind) collected ($0.10)
Seat 3: HubertusB (big blind) folded before Flop
Seat 4: SLuTxTReMe folded before Flop (didn't bet)
Seat 5: ItWasDuke folded before Flop (didn't bet)
Seat 6: vcf2013 folded before Flop (didn't bet)



PokerStars Zoom Hand #178483867301:  Hold'em No Limit ($0.02/$0.05) - 2017/11/20 22:02:25 CCT [2017/11/20 9:02:25 ET]
Table 'Donati' 6-max Seat #1 is the button
Seat 1: kirtsy244 ($5.17 in chips) 
Seat 2: Fi$hAndChipz ($8.67 in chips) 
Seat 3: Muurzik ($6.27 in chips) 
Seat 4: HubertusB ($6.24 in chips) 
Seat 5: AverianovA ($7.67 in chips) 
Seat 6: Bossnia007 ($5.62 in chips) 
Fi$hAndChipz: posts small blind $0.02
Muurzik: posts big blind $0.05
*** HOLE CARDS ***
Dealt to HubertusB [Tc Th]
HubertusB: raises $0.05 to $0.10
AverianovA: folds 
Bossnia007: folds 
kirtsy244: folds 
Fi$hAndChipz: folds 
Muurzik: folds 
Uncalled bet ($0.05) returned to HubertusB
HubertusB collected $0.12 from pot
HubertusB: doesn't show hand 
*** SUMMARY ***
Total pot $0.12 | Rake $0 
Seat 1: kirtsy244 (button) folded before Flop (didn't bet)
Seat 2: Fi$hAndChipz (small blind) folded before Flop
Seat 3: Muurzik (big blind) folded before Flop
Seat 4: HubertusB collected ($0.12)
Seat 5: AverianovA folded before Flop (didn't bet)
Seat 6: Bossnia007 folded before Flop (didn't bet)



PokerStars Zoom Hand #178483875290:  Hold'em No Limit ($0.02/$0.05) - 2017/11/20 22:02:41 CCT [2017/11/20 9:02:41 ET]
Table 'Donati' 6-max Seat #1 is the button
Seat 1: HubertusB ($6.31 in chips) 
Seat 2: Mike3stakana ($5 in chips) 
Seat 3: svansong ($5.18 in chips) 
Seat 4: tifakhten ($5.81 in chips) 
Seat 5: McFischer87 ($6.30 in chips) 
Seat 6: chester8676 ($4.93 in chips) 
Mike3stakana: posts small blind $0.02
svansong: posts big blind $0.05
*** HOLE CARDS ***
Dealt to HubertusB [2d 7c]
tifakhten: folds 
McFischer87: raises $0.10 to $0.15
chester8676: folds 
HubertusB: folds 
Mike3stakana: folds 
svansong: folds 
Uncalled bet ($0.10) returned to McFischer87
McFischer87 collected $0.12 from pot
McFischer87: doesn't show hand 
*** SUMMARY ***
Total pot $0.12 | Rake $0 
Seat 1: HubertusB (button) folded before Flop (didn't bet)
Seat 2: Mike3stakana (small blind) folded before Flop
Seat 3: svansong (big blind) folded before Flop
Seat 4: tifakhten folded before Flop (didn't bet)
Seat 5: McFischer87 collected ($0.12)
Seat 6: chester8676 folded before Flop (didn't bet)



PokerStars Zoom Hand #178483864155:  Hold'em No Limit ($0.02/$0.05) - 2017/11/20 22:02:19 CCT [2017/11/20 9:02:19 ET]
Table 'Donati' 6-max Seat #1 is the button
Seat 1: 3iourou ($5.22 in chips) 
Seat 2: Kpaxa6op2 ($3.68 in chips) 
Seat 3: Vynnypoker ($5.64 in chips) 
Seat 4: JCG22222 ($7.85 in chips) 
Seat 5: HubertusB ($6.24 in chips) 
Seat 6: mitchm232 ($6.16 in chips) 
Kpaxa6op2: posts small blind $0.02
Vynnypoker: posts big blind $0.05
*** HOLE CARDS ***
Dealt to HubertusB [3h Td]
JCG22222: folds 
HubertusB: folds 
mitchm232: folds 
3iourou: raises $0.06 to $0.11
Kpaxa6op2: calls $0.09
Vynnypoker: folds 
*** FLOP *** [7h Qs 4s]
Kpaxa6op2: checks 
3iourou: bets $0.16
Kpaxa6op2: folds 
Uncalled bet ($0.16) returned to 3iourou
3iourou collected $0.26 from pot
3iourou: doesn't show hand 
*** SUMMARY ***
Total pot $0.27 | Rake $0.01 
Board [7h Qs 4s]
Seat 1: 3iourou (button) collected ($0.26)
Seat 2: Kpaxa6op2 (small blind) folded on the Flop
Seat 3: Vynnypoker (big blind) folded before Flop
Seat 4: JCG22222 folded before Flop (didn't bet)
Seat 5: HubertusB folded before Flop (didn't bet)
Seat 6: mitchm232 folded before Flop (didn't bet)



