PokerStars Zoom Hand #177277479397:  Hold'em No Limit ($0.02/$0.05) - 2017/10/23 21:28:37 CCT [2017/10/23 9:28:37 ET]
Table 'Donati' 6-max Seat #1 is the button
Seat 1: LIghtsout856 ($5.19 in chips) 
Seat 2: justchill198 ($9.35 in chips) 
Seat 3: HubertusB ($5 in chips) 
Seat 4: Liona Ohmann ($1.36 in chips) 
Seat 5: POKERMON 06 ($4.03 in chips) 
Seat 6: Xolod (rus) ($5.20 in chips) 
justchill198: posts small blind $0.02
HubertusB: posts big blind $0.05
*** HOLE CARDS ***
Dealt to HubertusB [Kd 7d]
Liona Ohmann: folds 
POKERMON 06: folds 
Xolod (rus): folds 
LIghtsout856: folds 
justchill198: raises $0.07 to $0.12
HubertusB: folds 
Uncalled bet ($0.07) returned to justchill198
justchill198 collected $0.10 from pot
justchill198: doesn't show hand 
*** SUMMARY ***
Total pot $0.10 | Rake $0 
Seat 1: LIghtsout856 (button) folded before Flop (didn't bet)
Seat 2: justchill198 (small blind) collected ($0.10)
Seat 3: HubertusB (big blind) folded before Flop
Seat 4: Liona Ohmann folded before Flop (didn't bet)
Seat 5: POKERMON 06 folded before Flop (didn't bet)
Seat 6: Xolod (rus) folded before Flop (didn't bet)



PokerStars Zoom Hand #177277494754:  Hold'em No Limit ($0.02/$0.05) - 2017/10/23 21:29:07 CCT [2017/10/23 9:29:07 ET]
Table 'Donati' 6-max Seat #1 is the button
Seat 1: Pandabear11 ($15.12 in chips) 
Seat 2: HubertusB ($4.95 in chips) 
Seat 3: sh1p1t0bv ($20.87 in chips) 
Seat 4: qk rodriguez ($5.82 in chips) 
Seat 5: FantomAsasin ($6.69 in chips) 
Seat 6: Serega93799 ($11.01 in chips) 
HubertusB: posts small blind $0.02
sh1p1t0bv: posts big blind $0.05
*** HOLE CARDS ***
Dealt to HubertusB [9d 3s]
qk rodriguez: folds 
FantomAsasin: folds 
Serega93799: raises $0.10 to $0.15
Pandabear11: folds 
HubertusB: folds 
sh1p1t0bv: folds 
Uncalled bet ($0.10) returned to Serega93799
Serega93799 collected $0.12 from pot
Serega93799: doesn't show hand 
*** SUMMARY ***
Total pot $0.12 | Rake $0 
Seat 1: Pandabear11 (button) folded before Flop (didn't bet)
Seat 2: HubertusB (small blind) folded before Flop
Seat 3: sh1p1t0bv (big blind) folded before Flop
Seat 4: qk rodriguez folded before Flop (didn't bet)
Seat 5: FantomAsasin folded before Flop (didn't bet)
Seat 6: Serega93799 collected ($0.12)



PokerStars Zoom Hand #177277489692:  Hold'em No Limit ($0.02/$0.05) - 2017/10/23 21:28:57 CCT [2017/10/23 9:28:57 ET]
Table 'Donati' 6-max Seat #1 is the button
Seat 1: HubertusB ($4.95 in chips) 
Seat 2: k1v0k ($5.22 in chips) 
Seat 3: PonasAurimas ($5 in chips) 
Seat 4: Excalibur997 ($4.68 in chips) 
Seat 5: Bjeujeuler ($5 in chips) 
Seat 6: sodapopinski70 ($4.68 in chips) 
k1v0k: posts small blind $0.02
PonasAurimas: posts big blind $0.05
*** HOLE CARDS ***
Dealt to HubertusB [7d 6h]
Excalibur997: folds 
Bjeujeuler: raises $0.07 to $0.12
sodapopinski70: calls $0.12
HubertusB: folds 
k1v0k: folds 
PonasAurimas: folds 
*** FLOP *** [Ac 3c 5c]
Bjeujeuler: bets $0.12
sodapopinski70: folds 
Uncalled bet ($0.12) returned to Bjeujeuler
Bjeujeuler collected $0.30 from pot
Bjeujeuler: doesn't show hand 
*** SUMMARY ***
Total pot $0.31 | Rake $0.01 
Board [Ac 3c 5c]
Seat 1: HubertusB (button) folded before Flop (didn't bet)
Seat 2: k1v0k (small blind) folded before Flop
Seat 3: PonasAurimas (big blind) folded before Flop
Seat 4: Excalibur997 folded before Flop (didn't bet)
Seat 5: Bjeujeuler collected ($0.30)
Seat 6: sodapopinski70 folded on the Flop



PokerStars Zoom Hand #177277502519:  Hold'em No Limit ($0.02/$0.05) - 2017/10/23 21:29:22 CCT [2017/10/23 9:29:22 ET]
Table 'Donati' 6-max Seat #1 is the button
Seat 1: diceman0909 ($16.19 in chips) 
Seat 2: pokaloca77 ($7.87 in chips) 
Seat 3: XYHTRA ($5.14 in chips) 
Seat 4: Zavarzukin ($6.68 in chips) 
Seat 5: HubertusB ($4.93 in chips) 
Seat 6: Bacar88 ($5.20 in chips) 
pokaloca77: posts small blind $0.02
XYHTRA: posts big blind $0.05
*** HOLE CARDS ***
Dealt to HubertusB [7h 9s]
Zavarzukin: folds 
HubertusB: folds 
Bacar88: folds 
diceman0909: folds 
pokaloca77: folds 
Uncalled bet ($0.03) returned to XYHTRA
XYHTRA collected $0.04 from pot
XYHTRA: doesn't show hand 
*** SUMMARY ***
Total pot $0.04 | Rake $0 
Seat 1: diceman0909 (button) folded before Flop (didn't bet)
Seat 2: pokaloca77 (small blind) folded before Flop
Seat 3: XYHTRA (big blind) collected ($0.04)
Seat 4: Zavarzukin folded before Flop (didn't bet)
Seat 5: HubertusB folded before Flop (didn't bet)
Seat 6: Bacar88 folded before Flop (didn't bet)



PokerStars Zoom Hand #177277499967:  Hold'em No Limit ($0.02/$0.05) - 2017/10/23 21:29:17 CCT [2017/10/23 9:29:17 ET]
Table 'Donati' 6-max Seat #1 is the button
Seat 1: zz3826638 ($6.56 in chips) 
Seat 2: rack1777 ($5.09 in chips) 
Seat 3: danjmekeru ($5 in chips) 
Seat 4: anett0406 ($2.38 in chips) 
Seat 5: Pawellloo ($14.43 in chips) 
Seat 6: HubertusB ($4.93 in chips) 
rack1777: posts small blind $0.02
danjmekeru: posts big blind $0.05
*** HOLE CARDS ***
Dealt to HubertusB [Ac 2s]
anett0406: raises $0.10 to $0.15
Pawellloo: folds 
HubertusB: folds 
zz3826638: folds 
rack1777: folds 
danjmekeru: folds 
Uncalled bet ($0.10) returned to anett0406
anett0406 collected $0.12 from pot
anett0406: doesn't show hand 
*** SUMMARY ***
Total pot $0.12 | Rake $0 
Seat 1: zz3826638 (button) folded before Flop (didn't bet)
Seat 2: rack1777 (small blind) folded before Flop
Seat 3: danjmekeru (big blind) folded before Flop
Seat 4: anett0406 collected ($0.12)
Seat 5: Pawellloo folded before Flop (didn't bet)
Seat 6: HubertusB folded before Flop (didn't bet)



PokerStars Zoom Hand #177277505123:  Hold'em No Limit ($0.02/$0.05) - 2017/10/23 21:29:27 CCT [2017/10/23 9:29:27 ET]
Table 'Donati' 6-max Seat #1 is the button
Seat 1: Hirx123 ($6.04 in chips) 
Seat 2: sh1p1t0bv ($9.91 in chips) 
Seat 3: HubertusB ($4.93 in chips) 
Seat 4: Muurzik ($5.81 in chips) 
Seat 5: docent3366 ($7.24 in chips) 
Seat 6: GamblerWW ($10.31 in chips) 
sh1p1t0bv: posts small blind $0.02
HubertusB: posts big blind $0.05
*** HOLE CARDS ***
Dealt to HubertusB [Qc Jh]
Muurzik: folds 
docent3366: folds 
GamblerWW: raises $0.10 to $0.15
Hirx123: calls $0.15
sh1p1t0bv: calls $0.13
HubertusB: folds 
*** FLOP *** [Kc 4d Ac]
sh1p1t0bv: checks 
GamblerWW: bets $0.32
Hirx123: folds 
sh1p1t0bv: folds 
Uncalled bet ($0.32) returned to GamblerWW
GamblerWW collected $0.48 from pot
GamblerWW: doesn't show hand 
*** SUMMARY ***
Total pot $0.50 | Rake $0.02 
Board [Kc 4d Ac]
Seat 1: Hirx123 (button) folded on the Flop
Seat 2: sh1p1t0bv (small blind) folded on the Flop
Seat 3: HubertusB (big blind) folded before Flop
Seat 4: Muurzik folded before Flop (didn't bet)
Seat 5: docent3366 folded before Flop (didn't bet)
Seat 6: GamblerWW collected ($0.48)



PokerStars Zoom Hand #177277509794:  Hold'em No Limit ($0.02/$0.05) - 2017/10/23 21:29:36 CCT [2017/10/23 9:29:36 ET]
Table 'Donati' 6-max Seat #1 is the button
Seat 1: Dimks46 ($5 in chips) 
Seat 2: nar0113 ($5 in chips) 
Seat 3: Galaktika74 ($5.99 in chips) 
Seat 4: HubertusB ($4.88 in chips) 
Seat 5: infokiraly ($6.97 in chips) 
Seat 6: geochar87 ($6.25 in chips) 
nar0113: posts small blind $0.02
Galaktika74: posts big blind $0.05
*** HOLE CARDS ***
Dealt to HubertusB [4h Ad]
HubertusB: folds 
infokiraly: raises $0.05 to $0.10
geochar87: folds 
Dimks46: folds 
nar0113: folds 
Galaktika74: calls $0.05
*** FLOP *** [7h 2h 5s]
Galaktika74: checks 
infokiraly: checks 
*** TURN *** [7h 2h 5s] [Kc]
Galaktika74: bets $0.11
infokiraly: folds 
Uncalled bet ($0.11) returned to Galaktika74
Galaktika74 collected $0.21 from pot
Galaktika74: doesn't show hand 
*** SUMMARY ***
Total pot $0.22 | Rake $0.01 
Board [7h 2h 5s Kc]
Seat 1: Dimks46 (button) folded before Flop (didn't bet)
Seat 2: nar0113 (small blind) folded before Flop
Seat 3: Galaktika74 (big blind) collected ($0.21)
Seat 4: HubertusB folded before Flop (didn't bet)
Seat 5: infokiraly folded on the Turn
Seat 6: geochar87 folded before Flop (didn't bet)



PokerStars Zoom Hand #177277522690:  Hold'em No Limit ($0.02/$0.05) - 2017/10/23 21:30:01 CCT [2017/10/23 9:30:01 ET]
Table 'Donati' 6-max Seat #1 is the button
Seat 1: Bjeujeuler ($5.18 in chips) 
Seat 2: k1v0k ($5.02 in chips) 
Seat 3: osfp7john ($11.36 in chips) 
Seat 4: NickSimonik ($8.26 in chips) 
Seat 5: hels1707 ($2.54 in chips) 
Seat 6: HubertusB ($4.86 in chips) 
k1v0k: posts small blind $0.02
osfp7john: posts big blind $0.05
*** HOLE CARDS ***
Dealt to HubertusB [Th Ks]
NickSimonik: folds 
hels1707: folds 
HubertusB: raises $0.05 to $0.10
Bjeujeuler: folds 
k1v0k: folds 
osfp7john: folds 
Uncalled bet ($0.05) returned to HubertusB
HubertusB collected $0.12 from pot
HubertusB: doesn't show hand 
*** SUMMARY ***
Total pot $0.12 | Rake $0 
Seat 1: Bjeujeuler (button) folded before Flop (didn't bet)
Seat 2: k1v0k (small blind) folded before Flop
Seat 3: osfp7john (big blind) folded before Flop
Seat 4: NickSimonik folded before Flop (didn't bet)
Seat 5: hels1707 folded before Flop (didn't bet)
Seat 6: HubertusB collected ($0.12)



PokerStars Zoom Hand #177277512385:  Hold'em No Limit ($0.02/$0.05) - 2017/10/23 21:29:41 CCT [2017/10/23 9:29:41 ET]
Table 'Donati' 6-max Seat #1 is the button
Seat 1: Morgot339 ($5.02 in chips) 
Seat 2: HubertusB ($4.88 in chips) 
Seat 3: jjdns ($3.60 in chips) 
Seat 4: Cleaner108 ($13.27 in chips) 
Seat 5: zale73 ($4.60 in chips) 
Seat 6: Leodr ($4.57 in chips) 
HubertusB: posts small blind $0.02
jjdns: posts big blind $0.05
*** HOLE CARDS ***
Dealt to HubertusB [5d 4c]
Cleaner108: raises $0.09 to $0.14
zale73: calls $0.14
Leodr: folds 
Morgot339: folds 
HubertusB: folds 
jjdns: calls $0.09
*** FLOP *** [Th Ad 5c]
jjdns: checks 
Cleaner108: checks 
zale73: checks 
*** TURN *** [Th Ad 5c] [Ac]
jjdns: checks 
Cleaner108: bets $0.12
zale73: folds 
jjdns: folds 
Uncalled bet ($0.12) returned to Cleaner108
Cleaner108 collected $0.42 from pot
Cleaner108: doesn't show hand 
*** SUMMARY ***
Total pot $0.44 | Rake $0.02 
Board [Th Ad 5c Ac]
Seat 1: Morgot339 (button) folded before Flop (didn't bet)
Seat 2: HubertusB (small blind) folded before Flop
Seat 3: jjdns (big blind) folded on the Turn
Seat 4: Cleaner108 collected ($0.42)
Seat 5: zale73 folded on the Turn
Seat 6: Leodr folded before Flop (didn't bet)



PokerStars Zoom Hand #177277520181:  Hold'em No Limit ($0.02/$0.05) - 2017/10/23 21:29:56 CCT [2017/10/23 9:29:56 ET]
Table 'Donati' 6-max Seat #1 is the button
Seat 1: y=sqrt(5x^3) ($5 in chips) 
Seat 2: MDAlexandru ($5.57 in chips) 
Seat 3: BOSCOBOT ($6.40 in chips) 
Seat 4: HACHI1111 ($7.10 in chips) 
Seat 5: HubertusB ($4.86 in chips) 
Seat 6: Dimks46 ($5 in chips) 
MDAlexandru: posts small blind $0.02
BOSCOBOT: posts big blind $0.05
*** HOLE CARDS ***
Dealt to HubertusB [Jh 2h]
HACHI1111: folds 
HubertusB: folds 
Dimks46: folds 
y=sqrt(5x^3): raises $0.05 to $0.10
MDAlexandru: folds 
BOSCOBOT: calls $0.05
*** FLOP *** [8d Ac Qh]
BOSCOBOT: checks 
y=sqrt(5x^3): bets $0.11
BOSCOBOT: folds 
Uncalled bet ($0.11) returned to y=sqrt(5x^3)
y=sqrt(5x^3) collected $0.21 from pot
y=sqrt(5x^3): doesn't show hand 
*** SUMMARY ***
Total pot $0.22 | Rake $0.01 
Board [8d Ac Qh]
Seat 1: y=sqrt(5x^3) (button) collected ($0.21)
Seat 2: MDAlexandru (small blind) folded before Flop
Seat 3: BOSCOBOT (big blind) folded on the Flop
Seat 4: HACHI1111 folded before Flop (didn't bet)
Seat 5: HubertusB folded before Flop (didn't bet)
Seat 6: Dimks46 folded before Flop (didn't bet)



PokerStars Zoom Hand #177277514978:  Hold'em No Limit ($0.02/$0.05) - 2017/10/23 21:29:46 CCT [2017/10/23 9:29:46 ET]
Table 'Donati' 6-max Seat #1 is the button
Seat 1: HubertusB ($4.86 in chips) 
Seat 2: pinklai ($2.74 in chips) 
Seat 3: pehtaras22 ($15.91 in chips) 
Seat 4: Guido-bomb ($12.66 in chips) 
Seat 5: andrqi ($6.07 in chips) 
Seat 6: Lehi423 ($5.05 in chips) 
pinklai: posts small blind $0.02
pehtaras22: posts big blind $0.05
*** HOLE CARDS ***
Dealt to HubertusB [Ks 9d]
Guido-bomb: folds 
andrqi: raises $0.10 to $0.15
Lehi423: folds 
HubertusB: folds 
pinklai: calls $0.13
pehtaras22: folds 
*** FLOP *** [3s Th Td]
pinklai: checks 
andrqi: checks 
*** TURN *** [3s Th Td] [Qs]
pinklai: checks 
andrqi: checks 
*** RIVER *** [3s Th Td Qs] [Kd]
pinklai: checks 
andrqi: bets $0.17
pinklai: calls $0.17
*** SHOW DOWN ***
andrqi: shows [Kh As] (two pair, Kings and Tens)
pinklai: mucks hand 
andrqi collected $0.66 from pot
*** SUMMARY ***
Total pot $0.69 | Rake $0.03 
Board [3s Th Td Qs Kd]
Seat 1: HubertusB (button) folded before Flop (didn't bet)
Seat 2: pinklai (small blind) mucked [6c 6s]
Seat 3: pehtaras22 (big blind) folded before Flop
Seat 4: Guido-bomb folded before Flop (didn't bet)
Seat 5: andrqi showed [Kh As] and won ($0.66) with two pair, Kings and Tens
Seat 6: Lehi423 folded before Flop (didn't bet)



PokerStars Zoom Hand #177277533634:  Hold'em No Limit ($0.02/$0.05) - 2017/10/23 21:30:22 CCT [2017/10/23 9:30:22 ET]
Table 'Donati' 6-max Seat #1 is the button
Seat 1: Lehi423 ($5 in chips) 
Seat 2: HubertusB ($4.88 in chips) 
Seat 3: salala87 ($10.81 in chips) 
Seat 4: sh1p1t0bv ($20.87 in chips) 
Seat 5: Cayoosh16 ($5.19 in chips) 
Seat 6: osfp7john ($11.29 in chips) 
HubertusB: posts small blind $0.02
salala87: posts big blind $0.05
*** HOLE CARDS ***
Dealt to HubertusB [Jd 7d]
sh1p1t0bv: folds 
Cayoosh16: raises $0.10 to $0.15
osfp7john: folds 
Lehi423: folds 
HubertusB: folds 
salala87: folds 
Uncalled bet ($0.10) returned to Cayoosh16
Cayoosh16 collected $0.12 from pot
Cayoosh16: doesn't show hand 
*** SUMMARY ***
Total pot $0.12 | Rake $0 
Seat 1: Lehi423 (button) folded before Flop (didn't bet)
Seat 2: HubertusB (small blind) folded before Flop
Seat 3: salala87 (big blind) folded before Flop
Seat 4: sh1p1t0bv folded before Flop (didn't bet)
Seat 5: Cayoosh16 collected ($0.12)
Seat 6: osfp7john folded before Flop (didn't bet)



PokerStars Zoom Hand #177277538837:  Hold'em No Limit ($0.02/$0.05) - 2017/10/23 21:30:32 CCT [2017/10/23 9:30:32 ET]
Table 'Donati' 6-max Seat #1 is the button
Seat 1: HubertusB ($4.86 in chips) 
Seat 2: Makum70 ($4.48 in chips) 
Seat 3: parfumer123 ($5.16 in chips) 
Seat 4: rack1777 ($5.38 in chips) 
Seat 5: McLaude669 ($2.50 in chips) 
Seat 6: Silencer91 ($7.42 in chips) 
Makum70: posts small blind $0.02
parfumer123: posts big blind $0.05
*** HOLE CARDS ***
Dealt to HubertusB [Th 4d]
rack1777: folds 
McLaude669: folds 
Silencer91: folds 
HubertusB: folds 
Makum70: folds 
Uncalled bet ($0.03) returned to parfumer123
parfumer123 collected $0.04 from pot
parfumer123: doesn't show hand 
*** SUMMARY ***
Total pot $0.04 | Rake $0 
Seat 1: HubertusB (button) folded before Flop (didn't bet)
Seat 2: Makum70 (small blind) folded before Flop
Seat 3: parfumer123 (big blind) collected ($0.04)
Seat 4: rack1777 folded before Flop (didn't bet)
Seat 5: McLaude669 folded before Flop (didn't bet)
Seat 6: Silencer91 folded before Flop (didn't bet)



PokerStars Zoom Hand #177277536281:  Hold'em No Limit ($0.02/$0.05) - 2017/10/23 21:30:27 CCT [2017/10/23 9:30:27 ET]
Table 'Donati' 6-max Seat #1 is the button
Seat 1: kareelwong ($4.83 in chips) 
Seat 2: Bjeujeuler ($5.09 in chips) 
Seat 3: qk rodriguez ($5.89 in chips) 
Seat 4: Sergei111772 ($2.65 in chips) 
Seat 5: Mo3r308 ($5.11 in chips) 
Seat 6: HubertusB ($4.86 in chips) 
Bjeujeuler: posts small blind $0.02
qk rodriguez: posts big blind $0.05
*** HOLE CARDS ***
Dealt to HubertusB [9s 3d]
Sergei111772: calls $0.05
Mo3r308: raises $0.15 to $0.20
HubertusB: folds 
kareelwong: folds 
Bjeujeuler: folds 
qk rodriguez: folds 
Sergei111772: calls $0.15
*** FLOP *** [Jh 5d 2h]
Sergei111772: checks 
Mo3r308: bets $0.25
Sergei111772: folds 
Uncalled bet ($0.25) returned to Mo3r308
Mo3r308 collected $0.45 from pot
Mo3r308: doesn't show hand 
*** SUMMARY ***
Total pot $0.47 | Rake $0.02 
Board [Jh 5d 2h]
Seat 1: kareelwong (button) folded before Flop (didn't bet)
Seat 2: Bjeujeuler (small blind) folded before Flop
Seat 3: qk rodriguez (big blind) folded before Flop
Seat 4: Sergei111772 folded on the Flop
Seat 5: Mo3r308 collected ($0.45)
Seat 6: HubertusB folded before Flop (didn't bet)



PokerStars Zoom Hand #177277530595:  Hold'em No Limit ($0.02/$0.05) - 2017/10/23 21:30:16 CCT [2017/10/23 9:30:16 ET]
Table 'Donati' 6-max Seat #1 is the button
Seat 1: jochenfratz ($5 in chips) 
Seat 2: Marvelous19 ($13.43 in chips) 
Seat 3: HubertusB ($4.93 in chips) 
Seat 4: Phadrigh ($5.26 in chips) 
Seat 5: ViktorRivne ($2.93 in chips) 
Seat 6: Arthas571 ($5.71 in chips) 
Marvelous19: posts small blind $0.02
HubertusB: posts big blind $0.05
*** HOLE CARDS ***
Dealt to HubertusB [5d Tc]
Phadrigh: raises $0.10 to $0.15
ViktorRivne: folds 
Arthas571: folds 
jochenfratz: calls $0.15
Marvelous19: folds 
HubertusB: folds 
*** FLOP *** [7h Kd 7d]
Phadrigh: bets $0.20
jochenfratz: calls $0.20
*** TURN *** [7h Kd 7d] [Qh]
Phadrigh: bets $0.44
jochenfratz: calls $0.44
*** RIVER *** [7h Kd 7d Qh] [8s]
Phadrigh: bets $1
jochenfratz: calls $1
*** SHOW DOWN ***
Phadrigh: shows [Qs Ks] (two pair, Kings and Queens)
jochenfratz: mucks hand 
Phadrigh collected $3.50 from pot
*** SUMMARY ***
Total pot $3.65 | Rake $0.15 
Board [7h Kd 7d Qh 8s]
Seat 1: jochenfratz (button) mucked [Jh Kh]
Seat 2: Marvelous19 (small blind) folded before Flop
Seat 3: HubertusB (big blind) folded before Flop
Seat 4: Phadrigh showed [Qs Ks] and won ($3.50) with two pair, Kings and Queens
Seat 5: ViktorRivne folded before Flop (didn't bet)
Seat 6: Arthas571 folded before Flop (didn't bet)



PokerStars Zoom Hand #177277550216:  Hold'em No Limit ($0.02/$0.05) - 2017/10/23 21:30:54 CCT [2017/10/23 9:30:54 ET]
Table 'Donati' 6-max Seat #1 is the button
Seat 1: BardJeka ($5 in chips) 
Seat 2: Hoxt0n ($2.79 in chips) 
Seat 3: Sergei111772 ($2.45 in chips) 
Seat 4: HubertusB ($4.86 in chips) 
Seat 5: Baker1326 ($6.01 in chips) 
Seat 6: koreahulk ($9.29 in chips) 
Hoxt0n: posts small blind $0.02
Sergei111772: posts big blind $0.05
*** HOLE CARDS ***
Dealt to HubertusB [Jh 7d]
HubertusB: folds 
Baker1326: folds 
koreahulk: folds 
BardJeka: folds 
Hoxt0n: folds 
Uncalled bet ($0.03) returned to Sergei111772
Sergei111772 collected $0.04 from pot
Sergei111772: doesn't show hand 
*** SUMMARY ***
Total pot $0.04 | Rake $0 
Seat 1: BardJeka (button) folded before Flop (didn't bet)
Seat 2: Hoxt0n (small blind) folded before Flop
Seat 3: Sergei111772 (big blind) collected ($0.04)
Seat 4: HubertusB folded before Flop (didn't bet)
Seat 5: Baker1326 folded before Flop (didn't bet)
Seat 6: koreahulk folded before Flop (didn't bet)



PokerStars Zoom Hand #177277542982:  Hold'em No Limit ($0.02/$0.05) - 2017/10/23 21:30:40 CCT [2017/10/23 9:30:40 ET]
Table 'Donati' 6-max Seat #1 is the button
Seat 1: vickolay ($5 in chips) 
Seat 2: Only_Vizard ($10.90 in chips) 
Seat 3: FootTea ($5.57 in chips) 
Seat 4: BOSCOBOT ($5 in chips) 
Seat 5: HubertusB ($4.86 in chips) 
Seat 6: jjdns ($3.31 in chips) 
Only_Vizard: posts small blind $0.02
FootTea: posts big blind $0.05
*** HOLE CARDS ***
Dealt to HubertusB [2c Qc]
BOSCOBOT: folds 
HubertusB: folds 
jjdns: raises $0.10 to $0.15
vickolay: folds 
Only_Vizard: folds 
FootTea: folds 
Uncalled bet ($0.10) returned to jjdns
jjdns collected $0.12 from pot
jjdns: doesn't show hand 
*** SUMMARY ***
Total pot $0.12 | Rake $0 
Seat 1: vickolay (button) folded before Flop (didn't bet)
Seat 2: Only_Vizard (small blind) folded before Flop
Seat 3: FootTea (big blind) folded before Flop
Seat 4: BOSCOBOT folded before Flop (didn't bet)
Seat 5: HubertusB folded before Flop (didn't bet)
Seat 6: jjdns collected ($0.12)



PokerStars Zoom Hand #177277547604:  Hold'em No Limit ($0.02/$0.05) - 2017/10/23 21:30:49 CCT [2017/10/23 9:30:49 ET]
Table 'Donati' 6-max Seat #1 is the button
Seat 1: NuKEr2k ($2.57 in chips) 
Seat 2: swesda21 ($5.96 in chips) 
Seat 3: Comra1d ($11.92 in chips) 
Seat 4: HubertusB ($4.86 in chips) 
Seat 5: viktor_KK ($10.19 in chips) 
Seat 6: zisis83 ($6.32 in chips) 
swesda21: posts small blind $0.02
Comra1d: posts big blind $0.05
*** HOLE CARDS ***
Dealt to HubertusB [7h 4h]
HubertusB: folds 
viktor_KK: folds 
zisis83: folds 
NuKEr2k: raises $0.07 to $0.12
swesda21: folds 
Comra1d: raises $0.38 to $0.50
NuKEr2k: calls $0.38
*** FLOP *** [7d Qd 4c]
Comra1d: bets $0.54
NuKEr2k: raises $1.53 to $2.07 and is all-in
Comra1d: calls $1.53
*** FIRST TURN *** [7d Qd 4c] [Jc]
*** FIRST RIVER *** [7d Qd 4c Jc] [5h]
*** SECOND TURN *** [7d Qd 4c] [4s]
*** SECOND RIVER *** [7d Qd 4c 4s] [Jd]
*** FIRST SHOW DOWN ***
Comra1d: shows [As Kh] (high card Ace)
NuKEr2k: shows [Kd 4d] (a pair of Fours)
NuKEr2k collected $2.48 from pot
*** SECOND SHOW DOWN ***
Comra1d: shows [As Kh] (a pair of Fours)
NuKEr2k: shows [Kd 4d] (a flush, King high)
NuKEr2k collected $2.47 from pot
*** SUMMARY ***
Total pot $5.16 | Rake $0.21 
Hand was run twice
FIRST Board [7d Qd 4c Jc 5h]
SECOND Board [7d Qd 4c 4s Jd]
Seat 1: NuKEr2k (button) showed [Kd 4d] and won ($2.48) with a pair of Fours, and won ($2.47) with a flush, King high
Seat 2: swesda21 (small blind) folded before Flop
Seat 3: Comra1d (big blind) showed [As Kh] and lost with high card Ace, and lost with a pair of Fours
Seat 4: HubertusB folded before Flop (didn't bet)
Seat 5: viktor_KK folded before Flop (didn't bet)
Seat 6: zisis83 folded before Flop (didn't bet)



PokerStars Zoom Hand #177277552824:  Hold'em No Limit ($0.02/$0.05) - 2017/10/23 21:30:59 CCT [2017/10/23 9:30:59 ET]
Table 'Donati' 6-max Seat #1 is the button
Seat 1: LeXPSU ($6.82 in chips) 
Seat 2: Mo3r308 ($5.36 in chips) 
Seat 3: HubertusB ($4.86 in chips) 
Seat 4: kareelwong ($4.93 in chips) 
Seat 5: koreahulk ($9.29 in chips) 
Seat 6: xoshimin ($6.21 in chips) 
Mo3r308: posts small blind $0.02
HubertusB: posts big blind $0.05
*** HOLE CARDS ***
Dealt to HubertusB [Js Jh]
kareelwong: raises $0.10 to $0.15
koreahulk: folds 
xoshimin: folds 
LeXPSU: folds 
Mo3r308: folds 
HubertusB: calls $0.10
*** FLOP *** [Qh 6d 8h]
HubertusB: checks 
kareelwong: bets $0.22
HubertusB: calls $0.22
*** TURN *** [Qh 6d 8h] [2d]
HubertusB: checks 
kareelwong: bets $0.58
HubertusB: raises $0.58 to $1.16
kareelwong: raises $3.40 to $4.56 and is all-in
HubertusB: folds 
Uncalled bet ($3.40) returned to kareelwong
kareelwong collected $2.95 from pot
kareelwong: doesn't show hand 
*** SUMMARY ***
Total pot $3.08 | Rake $0.13 
Board [Qh 6d 8h 2d]
Seat 1: LeXPSU (button) folded before Flop (didn't bet)
Seat 2: Mo3r308 (small blind) folded before Flop
Seat 3: HubertusB (big blind) folded on the Turn
Seat 4: kareelwong collected ($2.95)
Seat 5: koreahulk folded before Flop (didn't bet)
Seat 6: xoshimin folded before Flop (didn't bet)



PokerStars Zoom Hand #177277601457:  Hold'em No Limit ($0.02/$0.05) - 2017/10/23 21:32:33 CCT [2017/10/23 9:32:33 ET]
Table 'Donati' 6-max Seat #1 is the button
Seat 1: PeterBig555 ($5 in chips) 
Seat 2: andrqi ($6.35 in chips) 
Seat 3: Serega93799 ($3.11 in chips) 
Seat 4: HubertusB ($3.33 in chips) 
Seat 5: justchill198 ($9.44 in chips) 
Seat 6: syuzu08 ($5.07 in chips) 
andrqi: posts small blind $0.02
Serega93799: posts big blind $0.05
*** HOLE CARDS ***
Dealt to HubertusB [8s 5c]
HubertusB: folds 
justchill198: folds 
syuzu08: folds 
PeterBig555: folds 
andrqi: folds 
Uncalled bet ($0.03) returned to Serega93799
Serega93799 collected $0.04 from pot
Serega93799: doesn't show hand 
*** SUMMARY ***
Total pot $0.04 | Rake $0 
Seat 1: PeterBig555 (button) folded before Flop (didn't bet)
Seat 2: andrqi (small blind) folded before Flop
Seat 3: Serega93799 (big blind) collected ($0.04)
Seat 4: HubertusB folded before Flop (didn't bet)
Seat 5: justchill198 folded before Flop (didn't bet)
Seat 6: syuzu08 folded before Flop (didn't bet)



PokerStars Zoom Hand #177277598938:  Hold'em No Limit ($0.02/$0.05) - 2017/10/23 21:32:28 CCT [2017/10/23 9:32:28 ET]
Table 'Donati' 6-max Seat #1 is the button
Seat 1: Dimks46 ($5.79 in chips) 
Seat 2: kraquosAA ($5 in chips) 
Seat 3: rack1777 ($6 in chips) 
Seat 4: Gaben ICM ($7.21 in chips) 
Seat 5: FootTea ($5.64 in chips) 
Seat 6: HubertusB ($3.33 in chips) 
kraquosAA: posts small blind $0.02
rack1777: posts big blind $0.05
*** HOLE CARDS ***
Dealt to HubertusB [9c 7h]
Gaben ICM: folds 
FootTea: folds 
HubertusB: folds 
Dimks46: folds 
kraquosAA: raises $0.10 to $0.15
rack1777: calls $0.10
*** FLOP *** [Ac Tc 4s]
kraquosAA: bets $0.15
rack1777: raises $0.20 to $0.35
kraquosAA: folds 
Uncalled bet ($0.20) returned to rack1777
rack1777 collected $0.58 from pot
rack1777: doesn't show hand 
*** SUMMARY ***
Total pot $0.60 | Rake $0.02 
Board [Ac Tc 4s]
Seat 1: Dimks46 (button) folded before Flop (didn't bet)
Seat 2: kraquosAA (small blind) folded on the Flop
Seat 3: rack1777 (big blind) collected ($0.58)
Seat 4: Gaben ICM folded before Flop (didn't bet)
Seat 5: FootTea folded before Flop (didn't bet)
Seat 6: HubertusB folded before Flop (didn't bet)



PokerStars Zoom Hand #177277604080:  Hold'em No Limit ($0.02/$0.05) - 2017/10/23 21:32:38 CCT [2017/10/23 9:32:38 ET]
Table 'Donati' 6-max Seat #1 is the button
Seat 1: GBR96 ($5.08 in chips) 
Seat 2: HubertusB ($3.33 in chips) 
Seat 3: NuKEr2k ($4.77 in chips) 
Seat 4: ZyntexX ($7.06 in chips) 
Seat 5: nar0113 ($9.65 in chips) 
Seat 6: olig@rchic ($9.86 in chips) 
HubertusB: posts small blind $0.02
NuKEr2k: posts big blind $0.05
*** HOLE CARDS ***
Dealt to HubertusB [Kh Ad]
ZyntexX: folds 
nar0113: folds 
olig@rchic: folds 
GBR96: folds 
HubertusB: raises $0.10 to $0.15
NuKEr2k: calls $0.10
*** FLOP *** [5c 8s 7d]
HubertusB: checks 
NuKEr2k: checks 
*** TURN *** [5c 8s 7d] [2s]
HubertusB: checks 
NuKEr2k: bets $0.19
HubertusB: calls $0.19
*** RIVER *** [5c 8s 7d 2s] [Ts]
HubertusB: checks 
NuKEr2k: bets $0.43
HubertusB: calls $0.43
*** SHOW DOWN ***
NuKEr2k: shows [Jh Kd] (high card King)
HubertusB: shows [Kh Ad] (high card Ace)
HubertusB collected $1.48 from pot
*** SUMMARY ***
Total pot $1.54 | Rake $0.06 
Board [5c 8s 7d 2s Ts]
Seat 1: GBR96 (button) folded before Flop (didn't bet)
Seat 2: HubertusB (small blind) showed [Kh Ad] and won ($1.48) with high card Ace
Seat 3: NuKEr2k (big blind) showed [Jh Kd] and lost with high card King
Seat 4: ZyntexX folded before Flop (didn't bet)
Seat 5: nar0113 folded before Flop (didn't bet)
Seat 6: olig@rchic folded before Flop (didn't bet)



PokerStars Zoom Hand #177277640243:  Hold'em No Limit ($0.02/$0.05) - 2017/10/23 21:33:48 CCT [2017/10/23 9:33:48 ET]
Table 'Donati' 6-max Seat #1 is the button
Seat 1: HubertusB ($4.04 in chips) 
Seat 2: PeterBig555 ($5.21 in chips) 
Seat 3: deeepstack ($4.54 in chips) 
Seat 4: Only_Vizard ($5.27 in chips) 
Seat 5: zeppelin707 ($4.70 in chips) 
Seat 6: Ruslan829 ($6.42 in chips) 
PeterBig555: posts small blind $0.02
deeepstack: posts big blind $0.05
*** HOLE CARDS ***
Dealt to HubertusB [4s 8h]
Only_Vizard: folds 
zeppelin707: folds 
Ruslan829: raises $0.12 to $0.17
HubertusB: folds 
PeterBig555: folds 
deeepstack: folds 
Uncalled bet ($0.12) returned to Ruslan829
Ruslan829 collected $0.12 from pot
Ruslan829: doesn't show hand 
*** SUMMARY ***
Total pot $0.12 | Rake $0 
Seat 1: HubertusB (button) folded before Flop (didn't bet)
Seat 2: PeterBig555 (small blind) folded before Flop
Seat 3: deeepstack (big blind) folded before Flop
Seat 4: Only_Vizard folded before Flop (didn't bet)
Seat 5: zeppelin707 folded before Flop (didn't bet)
Seat 6: Ruslan829 collected ($0.12)



PokerStars Zoom Hand #177277644961:  Hold'em No Limit ($0.02/$0.05) - 2017/10/23 21:33:57 CCT [2017/10/23 9:33:57 ET]
Table 'Donati' 6-max Seat #1 is the button
Seat 1: BogMiros1 ($5.89 in chips) 
Seat 2: Lehi423 ($5.63 in chips) 
Seat 3: telapantela ($8.82 in chips) 
Seat 4: Gregório26 ($17.55 in chips) 
Seat 5: Serega93799 ($2.66 in chips) 
Seat 6: HubertusB ($4.04 in chips) 
Lehi423: posts small blind $0.02
telapantela: posts big blind $0.05
*** HOLE CARDS ***
Dealt to HubertusB [3c 4s]
Gregório26: folds 
Serega93799: folds 
HubertusB: folds 
BogMiros1: folds 
Lehi423: folds 
Uncalled bet ($0.03) returned to telapantela
telapantela collected $0.04 from pot
telapantela: doesn't show hand 
*** SUMMARY ***
Total pot $0.04 | Rake $0 
Seat 1: BogMiros1 (button) folded before Flop (didn't bet)
Seat 2: Lehi423 (small blind) folded before Flop
Seat 3: telapantela (big blind) collected ($0.04)
Seat 4: Gregório26 folded before Flop (didn't bet)
Seat 5: Serega93799 folded before Flop (didn't bet)
Seat 6: HubertusB folded before Flop (didn't bet)



PokerStars Zoom Hand #177277649065:  Hold'em No Limit ($0.02/$0.05) - 2017/10/23 21:34:05 CCT [2017/10/23 9:34:05 ET]
Table 'Donati' 6-max Seat #1 is the button
Seat 1: xoshimin ($5.34 in chips) 
Seat 2: TibyStar ($5.22 in chips) 
Seat 3: Zayz1 ($7.76 in chips) 
Seat 4: Cleaner108 ($8.68 in chips) 
Seat 5: HubertusB ($4.04 in chips) 
Seat 6: Serega93799 ($10.92 in chips) 
TibyStar: posts small blind $0.02
Zayz1: posts big blind $0.05
*** HOLE CARDS ***
Dealt to HubertusB [Ks 5h]
Cleaner108: folds 
HubertusB: folds 
Serega93799: raises $0.10 to $0.15
xoshimin: folds 
TibyStar: folds 
Zayz1: folds 
Uncalled bet ($0.10) returned to Serega93799
Serega93799 collected $0.12 from pot
Serega93799: doesn't show hand 
*** SUMMARY ***
Total pot $0.12 | Rake $0 
Seat 1: xoshimin (button) folded before Flop (didn't bet)
Seat 2: TibyStar (small blind) folded before Flop
Seat 3: Zayz1 (big blind) folded before Flop
Seat 4: Cleaner108 folded before Flop (didn't bet)
Seat 5: HubertusB folded before Flop (didn't bet)
Seat 6: Serega93799 collected ($0.12)



PokerStars Zoom Hand #177277652154:  Hold'em No Limit ($0.02/$0.05) - 2017/10/23 21:34:11 CCT [2017/10/23 9:34:11 ET]
Table 'Donati' 6-max Seat #1 is the button
Seat 1: zisis83 ($4.71 in chips) 
Seat 2: Pandabear11 ($14.38 in chips) 
Seat 3: HubertusB ($4.04 in chips) 
Seat 4: xampos77 ($10.82 in chips) 
Seat 5: YV01 ($5.17 in chips) 
Seat 6: Barbos383 ($1.72 in chips) 
Pandabear11: posts small blind $0.02
HubertusB: posts big blind $0.05
*** HOLE CARDS ***
Dealt to HubertusB [8s Ts]
xampos77: folds 
YV01: folds 
Barbos383: folds 
zisis83: folds 
Pandabear11: raises $0.10 to $0.15
HubertusB: folds 
Uncalled bet ($0.10) returned to Pandabear11
Pandabear11 collected $0.10 from pot
Pandabear11: doesn't show hand 
*** SUMMARY ***
Total pot $0.10 | Rake $0 
Seat 1: zisis83 (button) folded before Flop (didn't bet)
Seat 2: Pandabear11 (small blind) collected ($0.10)
Seat 3: HubertusB (big blind) folded before Flop
Seat 4: xampos77 folded before Flop (didn't bet)
Seat 5: YV01 folded before Flop (didn't bet)
Seat 6: Barbos383 folded before Flop (didn't bet)



PokerStars Zoom Hand #177277663092:  Hold'em No Limit ($0.02/$0.05) - 2017/10/23 21:34:32 CCT [2017/10/23 9:34:32 ET]
Table 'Donati' 6-max Seat #1 is the button
Seat 1: Lehi423 ($5.71 in chips) 
Seat 2: FootTea ($5.29 in chips) 
Seat 3: McLaude669 ($2.91 in chips) 
Seat 4: P0KERB0Y ($8.18 in chips) 
Seat 5: HubertusB ($3.99 in chips) 
Seat 6: zisis83 ($5.84 in chips) 
FootTea: posts small blind $0.02
McLaude669: posts big blind $0.05
*** HOLE CARDS ***
Dealt to HubertusB [Jh Td]
P0KERB0Y: folds 
HubertusB: folds 
zisis83: folds 
Lehi423: raises $0.10 to $0.15
FootTea: folds 
McLaude669: folds 
Uncalled bet ($0.10) returned to Lehi423
Lehi423 collected $0.12 from pot
Lehi423: doesn't show hand 
*** SUMMARY ***
Total pot $0.12 | Rake $0 
Seat 1: Lehi423 (button) collected ($0.12)
Seat 2: FootTea (small blind) folded before Flop
Seat 3: McLaude669 (big blind) folded before Flop
Seat 4: P0KERB0Y folded before Flop (didn't bet)
Seat 5: HubertusB folded before Flop (didn't bet)
Seat 6: zisis83 folded before Flop (didn't bet)



PokerStars Zoom Hand #177277665611:  Hold'em No Limit ($0.02/$0.05) - 2017/10/23 21:34:37 CCT [2017/10/23 9:34:37 ET]
Table 'Donati' 6-max Seat #1 is the button
Seat 1: pittibaerli ($5 in chips) 
Seat 2: HubertusB ($3.99 in chips) 
Seat 3: osfp7john ($8.75 in chips) 
Seat 4: Kerberus94 ($5 in chips) 
Seat 5: prochy1909 ($6.79 in chips) 
Seat 6: Bernoulli834 ($6.42 in chips) 
HubertusB: posts small blind $0.02
osfp7john: posts big blind $0.05
*** HOLE CARDS ***
Dealt to HubertusB [Kh Qh]
Kerberus94: folds 
prochy1909: folds 
Bernoulli834: folds 
pittibaerli: folds 
HubertusB: raises $0.10 to $0.15
osfp7john: folds 
Uncalled bet ($0.10) returned to HubertusB
HubertusB collected $0.10 from pot
HubertusB: doesn't show hand 
*** SUMMARY ***
Total pot $0.10 | Rake $0 
Seat 1: pittibaerli (button) folded before Flop (didn't bet)
Seat 2: HubertusB (small blind) collected ($0.10)
Seat 3: osfp7john (big blind) folded before Flop
Seat 4: Kerberus94 folded before Flop (didn't bet)
Seat 5: prochy1909 folded before Flop (didn't bet)
Seat 6: Bernoulli834 folded before Flop (didn't bet)



PokerStars Zoom Hand #177277673928:  Hold'em No Limit ($0.02/$0.05) - 2017/10/23 21:34:53 CCT [2017/10/23 9:34:53 ET]
Table 'Donati' 6-max Seat #1 is the button
Seat 1: HubertusB ($4.04 in chips) 
Seat 2: ikzw ($19.25 in chips) 
Seat 3: Fikcyjny ($6.86 in chips) 
Seat 4: Galaktika74 ($5.76 in chips) 
Seat 5: GBR96 ($14.52 in chips) 
Seat 6: Badger4515 ($5.55 in chips) 
ikzw: posts small blind $0.02
Fikcyjny: posts big blind $0.05
*** HOLE CARDS ***
Dealt to HubertusB [2h 3h]
Galaktika74: folds 
GBR96: folds 
Badger4515: folds 
HubertusB: raises $0.05 to $0.10
ikzw: folds 
Fikcyjny: raises $0.30 to $0.40
HubertusB: folds 
Uncalled bet ($0.30) returned to Fikcyjny
Fikcyjny collected $0.22 from pot
Fikcyjny: doesn't show hand 
*** SUMMARY ***
Total pot $0.22 | Rake $0 
Seat 1: HubertusB (button) folded before Flop
Seat 2: ikzw (small blind) folded before Flop
Seat 3: Fikcyjny (big blind) collected ($0.22)
Seat 4: Galaktika74 folded before Flop (didn't bet)
Seat 5: GBR96 folded before Flop (didn't bet)
Seat 6: Badger4515 folded before Flop (didn't bet)



PokerStars Zoom Hand #177277684806:  Hold'em No Limit ($0.02/$0.05) - 2017/10/23 21:35:14 CCT [2017/10/23 9:35:14 ET]
Table 'Donati' 6-max Seat #1 is the button
Seat 1: Kimovich 14 ($4.45 in chips) 
Seat 2: PEJA358 ($5.89 in chips) 
Seat 3: a7v8xlaplace ($5.53 in chips) 
Seat 4: HubertusB ($3.94 in chips) 
Seat 5: ooiaooao ($5.76 in chips) 
Seat 6: cwcestari ($17.33 in chips) 
PEJA358: posts small blind $0.02
a7v8xlaplace: posts big blind $0.05
*** HOLE CARDS ***
Dealt to HubertusB [5h Kd]
HubertusB: folds 
ooiaooao: folds 
cwcestari: folds 
Kimovich 14: raises $0.10 to $0.15
PEJA358: folds 
a7v8xlaplace: folds 
Uncalled bet ($0.10) returned to Kimovich 14
Kimovich 14 collected $0.12 from pot
Kimovich 14: doesn't show hand 
*** SUMMARY ***
Total pot $0.12 | Rake $0 
Seat 1: Kimovich 14 (button) collected ($0.12)
Seat 2: PEJA358 (small blind) folded before Flop
Seat 3: a7v8xlaplace (big blind) folded before Flop
Seat 4: HubertusB folded before Flop (didn't bet)
Seat 5: ooiaooao folded before Flop (didn't bet)
Seat 6: cwcestari folded before Flop (didn't bet)



PokerStars Zoom Hand #177277687438:  Hold'em No Limit ($0.02/$0.05) - 2017/10/23 21:35:19 CCT [2017/10/23 9:35:19 ET]
Table 'Donati' 6-max Seat #1 is the button
Seat 1: sh1p1t0bv ($9.65 in chips) 
Seat 2: geboure ($1.31 in chips) 
Seat 3: HubertusB ($3.94 in chips) 
Seat 4: rack1777 ($6.28 in chips) 
Seat 5: Tomirlan8 ($8.93 in chips) 
Seat 6: Kerberus94 ($5 in chips) 
geboure: posts small blind $0.02
HubertusB: posts big blind $0.05
*** HOLE CARDS ***
Dealt to HubertusB [9d Kc]
rack1777: folds 
Tomirlan8: raises $0.10 to $0.15
Kerberus94: folds 
sh1p1t0bv: folds 
geboure: folds 
HubertusB: folds 
Uncalled bet ($0.10) returned to Tomirlan8
Tomirlan8 collected $0.12 from pot
Tomirlan8: doesn't show hand 
*** SUMMARY ***
Total pot $0.12 | Rake $0 
Seat 1: sh1p1t0bv (button) folded before Flop (didn't bet)
Seat 2: geboure (small blind) folded before Flop
Seat 3: HubertusB (big blind) folded before Flop
Seat 4: rack1777 folded before Flop (didn't bet)
Seat 5: Tomirlan8 collected ($0.12)
Seat 6: Kerberus94 folded before Flop (didn't bet)



PokerStars Zoom Hand #177277696082:  Hold'em No Limit ($0.02/$0.05) - 2017/10/23 21:35:36 CCT [2017/10/23 9:35:36 ET]
Table 'Donati' 6-max Seat #1 is the button
Seat 1: MDAlexandru ($5.62 in chips) 
Seat 2: oessi11 ($8.95 in chips) 
Seat 3: diablo4824 ($5.12 in chips) 
Seat 4: Only_Vizard ($10.53 in chips) 
Seat 5: r3x1a ($7.21 in chips) 
Seat 6: HubertusB ($3.89 in chips) 
oessi11: posts small blind $0.02
diablo4824: posts big blind $0.05
*** HOLE CARDS ***
Dealt to HubertusB [Jh 5d]
Only_Vizard: raises $0.10 to $0.15
r3x1a: folds 
HubertusB: folds 
MDAlexandru: folds 
oessi11: folds 
diablo4824: folds 
Uncalled bet ($0.10) returned to Only_Vizard
Only_Vizard collected $0.12 from pot
Only_Vizard: doesn't show hand 
*** SUMMARY ***
Total pot $0.12 | Rake $0 
Seat 1: MDAlexandru (button) folded before Flop (didn't bet)
Seat 2: oessi11 (small blind) folded before Flop
Seat 3: diablo4824 (big blind) folded before Flop
Seat 4: Only_Vizard collected ($0.12)
Seat 5: r3x1a folded before Flop (didn't bet)
Seat 6: HubertusB folded before Flop (didn't bet)



PokerStars Zoom Hand #177277700036:  Hold'em No Limit ($0.02/$0.05) - 2017/10/23 21:35:42 CCT [2017/10/23 9:35:42 ET]
Table 'Donati' 6-max Seat #1 is the button
Seat 1: sh1p1t0bv ($5.09 in chips) 
Seat 2: ooiaooao ($8.71 in chips) 
Seat 3: benijake0000 ($5.78 in chips) 
Seat 4: cwcestari ($17.31 in chips) 
Seat 5: HubertusB ($3.89 in chips) 
Seat 6: Raux17 ($8.30 in chips) 
ooiaooao: posts small blind $0.02
benijake0000: posts big blind $0.05
*** HOLE CARDS ***
Dealt to HubertusB [Ah Ac]
cwcestari: folds 
HubertusB: raises $0.08 to $0.13
Raux17: folds 
sh1p1t0bv: calls $0.13
ooiaooao: folds 
benijake0000: folds 
*** FLOP *** [Qc 9d Kd]
HubertusB: bets $0.25
sh1p1t0bv: raises $0.65 to $0.90
HubertusB: raises $2.86 to $3.76 and is all-in
sh1p1t0bv: calls $2.86
*** TURN *** [Qc 9d Kd] [4c]
*** RIVER *** [Qc 9d Kd 4c] [6h]
*** SHOW DOWN ***
HubertusB: shows [Ah Ac] (a pair of Aces)
sh1p1t0bv: shows [Jc Tc] (a straight, Nine to King)
sh1p1t0bv collected $7.52 from pot
*** SUMMARY ***
Total pot $7.85 | Rake $0.33 
Board [Qc 9d Kd 4c 6h]
Seat 1: sh1p1t0bv (button) showed [Jc Tc] and won ($7.52) with a straight, Nine to King
Seat 2: ooiaooao (small blind) folded before Flop
Seat 3: benijake0000 (big blind) folded before Flop
Seat 4: cwcestari folded before Flop (didn't bet)
Seat 5: HubertusB showed [Ah Ac] and lost with a pair of Aces
Seat 6: Raux17 folded before Flop (didn't bet)



PokerStars Zoom Hand #177277743533:  Hold'em No Limit ($0.02/$0.05) - 2017/10/23 21:37:06 CCT [2017/10/23 9:37:06 ET]
Table 'Donati' 6-max Seat #1 is the button
Seat 1: Fäldy ($4.41 in chips) 
Seat 2: HubertusB ($5 in chips) 
Seat 3: tatucarreta ($2.60 in chips) 
Seat 4: Moneybaker88 ($6.74 in chips) 
Seat 5: anasanto ($9.90 in chips) 
Seat 6: TOKI1509 ($6.11 in chips) 
HubertusB: posts small blind $0.02
tatucarreta: posts big blind $0.05
*** HOLE CARDS ***
Dealt to HubertusB [Ac 3h]
Moneybaker88: folds 
anasanto: raises $0.07 to $0.12
TOKI1509: folds 
Fäldy: folds 
HubertusB: folds 
tatucarreta: folds 
Uncalled bet ($0.07) returned to anasanto
anasanto collected $0.12 from pot
anasanto: doesn't show hand 
*** SUMMARY ***
Total pot $0.12 | Rake $0 
Seat 1: Fäldy (button) folded before Flop (didn't bet)
Seat 2: HubertusB (small blind) folded before Flop
Seat 3: tatucarreta (big blind) folded before Flop
Seat 4: Moneybaker88 folded before Flop (didn't bet)
Seat 5: anasanto collected ($0.12)
Seat 6: TOKI1509 folded before Flop (didn't bet)



PokerStars Zoom Hand #177277740469:  Hold'em No Limit ($0.02/$0.05) - 2017/10/23 21:37:00 CCT [2017/10/23 9:37:00 ET]
Table 'Donati' 6-max Seat #1 is the button
Seat 1: taniunia1988 ($5.06 in chips) 
Seat 2: Gregório26 ($19 in chips) 
Seat 3: Raux17 ($7.54 in chips) 
Seat 4: Bjeujeuler ($5 in chips) 
Seat 5: DRUM31 ($2.50 in chips) 
Seat 6: HubertusB ($5 in chips) 
Gregório26: posts small blind $0.02
Raux17: posts big blind $0.05
*** HOLE CARDS ***
Dealt to HubertusB [6s 9s]
Bjeujeuler: folds 
DRUM31: folds 
HubertusB: folds 
taniunia1988: raises $0.10 to $0.15
Gregório26: folds 
Raux17: raises $0.15 to $0.30
taniunia1988: calls $0.15
*** FLOP *** [7c Js 6c]
Raux17: bets $0.35
taniunia1988: folds 
Uncalled bet ($0.35) returned to Raux17
Raux17 collected $0.59 from pot
Raux17: doesn't show hand 
*** SUMMARY ***
Total pot $0.62 | Rake $0.03 
Board [7c Js 6c]
Seat 1: taniunia1988 (button) folded on the Flop
Seat 2: Gregório26 (small blind) folded before Flop
Seat 3: Raux17 (big blind) collected ($0.59)
Seat 4: Bjeujeuler folded before Flop (didn't bet)
Seat 5: DRUM31 folded before Flop (didn't bet)
Seat 6: HubertusB folded before Flop (didn't bet)



PokerStars Zoom Hand #177277749288:  Hold'em No Limit ($0.02/$0.05) - 2017/10/23 21:37:17 CCT [2017/10/23 9:37:17 ET]
Table 'Donati' 6-max Seat #1 is the button
Seat 1: HubertusB ($4.98 in chips) 
Seat 2: danjmekeru ($5.07 in chips) 
Seat 3: xampos77 ($10.68 in chips) 
Seat 4: Tenbi13112 ($5.59 in chips) 
Seat 5: architetti ($5.71 in chips) 
Seat 6: Cleaner108 ($8.35 in chips) 
danjmekeru: posts small blind $0.02
xampos77: posts big blind $0.05
*** HOLE CARDS ***
Dealt to HubertusB [Jh Kh]
Tenbi13112: raises $0.12 to $0.17
architetti: folds 
Cleaner108: calls $0.17
HubertusB: calls $0.17
danjmekeru: folds 
xampos77: calls $0.12
*** FLOP *** [2c 5s 8c]
xampos77: checks 
Tenbi13112: bets $0.65
Cleaner108: calls $0.65
HubertusB: folds 
xampos77: folds 
*** TURN *** [2c 5s 8c] [As]
Tenbi13112: checks 
Cleaner108: checks 
*** RIVER *** [2c 5s 8c As] [Qc]
Tenbi13112: bets $4.77 and is all-in
Cleaner108: folds 
Uncalled bet ($4.77) returned to Tenbi13112
Tenbi13112 collected $1.92 from pot
Tenbi13112: doesn't show hand 
*** SUMMARY ***
Total pot $2 | Rake $0.08 
Board [2c 5s 8c As Qc]
Seat 1: HubertusB (button) folded on the Flop
Seat 2: danjmekeru (small blind) folded before Flop
Seat 3: xampos77 (big blind) folded on the Flop
Seat 4: Tenbi13112 collected ($1.92)
Seat 5: architetti folded before Flop (didn't bet)
Seat 6: Cleaner108 folded on the River



PokerStars Zoom Hand #177277783579:  Hold'em No Limit ($0.02/$0.05) - 2017/10/23 21:38:23 CCT [2017/10/23 9:38:23 ET]
Table 'Donati' 6-max Seat #1 is the button
Seat 1: Pandabear11 ($19.23 in chips) 
Seat 2: KOWAL530 ($6.51 in chips) 
Seat 3: HubertusB ($4.81 in chips) 
Seat 4: hsingyang ($18.51 in chips) 
Seat 5: InfideliX ($2.83 in chips) 
Seat 6: tampak120 ($3.99 in chips) 
KOWAL530: posts small blind $0.02
HubertusB: posts big blind $0.05
*** HOLE CARDS ***
Dealt to HubertusB [9c 2c]
hsingyang has timed out
hsingyang: folds 
InfideliX: folds 
tampak120: folds 
Pandabear11: folds 
KOWAL530: raises $0.10 to $0.15
HubertusB: folds 
Uncalled bet ($0.10) returned to KOWAL530
KOWAL530 collected $0.10 from pot
KOWAL530: doesn't show hand 
*** SUMMARY ***
Total pot $0.10 | Rake $0 
Seat 1: Pandabear11 (button) folded before Flop (didn't bet)
Seat 2: KOWAL530 (small blind) collected ($0.10)
Seat 3: HubertusB (big blind) folded before Flop
Seat 4: hsingyang folded before Flop (didn't bet)
Seat 5: InfideliX folded before Flop (didn't bet)
Seat 6: tampak120 folded before Flop (didn't bet)



PokerStars Zoom Hand #177277796108:  Hold'em No Limit ($0.02/$0.05) - 2017/10/23 21:38:47 CCT [2017/10/23 9:38:47 ET]
Table 'Donati' 6-max Seat #1 is the button
Seat 1: Bocyk ($5.22 in chips) 
Seat 2: geochar87 ($10.68 in chips) 
Seat 3: petokrcmar ($1.27 in chips) 
Seat 4: HubertusB ($4.76 in chips) 
Seat 5: lll1112 ($5.90 in chips) 
Seat 6: Region059 ($7.14 in chips) 
geochar87: posts small blind $0.02
petokrcmar: posts big blind $0.05
*** HOLE CARDS ***
Dealt to HubertusB [4d Td]
HubertusB: folds 
lll1112: folds 
Region059: raises $0.07 to $0.12
Bocyk: folds 
geochar87: folds 
petokrcmar: folds 
Uncalled bet ($0.07) returned to Region059
Region059 collected $0.12 from pot
Region059: doesn't show hand 
*** SUMMARY ***
Total pot $0.12 | Rake $0 
Seat 1: Bocyk (button) folded before Flop (didn't bet)
Seat 2: geochar87 (small blind) folded before Flop
Seat 3: petokrcmar (big blind) folded before Flop
Seat 4: HubertusB folded before Flop (didn't bet)
Seat 5: lll1112 folded before Flop (didn't bet)
Seat 6: Region059 collected ($0.12)



PokerStars Zoom Hand #177277802289:  Hold'em No Limit ($0.02/$0.05) - 2017/10/23 21:38:59 CCT [2017/10/23 9:38:59 ET]
Table 'Donati' 6-max Seat #1 is the button
Seat 1: kennyroosje ($4.54 in chips) 
Seat 2: HubertusB ($4.76 in chips) 
Seat 3: dariusgeorge ($3.18 in chips) 
Seat 4: pittibaerli ($6.43 in chips) 
Seat 5: AndreyDOOM ($10.91 in chips) 
Seat 6: oessi11 ($5 in chips) 
HubertusB: posts small blind $0.02
dariusgeorge: posts big blind $0.05
*** HOLE CARDS ***
Dealt to HubertusB [5c Ah]
pittibaerli: folds 
AndreyDOOM: folds 
oessi11: folds 
kennyroosje: folds 
HubertusB: folds 
Uncalled bet ($0.03) returned to dariusgeorge
dariusgeorge collected $0.04 from pot
dariusgeorge: doesn't show hand 
*** SUMMARY ***
Total pot $0.04 | Rake $0 
Seat 1: kennyroosje (button) folded before Flop (didn't bet)
Seat 2: HubertusB (small blind) folded before Flop
Seat 3: dariusgeorge (big blind) collected ($0.04)
Seat 4: pittibaerli folded before Flop (didn't bet)
Seat 5: AndreyDOOM folded before Flop (didn't bet)
Seat 6: oessi11 folded before Flop (didn't bet)



PokerStars Zoom Hand #177277799169:  Hold'em No Limit ($0.02/$0.05) - 2017/10/23 21:38:53 CCT [2017/10/23 9:38:53 ET]
Table 'Donati' 6-max Seat #1 is the button
Seat 1: rack1777 ($5.10 in chips) 
Seat 2: McLaude669 ($2.56 in chips) 
Seat 3: Hirx123 ($5.70 in chips) 
Seat 4: HubertusB ($4.76 in chips) 
Seat 5: ODIN-23-ua ($9.72 in chips) 
Seat 6: flamnr2 ($9.56 in chips) 
McLaude669: posts small blind $0.02
Hirx123: posts big blind $0.05
*** HOLE CARDS ***
Dealt to HubertusB [8s 7h]
HubertusB: folds 
ODIN-23-ua: folds 
flamnr2: raises $0.10 to $0.15
rack1777: folds 
McLaude669: folds 
Hirx123: folds 
Uncalled bet ($0.10) returned to flamnr2
flamnr2 collected $0.12 from pot
flamnr2: doesn't show hand 
*** SUMMARY ***
Total pot $0.12 | Rake $0 
Seat 1: rack1777 (button) folded before Flop (didn't bet)
Seat 2: McLaude669 (small blind) folded before Flop
Seat 3: Hirx123 (big blind) folded before Flop
Seat 4: HubertusB folded before Flop (didn't bet)
Seat 5: ODIN-23-ua folded before Flop (didn't bet)
Seat 6: flamnr2 collected ($0.12)



PokerStars Zoom Hand #177277808044:  Hold'em No Limit ($0.02/$0.05) - 2017/10/23 21:39:10 CCT [2017/10/23 9:39:10 ET]
Table 'Donati' 6-max Seat #1 is the button
Seat 1: ohukainen80 ($10.03 in chips) 
Seat 2: Morgot339 ($11.26 in chips) 
Seat 3: HubertusB ($4.74 in chips) 
Seat 4: GamblerWW ($5 in chips) 
Seat 5: puertabarba ($10.43 in chips) 
Seat 6: andrqi ($5.05 in chips) 
Morgot339: posts small blind $0.02
HubertusB: posts big blind $0.05
*** HOLE CARDS ***
Dealt to HubertusB [2s 3c]
GamblerWW: folds 
puertabarba: raises $0.05 to $0.10
andrqi: folds 
ohukainen80: folds 
Morgot339: folds 
HubertusB: folds 
Uncalled bet ($0.05) returned to puertabarba
puertabarba collected $0.12 from pot
puertabarba: doesn't show hand 
*** SUMMARY ***
Total pot $0.12 | Rake $0 
Seat 1: ohukainen80 (button) folded before Flop (didn't bet)
Seat 2: Morgot339 (small blind) folded before Flop
Seat 3: HubertusB (big blind) folded before Flop
Seat 4: GamblerWW folded before Flop (didn't bet)
Seat 5: puertabarba collected ($0.12)
Seat 6: andrqi folded before Flop (didn't bet)



PokerStars Zoom Hand #177277805444:  Hold'em No Limit ($0.02/$0.05) - 2017/10/23 21:39:05 CCT [2017/10/23 9:39:05 ET]
Table 'Donati' 6-max Seat #1 is the button
Seat 1: HubertusB ($4.74 in chips) 
Seat 2: Kerberus94 ($5.40 in chips) 
Seat 3: Ridvan 1111 ($2.53 in chips) 
Seat 4: Barbos383 ($3.40 in chips) 
Seat 5: Hohol 2011 ($5.89 in chips) 
Seat 6: AndreyDOOM ($9.02 in chips) 
Kerberus94: posts small blind $0.02
Ridvan 1111: posts big blind $0.05
*** HOLE CARDS ***
Dealt to HubertusB [9s Qc]
Barbos383: raises $0.10 to $0.15
Hohol 2011: folds 
AndreyDOOM: folds 
HubertusB: folds 
Kerberus94: folds 
Ridvan 1111: calls $0.10
*** FLOP *** [8c 3c 9c]
Ridvan 1111: bets $0.15
Barbos383: calls $0.15
*** TURN *** [8c 3c 9c] [2h]
Ridvan 1111: checks 
Barbos383: bets $0.20
Ridvan 1111: folds 
Uncalled bet ($0.20) returned to Barbos383
Barbos383 collected $0.59 from pot
Barbos383: doesn't show hand 
*** SUMMARY ***
Total pot $0.62 | Rake $0.03 
Board [8c 3c 9c 2h]
Seat 1: HubertusB (button) folded before Flop (didn't bet)
Seat 2: Kerberus94 (small blind) folded before Flop
Seat 3: Ridvan 1111 (big blind) folded on the Turn
Seat 4: Barbos383 collected ($0.59)
Seat 5: Hohol 2011 folded before Flop (didn't bet)
Seat 6: AndreyDOOM folded before Flop (didn't bet)



PokerStars Zoom Hand #177277812185:  Hold'em No Limit ($0.02/$0.05) - 2017/10/23 21:39:18 CCT [2017/10/23 9:39:18 ET]
Table 'Donati' 6-max Seat #1 is the button
Seat 1: Hirx123 ($5.63 in chips) 
Seat 2: botzanu ($3.78 in chips) 
Seat 3: BOSCOBOT ($5.07 in chips) 
Seat 4: DavagaKDV ($5 in chips) 
Seat 5: MrSuperior ($5.76 in chips) 
Seat 6: HubertusB ($4.69 in chips) 
botzanu: posts small blind $0.02
BOSCOBOT: posts big blind $0.05
*** HOLE CARDS ***
Dealt to HubertusB [Ah Js]
DavagaKDV: folds 
MrSuperior: folds 
HubertusB: raises $0.05 to $0.10
Hirx123: folds 
botzanu: raises $0.30 to $0.40
BOSCOBOT: folds 
HubertusB: folds 
Uncalled bet ($0.30) returned to botzanu
botzanu collected $0.25 from pot
botzanu: doesn't show hand 
*** SUMMARY ***
Total pot $0.25 | Rake $0 
Seat 1: Hirx123 (button) folded before Flop (didn't bet)
Seat 2: botzanu (small blind) collected ($0.25)
Seat 3: BOSCOBOT (big blind) folded before Flop
Seat 4: DavagaKDV folded before Flop (didn't bet)
Seat 5: MrSuperior folded before Flop (didn't bet)
Seat 6: HubertusB folded before Flop



PokerStars Zoom Hand #177277825177:  Hold'em No Limit ($0.02/$0.05) - 2017/10/23 21:39:43 CCT [2017/10/23 9:39:43 ET]
Table 'Donati' 6-max Seat #1 is the button
Seat 1: HubertusB ($4.59 in chips) 
Seat 2: Marvelous19 ($12.69 in chips) 
Seat 3: Dariev ($11.37 in chips) 
Seat 4: knejevic ($4.83 in chips) 
Seat 5: taypan101 ($5.49 in chips) 
Seat 6: zisis83 ($6.87 in chips) 
Marvelous19: posts small blind $0.02
Dariev: posts big blind $0.05
*** HOLE CARDS ***
Dealt to HubertusB [Ad 2s]
knejevic: folds 
taypan101: folds 
zisis83 has timed out
zisis83: folds 
HubertusB: folds 
Marvelous19: folds 
Uncalled bet ($0.03) returned to Dariev
Dariev collected $0.04 from pot
Dariev: doesn't show hand 
*** SUMMARY ***
Total pot $0.04 | Rake $0 
Seat 1: HubertusB (button) folded before Flop (didn't bet)
Seat 2: Marvelous19 (small blind) folded before Flop
Seat 3: Dariev (big blind) collected ($0.04)
Seat 4: knejevic folded before Flop (didn't bet)
Seat 5: taypan101 folded before Flop (didn't bet)
Seat 6: zisis83 folded before Flop (didn't bet)



PokerStars Zoom Hand #177277831409:  Hold'em No Limit ($0.02/$0.05) - 2017/10/23 21:39:55 CCT [2017/10/23 9:39:55 ET]
Table 'Donati' 6-max Seat #1 is the button
Seat 1: batitibi ($5 in chips) 
Seat 2: HubertusB ($4.59 in chips) 
Seat 3: puertabarba ($15.12 in chips) 
Seat 4: hajdua0123 ($4.88 in chips) 
Seat 5: zale73 ($4.46 in chips) 
Seat 6: Hoxt0n ($6.80 in chips) 
HubertusB: posts small blind $0.02
puertabarba: posts big blind $0.05
*** HOLE CARDS ***
Dealt to HubertusB [6s 9h]
hajdua0123: folds 
zale73: folds 
Hoxt0n: folds 
batitibi: folds 
HubertusB: folds 
Uncalled bet ($0.03) returned to puertabarba
puertabarba collected $0.04 from pot
puertabarba: doesn't show hand 
*** SUMMARY ***
Total pot $0.04 | Rake $0 
Seat 1: batitibi (button) folded before Flop (didn't bet)
Seat 2: HubertusB (small blind) folded before Flop
Seat 3: puertabarba (big blind) collected ($0.04)
Seat 4: hajdua0123 folded before Flop (didn't bet)
Seat 5: zale73 folded before Flop (didn't bet)
Seat 6: Hoxt0n folded before Flop (didn't bet)



PokerStars Zoom Hand #177277821601:  Hold'em No Limit ($0.02/$0.05) - 2017/10/23 21:39:36 CCT [2017/10/23 9:39:36 ET]
Table 'Donati' 6-max Seat #1 is the button
Seat 1: Galaktika74 ($5.26 in chips) 
Seat 2: KatalaJon ($1.65 in chips) 
Seat 3: KOWAL530 ($5 in chips) 
Seat 4: InfideliX ($2.28 in chips) 
Seat 5: HubertusB ($4.59 in chips) 
Seat 6: Guest533 ($49.54 in chips) 
KatalaJon: posts small blind $0.02
KOWAL530: posts big blind $0.05
*** HOLE CARDS ***
Dealt to HubertusB [7h 9h]
InfideliX: raises $0.09 to $0.14
HubertusB: folds 
Guest533: folds 
Galaktika74: folds 
KatalaJon: folds 
KOWAL530: calls $0.09
*** FLOP *** [Jc 9s Td]
KOWAL530: checks 
InfideliX: bets $0.16
KOWAL530: folds 
Uncalled bet ($0.16) returned to InfideliX
InfideliX collected $0.29 from pot
InfideliX: doesn't show hand 
*** SUMMARY ***
Total pot $0.30 | Rake $0.01 
Board [Jc 9s Td]
Seat 1: Galaktika74 (button) folded before Flop (didn't bet)
Seat 2: KatalaJon (small blind) folded before Flop
Seat 3: KOWAL530 (big blind) folded on the Flop
Seat 4: InfideliX collected ($0.29)
Seat 5: HubertusB folded before Flop (didn't bet)
Seat 6: Guest533 folded before Flop (didn't bet)



PokerStars Zoom Hand #177277834523:  Hold'em No Limit ($0.02/$0.05) - 2017/10/23 21:40:01 CCT [2017/10/23 9:40:01 ET]
Table 'Donati' 6-max Seat #1 is the button
Seat 1: danjmekeru ($5.15 in chips) 
Seat 2: I'm Primera ($5.20 in chips) 
Seat 3: WaiT4U ($5.19 in chips) 
Seat 4: kareelwong ($4.09 in chips) 
Seat 5: HubertusB ($4.57 in chips) 
Seat 6: petokrcmar ($1.13 in chips) 
I'm Primera: posts small blind $0.02
WaiT4U: posts big blind $0.05
*** HOLE CARDS ***
Dealt to HubertusB [Qc Th]
kareelwong: folds 
HubertusB: folds 
petokrcmar: folds 
danjmekeru: folds 
I'm Primera: raises $0.10 to $0.15
WaiT4U: raises $0.30 to $0.45
I'm Primera: folds 
Uncalled bet ($0.30) returned to WaiT4U
WaiT4U collected $0.30 from pot
WaiT4U: doesn't show hand 
*** SUMMARY ***
Total pot $0.30 | Rake $0 
Seat 1: danjmekeru (button) folded before Flop (didn't bet)
Seat 2: I'm Primera (small blind) folded before Flop
Seat 3: WaiT4U (big blind) collected ($0.30)
Seat 4: kareelwong folded before Flop (didn't bet)
Seat 5: HubertusB folded before Flop (didn't bet)
Seat 6: petokrcmar folded before Flop (didn't bet)



PokerStars Zoom Hand #177277837728:  Hold'em No Limit ($0.02/$0.05) - 2017/10/23 21:40:07 CCT [2017/10/23 9:40:07 ET]
Table 'Donati' 6-max Seat #1 is the button
Seat 1: @moromin ($6.35 in chips) 
Seat 2: Phadrigh ($5 in chips) 
Seat 3: HubertusB ($4.57 in chips) 
Seat 4: siky1994 ($3.71 in chips) 
Seat 5: anett0406 ($3.22 in chips) 
Seat 6: xinjin669 ($7.30 in chips) 
Phadrigh: posts small blind $0.02
HubertusB: posts big blind $0.05
*** HOLE CARDS ***
Dealt to HubertusB [7s Jc]
siky1994: raises $0.15 to $0.20
anett0406: folds 
xinjin669: calls $0.20
@moromin: folds 
Phadrigh: raises $0.70 to $0.90
HubertusB: folds 
siky1994: folds 
xinjin669: folds 
Uncalled bet ($0.70) returned to Phadrigh
Phadrigh collected $0.65 from pot
Phadrigh: doesn't show hand 
*** SUMMARY ***
Total pot $0.65 | Rake $0 
Seat 1: @moromin (button) folded before Flop (didn't bet)
Seat 2: Phadrigh (small blind) collected ($0.65)
Seat 3: HubertusB (big blind) folded before Flop
Seat 4: siky1994 folded before Flop
Seat 5: anett0406 folded before Flop (didn't bet)
Seat 6: xinjin669 folded before Flop



PokerStars Zoom Hand #177277841247:  Hold'em No Limit ($0.02/$0.05) - 2017/10/23 21:40:14 CCT [2017/10/23 9:40:14 ET]
Table 'Donati' 6-max Seat #1 is the button
Seat 1: HubertusB ($4.52 in chips) 
Seat 2: AverianovA ($6.99 in chips) 
Seat 3: zzpotter ($5 in chips) 
Seat 4: 65Johansen ($5.09 in chips) 
Seat 5: tohlenechceš ($6.99 in chips) 
Seat 6: andreascris1 ($5 in chips) 
AverianovA: posts small blind $0.02
zzpotter: posts big blind $0.05
*** HOLE CARDS ***
Dealt to HubertusB [Jc Qd]
65Johansen: folds 
tohlenechceš: calls $0.05
andreascris1: folds 
HubertusB: calls $0.05
AverianovA: folds 
zzpotter: checks 
*** FLOP *** [7h 3h Tc]
zzpotter: checks 
tohlenechceš: checks 
HubertusB: checks 
*** TURN *** [7h 3h Tc] [9d]
zzpotter: checks 
tohlenechceš: checks 
HubertusB: bets $0.10
zzpotter: folds 
tohlenechceš: calls $0.10
*** RIVER *** [7h 3h Tc 9d] [2h]
tohlenechceš: checks 
HubertusB: checks 
*** SHOW DOWN ***
tohlenechceš: shows [3s 9s] (two pair, Nines and Threes)
HubertusB: mucks hand 
tohlenechceš collected $0.35 from pot
*** SUMMARY ***
Total pot $0.37 | Rake $0.02 
Board [7h 3h Tc 9d 2h]
Seat 1: HubertusB (button) mucked [Jc Qd]
Seat 2: AverianovA (small blind) folded before Flop
Seat 3: zzpotter (big blind) folded on the Turn
Seat 4: 65Johansen folded before Flop (didn't bet)
Seat 5: tohlenechceš showed [3s 9s] and won ($0.35) with two pair, Nines and Threes
Seat 6: andreascris1 folded before Flop (didn't bet)



PokerStars Zoom Hand #177277874275:  Hold'em No Limit ($0.02/$0.05) - 2017/10/23 21:41:18 CCT [2017/10/23 9:41:18 ET]
Table 'Donati' 6-max Seat #1 is the button
Seat 1: thx_donkey ($5.71 in chips) 
Seat 2: petokrcmar ($2.27 in chips) 
Seat 3: Martastarta ($5.05 in chips) 
Seat 4: FootTea ($7.75 in chips) 
Seat 5: MyFantassy ($4.03 in chips) 
Seat 6: HubertusB ($4.37 in chips) 
petokrcmar: posts small blind $0.02
Martastarta: posts big blind $0.05
*** HOLE CARDS ***
Dealt to HubertusB [Qd 7h]
FootTea: folds 
MyFantassy: raises $0.10 to $0.15
HubertusB: folds 
thx_donkey: folds 
petokrcmar: folds 
Martastarta: calls $0.10
*** FLOP *** [8c Qc Kd]
Martastarta: checks 
MyFantassy: bets $0.19
Martastarta: folds 
Uncalled bet ($0.19) returned to MyFantassy
MyFantassy collected $0.31 from pot
MyFantassy: doesn't show hand 
*** SUMMARY ***
Total pot $0.32 | Rake $0.01 
Board [8c Qc Kd]
Seat 1: thx_donkey (button) folded before Flop (didn't bet)
Seat 2: petokrcmar (small blind) folded before Flop
Seat 3: Martastarta (big blind) folded on the Flop
Seat 4: FootTea folded before Flop (didn't bet)
Seat 5: MyFantassy collected ($0.31)
Seat 6: HubertusB folded before Flop (didn't bet)



PokerStars Zoom Hand #177277882589:  Hold'em No Limit ($0.02/$0.05) - 2017/10/23 21:41:34 CCT [2017/10/23 9:41:34 ET]
Table 'Donati' 6-max Seat #1 is the button
Seat 1: AndreyDOOM ($8.91 in chips) 
Seat 2: Aristovoulos ($9.75 in chips) 
Seat 3: batitibi ($5 in chips) 
Seat 4: HubertusB ($4.35 in chips) 
Seat 5: siky1994 ($3.56 in chips) 
Seat 6: kingkonk123 ($5 in chips) 
Aristovoulos: posts small blind $0.02
batitibi: posts big blind $0.05
*** HOLE CARDS ***
Dealt to HubertusB [Jh 3s]
HubertusB: folds 
siky1994: folds 
kingkonk123: folds 
AndreyDOOM: folds 
Aristovoulos: raises $0.10 to $0.15
batitibi: folds 
Uncalled bet ($0.10) returned to Aristovoulos
Aristovoulos collected $0.10 from pot
Aristovoulos: doesn't show hand 
*** SUMMARY ***
Total pot $0.10 | Rake $0 
Seat 1: AndreyDOOM (button) folded before Flop (didn't bet)
Seat 2: Aristovoulos (small blind) collected ($0.10)
Seat 3: batitibi (big blind) folded before Flop
Seat 4: HubertusB folded before Flop (didn't bet)
Seat 5: siky1994 folded before Flop (didn't bet)
Seat 6: kingkonk123 folded before Flop (didn't bet)



PokerStars Zoom Hand #177277888800:  Hold'em No Limit ($0.02/$0.05) - 2017/10/23 21:41:46 CCT [2017/10/23 9:41:46 ET]
Table 'Donati' 6-max Seat #1 is the button
Seat 1: Region059 ($7.86 in chips) 
Seat 2: mixnovstar1 ($2.22 in chips) 
Seat 3: HubertusB ($4.35 in chips) 
Seat 4: lihkel ($5.19 in chips) 
Seat 5: Kerberus94 ($5.13 in chips) 
Seat 6: purkkot ($4.93 in chips) 
mixnovstar1: posts small blind $0.02
HubertusB: posts big blind $0.05
*** HOLE CARDS ***
Dealt to HubertusB [9c Ah]
lihkel: folds 
Kerberus94: folds 
purkkot: folds 
Region059: raises $0.07 to $0.12
mixnovstar1: calls $0.10
HubertusB: folds 
*** FLOP *** [6d As 7c]
mixnovstar1: checks 
Region059: bets $0.15
mixnovstar1: folds 
Uncalled bet ($0.15) returned to Region059
Region059 collected $0.28 from pot
Region059: doesn't show hand 
*** SUMMARY ***
Total pot $0.29 | Rake $0.01 
Board [6d As 7c]
Seat 1: Region059 (button) collected ($0.28)
Seat 2: mixnovstar1 (small blind) folded on the Flop
Seat 3: HubertusB (big blind) folded before Flop
Seat 4: lihkel folded before Flop (didn't bet)
Seat 5: Kerberus94 folded before Flop (didn't bet)
Seat 6: purkkot folded before Flop (didn't bet)



PokerStars Zoom Hand #177277877385:  Hold'em No Limit ($0.02/$0.05) - 2017/10/23 21:41:24 CCT [2017/10/23 9:41:24 ET]
Table 'Donati' 6-max Seat #1 is the button
Seat 1: kanclerz ($10.29 in chips) 
Seat 2: HubertusB ($4.37 in chips) 
Seat 3: YBANick ($4.95 in chips) 
Seat 4: infokiraly ($8.75 in chips) 
Seat 5: ooiaooao ($5.27 in chips) 
Seat 6: Comra1d ($5.36 in chips) 
HubertusB: posts small blind $0.02
YBANick: posts big blind $0.05
*** HOLE CARDS ***
Dealt to HubertusB [8h Ts]
infokiraly: folds 
ooiaooao: folds 
Comra1d: raises $0.07 to $0.12
kanclerz: calls $0.12
HubertusB: folds 
YBANick: folds 
*** FLOP *** [5d Qd Ad]
Comra1d: bets $0.16
kanclerz: calls $0.16
*** TURN *** [5d Qd Ad] [2d]
Comra1d: checks 
kanclerz: bets $0.25
Comra1d: calls $0.25
*** RIVER *** [5d Qd Ad 2d] [Js]
Comra1d: checks 
kanclerz: checks 
*** SHOW DOWN ***
Comra1d: shows [8d 7d] (a flush, Ace high)
kanclerz: mucks hand 
Comra1d collected $1.08 from pot
*** SUMMARY ***
Total pot $1.13 | Rake $0.05 
Board [5d Qd Ad 2d Js]
Seat 1: kanclerz (button) mucked [3c Ac]
Seat 2: HubertusB (small blind) folded before Flop
Seat 3: YBANick (big blind) folded before Flop
Seat 4: infokiraly folded before Flop (didn't bet)
Seat 5: ooiaooao folded before Flop (didn't bet)
Seat 6: Comra1d showed [8d 7d] and won ($1.08) with a flush, Ace high



PokerStars Zoom Hand #177277895618:  Hold'em No Limit ($0.02/$0.05) - 2017/10/23 21:41:59 CCT [2017/10/23 9:41:59 ET]
Table 'Donati' 6-max Seat #1 is the button
Seat 1: Silencer91 ($5 in chips) 
Seat 2: AndrewKomend ($2.71 in chips) 
Seat 3: GuardCorp ($5 in chips) 
Seat 4: HubertusB ($4.30 in chips) 
Seat 5: cadexuu ($10.30 in chips) 
Seat 6: InfideliX ($4.92 in chips) 
AndrewKomend: posts small blind $0.02
GuardCorp: posts big blind $0.05
*** HOLE CARDS ***
Dealt to HubertusB [Ks 4c]
HubertusB: folds 
cadexuu: folds 
InfideliX: raises $0.07 to $0.12
Silencer91: folds 
AndrewKomend: folds 
GuardCorp: folds 
Uncalled bet ($0.07) returned to InfideliX
InfideliX collected $0.12 from pot
InfideliX: doesn't show hand 
*** SUMMARY ***
Total pot $0.12 | Rake $0 
Seat 1: Silencer91 (button) folded before Flop (didn't bet)
Seat 2: AndrewKomend (small blind) folded before Flop
Seat 3: GuardCorp (big blind) folded before Flop
Seat 4: HubertusB folded before Flop (didn't bet)
Seat 5: cadexuu folded before Flop (didn't bet)
Seat 6: InfideliX collected ($0.12)



PokerStars Zoom Hand #177277886205:  Hold'em No Limit ($0.02/$0.05) - 2017/10/23 21:41:41 CCT [2017/10/23 9:41:41 ET]
Table 'Donati' 6-max Seat #1 is the button
Seat 1: opel9194 ($4.99 in chips) 
Seat 2: Hirx123 ($5.05 in chips) 
Seat 3: Baker1326 ($5 in chips) 
Seat 4: k1v0k ($7.02 in chips) 
Seat 5: qk rodriguez ($5.12 in chips) 
Seat 6: HubertusB ($4.35 in chips) 
Hirx123: posts small blind $0.02
Baker1326: posts big blind $0.05
*** HOLE CARDS ***
Dealt to HubertusB [Kd 3h]
k1v0k: folds 
qk rodriguez: folds 
HubertusB: folds 
opel9194: calls $0.05
Hirx123: folds 
Baker1326: checks 
*** FLOP *** [7s 9s 7c]
Baker1326: checks 
opel9194: checks 
*** TURN *** [7s 9s 7c] [9h]
Baker1326: checks 
opel9194: checks 
*** RIVER *** [7s 9s 7c 9h] [4d]
Baker1326: bets $0.05
opel9194: folds 
Uncalled bet ($0.05) returned to Baker1326
Baker1326 collected $0.12 from pot
Baker1326: doesn't show hand 
*** SUMMARY ***
Total pot $0.12 | Rake $0 
Board [7s 9s 7c 9h 4d]
Seat 1: opel9194 (button) folded on the River
Seat 2: Hirx123 (small blind) folded before Flop
Seat 3: Baker1326 (big blind) collected ($0.12)
Seat 4: k1v0k folded before Flop (didn't bet)
Seat 5: qk rodriguez folded before Flop (didn't bet)
Seat 6: HubertusB folded before Flop (didn't bet)



PokerStars Zoom Hand #177277880547:  Hold'em No Limit ($0.02/$0.05) - 2017/10/23 21:41:30 CCT [2017/10/23 9:41:30 ET]
Table 'Donati' 6-max Seat #1 is the button
Seat 1: Only_Vizard ($10.65 in chips) 
Seat 2: Kimovich 14 ($4.25 in chips) 
Seat 3: puertabarba ($4.81 in chips) 
Seat 4: Silencer91 ($6.56 in chips) 
Seat 5: HubertusB ($4.35 in chips) 
Seat 6: dajg2 ($7.42 in chips) 
Kimovich 14: posts small blind $0.02
puertabarba: posts big blind $0.05
*** HOLE CARDS ***
Dealt to HubertusB [4s Ah]
Silencer91: raises $0.10 to $0.15
HubertusB: folds 
dajg2: folds 
Only_Vizard: folds 
Kimovich 14: calls $0.13
puertabarba: folds 
*** FLOP *** [2c 7d 8d]
Kimovich 14: checks 
Silencer91: checks 
*** TURN *** [2c 7d 8d] [5h]
Kimovich 14: checks 
Silencer91: checks 
*** RIVER *** [2c 7d 8d 5h] [Tc]
Kimovich 14: checks 
Silencer91: bets $0.20
Kimovich 14: calls $0.20
*** SHOW DOWN ***
Silencer91: shows [Jc 9c] (a straight, Seven to Jack)
Kimovich 14: mucks hand 
Silencer91 collected $0.72 from pot
*** SUMMARY ***
Total pot $0.75 | Rake $0.03 
Board [2c 7d 8d 5h Tc]
Seat 1: Only_Vizard (button) folded before Flop (didn't bet)
Seat 2: Kimovich 14 (small blind) mucked [Qs Th]
Seat 3: puertabarba (big blind) folded before Flop
Seat 4: Silencer91 showed [Jc 9c] and won ($0.72) with a straight, Seven to Jack
Seat 5: HubertusB folded before Flop (didn't bet)
Seat 6: dajg2 folded before Flop (didn't bet)



PokerStars Zoom Hand #177277898195:  Hold'em No Limit ($0.02/$0.05) - 2017/10/23 21:42:04 CCT [2017/10/23 9:42:04 ET]
Table 'Donati' 6-max Seat #1 is the button
Seat 1: Gregório26 ($18.52 in chips) 
Seat 2: xampos77 ($11.72 in chips) 
Seat 3: akagiooo ($6.03 in chips) 
Seat 4: HubertusB ($4.30 in chips) 
Seat 5: Gladolsippax ($4.01 in chips) 
Seat 6: kareelwong ($4.62 in chips) 
xampos77: posts small blind $0.02
akagiooo: posts big blind $0.05
*** HOLE CARDS ***
Dealt to HubertusB [2c 8h]
HubertusB: folds 
Gladolsippax: folds 
kareelwong: raises $0.10 to $0.15
Gregório26: folds 
xampos77: raises $0.35 to $0.50
akagiooo: folds 
kareelwong: folds 
Uncalled bet ($0.35) returned to xampos77
xampos77 collected $0.35 from pot
xampos77: doesn't show hand 
*** SUMMARY ***
Total pot $0.35 | Rake $0 
Seat 1: Gregório26 (button) folded before Flop (didn't bet)
Seat 2: xampos77 (small blind) collected ($0.35)
Seat 3: akagiooo (big blind) folded before Flop
Seat 4: HubertusB folded before Flop (didn't bet)
Seat 5: Gladolsippax folded before Flop (didn't bet)
Seat 6: kareelwong folded before Flop



PokerStars Zoom Hand #177277902913:  Hold'em No Limit ($0.02/$0.05) - 2017/10/23 21:42:13 CCT [2017/10/23 9:42:13 ET]
Table 'Donati' 6-max Seat #1 is the button
Seat 1: HubertusB ($4.28 in chips) 
Seat 2: Comra1d ($6.48 in chips) 
Seat 3: zisis83 ($6.80 in chips) 
Seat 4: AverianovA ($6.90 in chips) 
Seat 5: Mo3r308 ($6.98 in chips) 
Seat 6: anett0406 ($3.28 in chips) 
Comra1d: posts small blind $0.02
zisis83: posts big blind $0.05
*** HOLE CARDS ***
Dealt to HubertusB [As 7d]
AverianovA: folds 
Mo3r308: folds 
anett0406: raises $0.10 to $0.15
HubertusB: folds 
Comra1d: folds 
zisis83: folds 
Uncalled bet ($0.10) returned to anett0406
anett0406 collected $0.12 from pot
anett0406: doesn't show hand 
*** SUMMARY ***
Total pot $0.12 | Rake $0 
Seat 1: HubertusB (button) folded before Flop (didn't bet)
Seat 2: Comra1d (small blind) folded before Flop
Seat 3: zisis83 (big blind) folded before Flop
Seat 4: AverianovA folded before Flop (didn't bet)
Seat 5: Mo3r308 folded before Flop (didn't bet)
Seat 6: anett0406 collected ($0.12)



PokerStars Zoom Hand #177277900250:  Hold'em No Limit ($0.02/$0.05) - 2017/10/23 21:42:08 CCT [2017/10/23 9:42:08 ET]
Table 'Donati' 6-max Seat #1 is the button
Seat 1: k1v0k ($5 in chips) 
Seat 2: HubertusB ($4.30 in chips) 
Seat 3: GBR96 ($5 in chips) 
Seat 4: Angela1987 ($5.05 in chips) 
Seat 5: Marlboro561 ($8.22 in chips) 
Seat 6: Sergejluga ($5.26 in chips) 
HubertusB: posts small blind $0.02
GBR96: posts big blind $0.05
*** HOLE CARDS ***
Dealt to HubertusB [Tc 8c]
Angela1987: raises $0.09 to $0.14
Marlboro561: folds 
Sergejluga: folds 
k1v0k: folds 
HubertusB: folds 
GBR96: calls $0.09
*** FLOP *** [Jc 9h Kc]
GBR96: checks 
Angela1987: checks 
*** TURN *** [Jc 9h Kc] [7c]
GBR96: checks 
Angela1987: checks 
*** RIVER *** [Jc 9h Kc 7c] [5c]
GBR96: checks 
Angela1987: checks 
*** SHOW DOWN ***
GBR96: shows [Ah Qs] (high card Ace)
Angela1987: shows [7s 5s] (two pair, Sevens and Fives)
Angela1987 collected $0.29 from pot
*** SUMMARY ***
Total pot $0.30 | Rake $0.01 
Board [Jc 9h Kc 7c 5c]
Seat 1: k1v0k (button) folded before Flop (didn't bet)
Seat 2: HubertusB (small blind) folded before Flop
Seat 3: GBR96 (big blind) showed [Ah Qs] and lost with high card Ace
Seat 4: Angela1987 showed [7s 5s] and won ($0.29) with two pair, Sevens and Fives
Seat 5: Marlboro561 folded before Flop (didn't bet)
Seat 6: Sergejluga folded before Flop (didn't bet)



PokerStars Zoom Hand #177277913882:  Hold'em No Limit ($0.02/$0.05) - 2017/10/23 21:42:34 CCT [2017/10/23 9:42:34 ET]
Table 'Donati' 6-max Seat #1 is the button
Seat 1: AndrewKomend ($2.64 in chips) 
Seat 2: catrat100 ($2.46 in chips) 
Seat 3: puertabarba ($4.86 in chips) 
Seat 4: GamblerWW ($12.39 in chips) 
Seat 5: HubertusB ($4.28 in chips) 
Seat 6: pisia20sm ($4.64 in chips) 
catrat100: posts small blind $0.02
puertabarba: posts big blind $0.05
*** HOLE CARDS ***
Dealt to HubertusB [Ts Ks]
GamblerWW: folds 
HubertusB: raises $0.05 to $0.10
pisia20sm: folds 
AndrewKomend: folds 
catrat100: folds 
puertabarba: folds 
Uncalled bet ($0.05) returned to HubertusB
HubertusB collected $0.12 from pot
HubertusB: doesn't show hand 
*** SUMMARY ***
Total pot $0.12 | Rake $0 
Seat 1: AndrewKomend (button) folded before Flop (didn't bet)
Seat 2: catrat100 (small blind) folded before Flop
Seat 3: puertabarba (big blind) folded before Flop
Seat 4: GamblerWW folded before Flop (didn't bet)
Seat 5: HubertusB collected ($0.12)
Seat 6: pisia20sm folded before Flop (didn't bet)



PokerStars Zoom Hand #177277922341:  Hold'em No Limit ($0.02/$0.05) - 2017/10/23 21:42:50 CCT [2017/10/23 9:42:50 ET]
Table 'Donati' 6-max Seat #1 is the button
Seat 1: Phadrigh ($5.35 in chips) 
Seat 2: InfideliX ($1.61 in chips) 
Seat 3: HubertusB ($4.35 in chips) 
Seat 4: Angela1987 ($5.20 in chips) 
Seat 5: andrqi ($5.23 in chips) 
Seat 6: Teflonmemory ($5 in chips) 
InfideliX: posts small blind $0.02
HubertusB: posts big blind $0.05
*** HOLE CARDS ***
Dealt to HubertusB [Qc Kh]
Angela1987: folds 
andrqi: folds 
Teflonmemory: folds 
Phadrigh: raises $0.05 to $0.10
InfideliX: folds 
HubertusB: calls $0.05
*** FLOP *** [2h Th 3d]
HubertusB: checks 
Phadrigh: bets $0.14
HubertusB: folds 
Uncalled bet ($0.14) returned to Phadrigh
Phadrigh collected $0.21 from pot
Phadrigh: doesn't show hand 
*** SUMMARY ***
Total pot $0.22 | Rake $0.01 
Board [2h Th 3d]
Seat 1: Phadrigh (button) collected ($0.21)
Seat 2: InfideliX (small blind) folded before Flop
Seat 3: HubertusB (big blind) folded on the Flop
Seat 4: Angela1987 folded before Flop (didn't bet)
Seat 5: andrqi folded before Flop (didn't bet)
Seat 6: Teflonmemory folded before Flop (didn't bet)



PokerStars Zoom Hand #177277931884:  Hold'em No Limit ($0.02/$0.05) - 2017/10/23 21:43:08 CCT [2017/10/23 9:43:08 ET]
Table 'Donati' 6-max Seat #1 is the button
Seat 1: qkrgmlrjs ($6.28 in chips) 
Seat 2: CoolFireX ($6.93 in chips) 
Seat 3: gutshotHuntr ($5 in chips) 
Seat 4: Pirotechnima ($6.55 in chips) 
Seat 5: McLaude669 ($2.57 in chips) 
Seat 6: HubertusB ($4.25 in chips) 
CoolFireX: posts small blind $0.02
gutshotHuntr: posts big blind $0.05
*** HOLE CARDS ***
Dealt to HubertusB [3h Th]
Pirotechnima: folds 
McLaude669: folds 
HubertusB: folds 
qkrgmlrjs: folds 
CoolFireX: folds 
Uncalled bet ($0.03) returned to gutshotHuntr
gutshotHuntr collected $0.04 from pot
gutshotHuntr: doesn't show hand 
*** SUMMARY ***
Total pot $0.04 | Rake $0 
Seat 1: qkrgmlrjs (button) folded before Flop (didn't bet)
Seat 2: CoolFireX (small blind) folded before Flop
Seat 3: gutshotHuntr (big blind) collected ($0.04)
Seat 4: Pirotechnima folded before Flop (didn't bet)
Seat 5: McLaude669 folded before Flop (didn't bet)
Seat 6: HubertusB folded before Flop (didn't bet)



PokerStars Zoom Hand #177277934570:  Hold'em No Limit ($0.02/$0.05) - 2017/10/23 21:43:13 CCT [2017/10/23 9:43:13 ET]
Table 'Donati' 6-max Seat #1 is the button
Seat 1: HubertusB ($4.25 in chips) 
Seat 2: cadexuu ($7.77 in chips) 
Seat 3: waitwalter ($15.27 in chips) 
Seat 4: Mo3r308 ($5.09 in chips) 
Seat 5: TibyStar ($5.37 in chips) 
Seat 6: Badger4515 ($5.48 in chips) 
cadexuu: posts small blind $0.02
waitwalter: posts big blind $0.05
*** HOLE CARDS ***
Dealt to HubertusB [Kd 4d]
Mo3r308: folds 
TibyStar: folds 
Badger4515: folds 
HubertusB: raises $0.05 to $0.10
cadexuu: calls $0.08
waitwalter: calls $0.05
*** FLOP *** [Th 8h 9h]
cadexuu: checks 
waitwalter: checks 
HubertusB: checks 
*** TURN *** [Th 8h 9h] [4h]
cadexuu: checks 
waitwalter: checks 
HubertusB: checks 
*** RIVER *** [Th 8h 9h 4h] [3c]
cadexuu: checks 
waitwalter: checks 
HubertusB: checks 
*** SHOW DOWN ***
cadexuu: shows [9s Js] (a pair of Nines)
waitwalter: shows [9c 8s] (two pair, Nines and Eights)
HubertusB: mucks hand 
waitwalter collected $0.29 from pot
*** SUMMARY ***
Total pot $0.30 | Rake $0.01 
Board [Th 8h 9h 4h 3c]
Seat 1: HubertusB (button) mucked [Kd 4d]
Seat 2: cadexuu (small blind) showed [9s Js] and lost with a pair of Nines
Seat 3: waitwalter (big blind) showed [9c 8s] and won ($0.29) with two pair, Nines and Eights
Seat 4: Mo3r308 folded before Flop (didn't bet)
Seat 5: TibyStar folded before Flop (didn't bet)
Seat 6: Badger4515 folded before Flop (didn't bet)



PokerStars Zoom Hand #177277954516:  Hold'em No Limit ($0.02/$0.05) - 2017/10/23 21:43:51 CCT [2017/10/23 9:43:51 ET]
Table 'Donati' 6-max Seat #1 is the button
Seat 1: jjdns ($1.61 in chips) 
Seat 2: HubertusB ($4.15 in chips) 
Seat 3: Faraon1207 ($1.43 in chips) 
Seat 4: Bernoulli834 ($6.90 in chips) 
Seat 5: M.BLOCH74 ($9.36 in chips) 
Seat 6: flamnr2 ($10.66 in chips) 
HubertusB: posts small blind $0.02
Faraon1207: posts big blind $0.05
*** HOLE CARDS ***
Dealt to HubertusB [5h 8h]
Bernoulli834: folds 
M.BLOCH74: raises $0.10 to $0.15
flamnr2: folds 
jjdns: calls $0.15
HubertusB: folds 
Faraon1207: folds 
*** FLOP *** [7s 3h 5c]
M.BLOCH74: bets $0.20
jjdns: folds 
Uncalled bet ($0.20) returned to M.BLOCH74
M.BLOCH74 collected $0.35 from pot
M.BLOCH74: doesn't show hand 
*** SUMMARY ***
Total pot $0.37 | Rake $0.02 
Board [7s 3h 5c]
Seat 1: jjdns (button) folded on the Flop
Seat 2: HubertusB (small blind) folded before Flop
Seat 3: Faraon1207 (big blind) folded before Flop
Seat 4: Bernoulli834 folded before Flop (didn't bet)
Seat 5: M.BLOCH74 collected ($0.35)
Seat 6: flamnr2 folded before Flop (didn't bet)



PokerStars Zoom Hand #177277963338:  Hold'em No Limit ($0.02/$0.05) - 2017/10/23 21:44:08 CCT [2017/10/23 9:44:08 ET]
Table 'Donati' 6-max Seat #1 is the button
Seat 1: GuardCorp ($5.07 in chips) 
Seat 2: cwcestari ($20.53 in chips) 
Seat 3: ikzw ($21.34 in chips) 
Seat 4: Aleks_Mag63 ($5.63 in chips) 
Seat 5: couchmichel ($9.28 in chips) 
Seat 6: HubertusB ($4.13 in chips) 
cwcestari: posts small blind $0.02
ikzw: posts big blind $0.05
*** HOLE CARDS ***
Dealt to HubertusB [Js 2c]
Aleks_Mag63: raises $0.35 to $0.40
couchmichel: folds 
HubertusB: folds 
GuardCorp: folds 
cwcestari: folds 
ikzw: folds 
Uncalled bet ($0.35) returned to Aleks_Mag63
Aleks_Mag63 collected $0.12 from pot
Aleks_Mag63: doesn't show hand 
*** SUMMARY ***
Total pot $0.12 | Rake $0 
Seat 1: GuardCorp (button) folded before Flop (didn't bet)
Seat 2: cwcestari (small blind) folded before Flop
Seat 3: ikzw (big blind) folded before Flop
Seat 4: Aleks_Mag63 collected ($0.12)
Seat 5: couchmichel folded before Flop (didn't bet)
Seat 6: HubertusB folded before Flop (didn't bet)



PokerStars Zoom Hand #177277959662:  Hold'em No Limit ($0.02/$0.05) - 2017/10/23 21:44:01 CCT [2017/10/23 9:44:01 ET]
Table 'Donati' 6-max Seat #1 is the button
Seat 1: anasanto ($11.05 in chips) 
Seat 2: ZyntexX ($9.03 in chips) 
Seat 3: shedboy96 ($5.05 in chips) 
Seat 4: Kerberus94 ($4.65 in chips) 
Seat 5: HubertusB ($4.13 in chips) 
Seat 6: XYHTRA ($5.21 in chips) 
ZyntexX: posts small blind $0.02
shedboy96: posts big blind $0.05
*** HOLE CARDS ***
Dealt to HubertusB [6h Qd]
Kerberus94: folds 
HubertusB: folds 
XYHTRA: raises $0.10 to $0.15
anasanto: folds 
ZyntexX: calls $0.13
shedboy96: folds 
*** FLOP *** [Jc 9d 3c]
ZyntexX: bets $0.17
XYHTRA: folds 
Uncalled bet ($0.17) returned to ZyntexX
ZyntexX collected $0.34 from pot
ZyntexX: doesn't show hand 
*** SUMMARY ***
Total pot $0.35 | Rake $0.01 
Board [Jc 9d 3c]
Seat 1: anasanto (button) folded before Flop (didn't bet)
Seat 2: ZyntexX (small blind) collected ($0.34)
Seat 3: shedboy96 (big blind) folded before Flop
Seat 4: Kerberus94 folded before Flop (didn't bet)
Seat 5: HubertusB folded before Flop (didn't bet)
Seat 6: XYHTRA folded on the Flop



PokerStars Zoom Hand #177277966387:  Hold'em No Limit ($0.02/$0.05) - 2017/10/23 21:44:14 CCT [2017/10/23 9:44:14 ET]
Table 'Donati' 6-max Seat #1 is the button
Seat 1: waitwalter ($15.44 in chips) 
Seat 2: Baker1326 ($5 in chips) 
Seat 3: docent3366 ($5 in chips) 
Seat 4: HubertusB ($4.13 in chips) 
Seat 5: shedboy96 ($5 in chips) 
Seat 6: Aristovoulos ($6.69 in chips) 
Baker1326: posts small blind $0.02
docent3366: posts big blind $0.05
*** HOLE CARDS ***
Dealt to HubertusB [7d Kc]
HubertusB: folds 
shedboy96: folds 
Aristovoulos: raises $0.10 to $0.15
waitwalter: folds 
Baker1326: calls $0.13
docent3366: folds 
*** FLOP *** [6c Jc 2d]
Baker1326: checks 
Aristovoulos: checks 
*** TURN *** [6c Jc 2d] [3c]
Baker1326: checks 
Aristovoulos: bets $0.20
Baker1326: folds 
Uncalled bet ($0.20) returned to Aristovoulos
Aristovoulos collected $0.34 from pot
Aristovoulos: doesn't show hand 
*** SUMMARY ***
Total pot $0.35 | Rake $0.01 
Board [6c Jc 2d 3c]
Seat 1: waitwalter (button) folded before Flop (didn't bet)
Seat 2: Baker1326 (small blind) folded on the Turn
Seat 3: docent3366 (big blind) folded before Flop
Seat 4: HubertusB folded before Flop (didn't bet)
Seat 5: shedboy96 folded before Flop (didn't bet)
Seat 6: Aristovoulos collected ($0.34)



PokerStars Zoom Hand #177277968959:  Hold'em No Limit ($0.02/$0.05) - 2017/10/23 21:44:19 CCT [2017/10/23 9:44:19 ET]
Table 'Donati' 6-max Seat #1 is the button
Seat 1: noemil073 ($5.70 in chips) 
Seat 2: Pawellloo ($8.47 in chips) 
Seat 3: Pirotechnima ($6.30 in chips) 
Seat 4: MrSuperior ($4.30 in chips) 
Seat 5: HubertusB ($4.13 in chips) 
Seat 6: cadexuu ($7.62 in chips) 
Pawellloo: posts small blind $0.02
Pirotechnima: posts big blind $0.05
*** HOLE CARDS ***
Dealt to HubertusB [5h Ks]
MrSuperior: folds 
HubertusB: folds 
cadexuu: raises $0.10 to $0.15
noemil073: calls $0.15
Pawellloo: folds 
Pirotechnima: folds 
*** FLOP *** [9h Tc Td]
cadexuu: bets $0.20
noemil073: calls $0.20
*** TURN *** [9h Tc Td] [2h]
cadexuu: bets $0.40
noemil073: calls $0.40
*** RIVER *** [9h Tc Td 2h] [5c]
cadexuu: checks 
noemil073: checks 
*** SHOW DOWN ***
cadexuu: shows [8d 9d] (two pair, Tens and Nines)
noemil073: mucks hand 
cadexuu collected $1.50 from pot
*** SUMMARY ***
Total pot $1.57 | Rake $0.07 
Board [9h Tc Td 2h 5c]
Seat 1: noemil073 (button) mucked [Kd Ah]
Seat 2: Pawellloo (small blind) folded before Flop
Seat 3: Pirotechnima (big blind) folded before Flop
Seat 4: MrSuperior folded before Flop (didn't bet)
Seat 5: HubertusB folded before Flop (didn't bet)
Seat 6: cadexuu showed [8d 9d] and won ($1.50) with two pair, Tens and Nines



PokerStars Zoom Hand #177277975100:  Hold'em No Limit ($0.02/$0.05) - 2017/10/23 21:44:31 CCT [2017/10/23 9:44:31 ET]
Table 'Donati' 6-max Seat #1 is the button
Seat 1: MrInTerra ($10.51 in chips) 
Seat 2: HubertusB ($4.08 in chips) 
Seat 3: knejevic ($4.77 in chips) 
Seat 4: AndreyDOOM ($10.09 in chips) 
Seat 5: couchmichel ($7.74 in chips) 
Seat 6: Only_Vizard ($9.34 in chips) 
HubertusB: posts small blind $0.02
knejevic: posts big blind $0.05
*** HOLE CARDS ***
Dealt to HubertusB [7s 6s]
AndreyDOOM: folds 
couchmichel: folds 
Only_Vizard: folds 
MrInTerra: raises $0.05 to $0.10
HubertusB: raises $0.30 to $0.40
knejevic: folds 
MrInTerra: folds 
Uncalled bet ($0.30) returned to HubertusB
HubertusB collected $0.25 from pot
HubertusB: doesn't show hand 
*** SUMMARY ***
Total pot $0.25 | Rake $0 
Seat 1: MrInTerra (button) folded before Flop
Seat 2: HubertusB (small blind) collected ($0.25)
Seat 3: knejevic (big blind) folded before Flop
Seat 4: AndreyDOOM folded before Flop (didn't bet)
Seat 5: couchmichel folded before Flop (didn't bet)
Seat 6: Only_Vizard folded before Flop (didn't bet)



PokerStars Zoom Hand #177277971507:  Hold'em No Limit ($0.02/$0.05) - 2017/10/23 21:44:24 CCT [2017/10/23 9:44:24 ET]
Table 'Donati' 6-max Seat #1 is the button
Seat 1: a.sh.1952 ($8.90 in chips) 
Seat 2: Arthas571 ($6.54 in chips) 
Seat 3: HubertusB ($4.13 in chips) 
Seat 4: kareelwong ($4.62 in chips) 
Seat 5: prochy1909 ($14.23 in chips) 
Seat 6: TOKI1509 ($6.30 in chips) 
Arthas571: posts small blind $0.02
HubertusB: posts big blind $0.05
*** HOLE CARDS ***
Dealt to HubertusB [Ah 5c]
kareelwong: raises $0.10 to $0.15
prochy1909: folds 
TOKI1509: folds 
a.sh.1952: raises $0.10 to $0.25
Arthas571: folds 
HubertusB: folds 
kareelwong: calls $0.10
*** FLOP *** [7d 4c 4d]
kareelwong: checks 
a.sh.1952: bets $0.55
kareelwong: calls $0.55
*** TURN *** [7d 4c 4d] [2c]
kareelwong: checks 
a.sh.1952: bets $0.80
kareelwong: folds 
Uncalled bet ($0.80) returned to a.sh.1952
a.sh.1952 collected $1.60 from pot
a.sh.1952: doesn't show hand 
*** SUMMARY ***
Total pot $1.67 | Rake $0.07 
Board [7d 4c 4d 2c]
Seat 1: a.sh.1952 (button) collected ($1.60)
Seat 2: Arthas571 (small blind) folded before Flop
Seat 3: HubertusB (big blind) folded before Flop
Seat 4: kareelwong folded on the Turn
Seat 5: prochy1909 folded before Flop (didn't bet)
Seat 6: TOKI1509 folded before Flop (didn't bet)



PokerStars Zoom Hand #177277991814:  Hold'em No Limit ($0.02/$0.05) - 2017/10/23 21:45:03 CCT [2017/10/23 9:45:03 ET]
Table 'Donati' 6-max Seat #1 is the button
Seat 1: HubertusB ($4.23 in chips) 
Seat 2: M.BLOCH74 ($6.12 in chips) 
Seat 3: hsingyang ($10.78 in chips) 
Seat 4: Aristovoulos ($11.58 in chips) 
Seat 5: batitibi ($5.69 in chips) 
Seat 6: kareelwong ($5.81 in chips) 
M.BLOCH74: posts small blind $0.02
hsingyang: posts big blind $0.05
*** HOLE CARDS ***
Dealt to HubertusB [Ts 9h]
Aristovoulos: folds 
batitibi: folds 
kareelwong: folds 
HubertusB: folds 
M.BLOCH74: folds 
Uncalled bet ($0.03) returned to hsingyang
hsingyang collected $0.04 from pot
hsingyang: doesn't show hand 
*** SUMMARY ***
Total pot $0.04 | Rake $0 
Seat 1: HubertusB (button) folded before Flop (didn't bet)
Seat 2: M.BLOCH74 (small blind) folded before Flop
Seat 3: hsingyang (big blind) collected ($0.04)
Seat 4: Aristovoulos folded before Flop (didn't bet)
Seat 5: batitibi folded before Flop (didn't bet)
Seat 6: kareelwong folded before Flop (didn't bet)



PokerStars Zoom Hand #177278001199:  Hold'em No Limit ($0.02/$0.05) - 2017/10/23 21:45:21 CCT [2017/10/23 9:45:21 ET]
Table 'Donati' 6-max Seat #1 is the button
Seat 1: HubertusB ($4.23 in chips) 
Seat 2: Kadastep ($7.25 in chips) 
Seat 3: geboure ($1.53 in chips) 
Seat 4: GamblerWW ($9.02 in chips) 
Seat 5: botzanu ($6.42 in chips) 
Seat 6: Marlboro561 ($7.95 in chips) 
Kadastep: posts small blind $0.02
geboure: posts big blind $0.05
*** HOLE CARDS ***
Dealt to HubertusB [Jd Kd]
GamblerWW: folds 
botzanu: folds 
Marlboro561: folds 
HubertusB: raises $0.05 to $0.10
Kadastep: folds 
geboure: folds 
Uncalled bet ($0.05) returned to HubertusB
HubertusB collected $0.12 from pot
HubertusB: doesn't show hand 
*** SUMMARY ***
Total pot $0.12 | Rake $0 
Seat 1: HubertusB (button) collected ($0.12)
Seat 2: Kadastep (small blind) folded before Flop
Seat 3: geboure (big blind) folded before Flop
Seat 4: GamblerWW folded before Flop (didn't bet)
Seat 5: botzanu folded before Flop (didn't bet)
Seat 6: Marlboro561 folded before Flop (didn't bet)



PokerStars Zoom Hand #177277994937:  Hold'em No Limit ($0.02/$0.05) - 2017/10/23 21:45:09 CCT [2017/10/23 9:45:09 ET]
Table 'Donati' 6-max Seat #1 is the button
Seat 1: GamblerWW ($12.27 in chips) 
Seat 2: couchmichel ($8.91 in chips) 
Seat 3: rack1777 ($6.24 in chips) 
Seat 4: HubertusB ($4.23 in chips) 
Seat 5: LeXPSU ($6.45 in chips) 
Seat 6: BOSCOBOT ($9.11 in chips) 
couchmichel: posts small blind $0.02
rack1777: posts big blind $0.05
*** HOLE CARDS ***
Dealt to HubertusB [Ah 7d]
HubertusB: folds 
LeXPSU: folds 
BOSCOBOT: folds 
GamblerWW: raises $0.10 to $0.15
couchmichel: folds 
rack1777: folds 
Uncalled bet ($0.10) returned to GamblerWW
GamblerWW collected $0.12 from pot
GamblerWW: doesn't show hand 
*** SUMMARY ***
Total pot $0.12 | Rake $0 
Seat 1: GamblerWW (button) collected ($0.12)
Seat 2: couchmichel (small blind) folded before Flop
Seat 3: rack1777 (big blind) folded before Flop
Seat 4: HubertusB folded before Flop (didn't bet)
Seat 5: LeXPSU folded before Flop (didn't bet)
Seat 6: BOSCOBOT folded before Flop (didn't bet)



PokerStars Zoom Hand #177277998002:  Hold'em No Limit ($0.02/$0.05) - 2017/10/23 21:45:15 CCT [2017/10/23 9:45:15 ET]
Table 'Donati' 6-max Seat #1 is the button
Seat 1: prochy1909 ($14.16 in chips) 
Seat 2: Angee1962 ($4.29 in chips) 
Seat 3: 65Johansen ($3.11 in chips) 
Seat 4: pittibaerli ($5.96 in chips) 
Seat 5: geboure ($1.53 in chips) 
Seat 6: HubertusB ($4.23 in chips) 
Angee1962: posts small blind $0.02
65Johansen: posts big blind $0.05
*** HOLE CARDS ***
Dealt to HubertusB [6h Kc]
pittibaerli: folds 
geboure: folds 
HubertusB: folds 
prochy1909: raises $0.08 to $0.13
Angee1962: folds 
65Johansen: folds 
Uncalled bet ($0.08) returned to prochy1909
prochy1909 collected $0.12 from pot
prochy1909: doesn't show hand 
*** SUMMARY ***
Total pot $0.12 | Rake $0 
Seat 1: prochy1909 (button) collected ($0.12)
Seat 2: Angee1962 (small blind) folded before Flop
Seat 3: 65Johansen (big blind) folded before Flop
Seat 4: pittibaerli folded before Flop (didn't bet)
Seat 5: geboure folded before Flop (didn't bet)
Seat 6: HubertusB folded before Flop (didn't bet)



PokerStars Zoom Hand #177278011570:  Hold'em No Limit ($0.02/$0.05) - 2017/10/23 21:45:41 CCT [2017/10/23 9:45:41 ET]
Table 'Donati' 6-max Seat #1 is the button
Seat 1: Ser Tyapkin ($5 in chips) 
Seat 2: zeys99 ($8.92 in chips) 
Seat 3: HubertusB ($4.30 in chips) 
Seat 4: Barbaroid ($5.68 in chips) 
Seat 5: Amigo113 ($5.14 in chips) 
Seat 6: 23Vadimka ($7.04 in chips) 
zeys99: posts small blind $0.02
HubertusB: posts big blind $0.05
*** HOLE CARDS ***
Dealt to HubertusB [Ah 4d]
Barbaroid: folds 
Amigo113: folds 
23Vadimka: folds 
Ser Tyapkin: raises $0.05 to $0.10
zeys99: folds 
HubertusB: folds 
Uncalled bet ($0.05) returned to Ser Tyapkin
Ser Tyapkin collected $0.12 from pot
Ser Tyapkin: doesn't show hand 
*** SUMMARY ***
Total pot $0.12 | Rake $0 
Seat 1: Ser Tyapkin (button) collected ($0.12)
Seat 2: zeys99 (small blind) folded before Flop
Seat 3: HubertusB (big blind) folded before Flop
Seat 4: Barbaroid folded before Flop (didn't bet)
Seat 5: Amigo113 folded before Flop (didn't bet)
Seat 6: 23Vadimka folded before Flop (didn't bet)



PokerStars Zoom Hand #177278015799:  Hold'em No Limit ($0.02/$0.05) - 2017/10/23 21:45:49 CCT [2017/10/23 9:45:49 ET]
Table 'Donati' 6-max Seat #1 is the button
Seat 1: 500Ang ($4.55 in chips) 
Seat 2: HubertusB ($4.25 in chips) 
Seat 3: oessi11 ($5.46 in chips) 
Seat 4: Do4ka ($3.01 in chips) 
Seat 5: kanclerz ($14.65 in chips) 
Seat 6: AK@KK@AK ($24.02 in chips) 
HubertusB: posts small blind $0.02
oessi11: posts big blind $0.05
*** HOLE CARDS ***
Dealt to HubertusB [6s Kd]
Do4ka: folds 
kanclerz: raises $0.10 to $0.15
AK@KK@AK: folds 
500Ang: folds 
HubertusB: folds 
oessi11: folds 
Uncalled bet ($0.10) returned to kanclerz
kanclerz collected $0.12 from pot
kanclerz: doesn't show hand 
*** SUMMARY ***
Total pot $0.12 | Rake $0 
Seat 1: 500Ang (button) folded before Flop (didn't bet)
Seat 2: HubertusB (small blind) folded before Flop
Seat 3: oessi11 (big blind) folded before Flop
Seat 4: Do4ka folded before Flop (didn't bet)
Seat 5: kanclerz collected ($0.12)
Seat 6: AK@KK@AK folded before Flop (didn't bet)



PokerStars Zoom Hand #177278022646:  Hold'em No Limit ($0.02/$0.05) - 2017/10/23 21:46:02 CCT [2017/10/23 9:46:02 ET]
Table 'Donati' 6-max Seat #1 is the button
Seat 1: kareelwong ($5.93 in chips) 
Seat 2: lll1112 ($5.32 in chips) 
Seat 3: @moromin ($8.32 in chips) 
Seat 4: Teflonmemory ($6.43 in chips) 
Seat 5: HubertusB ($4.23 in chips) 
Seat 6: taniunia1988 ($5.07 in chips) 
lll1112: posts small blind $0.02
@moromin: posts big blind $0.05
*** HOLE CARDS ***
Dealt to HubertusB [Ah Jh]
Teflonmemory: folds 
HubertusB: raises $0.05 to $0.10
taniunia1988: folds 
kareelwong: folds 
lll1112: folds 
@moromin: folds 
Uncalled bet ($0.05) returned to HubertusB
HubertusB collected $0.12 from pot
HubertusB: doesn't show hand 
*** SUMMARY ***
Total pot $0.12 | Rake $0 
Seat 1: kareelwong (button) folded before Flop (didn't bet)
Seat 2: lll1112 (small blind) folded before Flop
Seat 3: @moromin (big blind) folded before Flop
Seat 4: Teflonmemory folded before Flop (didn't bet)
Seat 5: HubertusB collected ($0.12)
Seat 6: taniunia1988 folded before Flop (didn't bet)



PokerStars Zoom Hand #177278020033:  Hold'em No Limit ($0.02/$0.05) - 2017/10/23 21:45:57 CCT [2017/10/23 9:45:57 ET]
Table 'Donati' 6-max Seat #1 is the button
Seat 1: AverianovA ($6.04 in chips) 
Seat 2: Badger4515 ($5.23 in chips) 
Seat 3: hsingyang ($17.79 in chips) 
Seat 4: sr21cm ($4.81 in chips) 
Seat 5: Mircea Mir ($4.72 in chips) 
Seat 6: HubertusB ($4.23 in chips) 
Badger4515: posts small blind $0.02
hsingyang: posts big blind $0.05
*** HOLE CARDS ***
Dealt to HubertusB [Qd 5c]
sr21cm: folds 
Mircea Mir: folds 
HubertusB: folds 
AverianovA: raises $0.07 to $0.12
Badger4515: folds 
hsingyang: folds 
Uncalled bet ($0.07) returned to AverianovA
AverianovA collected $0.12 from pot
AverianovA: doesn't show hand 
*** SUMMARY ***
Total pot $0.12 | Rake $0 
Seat 1: AverianovA (button) collected ($0.12)
Seat 2: Badger4515 (small blind) folded before Flop
Seat 3: hsingyang (big blind) folded before Flop
Seat 4: sr21cm folded before Flop (didn't bet)
Seat 5: Mircea Mir folded before Flop (didn't bet)
Seat 6: HubertusB folded before Flop (didn't bet)



PokerStars Zoom Hand #177278008942:  Hold'em No Limit ($0.02/$0.05) - 2017/10/23 21:45:36 CCT [2017/10/23 9:45:36 ET]
Table 'Donati' 6-max Seat #1 is the button
Seat 1: Arthas571 ($6.42 in chips) 
Seat 2: diablo4824 ($6.70 in chips) 
Seat 3: qkrgmlrjs ($6.17 in chips) 
Seat 4: HubertusB ($4.30 in chips) 
Seat 5: artemlennon ($10.94 in chips) 
Seat 6: Kerberus94 ($4.32 in chips) 
diablo4824: posts small blind $0.02
qkrgmlrjs: posts big blind $0.05
*** HOLE CARDS ***
Dealt to HubertusB [2c Kc]
HubertusB: folds 
artemlennon: folds 
Kerberus94: folds 
Arthas571: folds 
diablo4824: raises $0.10 to $0.15
qkrgmlrjs: calls $0.10
*** FLOP *** [7h Kh Jc]
diablo4824: checks 
qkrgmlrjs: bets $0.15
diablo4824: folds 
Uncalled bet ($0.15) returned to qkrgmlrjs
qkrgmlrjs collected $0.29 from pot
qkrgmlrjs: doesn't show hand 
*** SUMMARY ***
Total pot $0.30 | Rake $0.01 
Board [7h Kh Jc]
Seat 1: Arthas571 (button) folded before Flop (didn't bet)
Seat 2: diablo4824 (small blind) folded on the Flop
Seat 3: qkrgmlrjs (big blind) collected ($0.29)
Seat 4: HubertusB folded before Flop (didn't bet)
Seat 5: artemlennon folded before Flop (didn't bet)
Seat 6: Kerberus94 folded before Flop (didn't bet)



PokerStars Zoom Hand #177278028464:  Hold'em No Limit ($0.02/$0.05) - 2017/10/23 21:46:13 CCT [2017/10/23 9:46:13 ET]
Table 'Donati' 6-max Seat #1 is the button
Seat 1: HubertusB ($4.30 in chips) 
Seat 2: WALLERHANS ($2.45 in chips) 
Seat 3: rack1777 ($5.56 in chips) 
Seat 4: BogMiros1 ($5.68 in chips) 
Seat 5: Blackantz ($5.38 in chips) 
Seat 6: Bernoulli834 ($7.01 in chips) 
WALLERHANS: posts small blind $0.02
rack1777: posts big blind $0.05
*** HOLE CARDS ***
Dealt to HubertusB [2s Tc]
BogMiros1: folds 
Blackantz: folds 
Bernoulli834: folds 
HubertusB: folds 
WALLERHANS: calls $0.03
rack1777: checks 
*** FLOP *** [7c 6c 9c]
WALLERHANS: bets $0.15
rack1777: folds 
Uncalled bet ($0.15) returned to WALLERHANS
WALLERHANS collected $0.10 from pot
WALLERHANS: doesn't show hand 
*** SUMMARY ***
Total pot $0.10 | Rake $0 
Board [7c 6c 9c]
Seat 1: HubertusB (button) folded before Flop (didn't bet)
Seat 2: WALLERHANS (small blind) collected ($0.10)
Seat 3: rack1777 (big blind) folded on the Flop
Seat 4: BogMiros1 folded before Flop (didn't bet)
Seat 5: Blackantz folded before Flop (didn't bet)
Seat 6: Bernoulli834 folded before Flop (didn't bet)



PokerStars Zoom Hand #177278033159:  Hold'em No Limit ($0.02/$0.05) - 2017/10/23 21:46:22 CCT [2017/10/23 9:46:22 ET]
Table 'Donati' 6-max Seat #1 is the button
Seat 1: swesda21 ($8.12 in chips) 
Seat 2: GaSeR_77 ($17.44 in chips) 
Seat 3: HubertusB ($4.30 in chips) 
Seat 4: qk rodriguez ($10.89 in chips) 
Seat 5: Bjeujeuler ($5 in chips) 
Seat 6: xoshimin ($6.04 in chips) 
GaSeR_77: posts small blind $0.02
HubertusB: posts big blind $0.05
*** HOLE CARDS ***
Dealt to HubertusB [6s 8s]
qk rodriguez: folds 
Bjeujeuler: folds 
xoshimin: folds 
swesda21: raises $0.07 to $0.12
GaSeR_77: folds 
HubertusB: folds 
Uncalled bet ($0.07) returned to swesda21
swesda21 collected $0.12 from pot
swesda21: doesn't show hand 
*** SUMMARY ***
Total pot $0.12 | Rake $0 
Seat 1: swesda21 (button) collected ($0.12)
Seat 2: GaSeR_77 (small blind) folded before Flop
Seat 3: HubertusB (big blind) folded before Flop
Seat 4: qk rodriguez folded before Flop (didn't bet)
Seat 5: Bjeujeuler folded before Flop (didn't bet)
Seat 6: xoshimin folded before Flop (didn't bet)



PokerStars Zoom Hand #177278031029:  Hold'em No Limit ($0.02/$0.05) - 2017/10/23 21:46:18 CCT [2017/10/23 9:46:18 ET]
Table 'Donati' 6-max Seat #1 is the button
Seat 1: biv6b ($4.37 in chips) 
Seat 2: Region059 ($5.88 in chips) 
Seat 3: sr21cm ($4.79 in chips) 
Seat 4: HubertusB ($4.30 in chips) 
Seat 5: -=KZ PRO=- ($5.83 in chips) 
Seat 6: Bjeujeuler ($5 in chips) 
Region059: posts small blind $0.02
sr21cm: posts big blind $0.05
*** HOLE CARDS ***
Dealt to HubertusB [Ks 7h]
HubertusB: folds 
-=KZ PRO=-: folds 
Bjeujeuler: folds 
biv6b: raises $0.07 to $0.12
Region059: folds 
sr21cm: calls $0.07
*** FLOP *** [Kd 8c 3h]
sr21cm: checks 
biv6b: checks 
*** TURN *** [Kd 8c 3h] [3s]
sr21cm: bets $0.16
biv6b: calls $0.16
*** RIVER *** [Kd 8c 3h 3s] [9d]
sr21cm: checks 
biv6b: bets $0.35
sr21cm: calls $0.35
*** SHOW DOWN ***
biv6b: shows [As 3d] (three of a kind, Threes)
sr21cm: mucks hand 
biv6b collected $1.23 from pot
*** SUMMARY ***
Total pot $1.28 | Rake $0.05 
Board [Kd 8c 3h 3s 9d]
Seat 1: biv6b (button) showed [As 3d] and won ($1.23) with three of a kind, Threes
Seat 2: Region059 (small blind) folded before Flop
Seat 3: sr21cm (big blind) mucked [6c 6d]
Seat 4: HubertusB folded before Flop (didn't bet)
Seat 5: -=KZ PRO=- folded before Flop (didn't bet)
Seat 6: Bjeujeuler folded before Flop (didn't bet)



PokerStars Zoom Hand #177278041168:  Hold'em No Limit ($0.02/$0.05) - 2017/10/23 21:46:37 CCT [2017/10/23 9:46:37 ET]
Table 'Donati' 6-max Seat #1 is the button
Seat 1: Aleks_Mag63 ($5.95 in chips) 
Seat 2: HubertusB ($4.25 in chips) 
Seat 3: Baker1326 ($5.70 in chips) 
Seat 4: artemlennon ($10.92 in chips) 
Seat 5: Novaa3 ($23.75 in chips) 
Seat 6: kingkonk123 ($5.05 in chips) 
HubertusB: posts small blind $0.02
Baker1326: posts big blind $0.05
*** HOLE CARDS ***
Dealt to HubertusB [7s 9c]
artemlennon: folds 
Novaa3: folds 
kingkonk123: folds 
Aleks_Mag63: raises $0.20 to $0.25
HubertusB: folds 
Baker1326: folds 
Uncalled bet ($0.20) returned to Aleks_Mag63
Aleks_Mag63 collected $0.12 from pot
Aleks_Mag63: doesn't show hand 
*** SUMMARY ***
Total pot $0.12 | Rake $0 
Seat 1: Aleks_Mag63 (button) collected ($0.12)
Seat 2: HubertusB (small blind) folded before Flop
Seat 3: Baker1326 (big blind) folded before Flop
Seat 4: artemlennon folded before Flop (didn't bet)
Seat 5: Novaa3 folded before Flop (didn't bet)
Seat 6: kingkonk123 folded before Flop (didn't bet)



PokerStars Zoom Hand #177278044395:  Hold'em No Limit ($0.02/$0.05) - 2017/10/23 21:46:43 CCT [2017/10/23 9:46:43 ET]
Table 'Donati' 6-max Seat #1 is the button
Seat 1: kareelwong ($4.85 in chips) 
Seat 2: petokrcmar ($2.24 in chips) 
Seat 3: pisia20sm ($5 in chips) 
Seat 4: VankaSIP ($5.02 in chips) 
Seat 5: Quadrazar ($5 in chips) 
Seat 6: HubertusB ($4.23 in chips) 
petokrcmar: posts small blind $0.02
pisia20sm: posts big blind $0.05
*** HOLE CARDS ***
Dealt to HubertusB [4d 6h]
VankaSIP: folds 
Quadrazar: folds 
HubertusB: folds 
kareelwong: folds 
petokrcmar: folds 
Uncalled bet ($0.03) returned to pisia20sm
pisia20sm collected $0.04 from pot
pisia20sm: doesn't show hand 
*** SUMMARY ***
Total pot $0.04 | Rake $0 
Seat 1: kareelwong (button) folded before Flop (didn't bet)
Seat 2: petokrcmar (small blind) folded before Flop
Seat 3: pisia20sm (big blind) collected ($0.04)
Seat 4: VankaSIP folded before Flop (didn't bet)
Seat 5: Quadrazar folded before Flop (didn't bet)
Seat 6: HubertusB folded before Flop (didn't bet)



PokerStars Zoom Hand #177278038496:  Hold'em No Limit ($0.02/$0.05) - 2017/10/23 21:46:32 CCT [2017/10/23 9:46:32 ET]
Table 'Donati' 6-max Seat #1 is the button
Seat 1: fonsdewolf ($5 in chips) 
Seat 2: Quadrazar ($5 in chips) 
Seat 3: anasanto ($11.26 in chips) 
Seat 4: EasyGamerrr ($6.69 in chips) 
Seat 5: HubertusB ($4.25 in chips) 
Seat 6: Solarse ($4.72 in chips) 
Quadrazar: posts small blind $0.02
anasanto: posts big blind $0.05
*** HOLE CARDS ***
Dealt to HubertusB [Jc 2s]
EasyGamerrr: folds 
HubertusB: folds 
Solarse: raises $0.12 to $0.17
fonsdewolf: folds 
Quadrazar: folds 
anasanto: folds 
Uncalled bet ($0.12) returned to Solarse
Solarse collected $0.12 from pot
Solarse: doesn't show hand 
*** SUMMARY ***
Total pot $0.12 | Rake $0 
Seat 1: fonsdewolf (button) folded before Flop (didn't bet)
Seat 2: Quadrazar (small blind) folded before Flop
Seat 3: anasanto (big blind) folded before Flop
Seat 4: EasyGamerrr folded before Flop (didn't bet)
Seat 5: HubertusB folded before Flop (didn't bet)
Seat 6: Solarse collected ($0.12)



PokerStars Zoom Hand #177278049638:  Hold'em No Limit ($0.02/$0.05) - 2017/10/23 21:46:53 CCT [2017/10/23 9:46:53 ET]
Table 'Donati' 6-max Seat #1 is the button
Seat 1: HubertusB ($4.23 in chips) 
Seat 2: Aristovoulos ($11.23 in chips) 
Seat 3: anasanto ($5 in chips) 
Seat 4: polybomy ($5 in chips) 
Seat 5: nnbook ($3.96 in chips) 
Seat 6: BOSCOBOT ($5.56 in chips) 
Aristovoulos: posts small blind $0.02
anasanto: posts big blind $0.05
*** HOLE CARDS ***
Dealt to HubertusB [4d 3s]
polybomy: raises $0.07 to $0.12
nnbook: folds 
BOSCOBOT: folds 
HubertusB: folds 
Aristovoulos: folds 
anasanto: folds 
Uncalled bet ($0.07) returned to polybomy
polybomy collected $0.12 from pot
polybomy: doesn't show hand 
*** SUMMARY ***
Total pot $0.12 | Rake $0 
Seat 1: HubertusB (button) folded before Flop (didn't bet)
Seat 2: Aristovoulos (small blind) folded before Flop
Seat 3: anasanto (big blind) folded before Flop
Seat 4: polybomy collected ($0.12)
Seat 5: nnbook folded before Flop (didn't bet)
Seat 6: BOSCOBOT folded before Flop (didn't bet)



PokerStars Zoom Hand #177278046999:  Hold'em No Limit ($0.02/$0.05) - 2017/10/23 21:46:48 CCT [2017/10/23 9:46:48 ET]
Table 'Donati' 6-max Seat #1 is the button
Seat 1: Baker1326 ($5.65 in chips) 
Seat 2: Kerberus94 ($5.18 in chips) 
Seat 3: PointersDE ($5 in chips) 
Seat 4: Quadrazar ($5 in chips) 
Seat 5: HubertusB ($4.23 in chips) 
Seat 6: Hohol 2011 ($6.19 in chips) 
Kerberus94: posts small blind $0.02
PointersDE: posts big blind $0.05
*** HOLE CARDS ***
Dealt to HubertusB [Jh 5s]
Quadrazar: folds 
HubertusB: folds 
Hohol 2011: raises $0.08 to $0.13
Baker1326: calls $0.13
Kerberus94: folds 
PointersDE: calls $0.08
*** FLOP *** [9d 9c 5h]
PointersDE: checks 
Hohol 2011: checks 
Baker1326: bets $0.15
PointersDE: calls $0.15
Hohol 2011: folds 
*** TURN *** [9d 9c 5h] [As]
PointersDE: checks 
Baker1326: checks 
*** RIVER *** [9d 9c 5h As] [4d]
PointersDE: bets $0.35
Baker1326: folds 
Uncalled bet ($0.35) returned to PointersDE
PointersDE collected $0.68 from pot
PointersDE: doesn't show hand 
*** SUMMARY ***
Total pot $0.71 | Rake $0.03 
Board [9d 9c 5h As 4d]
Seat 1: Baker1326 (button) folded on the River
Seat 2: Kerberus94 (small blind) folded before Flop
Seat 3: PointersDE (big blind) collected ($0.68)
Seat 4: Quadrazar folded before Flop (didn't bet)
Seat 5: HubertusB folded before Flop (didn't bet)
Seat 6: Hohol 2011 folded on the Flop



PokerStars Zoom Hand #177278054854:  Hold'em No Limit ($0.02/$0.05) - 2017/10/23 21:47:03 CCT [2017/10/23 9:47:03 ET]
Table 'Donati' 6-max Seat #1 is the button
Seat 1: grosman1409 ($3.12 in chips) 
Seat 2: couchmichel ($10.64 in chips) 
Seat 3: HubertusB ($4.23 in chips) 
Seat 4: prochy1909 ($14.23 in chips) 
Seat 5: T0QOCR ($4.93 in chips) 
Seat 6: MoreThen3 ($5.67 in chips) 
couchmichel: posts small blind $0.02
HubertusB: posts big blind $0.05
*** HOLE CARDS ***
Dealt to HubertusB [Qd Kc]
prochy1909: folds 
T0QOCR: folds 
MoreThen3: raises $0.07 to $0.12
grosman1409: calls $0.12
couchmichel: folds 
HubertusB: calls $0.07
*** FLOP *** [2h Ks Tc]
HubertusB: checks 
MoreThen3: checks 
grosman1409: bets $0.15
HubertusB: calls $0.15
MoreThen3: calls $0.15
*** TURN *** [2h Ks Tc] [Th]
HubertusB: checks 
MoreThen3: checks 
grosman1409: bets $0.15
HubertusB: calls $0.15
MoreThen3: calls $0.15
*** RIVER *** [2h Ks Tc Th] [Jc]
HubertusB: checks 
MoreThen3: bets $0.81
grosman1409: calls $0.81
HubertusB: folds 
*** SHOW DOWN ***
MoreThen3: shows [Ts Jd] (a full house, Tens full of Jacks)
grosman1409: mucks hand 
MoreThen3 collected $2.78 from pot
*** SUMMARY ***
Total pot $2.90 | Rake $0.12 
Board [2h Ks Tc Th Jc]
Seat 1: grosman1409 (button) mucked [7h Kh]
Seat 2: couchmichel (small blind) folded before Flop
Seat 3: HubertusB (big blind) folded on the River
Seat 4: prochy1909 folded before Flop (didn't bet)
Seat 5: T0QOCR folded before Flop (didn't bet)
Seat 6: MoreThen3 showed [Ts Jd] and won ($2.78) with a full house, Tens full of Jacks



PokerStars Zoom Hand #177285412707:  Hold'em No Limit ($0.02/$0.05) - 2017/10/24 1:09:01 CCT [2017/10/23 13:09:01 ET]
Table 'Donati' 6-max Seat #1 is the button
Seat 1: BPinholeworl ($1.96 in chips) 
Seat 2: chobusina ($6.28 in chips) 
Seat 3: HubertusB ($5 in chips) 
Seat 4: bakha2226 ($8.96 in chips) 
Seat 5: sakamotoM ($5.02 in chips) 
Seat 6: docent3366 ($11.76 in chips) 
chobusina: posts small blind $0.02
HubertusB: posts big blind $0.05
*** HOLE CARDS ***
Dealt to HubertusB [Qh 3h]
bakha2226: folds 
sakamotoM: folds 
docent3366: folds 
BPinholeworl: folds 
chobusina: folds 
Uncalled bet ($0.03) returned to HubertusB
HubertusB collected $0.04 from pot
HubertusB: doesn't show hand 
*** SUMMARY ***
Total pot $0.04 | Rake $0 
Seat 1: BPinholeworl (button) folded before Flop (didn't bet)
Seat 2: chobusina (small blind) folded before Flop
Seat 3: HubertusB (big blind) collected ($0.04)
Seat 4: bakha2226 folded before Flop (didn't bet)
Seat 5: sakamotoM folded before Flop (didn't bet)
Seat 6: docent3366 folded before Flop (didn't bet)



PokerStars Zoom Hand #177285423703:  Hold'em No Limit ($0.02/$0.05) - 2017/10/24 1:09:16 CCT [2017/10/23 13:09:16 ET]
Table 'Donati' 6-max Seat #1 is the button
Seat 1: MR.LOCT ($4.89 in chips) 
Seat 2: HubertusB ($5.02 in chips) 
Seat 3: numelen ($5.85 in chips) 
Seat 4: -J0sh-SPA ($5.81 in chips) 
Seat 5: 1DollarDude ($5.58 in chips) 
Seat 6: DAZE400 ($5.35 in chips) 
HubertusB: posts small blind $0.02
numelen: posts big blind $0.05
*** HOLE CARDS ***
Dealt to HubertusB [5s 4c]
-J0sh-SPA: raises $0.10 to $0.15
1DollarDude: folds 
DAZE400: folds 
MR.LOCT: folds 
HubertusB: folds 
numelen: folds 
Uncalled bet ($0.10) returned to -J0sh-SPA
-J0sh-SPA collected $0.12 from pot
-J0sh-SPA: doesn't show hand 
*** SUMMARY ***
Total pot $0.12 | Rake $0 
Seat 1: MR.LOCT (button) folded before Flop (didn't bet)
Seat 2: HubertusB (small blind) folded before Flop
Seat 3: numelen (big blind) folded before Flop
Seat 4: -J0sh-SPA collected ($0.12)
Seat 5: 1DollarDude folded before Flop (didn't bet)
Seat 6: DAZE400 folded before Flop (didn't bet)



PokerStars Zoom Hand #177285427305:  Hold'em No Limit ($0.02/$0.05) - 2017/10/24 1:09:21 CCT [2017/10/23 13:09:21 ET]
Table 'Donati' 6-max Seat #1 is the button
Seat 1: HubertusB ($5 in chips) 
Seat 2: zizen86 ($3.02 in chips) 
Seat 3: MusTer300 ($5.33 in chips) 
Seat 4: abbelrus ($4.81 in chips) 
Seat 5: rokerstas ($7.58 in chips) 
Seat 6: cristian87 ($5 in chips) 
zizen86: posts small blind $0.02
MusTer300: posts big blind $0.05
*** HOLE CARDS ***
Dealt to HubertusB [Qc Ac]
abbelrus: folds 
rokerstas: folds 
cristian87: folds 
HubertusB: raises $0.06 to $0.11
zizen86: calls $0.09
MusTer300: calls $0.06
*** FLOP *** [3h Ah As]
zizen86: checks 
MusTer300: checks 
HubertusB: bets $0.18
zizen86: calls $0.18
MusTer300: folds 
*** TURN *** [3h Ah As] [Kd]
zizen86: checks 
HubertusB: bets $0.39
zizen86: raises $2.34 to $2.73 and is all-in
HubertusB: calls $2.34
*** RIVER *** [3h Ah As Kd] [7h]
*** SHOW DOWN ***
zizen86: shows [8c Ad] (three of a kind, Aces)
HubertusB: shows [Qc Ac] (three of a kind, Aces - King+Queen kicker)
HubertusB collected $5.89 from pot
*** SUMMARY ***
Total pot $6.15 | Rake $0.26 
Board [3h Ah As Kd 7h]
Seat 1: HubertusB (button) showed [Qc Ac] and won ($5.89) with three of a kind, Aces
Seat 2: zizen86 (small blind) showed [8c Ad] and lost with three of a kind, Aces
Seat 3: MusTer300 (big blind) folded on the Flop
Seat 4: abbelrus folded before Flop (didn't bet)
Seat 5: rokerstas folded before Flop (didn't bet)
Seat 6: cristian87 folded before Flop (didn't bet)



PokerStars Zoom Hand #177285469770:  Hold'em No Limit ($0.02/$0.05) - 2017/10/24 1:10:19 CCT [2017/10/23 13:10:19 ET]
Table 'Donati' 6-max Seat #1 is the button
Seat 1: ritasexy ($15.83 in chips) 
Seat 2: MOROZ056 ($7.79 in chips) 
Seat 3: AAabey ($6.84 in chips) 
Seat 4: HubertusB ($7.87 in chips) 
Seat 5: rekitikitik ($5 in chips) 
Seat 6: KinG_T1427 ($15.44 in chips) 
MOROZ056: posts small blind $0.02
AAabey: posts big blind $0.05
*** HOLE CARDS ***
Dealt to HubertusB [4s As]
HubertusB: folds 
rekitikitik: folds 
KinG_T1427: raises $0.15 to $0.20
ritasexy: folds 
MOROZ056: folds 
AAabey: folds 
Uncalled bet ($0.15) returned to KinG_T1427
KinG_T1427 collected $0.12 from pot
KinG_T1427: doesn't show hand 
*** SUMMARY ***
Total pot $0.12 | Rake $0 
Seat 1: ritasexy (button) folded before Flop (didn't bet)
Seat 2: MOROZ056 (small blind) folded before Flop
Seat 3: AAabey (big blind) folded before Flop
Seat 4: HubertusB folded before Flop (didn't bet)
Seat 5: rekitikitik folded before Flop (didn't bet)
Seat 6: KinG_T1427 collected ($0.12)



PokerStars Zoom Hand #177285464672:  Hold'em No Limit ($0.02/$0.05) - 2017/10/24 1:10:12 CCT [2017/10/23 13:10:12 ET]
Table 'Donati' 6-max Seat #1 is the button
Seat 1: P1T-BUL1 ($6.70 in chips) 
Seat 2: rekoj504 ($26.95 in chips) 
Seat 3: Daiskay888 ($4.98 in chips) 
Seat 4: Fekla248 ($5.27 in chips) 
Seat 5: maxinio2010 ($5 in chips) 
Seat 6: HubertusB ($7.87 in chips) 
rekoj504: posts small blind $0.02
Daiskay888: posts big blind $0.05
*** HOLE CARDS ***
Dealt to HubertusB [7h As]
Fekla248: folds 
maxinio2010: folds 
HubertusB: folds 
P1T-BUL1: raises $0.05 to $0.10
rekoj504: raises $0.25 to $0.35
Daiskay888: folds 
P1T-BUL1: folds 
Uncalled bet ($0.25) returned to rekoj504
rekoj504 collected $0.25 from pot
rekoj504: doesn't show hand 
*** SUMMARY ***
Total pot $0.25 | Rake $0 
Seat 1: P1T-BUL1 (button) folded before Flop
Seat 2: rekoj504 (small blind) collected ($0.25)
Seat 3: Daiskay888 (big blind) folded before Flop
Seat 4: Fekla248 folded before Flop (didn't bet)
Seat 5: maxinio2010 folded before Flop (didn't bet)
Seat 6: HubertusB folded before Flop (didn't bet)



PokerStars Zoom Hand #177285473530:  Hold'em No Limit ($0.02/$0.05) - 2017/10/24 1:10:25 CCT [2017/10/23 13:10:25 ET]
Table 'Donati' 6-max Seat #1 is the button
Seat 1: nickspeedace ($5.49 in chips) 
Seat 2: ctreko3a u 9 ($4.52 in chips) 
Seat 3: HubertusB ($7.87 in chips) 
Seat 4: Oleg3069 ($6.92 in chips) 
Seat 5: MV429 ($9.43 in chips) 
Seat 6: Minister.nsu ($4.02 in chips) 
ctreko3a u 9: posts small blind $0.02
HubertusB: posts big blind $0.05
*** HOLE CARDS ***
Dealt to HubertusB [Qh As]
Oleg3069: folds 
MV429: folds 
Minister.nsu: raises $0.10 to $0.15
nickspeedace: raises $0.29 to $0.44
ctreko3a u 9: folds 
HubertusB: folds 
Minister.nsu: folds 
Uncalled bet ($0.29) returned to nickspeedace
nickspeedace collected $0.37 from pot
nickspeedace: doesn't show hand 
*** SUMMARY ***
Total pot $0.37 | Rake $0 
Seat 1: nickspeedace (button) collected ($0.37)
Seat 2: ctreko3a u 9 (small blind) folded before Flop
Seat 3: HubertusB (big blind) folded before Flop
Seat 4: Oleg3069 folded before Flop (didn't bet)
Seat 5: MV429 folded before Flop (didn't bet)
Seat 6: Minister.nsu folded before Flop



PokerStars Zoom Hand #177285497008:  Hold'em No Limit ($0.02/$0.05) - 2017/10/24 1:10:56 CCT [2017/10/23 13:10:56 ET]
Table 'Donati' 6-max Seat #1 is the button
Seat 1: Tomirlan8 ($5.13 in chips) 
Seat 2: HubertusB ($7.82 in chips) 
Seat 3: takato99 ($4.18 in chips) 
Seat 4: zigaSpb ($5 in chips) 
Seat 5: sakamotoM ($5 in chips) 
Seat 6: Luca$$$ino ($2.55 in chips) 
HubertusB: posts small blind $0.02
takato99: posts big blind $0.05
*** HOLE CARDS ***
Dealt to HubertusB [Kh Jc]
zigaSpb: raises $0.09 to $0.14
sakamotoM: folds 
Luca$$$ino: folds 
Tomirlan8: folds 
HubertusB: folds 
takato99: folds 
Uncalled bet ($0.09) returned to zigaSpb
zigaSpb collected $0.12 from pot
zigaSpb: doesn't show hand 
*** SUMMARY ***
Total pot $0.12 | Rake $0 
Seat 1: Tomirlan8 (button) folded before Flop (didn't bet)
Seat 2: HubertusB (small blind) folded before Flop
Seat 3: takato99 (big blind) folded before Flop
Seat 4: zigaSpb collected ($0.12)
Seat 5: sakamotoM folded before Flop (didn't bet)
Seat 6: Luca$$$ino folded before Flop (didn't bet)



PokerStars Zoom Hand #177285505809:  Hold'em No Limit ($0.02/$0.05) - 2017/10/24 1:11:08 CCT [2017/10/23 13:11:08 ET]
Table 'Donati' 6-max Seat #1 is the button
Seat 1: prochy1909 ($28.57 in chips) 
Seat 2: Sonoionin ($5.18 in chips) 
Seat 3: csebonite ($16.80 in chips) 
Seat 4: sersom555 ($3.16 in chips) 
Seat 5: HubertusB ($7.80 in chips) 
Seat 6: Sherzod_s ($8.30 in chips) 
Sonoionin: posts small blind $0.02
csebonite: posts big blind $0.05
*** HOLE CARDS ***
Dealt to HubertusB [Qd Ts]
sersom555: folds 
HubertusB: folds 
Sherzod_s: folds 
prochy1909: folds 
Sonoionin: folds 
Uncalled bet ($0.03) returned to csebonite
csebonite collected $0.04 from pot
csebonite: doesn't show hand 
*** SUMMARY ***
Total pot $0.04 | Rake $0 
Seat 1: prochy1909 (button) folded before Flop (didn't bet)
Seat 2: Sonoionin (small blind) folded before Flop
Seat 3: csebonite (big blind) collected ($0.04)
Seat 4: sersom555 folded before Flop (didn't bet)
Seat 5: HubertusB folded before Flop (didn't bet)
Seat 6: Sherzod_s folded before Flop (didn't bet)



PokerStars Zoom Hand #177285510259:  Hold'em No Limit ($0.02/$0.05) - 2017/10/24 1:11:14 CCT [2017/10/23 13:11:14 ET]
Table 'Donati' 6-max Seat #1 is the button
Seat 1: xbusterx ($5.62 in chips) 
Seat 2: Krutikova212 ($5 in chips) 
Seat 3: MR.LOCT ($7.47 in chips) 
Seat 4: moneykeep ($4.40 in chips) 
Seat 5: HubertusB ($7.80 in chips) 
Seat 6: l0luf0ld ($8.46 in chips) 
Krutikova212: posts small blind $0.02
MR.LOCT: posts big blind $0.05
*** HOLE CARDS ***
Dealt to HubertusB [4c 9s]
moneykeep: folds 
HubertusB: folds 
l0luf0ld: folds 
xbusterx: folds 
Krutikova212: folds 
Uncalled bet ($0.03) returned to MR.LOCT
MR.LOCT collected $0.04 from pot
MR.LOCT: doesn't show hand 
*** SUMMARY ***
Total pot $0.04 | Rake $0 
Seat 1: xbusterx (button) folded before Flop (didn't bet)
Seat 2: Krutikova212 (small blind) folded before Flop
Seat 3: MR.LOCT (big blind) collected ($0.04)
Seat 4: moneykeep folded before Flop (didn't bet)
Seat 5: HubertusB folded before Flop (didn't bet)
Seat 6: l0luf0ld folded before Flop (didn't bet)



PokerStars Zoom Hand #177285492559:  Hold'em No Limit ($0.02/$0.05) - 2017/10/24 1:10:50 CCT [2017/10/23 13:10:50 ET]
Table 'Donati' 6-max Seat #1 is the button
Seat 1: 72odonkey ($5 in chips) 
Seat 2: ConnorM1888 ($5 in chips) 
Seat 3: Morgot339 ($5 in chips) 
Seat 4: tsatsos3 ($4.96 in chips) 
Seat 5: Bragaa93 ($11.10 in chips) 
Seat 6: HubertusB ($7.82 in chips) 
ConnorM1888: posts small blind $0.02
Morgot339: posts big blind $0.05
*** HOLE CARDS ***
Dealt to HubertusB [Tc 9h]
tsatsos3: folds 
Bragaa93: folds 
HubertusB: folds 
72odonkey: raises $0.08 to $0.13
ConnorM1888: folds 
Morgot339: calls $0.08
*** FLOP *** [Kh 6s 2d]
Morgot339: checks 
72odonkey: bets $0.09
Morgot339: calls $0.09
*** TURN *** [Kh 6s 2d] [7h]
Morgot339: checks 
72odonkey: bets $0.31
Morgot339: folds 
Uncalled bet ($0.31) returned to 72odonkey
72odonkey collected $0.44 from pot
72odonkey: doesn't show hand 
*** SUMMARY ***
Total pot $0.46 | Rake $0.02 
Board [Kh 6s 2d 7h]
Seat 1: 72odonkey (button) collected ($0.44)
Seat 2: ConnorM1888 (small blind) folded before Flop
Seat 3: Morgot339 (big blind) folded on the Turn
Seat 4: tsatsos3 folded before Flop (didn't bet)
Seat 5: Bragaa93 folded before Flop (didn't bet)
Seat 6: HubertusB folded before Flop (didn't bet)



PokerStars Zoom Hand #177285514684:  Hold'em No Limit ($0.02/$0.05) - 2017/10/24 1:11:20 CCT [2017/10/23 13:11:20 ET]
Table 'Donati' 6-max Seat #1 is the button
Seat 1: yorimitisyug ($4.06 in chips) 
Seat 2: qk rodriguez ($5.34 in chips) 
Seat 3: nickspeedace ($6.19 in chips) 
Seat 4: HubertusB ($7.80 in chips) 
Seat 5: CarltonLeech ($5.07 in chips) 
Seat 6: stefagr ($6.40 in chips) 
qk rodriguez: posts small blind $0.02
nickspeedace: posts big blind $0.05
*** HOLE CARDS ***
Dealt to HubertusB [3h Jh]
HubertusB: folds 
CarltonLeech: folds 
stefagr: folds 
yorimitisyug: raises $0.07 to $0.12
qk rodriguez: folds 
nickspeedace: calls $0.07
*** FLOP *** [6d Tc 6c]
nickspeedace: checks 
yorimitisyug: checks 
*** TURN *** [6d Tc 6c] [9c]
nickspeedace: checks 
yorimitisyug: checks 
*** RIVER *** [6d Tc 6c 9c] [Qs]
nickspeedace: checks 
yorimitisyug: checks 
*** SHOW DOWN ***
nickspeedace: shows [8s 9s] (two pair, Nines and Sixes)
yorimitisyug: mucks hand 
nickspeedace collected $0.25 from pot
*** SUMMARY ***
Total pot $0.26 | Rake $0.01 
Board [6d Tc 6c 9c Qs]
Seat 1: yorimitisyug (button) mucked [Ad 3c]
Seat 2: qk rodriguez (small blind) folded before Flop
Seat 3: nickspeedace (big blind) showed [8s 9s] and won ($0.25) with two pair, Nines and Sixes
Seat 4: HubertusB folded before Flop (didn't bet)
Seat 5: CarltonLeech folded before Flop (didn't bet)
Seat 6: stefagr folded before Flop (didn't bet)



PokerStars Zoom Hand #177285502169:  Hold'em No Limit ($0.02/$0.05) - 2017/10/24 1:11:03 CCT [2017/10/23 13:11:03 ET]
Table 'Donati' 6-max Seat #1 is the button
Seat 1: HubertusB ($7.80 in chips) 
Seat 2: Romuks33 ($6.71 in chips) 
Seat 3: ganivs777 ($3.01 in chips) 
Seat 4: docent3366 ($9.67 in chips) 
Seat 5: Fr13ndAG ($8.04 in chips) 
Seat 6: gurugeorge03 ($7.04 in chips) 
Romuks33: posts small blind $0.02
ganivs777: posts big blind $0.05
*** HOLE CARDS ***
Dealt to HubertusB [9d 6s]
docent3366 has timed out
docent3366: folds 
Fr13ndAG: folds 
gurugeorge03: folds 
HubertusB: folds 
Romuks33: raises $0.07 to $0.12
ganivs777: raises $0.24 to $0.36
Romuks33: calls $0.24
*** FLOP *** [Kc 7c 3h]
Romuks33: checks 
ganivs777: checks 
*** TURN *** [Kc 7c 3h] [8h]
Romuks33: checks 
ganivs777: bets $0.69
Romuks33: folds 
Uncalled bet ($0.69) returned to ganivs777
ganivs777 collected $0.69 from pot
ganivs777: doesn't show hand 
*** SUMMARY ***
Total pot $0.72 | Rake $0.03 
Board [Kc 7c 3h 8h]
Seat 1: HubertusB (button) folded before Flop (didn't bet)
Seat 2: Romuks33 (small blind) folded on the Turn
Seat 3: ganivs777 (big blind) collected ($0.69)
Seat 4: docent3366 folded before Flop (didn't bet)
Seat 5: Fr13ndAG folded before Flop (didn't bet)
Seat 6: gurugeorge03 folded before Flop (didn't bet)



PokerStars Zoom Hand #177285518995:  Hold'em No Limit ($0.02/$0.05) - 2017/10/24 1:11:26 CCT [2017/10/23 13:11:26 ET]
Table 'Donati' 6-max Seat #1 is the button
Seat 1: KrisDimitrov ($16.34 in chips) 
Seat 2: ritasexy ($5.50 in chips) 
Seat 3: HubertusB ($7.80 in chips) 
Seat 4: jenars23 ($6.53 in chips) 
Seat 5: rekoj504 ($27.03 in chips) 
Seat 6: erdtEV+ ($5.52 in chips) 
ritasexy: posts small blind $0.02
HubertusB: posts big blind $0.05
*** HOLE CARDS ***
Dealt to HubertusB [8s Ts]
jenars23: folds 
rekoj504: folds 
erdtEV+: folds 
KrisDimitrov: raises $0.05 to $0.10
ritasexy: folds 
HubertusB: raises $0.25 to $0.35
KrisDimitrov: calls $0.25
*** FLOP *** [8c Jd 5s]
HubertusB: bets $0.40
KrisDimitrov: folds 
Uncalled bet ($0.40) returned to HubertusB
HubertusB collected $0.69 from pot
HubertusB: doesn't show hand 
*** SUMMARY ***
Total pot $0.72 | Rake $0.03 
Board [8c Jd 5s]
Seat 1: KrisDimitrov (button) folded on the Flop
Seat 2: ritasexy (small blind) folded before Flop
Seat 3: HubertusB (big blind) collected ($0.69)
Seat 4: jenars23 folded before Flop (didn't bet)
Seat 5: rekoj504 folded before Flop (didn't bet)
Seat 6: erdtEV+ folded before Flop (didn't bet)



PokerStars Zoom Hand #177285543171:  Hold'em No Limit ($0.02/$0.05) - 2017/10/24 1:11:59 CCT [2017/10/23 13:11:59 ET]
Table 'Donati' 6-max Seat #1 is the button
Seat 1: HubertusB ($8.14 in chips) 
Seat 2: 6runogn ($5.44 in chips) 
Seat 3: Treysix ($5.12 in chips) 
Seat 4: yorimitisyug ($3.94 in chips) 
Seat 5: docent3366 ($11.89 in chips) 
Seat 6: pokerforgaba ($4.40 in chips) 
6runogn: posts small blind $0.02
Treysix: posts big blind $0.05
*** HOLE CARDS ***
Dealt to HubertusB [8h 5s]
yorimitisyug: folds 
docent3366: folds 
pokerforgaba: raises $0.10 to $0.15
HubertusB: folds 
6runogn: raises $0.36 to $0.51
Treysix: folds 
pokerforgaba: folds 
Uncalled bet ($0.36) returned to 6runogn
6runogn collected $0.35 from pot
6runogn: doesn't show hand 
*** SUMMARY ***
Total pot $0.35 | Rake $0 
Seat 1: HubertusB (button) folded before Flop (didn't bet)
Seat 2: 6runogn (small blind) collected ($0.35)
Seat 3: Treysix (big blind) folded before Flop
Seat 4: yorimitisyug folded before Flop (didn't bet)
Seat 5: docent3366 folded before Flop (didn't bet)
Seat 6: pokerforgaba folded before Flop



PokerStars Zoom Hand #177285554905:  Hold'em No Limit ($0.02/$0.05) - 2017/10/24 1:12:15 CCT [2017/10/23 13:12:15 ET]
Table 'Donati' 6-max Seat #1 is the button
Seat 1: Sarmatrus79 ($5 in chips) 
Seat 2: Pro100-LLaPb ($4.95 in chips) 
Seat 3: HubertusB ($8.12 in chips) 
Seat 4: Ignite13 ($20.74 in chips) 
Seat 5: Leodr ($6.61 in chips) 
Seat 6: Teflonmemory ($5 in chips) 
Pro100-LLaPb: posts small blind $0.02
HubertusB: posts big blind $0.05
*** HOLE CARDS ***
Dealt to HubertusB [3h 7h]
Ignite13: folds 
Leodr: raises $0.09 to $0.14
Teflonmemory: folds 
Sarmatrus79: folds 
Pro100-LLaPb: folds 
HubertusB: folds 
Uncalled bet ($0.09) returned to Leodr
Leodr collected $0.12 from pot
Leodr: doesn't show hand 
*** SUMMARY ***
Total pot $0.12 | Rake $0 
Seat 1: Sarmatrus79 (button) folded before Flop (didn't bet)
Seat 2: Pro100-LLaPb (small blind) folded before Flop
Seat 3: HubertusB (big blind) folded before Flop
Seat 4: Ignite13 folded before Flop (didn't bet)
Seat 5: Leodr collected ($0.12)
Seat 6: Teflonmemory folded before Flop (didn't bet)



PokerStars Zoom Hand #177285551341:  Hold'em No Limit ($0.02/$0.05) - 2017/10/24 1:12:11 CCT [2017/10/23 13:12:11 ET]
Table 'Donati' 6-max Seat #1 is the button
Seat 1: kiskisnetavo ($5.91 in chips) 
Seat 2: Alarmaz ($5.87 in chips) 
Seat 3: Hoxt0n ($10.72 in chips) 
Seat 4: MOROZ056 ($4.95 in chips) 
Seat 5: Krutikova212 ($5.36 in chips) 
Seat 6: HubertusB ($8.12 in chips) 
Alarmaz: posts small blind $0.02
Hoxt0n: posts big blind $0.05
*** HOLE CARDS ***
Dealt to HubertusB [4d 2c]
MOROZ056: folds 
Krutikova212: folds 
HubertusB: folds 
kiskisnetavo: raises $0.10 to $0.15
Alarmaz: folds 
Hoxt0n: folds 
Uncalled bet ($0.10) returned to kiskisnetavo
kiskisnetavo collected $0.12 from pot
kiskisnetavo: doesn't show hand 
*** SUMMARY ***
Total pot $0.12 | Rake $0 
Seat 1: kiskisnetavo (button) collected ($0.12)
Seat 2: Alarmaz (small blind) folded before Flop
Seat 3: Hoxt0n (big blind) folded before Flop
Seat 4: MOROZ056 folded before Flop (didn't bet)
Seat 5: Krutikova212 folded before Flop (didn't bet)
Seat 6: HubertusB folded before Flop (didn't bet)



PokerStars Zoom Hand #177285547599:  Hold'em No Limit ($0.02/$0.05) - 2017/10/24 1:12:05 CCT [2017/10/23 13:12:05 ET]
Table 'Donati' 6-max Seat #1 is the button
Seat 1: 13addict13 ($6.05 in chips) 
Seat 2: HubertusB ($8.14 in chips) 
Seat 3: burik2 ($8.02 in chips) 
Seat 4: kanclerz ($7.66 in chips) 
Seat 5: Bal87 ($5.41 in chips) 
Seat 6: suyuhang1990 ($8.41 in chips) 
HubertusB: posts small blind $0.02
burik2: posts big blind $0.05
*** HOLE CARDS ***
Dealt to HubertusB [3s Kd]
kanclerz: folds 
Bal87: raises $0.06 to $0.11
suyuhang1990: folds 
13addict13: folds 
HubertusB: folds 
burik2: folds 
Uncalled bet ($0.06) returned to Bal87
Bal87 collected $0.12 from pot
Bal87: doesn't show hand 
*** SUMMARY ***
Total pot $0.12 | Rake $0 
Seat 1: 13addict13 (button) folded before Flop (didn't bet)
Seat 2: HubertusB (small blind) folded before Flop
Seat 3: burik2 (big blind) folded before Flop
Seat 4: kanclerz folded before Flop (didn't bet)
Seat 5: Bal87 collected ($0.12)
Seat 6: suyuhang1990 folded before Flop (didn't bet)



PokerStars Zoom Hand #177285563000:  Hold'em No Limit ($0.02/$0.05) - 2017/10/24 1:12:26 CCT [2017/10/23 13:12:26 ET]
Table 'Donati' 6-max Seat #1 is the button
Seat 1: tintones ($5 in chips) 
Seat 2: iD_EAx ($5.29 in chips) 
Seat 3: fleassca ($10.84 in chips) 
Seat 4: Nohall-God ($9.84 in chips) 
Seat 5: X.MatuS ($8.98 in chips) 
Seat 6: HubertusB ($8.07 in chips) 
iD_EAx: posts small blind $0.02
fleassca: posts big blind $0.05
*** HOLE CARDS ***
Dealt to HubertusB [Jc Jh]
Nohall-God: folds 
X.MatuS: folds 
HubertusB: raises $0.06 to $0.11
tintones: folds 
iD_EAx: folds 
fleassca: folds 
Uncalled bet ($0.06) returned to HubertusB
HubertusB collected $0.12 from pot
HubertusB: doesn't show hand 
*** SUMMARY ***
Total pot $0.12 | Rake $0 
Seat 1: tintones (button) folded before Flop (didn't bet)
Seat 2: iD_EAx (small blind) folded before Flop
Seat 3: fleassca (big blind) folded before Flop
Seat 4: Nohall-God folded before Flop (didn't bet)
Seat 5: X.MatuS folded before Flop (didn't bet)
Seat 6: HubertusB collected ($0.12)



PokerStars Zoom Hand #177285578578:  Hold'em No Limit ($0.02/$0.05) - 2017/10/24 1:12:47 CCT [2017/10/23 13:12:47 ET]
Table 'Donati' 6-max Seat #1 is the button
Seat 1: Shurik389 ($4.93 in chips) 
Seat 2: GamblerWW ($9.16 in chips) 
Seat 3: alienhack ($8.27 in chips) 
Seat 4: HubertusB ($8.14 in chips) 
Seat 5: S1HED ($6.23 in chips) 
Seat 6: Papaya006 ($5.23 in chips) 
GamblerWW: posts small blind $0.02
alienhack: posts big blind $0.05
*** HOLE CARDS ***
Dealt to HubertusB [8c Tc]
HubertusB: folds 
S1HED: raises $0.10 to $0.15
Papaya006: folds 
Shurik389: folds 
GamblerWW: folds 
alienhack: folds 
Uncalled bet ($0.10) returned to S1HED
S1HED collected $0.12 from pot
S1HED: doesn't show hand 
*** SUMMARY ***
Total pot $0.12 | Rake $0 
Seat 1: Shurik389 (button) folded before Flop (didn't bet)
Seat 2: GamblerWW (small blind) folded before Flop
Seat 3: alienhack (big blind) folded before Flop
Seat 4: HubertusB folded before Flop (didn't bet)
Seat 5: S1HED collected ($0.12)
Seat 6: Papaya006 folded before Flop (didn't bet)



PokerStars Zoom Hand #177285589610:  Hold'em No Limit ($0.02/$0.05) - 2017/10/24 1:13:02 CCT [2017/10/23 13:13:02 ET]
Table 'Donati' 6-max Seat #1 is the button
Seat 1: HubertusB ($8.12 in chips) 
Seat 2: valdemar803 ($4.95 in chips) 
Seat 3: toltek555 ($5.54 in chips) 
Seat 4: Chris|Her0 ($5 in chips) 
Seat 5: S1HED ($5.21 in chips) 
Seat 6: GamblerWW ($11.70 in chips) 
valdemar803: posts small blind $0.02
toltek555: posts big blind $0.05
*** HOLE CARDS ***
Dealt to HubertusB [4h Ks]
Chris|Her0: folds 
S1HED: folds 
GamblerWW: folds 
HubertusB: folds 
valdemar803: folds 
Uncalled bet ($0.03) returned to toltek555
toltek555 collected $0.04 from pot
toltek555: doesn't show hand 
*** SUMMARY ***
Total pot $0.04 | Rake $0 
Seat 1: HubertusB (button) folded before Flop (didn't bet)
Seat 2: valdemar803 (small blind) folded before Flop
Seat 3: toltek555 (big blind) collected ($0.04)
Seat 4: Chris|Her0 folded before Flop (didn't bet)
Seat 5: S1HED folded before Flop (didn't bet)
Seat 6: GamblerWW folded before Flop (didn't bet)



PokerStars Zoom Hand #177285582280:  Hold'em No Limit ($0.02/$0.05) - 2017/10/24 1:12:52 CCT [2017/10/23 13:12:52 ET]
Table 'Donati' 6-max Seat #1 is the button
Seat 1: SergeySURK ($5.01 in chips) 
Seat 2: FarFromFish ($12.78 in chips) 
Seat 3: vanek-95all@ ($6.36 in chips) 
Seat 4: WisherBG ($5.07 in chips) 
Seat 5: HubertusB ($8.14 in chips) 
Seat 6: P0KERB0Y ($12.45 in chips) 
FarFromFish: posts small blind $0.02
vanek-95all@: posts big blind $0.05
*** HOLE CARDS ***
Dealt to HubertusB [7s 5h]
WisherBG: folds 
HubertusB: folds 
P0KERB0Y: folds 
SergeySURK: raises $0.10 to $0.15
FarFromFish: folds 
vanek-95all@: folds 
Uncalled bet ($0.10) returned to SergeySURK
SergeySURK collected $0.12 from pot
SergeySURK: doesn't show hand 
*** SUMMARY ***
Total pot $0.12 | Rake $0 
Seat 1: SergeySURK (button) collected ($0.12)
Seat 2: FarFromFish (small blind) folded before Flop
Seat 3: vanek-95all@ (big blind) folded before Flop
Seat 4: WisherBG folded before Flop (didn't bet)
Seat 5: HubertusB folded before Flop (didn't bet)
Seat 6: P0KERB0Y folded before Flop (didn't bet)



PokerStars Zoom Hand #177285595495:  Hold'em No Limit ($0.02/$0.05) - 2017/10/24 1:13:10 CCT [2017/10/23 13:13:10 ET]
Table 'Donati' 6-max Seat #1 is the button
Seat 1: HubertusB ($8.12 in chips) 
Seat 2: 2CiTY ($8.21 in chips) 
Seat 3: dmi9644 ($4.74 in chips) 
Seat 4: Krutikova212 ($5.47 in chips) 
Seat 5: ruShmell ($18.31 in chips) 
Seat 6: KrisDimitrov ($9.15 in chips) 
2CiTY: posts small blind $0.02
dmi9644: posts big blind $0.05
*** HOLE CARDS ***
Dealt to HubertusB [8s Ah]
Krutikova212: folds 
ruShmell: folds 
KrisDimitrov: folds 
HubertusB: raises $0.05 to $0.10
2CiTY: folds 
dmi9644: folds 
Uncalled bet ($0.05) returned to HubertusB
HubertusB collected $0.12 from pot
HubertusB: doesn't show hand 
*** SUMMARY ***
Total pot $0.12 | Rake $0 
Seat 1: HubertusB (button) collected ($0.12)
Seat 2: 2CiTY (small blind) folded before Flop
Seat 3: dmi9644 (big blind) folded before Flop
Seat 4: Krutikova212 folded before Flop (didn't bet)
Seat 5: ruShmell folded before Flop (didn't bet)
Seat 6: KrisDimitrov folded before Flop (didn't bet)



PokerStars Zoom Hand #177285605876:  Hold'em No Limit ($0.02/$0.05) - 2017/10/24 1:13:24 CCT [2017/10/23 13:13:24 ET]
Table 'Donati' 6-max Seat #1 is the button
Seat 1: KingPoker432 ($2.45 in chips) 
Seat 2: rekoj504 ($26.83 in chips) 
Seat 3: NORO30 ($3.31 in chips) 
Seat 4: Benschi83 ($6.31 in chips) 
Seat 5: svetogor1991 ($6.35 in chips) 
Seat 6: HubertusB ($8.19 in chips) 
rekoj504: posts small blind $0.02
NORO30: posts big blind $0.05
*** HOLE CARDS ***
Dealt to HubertusB [2h 4s]
Benschi83: folds 
svetogor1991: folds 
HubertusB: folds 
KingPoker432: folds 
rekoj504: folds 
Uncalled bet ($0.03) returned to NORO30
NORO30 collected $0.04 from pot
NORO30: doesn't show hand 
*** SUMMARY ***
Total pot $0.04 | Rake $0 
Seat 1: KingPoker432 (button) folded before Flop (didn't bet)
Seat 2: rekoj504 (small blind) folded before Flop
Seat 3: NORO30 (big blind) collected ($0.04)
Seat 4: Benschi83 folded before Flop (didn't bet)
Seat 5: svetogor1991 folded before Flop (didn't bet)
Seat 6: HubertusB folded before Flop (didn't bet)



PokerStars Zoom Hand #177285610900:  Hold'em No Limit ($0.02/$0.05) - 2017/10/24 1:13:31 CCT [2017/10/23 13:13:31 ET]
Table 'Donati' 6-max Seat #1 is the button
Seat 1: SandersWar ($2.64 in chips) 
Seat 2: Brosssea ($8.17 in chips) 
Seat 3: PusyManiak ($5.36 in chips) 
Seat 4: PandaAs ($5 in chips) 
Seat 5: HubertusB ($8.19 in chips) 
Seat 6: RedDosh ($5.39 in chips) 
Brosssea: posts small blind $0.02
PusyManiak: posts big blind $0.05
*** HOLE CARDS ***
Dealt to HubertusB [Ac 5s]
PandaAs: folds 
HubertusB: folds 
RedDosh: folds 
SandersWar: folds 
Brosssea: folds 
Uncalled bet ($0.03) returned to PusyManiak
PusyManiak collected $0.04 from pot
PusyManiak: doesn't show hand 
*** SUMMARY ***
Total pot $0.04 | Rake $0 
Seat 1: SandersWar (button) folded before Flop (didn't bet)
Seat 2: Brosssea (small blind) folded before Flop
Seat 3: PusyManiak (big blind) collected ($0.04)
Seat 4: PandaAs folded before Flop (didn't bet)
Seat 5: HubertusB folded before Flop (didn't bet)
Seat 6: RedDosh folded before Flop (didn't bet)



PokerStars Zoom Hand #177285585911:  Hold'em No Limit ($0.02/$0.05) - 2017/10/24 1:12:57 CCT [2017/10/23 13:12:57 ET]
Table 'Donati' 6-max Seat #1 is the button
Seat 1: FarFromFish ($12.76 in chips) 
Seat 2: HubertusB ($8.14 in chips) 
Seat 3: VARZEA ($5.07 in chips) 
Seat 4: MOROZ056 ($5.08 in chips) 
Seat 5: abbelrus ($5.09 in chips) 
Seat 6: WisherBG ($5.07 in chips) 
HubertusB: posts small blind $0.02
VARZEA: posts big blind $0.05
*** HOLE CARDS ***
Dealt to HubertusB [2h 4s]
MOROZ056: folds 
abbelrus: raises $0.10 to $0.15
WisherBG: folds 
FarFromFish: folds 
HubertusB: folds 
VARZEA: calls $0.10
*** FLOP *** [Ad 6d Kd]
VARZEA: bets $0.10
abbelrus: calls $0.10
*** TURN *** [Ad 6d Kd] [Td]
VARZEA: checks 
abbelrus: bets $0.40
VARZEA: folds 
Uncalled bet ($0.40) returned to abbelrus
abbelrus collected $0.50 from pot
abbelrus: doesn't show hand 
*** SUMMARY ***
Total pot $0.52 | Rake $0.02 
Board [Ad 6d Kd Td]
Seat 1: FarFromFish (button) folded before Flop (didn't bet)
Seat 2: HubertusB (small blind) folded before Flop
Seat 3: VARZEA (big blind) folded on the Turn
Seat 4: MOROZ056 folded before Flop (didn't bet)
Seat 5: abbelrus collected ($0.50)
Seat 6: WisherBG folded before Flop (didn't bet)



PokerStars Zoom Hand #177285616183:  Hold'em No Limit ($0.02/$0.05) - 2017/10/24 1:13:38 CCT [2017/10/23 13:13:38 ET]
Table 'Donati' 6-max Seat #1 is the button
Seat 1: LigoL ($6.86 in chips) 
Seat 2: Shinochino ($5.45 in chips) 
Seat 3: HubertusB ($8.19 in chips) 
Seat 4: den4ik.13 ($3.11 in chips) 
Seat 5: PandaAs ($5.15 in chips) 
Seat 6: KingPoker432 ($2.43 in chips) 
Shinochino: posts small blind $0.02
HubertusB: posts big blind $0.05
*** HOLE CARDS ***
Dealt to HubertusB [Ac 6d]
den4ik.13: folds 
PandaAs: folds 
KingPoker432: calls $0.05
LigoL: raises $0.11 to $0.16
Shinochino: folds 
HubertusB: folds 
KingPoker432: calls $0.11
*** FLOP *** [2d 5c Kc]
KingPoker432: checks 
LigoL: bets $0.19
KingPoker432: folds 
Uncalled bet ($0.19) returned to LigoL
LigoL collected $0.37 from pot
LigoL: doesn't show hand 
*** SUMMARY ***
Total pot $0.39 | Rake $0.02 
Board [2d 5c Kc]
Seat 1: LigoL (button) collected ($0.37)
Seat 2: Shinochino (small blind) folded before Flop
Seat 3: HubertusB (big blind) folded before Flop
Seat 4: den4ik.13 folded before Flop (didn't bet)
Seat 5: PandaAs folded before Flop (didn't bet)
Seat 6: KingPoker432 folded on the Flop



PokerStars Zoom Hand #177285630864:  Hold'em No Limit ($0.02/$0.05) - 2017/10/24 1:13:58 CCT [2017/10/23 13:13:58 ET]
Table 'Donati' 6-max Seat #1 is the button
Seat 1: BladeSonya ($5 in chips) 
Seat 2: HubertusB ($8.14 in chips) 
Seat 3: prochy1909 ($11.83 in chips) 
Seat 4: Antash.RU ($4.93 in chips) 
Seat 5: qk rodriguez ($8.35 in chips) 
Seat 6: R2R2806 ($5.47 in chips) 
HubertusB: posts small blind $0.02
prochy1909: posts big blind $0.05
*** HOLE CARDS ***
Dealt to HubertusB [Qh Qs]
Antash.RU: raises $0.10 to $0.15
qk rodriguez: folds 
R2R2806: folds 
BladeSonya: folds 
HubertusB: calls $0.13
prochy1909: raises $0.39 to $0.54
Antash.RU: calls $0.39
HubertusB: raises $1.46 to $2
prochy1909: raises $9.83 to $11.83 and is all-in
Antash.RU: folds 
HubertusB: calls $6.14 and is all-in
Uncalled bet ($3.69) returned to prochy1909
*** FLOP *** [8h 7s Ac]
*** TURN *** [8h 7s Ac] [Th]
*** RIVER *** [8h 7s Ac Th] [4d]
*** SHOW DOWN ***
HubertusB: shows [Qh Qs] (a pair of Queens)
prochy1909: shows [As Kd] (a pair of Aces)
prochy1909 collected $16.12 from pot
*** SUMMARY ***
Total pot $16.82 | Rake $0.70 
Board [8h 7s Ac Th 4d]
Seat 1: BladeSonya (button) folded before Flop (didn't bet)
Seat 2: HubertusB (small blind) showed [Qh Qs] and lost with a pair of Queens
Seat 3: prochy1909 (big blind) showed [As Kd] and won ($16.12) with a pair of Aces
Seat 4: Antash.RU folded before Flop
Seat 5: qk rodriguez folded before Flop (didn't bet)
Seat 6: R2R2806 folded before Flop (didn't bet)



PokerStars Zoom Hand #177285696488:  Hold'em No Limit ($0.02/$0.05) - 2017/10/24 1:15:27 CCT [2017/10/23 13:15:27 ET]
Table 'Donati' 6-max Seat #1 is the button
Seat 1: sepik200 ($4.83 in chips) 
Seat 2: yuhken ($9.24 in chips) 
Seat 3: Zzz@yka ($5.42 in chips) 
Seat 4: BrainInstant ($5.78 in chips) 
Seat 5: CrawlForSun ($5.36 in chips) 
Seat 6: HubertusB ($5 in chips) 
yuhken: posts small blind $0.02
Zzz@yka: posts big blind $0.05
*** HOLE CARDS ***
Dealt to HubertusB [2d Qh]
BrainInstant: folds 
CrawlForSun: folds 
HubertusB: folds 
sepik200: raises $0.05 to $0.10
yuhken: folds 
Zzz@yka: calls $0.05
*** FLOP *** [Kc Kd Ah]
Zzz@yka: checks 
sepik200: checks 
*** TURN *** [Kc Kd Ah] [5c]
Zzz@yka: checks 
sepik200: bets $0.10
Zzz@yka: folds 
Uncalled bet ($0.10) returned to sepik200
sepik200 collected $0.21 from pot
sepik200: doesn't show hand 
*** SUMMARY ***
Total pot $0.22 | Rake $0.01 
Board [Kc Kd Ah 5c]
Seat 1: sepik200 (button) collected ($0.21)
Seat 2: yuhken (small blind) folded before Flop
Seat 3: Zzz@yka (big blind) folded on the Turn
Seat 4: BrainInstant folded before Flop (didn't bet)
Seat 5: CrawlForSun folded before Flop (didn't bet)
Seat 6: HubertusB folded before Flop (didn't bet)



PokerStars Zoom Hand #177285706871:  Hold'em No Limit ($0.02/$0.05) - 2017/10/24 1:15:41 CCT [2017/10/23 13:15:41 ET]
Table 'Donati' 6-max Seat #1 is the button
Seat 1: JTbukowski ($5.69 in chips) 
Seat 2: HubertusB ($4.95 in chips) 
Seat 3: GuardCorp ($7.87 in chips) 
Seat 4: RedDosh ($5.07 in chips) 
Seat 5: komarilio ($5.12 in chips) 
Seat 6: PonasAurimas ($5.31 in chips) 
HubertusB: posts small blind $0.02
GuardCorp: posts big blind $0.05
*** HOLE CARDS ***
Dealt to HubertusB [8c Ts]
RedDosh: folds 
komarilio: folds 
PonasAurimas: raises $0.10 to $0.15
JTbukowski: folds 
HubertusB: folds 
GuardCorp: folds 
Uncalled bet ($0.10) returned to PonasAurimas
PonasAurimas collected $0.12 from pot
PonasAurimas: doesn't show hand 
*** SUMMARY ***
Total pot $0.12 | Rake $0 
Seat 1: JTbukowski (button) folded before Flop (didn't bet)
Seat 2: HubertusB (small blind) folded before Flop
Seat 3: GuardCorp (big blind) folded before Flop
Seat 4: RedDosh folded before Flop (didn't bet)
Seat 5: komarilio folded before Flop (didn't bet)
Seat 6: PonasAurimas collected ($0.12)



PokerStars Zoom Hand #177285701718:  Hold'em No Limit ($0.02/$0.05) - 2017/10/24 1:15:35 CCT [2017/10/23 13:15:35 ET]
Table 'Donati' 6-max Seat #1 is the button
Seat 1: Hoxt0n ($11.14 in chips) 
Seat 2: pedroaberger ($7.96 in chips) 
Seat 3: HubertusB ($5 in chips) 
Seat 4: [Apo]-1987 ($5.29 in chips) 
Seat 5: hadamar116 ($9.95 in chips) 
Seat 6: alienhack ($14.29 in chips) 
pedroaberger: posts small blind $0.02
HubertusB: posts big blind $0.05
*** HOLE CARDS ***
Dealt to HubertusB [Td Qs]
[Apo]-1987: raises $0.07 to $0.12
hadamar116: folds 
alienhack: calls $0.12
Hoxt0n: folds 
pedroaberger: folds 
HubertusB: folds 
*** FLOP *** [5s 8s Qh]
[Apo]-1987: checks 
alienhack: bets $0.10
[Apo]-1987: folds 
Uncalled bet ($0.10) returned to alienhack
alienhack collected $0.30 from pot
alienhack: doesn't show hand 
*** SUMMARY ***
Total pot $0.31 | Rake $0.01 
Board [5s 8s Qh]
Seat 1: Hoxt0n (button) folded before Flop (didn't bet)
Seat 2: pedroaberger (small blind) folded before Flop
Seat 3: HubertusB (big blind) folded before Flop
Seat 4: [Apo]-1987 folded on the Flop
Seat 5: hadamar116 folded before Flop (didn't bet)
Seat 6: alienhack collected ($0.30)



PokerStars Zoom Hand #177285710491:  Hold'em No Limit ($0.02/$0.05) - 2017/10/24 1:15:46 CCT [2017/10/23 13:15:46 ET]
Table 'Donati' 6-max Seat #1 is the button
Seat 1: HubertusB ($4.93 in chips) 
Seat 2: WisherBG ($5 in chips) 
Seat 3: Azatt02 ($8.15 in chips) 
Seat 4: padde886 ($5.24 in chips) 
Seat 5: zzdaw ($2.86 in chips) 
Seat 6: pedroaberger ($7.94 in chips) 
WisherBG: posts small blind $0.02
Azatt02: posts big blind $0.05
*** HOLE CARDS ***
Dealt to HubertusB [Kd Ac]
padde886: folds 
zzdaw: folds 
pedroaberger: folds 
HubertusB: raises $0.10 to $0.15
WisherBG: folds 
Azatt02: folds 
Uncalled bet ($0.10) returned to HubertusB
HubertusB collected $0.12 from pot
HubertusB: doesn't show hand 
*** SUMMARY ***
Total pot $0.12 | Rake $0 
Seat 1: HubertusB (button) collected ($0.12)
Seat 2: WisherBG (small blind) folded before Flop
Seat 3: Azatt02 (big blind) folded before Flop
Seat 4: padde886 folded before Flop (didn't bet)
Seat 5: zzdaw folded before Flop (didn't bet)
Seat 6: pedroaberger folded before Flop (didn't bet)



PokerStars Zoom Hand #177285729248:  Hold'em No Limit ($0.02/$0.05) - 2017/10/24 1:16:11 CCT [2017/10/23 13:16:11 ET]
Table 'Donati' 6-max Seat #1 is the button
Seat 1: advisory_in ($2.11 in chips) 
Seat 2: MrSuperior ($37.18 in chips) 
Seat 3: falcao991 ($6.06 in chips) 
Seat 4: TitanX1 ($2.09 in chips) 
Seat 5: HubertusB ($5 in chips) 
Seat 6: MOROZ056 ($6.22 in chips) 
MrSuperior: posts small blind $0.02
falcao991: posts big blind $0.05
*** HOLE CARDS ***
Dealt to HubertusB [5s 8h]
TitanX1: folds 
HubertusB: folds 
MOROZ056: folds 
advisory_in: folds 
MrSuperior: folds 
Uncalled bet ($0.03) returned to falcao991
falcao991 collected $0.04 from pot
falcao991: doesn't show hand 
*** SUMMARY ***
Total pot $0.04 | Rake $0 
Seat 1: advisory_in (button) folded before Flop (didn't bet)
Seat 2: MrSuperior (small blind) folded before Flop
Seat 3: falcao991 (big blind) collected ($0.04)
Seat 4: TitanX1 folded before Flop (didn't bet)
Seat 5: HubertusB folded before Flop (didn't bet)
Seat 6: MOROZ056 folded before Flop (didn't bet)



PokerStars Zoom Hand #177285732200:  Hold'em No Limit ($0.02/$0.05) - 2017/10/24 1:16:15 CCT [2017/10/23 13:16:15 ET]
Table 'Donati' 6-max Seat #1 is the button
Seat 1: La_moopet ($4.45 in chips) 
Seat 2: SSSR1978 ($6.44 in chips) 
Seat 3: andreascris1 ($11.19 in chips) 
Seat 4: HubertusB ($5 in chips) 
Seat 5: ercan008 ($5 in chips) 
Seat 6: koning504 ($10.05 in chips) 
SSSR1978: posts small blind $0.02
andreascris1: posts big blind $0.05
*** HOLE CARDS ***
Dealt to HubertusB [Jd Kc]
HubertusB: folds 
ercan008: folds 
koning504: folds 
La_moopet: raises $0.10 to $0.15
SSSR1978: folds 
andreascris1: folds 
Uncalled bet ($0.10) returned to La_moopet
La_moopet collected $0.12 from pot
La_moopet: doesn't show hand 
*** SUMMARY ***
Total pot $0.12 | Rake $0 
Seat 1: La_moopet (button) collected ($0.12)
Seat 2: SSSR1978 (small blind) folded before Flop
Seat 3: andreascris1 (big blind) folded before Flop
Seat 4: HubertusB folded before Flop (didn't bet)
Seat 5: ercan008 folded before Flop (didn't bet)
Seat 6: koning504 folded before Flop (didn't bet)



PokerStars Zoom Hand #177285735991:  Hold'em No Limit ($0.02/$0.05) - 2017/10/24 1:16:20 CCT [2017/10/23 13:16:20 ET]
Table 'Donati' 6-max Seat #1 is the button
Seat 1: HubertusB ($5 in chips) 
Seat 2: valdemar803 ($5.96 in chips) 
Seat 3: Porian ($6.09 in chips) 
Seat 4: Krutikova212 ($5 in chips) 
Seat 5: Gala7755 ($3.55 in chips) 
Seat 6: P0KERB0Y ($22.01 in chips) 
valdemar803: posts small blind $0.02
Porian: posts big blind $0.05
*** HOLE CARDS ***
Dealt to HubertusB [Ks 7s]
Krutikova212: folds 
Gala7755: folds 
P0KERB0Y: folds 
HubertusB: raises $0.05 to $0.10
valdemar803: folds 
Porian: folds 
Uncalled bet ($0.05) returned to HubertusB
HubertusB collected $0.12 from pot
HubertusB: doesn't show hand 
*** SUMMARY ***
Total pot $0.12 | Rake $0 
Seat 1: HubertusB (button) collected ($0.12)
Seat 2: valdemar803 (small blind) folded before Flop
Seat 3: Porian (big blind) folded before Flop
Seat 4: Krutikova212 folded before Flop (didn't bet)
Seat 5: Gala7755 folded before Flop (didn't bet)
Seat 6: P0KERB0Y folded before Flop (didn't bet)



PokerStars Zoom Hand #177285725486:  Hold'em No Limit ($0.02/$0.05) - 2017/10/24 1:16:06 CCT [2017/10/23 13:16:06 ET]
Table 'Donati' 6-max Seat #1 is the button
Seat 1: RedDosh ($5.14 in chips) 
Seat 2: AndreiV34rus ($7.14 in chips) 
Seat 3: caveman19681 ($5.10 in chips) 
Seat 4: qk rodriguez ($8.54 in chips) 
Seat 5: HubertusB ($5 in chips) 
Seat 6: FarFromFish ($12.62 in chips) 
AndreiV34rus: posts small blind $0.02
caveman19681: posts big blind $0.05
*** HOLE CARDS ***
Dealt to HubertusB [9c Kd]
qk rodriguez: raises $0.07 to $0.12
HubertusB: folds 
FarFromFish: folds 
RedDosh: folds 
AndreiV34rus: folds 
caveman19681: raises $0.38 to $0.50
qk rodriguez: calls $0.38
*** FLOP *** [3c 8d 4s]
caveman19681: bets $0.74
qk rodriguez: calls $0.74
*** TURN *** [3c 8d 4s] [2c]
caveman19681: bets $1.80
qk rodriguez: calls $1.80
*** RIVER *** [3c 8d 4s 2c] [9d]
caveman19681: checks 
qk rodriguez: checks 
*** SHOW DOWN ***
caveman19681: shows [7d 7c] (a pair of Sevens)
qk rodriguez: mucks hand 
caveman19681 collected $5.85 from pot
*** SUMMARY ***
Total pot $6.10 | Rake $0.25 
Board [3c 8d 4s 2c 9d]
Seat 1: RedDosh (button) folded before Flop (didn't bet)
Seat 2: AndreiV34rus (small blind) folded before Flop
Seat 3: caveman19681 (big blind) showed [7d 7c] and won ($5.85) with a pair of Sevens
Seat 4: qk rodriguez mucked [5c 5h]
Seat 5: HubertusB folded before Flop (didn't bet)
Seat 6: FarFromFish folded before Flop (didn't bet)



PokerStars Zoom Hand #177285692830:  Hold'em No Limit ($0.02/$0.05) - 2017/10/24 1:15:22 CCT [2017/10/23 13:15:22 ET]
Table 'Donati' 6-max Seat #1 is the button
Seat 1: fless836 ($5 in chips) 
Seat 2: hancockkas ($5.43 in chips) 
Seat 3: DAZE400 ($4.76 in chips) 
Seat 4: Tomirlan8 ($6.63 in chips) 
Seat 5: HubertusB ($5 in chips) 
Seat 6: Goakiller ($5.40 in chips) 
hancockkas: posts small blind $0.02
DAZE400: posts big blind $0.05
*** HOLE CARDS ***
Dealt to HubertusB [8c 7s]
Tomirlan8: folds 
HubertusB: folds 
Goakiller: raises $0.10 to $0.15
fless836: folds 
hancockkas: calls $0.13
DAZE400: folds 
*** FLOP *** [Ts 5d Tc]
hancockkas: checks 
Goakiller: bets $0.17
hancockkas: calls $0.17
*** TURN *** [Ts 5d Tc] [Td]
hancockkas: checks 
Goakiller: checks 
*** RIVER *** [Ts 5d Tc Td] [9s]
hancockkas: bets $0.33
Goakiller: raises $0.52 to $0.85
hancockkas: raises $1.80 to $2.65
Goakiller: calls $1.80
*** SHOW DOWN ***
hancockkas: shows [Ad Th] (four of a kind, Tens)
Goakiller: mucks hand 
hancockkas collected $5.74 from pot
*** SUMMARY ***
Total pot $5.99 | Rake $0.25 
Board [Ts 5d Tc Td 9s]
Seat 1: fless836 (button) folded before Flop (didn't bet)
Seat 2: hancockkas (small blind) showed [Ad Th] and won ($5.74) with four of a kind, Tens
Seat 3: DAZE400 (big blind) folded before Flop
Seat 4: Tomirlan8 folded before Flop (didn't bet)
Seat 5: HubertusB folded before Flop (didn't bet)
Seat 6: Goakiller mucked [Kd Kc]



PokerStars Zoom Hand #177285750159:  Hold'em No Limit ($0.02/$0.05) - 2017/10/24 1:16:39 CCT [2017/10/23 13:16:39 ET]
Table 'Donati' 6-max Seat #1 is the button
Seat 1: Balonas ($2.28 in chips) 
Seat 2: hitjts ($4.88 in chips) 
Seat 3: Efimov07 ($7.21 in chips) 
Seat 4: Faied123 ($5.16 in chips) 
Seat 5: padde886 ($5.38 in chips) 
Seat 6: HubertusB ($5.07 in chips) 
hitjts: posts small blind $0.02
Efimov07: posts big blind $0.05
*** HOLE CARDS ***
Dealt to HubertusB [Kc Ac]
Faied123: folds 
padde886: folds 
HubertusB: raises $0.10 to $0.15
Balonas: calls $0.15
hitjts: folds 
Efimov07: folds 
*** FLOP *** [Jd 7s 9d]
HubertusB: checks 
Balonas: checks 
*** TURN *** [Jd 7s 9d] [4h]
HubertusB: bets $0.15
Balonas: calls $0.15
*** RIVER *** [Jd 7s 9d 4h] [Ad]
HubertusB: checks 
Balonas: checks 
*** SHOW DOWN ***
HubertusB: shows [Kc Ac] (a pair of Aces)
Balonas: mucks hand 
HubertusB collected $0.64 from pot
*** SUMMARY ***
Total pot $0.67 | Rake $0.03 
Board [Jd 7s 9d 4h Ad]
Seat 1: Balonas (button) mucked [6s 6h]
Seat 2: hitjts (small blind) folded before Flop
Seat 3: Efimov07 (big blind) folded before Flop
Seat 4: Faied123 folded before Flop (didn't bet)
Seat 5: padde886 folded before Flop (didn't bet)
Seat 6: HubertusB showed [Kc Ac] and won ($0.64) with a pair of Aces



PokerStars Zoom Hand #177285777794:  Hold'em No Limit ($0.02/$0.05) - 2017/10/24 1:17:16 CCT [2017/10/23 13:17:16 ET]
Table 'Donati' 6-max Seat #1 is the button
Seat 1: andreascris1 ($5.95 in chips) 
Seat 2: Jajje7 ($5.55 in chips) 
Seat 3: HubertusB ($5.41 in chips) 
Seat 4: Balonas ($1.98 in chips) 
Seat 5: iD_EAx ($5 in chips) 
Seat 6: YouMom13 ($4.81 in chips) 
Jajje7: posts small blind $0.02
HubertusB: posts big blind $0.05
*** HOLE CARDS ***
Dealt to HubertusB [3h 5s]
Balonas: folds 
iD_EAx: folds 
YouMom13: folds 
andreascris1: folds 
Jajje7: folds 
Uncalled bet ($0.03) returned to HubertusB
HubertusB collected $0.04 from pot
HubertusB: doesn't show hand 
*** SUMMARY ***
Total pot $0.04 | Rake $0 
Seat 1: andreascris1 (button) folded before Flop (didn't bet)
Seat 2: Jajje7 (small blind) folded before Flop
Seat 3: HubertusB (big blind) collected ($0.04)
Seat 4: Balonas folded before Flop (didn't bet)
Seat 5: iD_EAx folded before Flop (didn't bet)
Seat 6: YouMom13 folded before Flop (didn't bet)



PokerStars Zoom Hand #177285786110:  Hold'em No Limit ($0.02/$0.05) - 2017/10/24 1:17:27 CCT [2017/10/23 13:17:27 ET]
Table 'Donati' 6-max Seat #1 is the button
Seat 1: Dima Jetta ($5.18 in chips) 
Seat 2: HubertusB ($5.43 in chips) 
Seat 3: WisherBG ($5.05 in chips) 
Seat 4: Ignite13 ($12.03 in chips) 
Seat 5: valdemar803 ($6.07 in chips) 
Seat 6: elbubu1984 ($6.06 in chips) 
HubertusB: posts small blind $0.02
WisherBG: posts big blind $0.05
*** HOLE CARDS ***
Dealt to HubertusB [Th Ks]
Ignite13: folds 
valdemar803: calls $0.05
elbubu1984: folds 
Dima Jetta: folds 
HubertusB: folds 
WisherBG: checks 
*** FLOP *** [3s 5h 7h]
WisherBG: checks 
valdemar803: bets $0.10
WisherBG: folds 
Uncalled bet ($0.10) returned to valdemar803
valdemar803 collected $0.12 from pot
valdemar803: doesn't show hand 
*** SUMMARY ***
Total pot $0.12 | Rake $0 
Board [3s 5h 7h]
Seat 1: Dima Jetta (button) folded before Flop (didn't bet)
Seat 2: HubertusB (small blind) folded before Flop
Seat 3: WisherBG (big blind) folded on the Flop
Seat 4: Ignite13 folded before Flop (didn't bet)
Seat 5: valdemar803 collected ($0.12)
Seat 6: elbubu1984 folded before Flop (didn't bet)



PokerStars Zoom Hand #177285804143:  Hold'em No Limit ($0.02/$0.05) - 2017/10/24 1:17:52 CCT [2017/10/23 13:17:52 ET]
Table 'Donati' 6-max Seat #1 is the button
Seat 1: [Apo]-1987 ($5.58 in chips) 
Seat 2: jenars23 ($6.19 in chips) 
Seat 3: HubertusB ($5.41 in chips) 
Seat 4: kailass ($5.14 in chips) 
Seat 5: koning504 ($5.07 in chips) 
Seat 6: fatherconmee ($3.47 in chips) 
jenars23: posts small blind $0.02
HubertusB: posts big blind $0.05
*** HOLE CARDS ***
Dealt to HubertusB [5d Tc]
kailass: folds 
koning504: folds 
fatherconmee: folds 
[Apo]-1987: folds 
jenars23: folds 
Uncalled bet ($0.03) returned to HubertusB
HubertusB collected $0.04 from pot
HubertusB: doesn't show hand 
*** SUMMARY ***
Total pot $0.04 | Rake $0 
Seat 1: [Apo]-1987 (button) folded before Flop (didn't bet)
Seat 2: jenars23 (small blind) folded before Flop
Seat 3: HubertusB (big blind) collected ($0.04)
Seat 4: kailass folded before Flop (didn't bet)
Seat 5: koning504 folded before Flop (didn't bet)
Seat 6: fatherconmee folded before Flop (didn't bet)



PokerStars Zoom Hand #177285789945:  Hold'em No Limit ($0.02/$0.05) - 2017/10/24 1:17:32 CCT [2017/10/23 13:17:32 ET]
Table 'Donati' 6-max Seat #1 is the button
Seat 1: laki371137 ($7.34 in chips) 
Seat 2: Torald89 ($3.19 in chips) 
Seat 3: Xéntis ($5 in chips) 
Seat 4: HubertusB ($5.41 in chips) 
Seat 5: rimizak12 ($3.23 in chips) 
Seat 6: [Apo]-1987 ($5.55 in chips) 
Torald89: posts small blind $0.02
Xéntis: posts big blind $0.05
*** HOLE CARDS ***
Dealt to HubertusB [7s Ac]
HubertusB: folds 
rimizak12: folds 
[Apo]-1987: raises $0.07 to $0.12
laki371137: folds 
Torald89: calls $0.10
Xéntis: calls $0.07
*** FLOP *** [2s 5s Kc]
Torald89: checks 
Xéntis: checks 
[Apo]-1987: checks 
*** TURN *** [2s 5s Kc] [Jh]
Torald89: checks 
Xéntis: checks 
[Apo]-1987: checks 
*** RIVER *** [2s 5s Kc Jh] [Tc]
Torald89: bets $0.05
Xéntis: calls $0.05
[Apo]-1987: folds 
*** SHOW DOWN ***
Torald89: shows [3h Ad] (high card Ace)
Xéntis: shows [3d 3c] (a pair of Threes)
Xéntis collected $0.44 from pot
*** SUMMARY ***
Total pot $0.46 | Rake $0.02 
Board [2s 5s Kc Jh Tc]
Seat 1: laki371137 (button) folded before Flop (didn't bet)
Seat 2: Torald89 (small blind) showed [3h Ad] and lost with high card Ace
Seat 3: Xéntis (big blind) showed [3d 3c] and won ($0.44) with a pair of Threes
Seat 4: HubertusB folded before Flop (didn't bet)
Seat 5: rimizak12 folded before Flop (didn't bet)
Seat 6: [Apo]-1987 folded on the River



PokerStars Zoom Hand #177285796548:  Hold'em No Limit ($0.02/$0.05) - 2017/10/24 1:17:41 CCT [2017/10/23 13:17:41 ET]
Table 'Donati' 6-max Seat #1 is the button
Seat 1: Jajje7 ($5.95 in chips) 
Seat 2: Demon31222 ($5 in chips) 
Seat 3: Raux17 ($13.82 in chips) 
Seat 4: HubertusB ($5.41 in chips) 
Seat 5: P1T-BUL1 ($4.60 in chips) 
Seat 6: EileenYl ($13.65 in chips) 
Demon31222: posts small blind $0.02
Raux17: posts big blind $0.05
*** HOLE CARDS ***
Dealt to HubertusB [Qc 7c]
HubertusB: folds 
P1T-BUL1: raises $0.05 to $0.10
EileenYl: calls $0.10
Jajje7: folds 
Demon31222: calls $0.08
Raux17: folds 
*** FLOP *** [2c Tc 8d]
Demon31222: checks 
P1T-BUL1: bets $0.05
EileenYl: raises $0.16 to $0.21
Demon31222: calls $0.21
P1T-BUL1: folds 
*** TURN *** [2c Tc 8d] [9d]
Demon31222: checks 
EileenYl: checks 
*** RIVER *** [2c Tc 8d 9d] [Ad]
Demon31222: checks 
EileenYl: checks 
*** SHOW DOWN ***
Demon31222: shows [4c 5c] (high card Ace)
EileenYl: shows [Jh Th] (a pair of Tens)
EileenYl collected $0.79 from pot
*** SUMMARY ***
Total pot $0.82 | Rake $0.03 
Board [2c Tc 8d 9d Ad]
Seat 1: Jajje7 (button) folded before Flop (didn't bet)
Seat 2: Demon31222 (small blind) showed [4c 5c] and lost with high card Ace
Seat 3: Raux17 (big blind) folded before Flop
Seat 4: HubertusB folded before Flop (didn't bet)
Seat 5: P1T-BUL1 folded on the Flop
Seat 6: EileenYl showed [Jh Th] and won ($0.79) with a pair of Tens



PokerStars Zoom Hand #177285810823:  Hold'em No Limit ($0.02/$0.05) - 2017/10/24 1:18:00 CCT [2017/10/23 13:18:00 ET]
Table 'Donati' 6-max Seat #1 is the button
Seat 1: Gregório26 ($4.40 in chips) 
Seat 2: kopatich52 ($11.33 in chips) 
Seat 3: Azamat446 ($4.59 in chips) 
Seat 4: Hoxt0n ($5.29 in chips) 
Seat 5: HubertusB ($5.43 in chips) 
Seat 6: Magz(vip) ($5.14 in chips) 
kopatich52: posts small blind $0.02
Azamat446: posts big blind $0.05
*** HOLE CARDS ***
Dealt to HubertusB [Kc Tc]
Hoxt0n: folds 
HubertusB: raises $0.05 to $0.10
Magz(vip): folds 
Gregório26: folds 
kopatich52: folds 
Azamat446: calls $0.05
*** FLOP *** [Ts Jh 5h]
Azamat446: checks 
HubertusB: bets $0.09
Azamat446: raises $0.20 to $0.29
HubertusB: calls $0.20
*** TURN *** [Ts Jh 5h] [2c]
Azamat446: bets $0.39
HubertusB: calls $0.39
*** RIVER *** [Ts Jh 5h 2c] [6d]
Azamat446: checks 
HubertusB: checks 
*** SHOW DOWN ***
Azamat446: shows [As Js] (a pair of Jacks)
HubertusB: mucks hand 
Azamat446 collected $1.51 from pot
*** SUMMARY ***
Total pot $1.58 | Rake $0.07 
Board [Ts Jh 5h 2c 6d]
Seat 1: Gregório26 (button) folded before Flop (didn't bet)
Seat 2: kopatich52 (small blind) folded before Flop
Seat 3: Azamat446 (big blind) showed [As Js] and won ($1.51) with a pair of Jacks
Seat 4: Hoxt0n folded before Flop (didn't bet)
Seat 5: HubertusB mucked [Kc Tc]
Seat 6: Magz(vip) folded before Flop (didn't bet)



PokerStars Zoom Hand #177285863962:  Hold'em No Limit ($0.02/$0.05) - 2017/10/24 1:19:10 CCT [2017/10/23 13:19:10 ET]
Table 'Donati' 6-max Seat #1 is the button
Seat 1: FarFromFish ($12.48 in chips) 
Seat 2: HubertusB ($4.65 in chips) 
Seat 3: pedroaberger ($6.54 in chips) 
Seat 4: SpaceSpinner ($6.72 in chips) 
Seat 5: LIghtsout856 ($5.69 in chips) 
Seat 6: 500Ang ($9.04 in chips) 
HubertusB: posts small blind $0.02
pedroaberger: posts big blind $0.05
*** HOLE CARDS ***
Dealt to HubertusB [As Jc]
SpaceSpinner: folds 
LIghtsout856: folds 
500Ang: folds 
FarFromFish: raises $0.10 to $0.15
HubertusB: folds 
pedroaberger: raises $0.32 to $0.47
FarFromFish: folds 
Uncalled bet ($0.32) returned to pedroaberger
pedroaberger collected $0.32 from pot
pedroaberger: doesn't show hand 
*** SUMMARY ***
Total pot $0.32 | Rake $0 
Seat 1: FarFromFish (button) folded before Flop
Seat 2: HubertusB (small blind) folded before Flop
Seat 3: pedroaberger (big blind) collected ($0.32)
Seat 4: SpaceSpinner folded before Flop (didn't bet)
Seat 5: LIghtsout856 folded before Flop (didn't bet)
Seat 6: 500Ang folded before Flop (didn't bet)



PokerStars Zoom Hand #177285872231:  Hold'em No Limit ($0.02/$0.05) - 2017/10/24 1:19:22 CCT [2017/10/23 13:19:22 ET]
Table 'Donati' 6-max Seat #1 is the button
Seat 1: HubertusB ($4.63 in chips) 
Seat 2: Oliana88 ($7.07 in chips) 
Seat 3: ASUS04 ($5.11 in chips) 
Seat 4: CarltonLeech ($5.60 in chips) 
Seat 5: pokerforgaba ($12.96 in chips) 
Seat 6: maloi_m3 ($6.32 in chips) 
Oliana88: posts small blind $0.02
ASUS04: posts big blind $0.05
*** HOLE CARDS ***
Dealt to HubertusB [9d 9s]
CarltonLeech: folds 
pokerforgaba: folds 
maloi_m3: folds 
HubertusB: raises $0.10 to $0.15
Oliana88: calls $0.13
ASUS04: raises $0.45 to $0.60
HubertusB: raises $4.03 to $4.63 and is all-in
Oliana88: raises $2.44 to $7.07 and is all-in
ASUS04: folds 
Uncalled bet ($2.44) returned to Oliana88
*** FLOP *** [Jc 5c Ac]
*** TURN *** [Jc 5c Ac] [2h]
*** RIVER *** [Jc 5c Ac 2h] [Jd]
*** SHOW DOWN ***
Oliana88: shows [Kc Ks] (two pair, Kings and Jacks)
HubertusB: shows [9d 9s] (two pair, Jacks and Nines)
Oliana88 collected $9.45 from pot
*** SUMMARY ***
Total pot $9.86 | Rake $0.41 
Board [Jc 5c Ac 2h Jd]
Seat 1: HubertusB (button) showed [9d 9s] and lost with two pair, Jacks and Nines
Seat 2: Oliana88 (small blind) showed [Kc Ks] and won ($9.45) with two pair, Kings and Jacks
Seat 3: ASUS04 (big blind) folded before Flop
Seat 4: CarltonLeech folded before Flop (didn't bet)
Seat 5: pokerforgaba folded before Flop (didn't bet)
Seat 6: maloi_m3 folded before Flop (didn't bet)



PokerStars Zoom Hand #177285904213:  Hold'em No Limit ($0.02/$0.05) - 2017/10/24 1:20:03 CCT [2017/10/23 13:20:03 ET]
Table 'Donati' 6-max Seat #1 is the button
Seat 1: Magz(vip) ($5 in chips) 
Seat 2: mst6 ($11.36 in chips) 
Seat 3: m-racer701 ($4.69 in chips) 
Seat 4: HubertusB ($5 in chips) 
Seat 5: XHerrTUMNUSX ($19.79 in chips) 
Seat 6: serik31 ($5.08 in chips) 
mst6: posts small blind $0.02
m-racer701: posts big blind $0.05
*** HOLE CARDS ***
Dealt to HubertusB [7d 3s]
HubertusB: folds 
XHerrTUMNUSX: raises $0.10 to $0.15
serik31: folds 
Magz(vip): folds 
mst6: folds 
m-racer701: folds 
Uncalled bet ($0.10) returned to XHerrTUMNUSX
XHerrTUMNUSX collected $0.12 from pot
XHerrTUMNUSX: doesn't show hand 
*** SUMMARY ***
Total pot $0.12 | Rake $0 
Seat 1: Magz(vip) (button) folded before Flop (didn't bet)
Seat 2: mst6 (small blind) folded before Flop
Seat 3: m-racer701 (big blind) folded before Flop
Seat 4: HubertusB folded before Flop (didn't bet)
Seat 5: XHerrTUMNUSX collected ($0.12)
Seat 6: serik31 folded before Flop (didn't bet)



PokerStars Zoom Hand #177285899564:  Hold'em No Limit ($0.02/$0.05) - 2017/10/24 1:19:57 CCT [2017/10/23 13:19:57 ET]
Table 'Donati' 6-max Seat #1 is the button
Seat 1: Tartarobass ($5.07 in chips) 
Seat 2: VinD777 ($2.35 in chips) 
Seat 3: raingoldgs ($6.05 in chips) 
Seat 4: Gregório26 ($17.36 in chips) 
Seat 5: hugedkeyfish ($6.96 in chips) 
Seat 6: HubertusB ($5 in chips) 
VinD777: posts small blind $0.02
raingoldgs: posts big blind $0.05
*** HOLE CARDS ***
Dealt to HubertusB [9c 7h]
Gregório26: folds 
hugedkeyfish: raises $0.10 to $0.15
HubertusB: folds 
Tartarobass: folds 
VinD777: folds 
raingoldgs: folds 
Uncalled bet ($0.10) returned to hugedkeyfish
hugedkeyfish collected $0.12 from pot
hugedkeyfish: doesn't show hand 
*** SUMMARY ***
Total pot $0.12 | Rake $0 
Seat 1: Tartarobass (button) folded before Flop (didn't bet)
Seat 2: VinD777 (small blind) folded before Flop
Seat 3: raingoldgs (big blind) folded before Flop
Seat 4: Gregório26 folded before Flop (didn't bet)
Seat 5: hugedkeyfish collected ($0.12)
Seat 6: HubertusB folded before Flop (didn't bet)



PokerStars Zoom Hand #177285908611:  Hold'em No Limit ($0.02/$0.05) - 2017/10/24 1:20:09 CCT [2017/10/23 13:20:09 ET]
Table 'Donati' 6-max Seat #1 is the button
Seat 1: Morgot339 ($7.56 in chips) 
Seat 2: mst6 ($8.71 in chips) 
Seat 3: 123456789163 ($0.66 in chips) 
Seat 4: HubertusB ($5 in chips) 
Seat 5: unFair235 ($6.65 in chips) 
Seat 6: Hoxt0n ($5.11 in chips) 
mst6: posts small blind $0.02
123456789163: posts big blind $0.05
*** HOLE CARDS ***
Dealt to HubertusB [8s As]
HubertusB: raises $0.05 to $0.10
unFair235: folds 
Hoxt0n: folds 
Morgot339: folds 
mst6: folds 
123456789163 has timed out
123456789163: folds 
Uncalled bet ($0.05) returned to HubertusB
HubertusB collected $0.12 from pot
HubertusB: doesn't show hand 
*** SUMMARY ***
Total pot $0.12 | Rake $0 
Seat 1: Morgot339 (button) folded before Flop (didn't bet)
Seat 2: mst6 (small blind) folded before Flop
Seat 3: 123456789163 (big blind) folded before Flop
Seat 4: HubertusB collected ($0.12)
Seat 5: unFair235 folded before Flop (didn't bet)
Seat 6: Hoxt0n folded before Flop (didn't bet)



PokerStars Zoom Hand #177285982089:  Hold'em No Limit ($0.02/$0.05) - 2017/10/24 1:21:46 CCT [2017/10/23 13:21:46 ET]
Table 'Donati' 6-max Seat #1 is the button
Seat 1: drannod ($4.95 in chips) 
Seat 2: Shurik389 ($11.10 in chips) 
Seat 3: HubertusB ($5.07 in chips) 
Seat 4: Brosssea ($11.78 in chips) 
Seat 5: sasha9031986 ($2.80 in chips) 
Seat 6: rack1777 ($8.73 in chips) 
Shurik389: posts small blind $0.02
HubertusB: posts big blind $0.05
*** HOLE CARDS ***
Dealt to HubertusB [Qd 9s]
Brosssea: raises $0.10 to $0.15
sasha9031986: folds 
rack1777: folds 
drannod: folds 
Shurik389: folds 
HubertusB: folds 
Uncalled bet ($0.10) returned to Brosssea
Brosssea collected $0.12 from pot
Brosssea: doesn't show hand 
*** SUMMARY ***
Total pot $0.12 | Rake $0 
Seat 1: drannod (button) folded before Flop (didn't bet)
Seat 2: Shurik389 (small blind) folded before Flop
Seat 3: HubertusB (big blind) folded before Flop
Seat 4: Brosssea collected ($0.12)
Seat 5: sasha9031986 folded before Flop (didn't bet)
Seat 6: rack1777 folded before Flop (didn't bet)



PokerStars Zoom Hand #177285987308:  Hold'em No Limit ($0.02/$0.05) - 2017/10/24 1:21:53 CCT [2017/10/23 13:21:53 ET]
Table 'Donati' 6-max Seat #1 is the button
Seat 1: Pirotechnima ($6.36 in chips) 
Seat 2: HubertusB ($5.02 in chips) 
Seat 3: Goakiller ($5.12 in chips) 
Seat 4: prochy1909 ($5.17 in chips) 
Seat 5: Balonas ($1.90 in chips) 
Seat 6: kotopes24 ($5 in chips) 
HubertusB: posts small blind $0.02
Goakiller: posts big blind $0.05
*** HOLE CARDS ***
Dealt to HubertusB [Qs 7c]
prochy1909: folds 
Balonas: folds 
kotopes24: folds 
Pirotechnima: raises $0.10 to $0.15
HubertusB: folds 
Goakiller: folds 
Uncalled bet ($0.10) returned to Pirotechnima
Pirotechnima collected $0.12 from pot
Pirotechnima: doesn't show hand 
*** SUMMARY ***
Total pot $0.12 | Rake $0 
Seat 1: Pirotechnima (button) collected ($0.12)
Seat 2: HubertusB (small blind) folded before Flop
Seat 3: Goakiller (big blind) folded before Flop
Seat 4: prochy1909 folded before Flop (didn't bet)
Seat 5: Balonas folded before Flop (didn't bet)
Seat 6: kotopes24 folded before Flop (didn't bet)



PokerStars Zoom Hand #177285994125:  Hold'em No Limit ($0.02/$0.05) - 2017/10/24 1:22:03 CCT [2017/10/23 13:22:03 ET]
Table 'Donati' 6-max Seat #1 is the button
Seat 1: Fekla248 ($6.39 in chips) 
Seat 2: Xéntis ($5 in chips) 
Seat 3: dmi9644 ($4.33 in chips) 
Seat 4: Dariev ($11.67 in chips) 
Seat 5: maloi_m3 ($5.28 in chips) 
Seat 6: HubertusB ($5 in chips) 
Xéntis: posts small blind $0.02
dmi9644: posts big blind $0.05
*** HOLE CARDS ***
Dealt to HubertusB [6c 8d]
Dariev: folds 
maloi_m3: folds 
HubertusB: folds 
Fekla248: raises $0.10 to $0.15
Xéntis: folds 
dmi9644: folds 
Uncalled bet ($0.10) returned to Fekla248
Fekla248 collected $0.12 from pot
Fekla248: doesn't show hand 
*** SUMMARY ***
Total pot $0.12 | Rake $0 
Seat 1: Fekla248 (button) collected ($0.12)
Seat 2: Xéntis (small blind) folded before Flop
Seat 3: dmi9644 (big blind) folded before Flop
Seat 4: Dariev folded before Flop (didn't bet)
Seat 5: maloi_m3 folded before Flop (didn't bet)
Seat 6: HubertusB folded before Flop (didn't bet)



PokerStars Zoom Hand #177285991120:  Hold'em No Limit ($0.02/$0.05) - 2017/10/24 1:21:58 CCT [2017/10/23 13:21:58 ET]
Table 'Donati' 6-max Seat #1 is the button
Seat 1: HubertusB ($5 in chips) 
Seat 2: Guest533 ($47.71 in chips) 
Seat 3: elbubu1984 ($5.31 in chips) 
Seat 4: Luckerly ($18.10 in chips) 
Seat 5: eraser242 ($8.45 in chips) 
Seat 6: iD_EAx ($5.31 in chips) 
Guest533: posts small blind $0.02
elbubu1984: posts big blind $0.05
*** HOLE CARDS ***
Dealt to HubertusB [4s 8h]
Luckerly: folds 
eraser242: raises $0.10 to $0.15
iD_EAx: folds 
HubertusB: folds 
Guest533: folds 
elbubu1984: folds 
Uncalled bet ($0.10) returned to eraser242
eraser242 collected $0.12 from pot
eraser242: doesn't show hand 
*** SUMMARY ***
Total pot $0.12 | Rake $0 
Seat 1: HubertusB (button) folded before Flop (didn't bet)
Seat 2: Guest533 (small blind) folded before Flop
Seat 3: elbubu1984 (big blind) folded before Flop
Seat 4: Luckerly folded before Flop (didn't bet)
Seat 5: eraser242 collected ($0.12)
Seat 6: iD_EAx folded before Flop (didn't bet)



PokerStars Zoom Hand #177285997952:  Hold'em No Limit ($0.02/$0.05) - 2017/10/24 1:22:08 CCT [2017/10/23 13:22:08 ET]
Table 'Donati' 6-max Seat #1 is the button
Seat 1: rekitikitik ($5.05 in chips) 
Seat 2: Balonas ($0.97 in chips) 
Seat 3: JuggerFanta ($7.89 in chips) 
Seat 4: Alucard5077 ($13.86 in chips) 
Seat 5: HubertusB ($5 in chips) 
Seat 6: AndreiV34rus ($11.65 in chips) 
Balonas: posts small blind $0.02
JuggerFanta: posts big blind $0.05
*** HOLE CARDS ***
Dealt to HubertusB [2h Kc]
Alucard5077: folds 
HubertusB: folds 
AndreiV34rus: folds 
rekitikitik: folds 
Balonas: raises $0.10 to $0.15
JuggerFanta: folds 
Uncalled bet ($0.10) returned to Balonas
Balonas collected $0.10 from pot
Balonas: doesn't show hand 
*** SUMMARY ***
Total pot $0.10 | Rake $0 
Seat 1: rekitikitik (button) folded before Flop (didn't bet)
Seat 2: Balonas (small blind) collected ($0.10)
Seat 3: JuggerFanta (big blind) folded before Flop
Seat 4: Alucard5077 folded before Flop (didn't bet)
Seat 5: HubertusB folded before Flop (didn't bet)
Seat 6: AndreiV34rus folded before Flop (didn't bet)



PokerStars Zoom Hand #177286003237:  Hold'em No Limit ($0.02/$0.05) - 2017/10/24 1:22:15 CCT [2017/10/23 13:22:15 ET]
Table 'Donati' 6-max Seat #1 is the button
Seat 1: Alfex820 ($2.09 in chips) 
Seat 2: prochy1909 ($5.29 in chips) 
Seat 3: Spinergy01 ($11.57 in chips) 
Seat 4: HubertusB ($5 in chips) 
Seat 5: nickspeedace ($5 in chips) 
Seat 6: Dafit83 ($9.09 in chips) 
prochy1909: posts small blind $0.02
Spinergy01: posts big blind $0.05
*** HOLE CARDS ***
Dealt to HubertusB [2c 3s]
HubertusB: folds 
nickspeedace: folds 
Dafit83: raises $0.07 to $0.12
Alfex820: folds 
prochy1909: folds 
Spinergy01: folds 
Uncalled bet ($0.07) returned to Dafit83
Dafit83 collected $0.12 from pot
Dafit83: doesn't show hand 
*** SUMMARY ***
Total pot $0.12 | Rake $0 
Seat 1: Alfex820 (button) folded before Flop (didn't bet)
Seat 2: prochy1909 (small blind) folded before Flop
Seat 3: Spinergy01 (big blind) folded before Flop
Seat 4: HubertusB folded before Flop (didn't bet)
Seat 5: nickspeedace folded before Flop (didn't bet)
Seat 6: Dafit83 collected ($0.12)



PokerStars Zoom Hand #177286006922:  Hold'em No Limit ($0.02/$0.05) - 2017/10/24 1:22:20 CCT [2017/10/23 13:22:20 ET]
Table 'Donati' 6-max Seat #1 is the button
Seat 1: firebolt1984 ($5.79 in chips) 
Seat 2: badnolte ($7.07 in chips) 
Seat 3: HubertusB ($5 in chips) 
Seat 4: Kern1922 ($8.64 in chips) 
Seat 5: RedDosh ($5.89 in chips) 
Seat 6: domosed351 ($7.77 in chips) 
badnolte: posts small blind $0.02
HubertusB: posts big blind $0.05
*** HOLE CARDS ***
Dealt to HubertusB [4d Qs]
Kern1922: folds 
RedDosh: folds 
domosed351: folds 
firebolt1984: raises $0.07 to $0.12
badnolte: raises $0.38 to $0.50
HubertusB: folds 
firebolt1984: folds 
Uncalled bet ($0.38) returned to badnolte
badnolte collected $0.29 from pot
badnolte: doesn't show hand 
*** SUMMARY ***
Total pot $0.29 | Rake $0 
Seat 1: firebolt1984 (button) folded before Flop
Seat 2: badnolte (small blind) collected ($0.29)
Seat 3: HubertusB (big blind) folded before Flop
Seat 4: Kern1922 folded before Flop (didn't bet)
Seat 5: RedDosh folded before Flop (didn't bet)
Seat 6: domosed351 folded before Flop (didn't bet)



PokerStars Zoom Hand #177286015991:  Hold'em No Limit ($0.02/$0.05) - 2017/10/24 1:22:31 CCT [2017/10/23 13:22:31 ET]
Table 'Donati' 6-max Seat #1 is the button
Seat 1: tintones ($5 in chips) 
Seat 2: HubertusB ($4.95 in chips) 
Seat 3: kailass ($5.86 in chips) 
Seat 4: Brosssea ($11.85 in chips) 
Seat 5: LIghtsout856 ($5.43 in chips) 
Seat 6: prochy1909 ($8.60 in chips) 
HubertusB: posts small blind $0.02
kailass: posts big blind $0.05
*** HOLE CARDS ***
Dealt to HubertusB [5d 6s]
Brosssea: raises $0.10 to $0.15
LIghtsout856: folds 
prochy1909: folds 
tintones: folds 
HubertusB: folds 
kailass: folds 
Uncalled bet ($0.10) returned to Brosssea
Brosssea collected $0.12 from pot
Brosssea: doesn't show hand 
*** SUMMARY ***
Total pot $0.12 | Rake $0 
Seat 1: tintones (button) folded before Flop (didn't bet)
Seat 2: HubertusB (small blind) folded before Flop
Seat 3: kailass (big blind) folded before Flop
Seat 4: Brosssea collected ($0.12)
Seat 5: LIghtsout856 folded before Flop (didn't bet)
Seat 6: prochy1909 folded before Flop (didn't bet)



PokerStars Zoom Hand #177286019821:  Hold'em No Limit ($0.02/$0.05) - 2017/10/24 1:22:36 CCT [2017/10/23 13:22:36 ET]
Table 'Donati' 6-max Seat #1 is the button
Seat 1: Tomo0110 ($4.50 in chips) 
Seat 2: Nohall-God ($11.30 in chips) 
Seat 3: Rasta Papst ($9.09 in chips) 
Seat 4: Benschi83 ($5 in chips) 
Seat 5: HubertusB ($4.93 in chips) 
Seat 6: Dariev ($11.67 in chips) 
Nohall-God: posts small blind $0.02
Rasta Papst: posts big blind $0.05
*** HOLE CARDS ***
Dealt to HubertusB [As 7h]
Benschi83: folds 
HubertusB: folds 
Dariev: folds 
Tomo0110: raises $0.25 to $0.30
Nohall-God: folds 
Rasta Papst: folds 
Uncalled bet ($0.25) returned to Tomo0110
Tomo0110 collected $0.12 from pot
Tomo0110: doesn't show hand 
*** SUMMARY ***
Total pot $0.12 | Rake $0 
Seat 1: Tomo0110 (button) collected ($0.12)
Seat 2: Nohall-God (small blind) folded before Flop
Seat 3: Rasta Papst (big blind) folded before Flop
Seat 4: Benschi83 folded before Flop (didn't bet)
Seat 5: HubertusB folded before Flop (didn't bet)
Seat 6: Dariev folded before Flop (didn't bet)



PokerStars Zoom Hand #177285979027:  Hold'em No Limit ($0.02/$0.05) - 2017/10/24 1:21:42 CCT [2017/10/23 13:21:42 ET]
Table 'Donati' 6-max Seat #1 is the button
Seat 1: anubis2008 ($4.74 in chips) 
Seat 2: Gala7755 ($2.62 in chips) 
Seat 3: Balonas ($1.02 in chips) 
Seat 4: HubertusB ($5.07 in chips) 
Seat 5: Faied123 ($6.28 in chips) 
Seat 6: Groningen84 ($1.74 in chips) 
Gala7755: posts small blind $0.02
Balonas: posts big blind $0.05
*** HOLE CARDS ***
Dealt to HubertusB [5c Qs]
HubertusB: folds 
Faied123: folds 
Groningen84: raises $0.10 to $0.15
anubis2008: calls $0.15
Gala7755: calls $0.13
Balonas: folds 
*** FLOP *** [Th 8h 2c]
Gala7755: checks 
Groningen84: bets $0.15
anubis2008: calls $0.15
Gala7755: calls $0.15
*** TURN *** [Th 8h 2c] [2s]
Gala7755: checks 
Groningen84: checks 
anubis2008: checks 
*** RIVER *** [Th 8h 2c 2s] [9c]
Gala7755: bets $0.91
Groningen84: folds 
anubis2008: folds 
Uncalled bet ($0.91) returned to Gala7755
Gala7755 collected $0.91 from pot
Gala7755: doesn't show hand 
*** SUMMARY ***
Total pot $0.95 | Rake $0.04 
Board [Th 8h 2c 2s 9c]
Seat 1: anubis2008 (button) folded on the River
Seat 2: Gala7755 (small blind) collected ($0.91)
Seat 3: Balonas (big blind) folded before Flop
Seat 4: HubertusB folded before Flop (didn't bet)
Seat 5: Faied123 folded before Flop (didn't bet)
Seat 6: Groningen84 folded on the River



PokerStars Zoom Hand #177286012169:  Hold'em No Limit ($0.02/$0.05) - 2017/10/24 1:22:26 CCT [2017/10/23 13:22:26 ET]
Table 'Donati' 6-max Seat #1 is the button
Seat 1: matanPS ($5.29 in chips) 
Seat 2: [Apo]-1987 ($6.74 in chips) 
Seat 3: batitibi ($5 in chips) 
Seat 4: koning504 ($12.98 in chips) 
Seat 5: kopatich52 ($12.04 in chips) 
Seat 6: HubertusB ($4.95 in chips) 
[Apo]-1987: posts small blind $0.02
batitibi: posts big blind $0.05
*** HOLE CARDS ***
Dealt to HubertusB [4d 9d]
koning504: raises $0.10 to $0.15
kopatich52: folds 
HubertusB: folds 
matanPS: folds 
[Apo]-1987: calls $0.13
batitibi: folds 
*** FLOP *** [6s 5c 3h]
[Apo]-1987: checks 
koning504: checks 
*** TURN *** [6s 5c 3h] [4s]
[Apo]-1987: bets $0.20
koning504: folds 
Uncalled bet ($0.20) returned to [Apo]-1987
[Apo]-1987 collected $0.34 from pot
[Apo]-1987: doesn't show hand 
*** SUMMARY ***
Total pot $0.35 | Rake $0.01 
Board [6s 5c 3h 4s]
Seat 1: matanPS (button) folded before Flop (didn't bet)
Seat 2: [Apo]-1987 (small blind) collected ($0.34)
Seat 3: batitibi (big blind) folded before Flop
Seat 4: koning504 folded on the Turn
Seat 5: kopatich52 folded before Flop (didn't bet)
Seat 6: HubertusB folded before Flop (didn't bet)



PokerStars Zoom Hand #177286034339:  Hold'em No Limit ($0.02/$0.05) - 2017/10/24 1:22:56 CCT [2017/10/23 13:22:56 ET]
Table 'Donati' 6-max Seat #1 is the button
Seat 1: Guest533 ($63.21 in chips) 
Seat 2: grunge&punk ($6.64 in chips) 
Seat 3: HubertusB ($4.93 in chips) 
Seat 4: Luckerly ($7.35 in chips) 
Seat 5: Faied123 ($6.14 in chips) 
Seat 6: fless836 ($6.60 in chips) 
grunge&punk: posts small blind $0.02
HubertusB: posts big blind $0.05
*** HOLE CARDS ***
Dealt to HubertusB [6c 7h]
Luckerly: folds 
Faied123: raises $0.10 to $0.15
fless836: raises $0.30 to $0.45
Guest533: folds 
grunge&punk: folds 
HubertusB: folds 
Faied123: folds 
Uncalled bet ($0.30) returned to fless836
fless836 collected $0.37 from pot
fless836: doesn't show hand 
*** SUMMARY ***
Total pot $0.37 | Rake $0 
Seat 1: Guest533 (button) folded before Flop (didn't bet)
Seat 2: grunge&punk (small blind) folded before Flop
Seat 3: HubertusB (big blind) folded before Flop
Seat 4: Luckerly folded before Flop (didn't bet)
Seat 5: Faied123 folded before Flop
Seat 6: fless836 collected ($0.37)



PokerStars Zoom Hand #177286030520:  Hold'em No Limit ($0.02/$0.05) - 2017/10/24 1:22:50 CCT [2017/10/23 13:22:50 ET]
Table 'Donati' 6-max Seat #1 is the button
Seat 1: Aaleks111 ($5.07 in chips) 
Seat 2: sarabskaya ($7.41 in chips) 
Seat 3: stefagr ($5.35 in chips) 
Seat 4: Treysix ($5.63 in chips) 
Seat 5: HubertusB ($4.93 in chips) 
Seat 6: WisherBG ($6.36 in chips) 
sarabskaya: posts small blind $0.02
stefagr: posts big blind $0.05
*** HOLE CARDS ***
Dealt to HubertusB [2h 9d]
Treysix: folds 
HubertusB: folds 
WisherBG: folds 
Aaleks111: raises $0.05 to $0.10
sarabskaya: folds 
stefagr: raises $0.21 to $0.31
Aaleks111: calls $0.21
*** FLOP *** [4s 6s Jc]
stefagr: bets $0.34
Aaleks111: calls $0.34
*** TURN *** [4s 6s Jc] [Kh]
stefagr: bets $0.20
Aaleks111: calls $0.20
*** RIVER *** [4s 6s Jc Kh] [7h]
stefagr: checks 
Aaleks111: checks 
*** SHOW DOWN ***
stefagr: shows [7s Ts] (a pair of Sevens)
Aaleks111: mucks hand 
stefagr collected $1.65 from pot
*** SUMMARY ***
Total pot $1.72 | Rake $0.07 
Board [4s 6s Jc Kh 7h]
Seat 1: Aaleks111 (button) mucked [4h 3c]
Seat 2: sarabskaya (small blind) folded before Flop
Seat 3: stefagr (big blind) showed [7s Ts] and won ($1.65) with a pair of Sevens
Seat 4: Treysix folded before Flop (didn't bet)
Seat 5: HubertusB folded before Flop (didn't bet)
Seat 6: WisherBG folded before Flop (didn't bet)



PokerStars Zoom Hand #177286041092:  Hold'em No Limit ($0.02/$0.05) - 2017/10/24 1:23:04 CCT [2017/10/23 13:23:04 ET]
Table 'Donati' 6-max Seat #1 is the button
Seat 1: HubertusB ($4.88 in chips) 
Seat 2: Piotru$Pan24 ($5.14 in chips) 
Seat 3: Lehi423 ($5 in chips) 
Seat 4: DavidR798 ($6.69 in chips) 
Seat 5: Oliana88 ($11.26 in chips) 
Seat 6: MR.LOCT ($4.78 in chips) 
Piotru$Pan24: posts small blind $0.02
Lehi423: posts big blind $0.05
*** HOLE CARDS ***
Dealt to HubertusB [Jc Ah]
DavidR798: folds 
Oliana88: folds 
MR.LOCT: folds 
HubertusB: raises $0.05 to $0.10
Piotru$Pan24: raises $0.25 to $0.35
Lehi423: folds 
HubertusB: calls $0.25
*** FLOP *** [Qs Jd 2c]
Piotru$Pan24: checks 
HubertusB: checks 
*** TURN *** [Qs Jd 2c] [Tc]
Piotru$Pan24: bets $0.30
HubertusB: calls $0.30
*** RIVER *** [Qs Jd 2c Tc] [Jh]
Piotru$Pan24: bets $0.80
HubertusB: calls $0.80
*** SHOW DOWN ***
Piotru$Pan24: shows [9d 7d] (a pair of Jacks)
HubertusB: shows [Jc Ah] (three of a kind, Jacks)
HubertusB collected $2.83 from pot
*** SUMMARY ***
Total pot $2.95 | Rake $0.12 
Board [Qs Jd 2c Tc Jh]
Seat 1: HubertusB (button) showed [Jc Ah] and won ($2.83) with three of a kind, Jacks
Seat 2: Piotru$Pan24 (small blind) showed [9d 7d] and lost with a pair of Jacks
Seat 3: Lehi423 (big blind) folded before Flop
Seat 4: DavidR798 folded before Flop (didn't bet)
Seat 5: Oliana88 folded before Flop (didn't bet)
Seat 6: MR.LOCT folded before Flop (didn't bet)



PokerStars Zoom Hand #177286023675:  Hold'em No Limit ($0.02/$0.05) - 2017/10/24 1:22:41 CCT [2017/10/23 13:22:41 ET]
Table 'Donati' 6-max Seat #1 is the button
Seat 1: HubertusB ($4.93 in chips) 
Seat 2: Sarmatrus79 ($5.35 in chips) 
Seat 3: sarabskaya ($7.05 in chips) 
Seat 4: BladeSonya ($5.01 in chips) 
Seat 5: Piotru$Pan24 ($5.19 in chips) 
Seat 6: avraam84 ($4.68 in chips) 
Sarmatrus79: posts small blind $0.02
sarabskaya: posts big blind $0.05
*** HOLE CARDS ***
Dealt to HubertusB [7s 8d]
BladeSonya: raises $0.10 to $0.15
Piotru$Pan24: folds 
avraam84: folds 
HubertusB: folds 
Sarmatrus79: folds 
sarabskaya: raises $0.40 to $0.55
BladeSonya: calls $0.40
*** FLOP *** [As 6c Td]
sarabskaya: bets $0.50
BladeSonya: calls $0.50
*** TURN *** [As 6c Td] [Js]
sarabskaya: checks 
BladeSonya: bets $1.02
sarabskaya: folds 
Uncalled bet ($1.02) returned to BladeSonya
BladeSonya collected $2.03 from pot
BladeSonya: doesn't show hand 
*** SUMMARY ***
Total pot $2.12 | Rake $0.09 
Board [As 6c Td Js]
Seat 1: HubertusB (button) folded before Flop (didn't bet)
Seat 2: Sarmatrus79 (small blind) folded before Flop
Seat 3: sarabskaya (big blind) folded on the Turn
Seat 4: BladeSonya collected ($2.03)
Seat 5: Piotru$Pan24 folded before Flop (didn't bet)
Seat 6: avraam84 folded before Flop (didn't bet)



PokerStars Zoom Hand #177286081307:  Hold'em No Limit ($0.02/$0.05) - 2017/10/24 1:23:58 CCT [2017/10/23 13:23:58 ET]
Table 'Donati' 6-max Seat #1 is the button
Seat 1: P0KERB0Y ($5.07 in chips) 
Seat 2: everfeo ($5.32 in chips) 
Seat 3: maxinio2010 ($5.50 in chips) 
Seat 4: nathaniel158 ($8.84 in chips) 
Seat 5: Clannisaje ($3.80 in chips) 
Seat 6: HubertusB ($6.26 in chips) 
everfeo: posts small blind $0.02
maxinio2010: posts big blind $0.05
*** HOLE CARDS ***
Dealt to HubertusB [Td 6d]
nathaniel158: folds 
Clannisaje: raises $0.10 to $0.15
HubertusB: folds 
P0KERB0Y: calls $0.15
everfeo: folds 
maxinio2010: folds 
*** FLOP *** [9s 3h Kc]
Clannisaje: bets $0.17
P0KERB0Y: raises $0.17 to $0.34
Clannisaje: calls $0.17
*** TURN *** [9s 3h Kc] [Qh]
Clannisaje: checks 
P0KERB0Y: checks 
*** RIVER *** [9s 3h Kc Qh] [7c]
Clannisaje: bets $0.75
P0KERB0Y: folds 
Uncalled bet ($0.75) returned to Clannisaje
Clannisaje collected $1.01 from pot
Clannisaje: doesn't show hand 
*** SUMMARY ***
Total pot $1.05 | Rake $0.04 
Board [9s 3h Kc Qh 7c]
Seat 1: P0KERB0Y (button) folded on the River
Seat 2: everfeo (small blind) folded before Flop
Seat 3: maxinio2010 (big blind) folded before Flop
Seat 4: nathaniel158 folded before Flop (didn't bet)
Seat 5: Clannisaje collected ($1.01)
Seat 6: HubertusB folded before Flop (didn't bet)



PokerStars Zoom Hand #177286085107:  Hold'em No Limit ($0.02/$0.05) - 2017/10/24 1:24:02 CCT [2017/10/23 13:24:02 ET]
Table 'Donati' 6-max Seat #1 is the button
Seat 1: ooiaooao ($10.29 in chips) 
Seat 2: HubertusB ($6.26 in chips) 
Seat 3: Comra1d ($11.66 in chips) 
Seat 4: Valio2015 ($4.94 in chips) 
Seat 5: Krutikova212 ($11.06 in chips) 
Seat 6: nickspeedace ($5 in chips) 
HubertusB: posts small blind $0.02
Comra1d: posts big blind $0.05
*** HOLE CARDS ***
Dealt to HubertusB [4c Tc]
Valio2015: folds 
Krutikova212: folds 
nickspeedace: folds 
ooiaooao: raises $0.15 to $0.20
HubertusB: folds 
Comra1d: calls $0.15
*** FLOP *** [9c 2h 9s]
Comra1d: checks 
ooiaooao: bets $0.20
Comra1d: folds 
Uncalled bet ($0.20) returned to ooiaooao
ooiaooao collected $0.40 from pot
ooiaooao: doesn't show hand 
*** SUMMARY ***
Total pot $0.42 | Rake $0.02 
Board [9c 2h 9s]
Seat 1: ooiaooao (button) collected ($0.40)
Seat 2: HubertusB (small blind) folded before Flop
Seat 3: Comra1d (big blind) folded on the Flop
Seat 4: Valio2015 folded before Flop (didn't bet)
Seat 5: Krutikova212 folded before Flop (didn't bet)
Seat 6: nickspeedace folded before Flop (didn't bet)



PokerStars Zoom Hand #177286088884:  Hold'em No Limit ($0.02/$0.05) - 2017/10/24 1:24:08 CCT [2017/10/23 13:24:08 ET]
Table 'Donati' 6-max Seat #1 is the button
Seat 1: P1T-BUL1 ($5.62 in chips) 
Seat 2: rokerstas ($11.65 in chips) 
Seat 3: anthony19719 ($35.05 in chips) 
Seat 4: GuardCorp ($9.52 in chips) 
Seat 5: HubertusB ($6.24 in chips) 
Seat 6: n1.1993 ($4.44 in chips) 
rokerstas: posts small blind $0.02
anthony19719: posts big blind $0.05
*** HOLE CARDS ***
Dealt to HubertusB [Ad Jd]
GuardCorp: folds 
HubertusB: raises $0.05 to $0.10
n1.1993: raises $0.20 to $0.30
P1T-BUL1: folds 
rokerstas: folds 
anthony19719: folds 
HubertusB: calls $0.20
*** FLOP *** [9s Ac 5d]
HubertusB: checks 
n1.1993: bets $0.32
HubertusB: calls $0.32
*** TURN *** [9s Ac 5d] [2h]
HubertusB: checks 
n1.1993: checks 
*** RIVER *** [9s Ac 5d 2h] [8d]
HubertusB: checks 
n1.1993: bets $0.63
HubertusB: calls $0.63
*** SHOW DOWN ***
n1.1993: shows [Kc Tc] (high card Ace)
HubertusB: shows [Ad Jd] (a pair of Aces)
HubertusB collected $2.46 from pot
*** SUMMARY ***
Total pot $2.57 | Rake $0.11 
Board [9s Ac 5d 2h 8d]
Seat 1: P1T-BUL1 (button) folded before Flop (didn't bet)
Seat 2: rokerstas (small blind) folded before Flop
Seat 3: anthony19719 (big blind) folded before Flop
Seat 4: GuardCorp folded before Flop (didn't bet)
Seat 5: HubertusB showed [Ad Jd] and won ($2.46) with a pair of Aces
Seat 6: n1.1993 showed [Kc Tc] and lost with high card Ace



PokerStars Zoom Hand #177286132621:  Hold'em No Limit ($0.02/$0.05) - 2017/10/24 1:25:05 CCT [2017/10/23 13:25:05 ET]
Table 'Donati' 6-max Seat #1 is the button
Seat 1: Treysix ($5.27 in chips) 
Seat 2: kotopes24 ($5.11 in chips) 
Seat 3: HubertusB ($7.45 in chips) 
Seat 4: sarabskaya ($12.44 in chips) 
Seat 5: bybaleh52 ($16.82 in chips) 
Seat 6: alienhack ($20.48 in chips) 
kotopes24: posts small blind $0.02
HubertusB: posts big blind $0.05
*** HOLE CARDS ***
Dealt to HubertusB [7h 8d]
sarabskaya: folds 
bybaleh52: folds 
alienhack: folds 
Treysix: raises $0.07 to $0.12
kotopes24: folds 
HubertusB: folds 
Uncalled bet ($0.07) returned to Treysix
Treysix collected $0.12 from pot
Treysix: doesn't show hand 
*** SUMMARY ***
Total pot $0.12 | Rake $0 
Seat 1: Treysix (button) collected ($0.12)
Seat 2: kotopes24 (small blind) folded before Flop
Seat 3: HubertusB (big blind) folded before Flop
Seat 4: sarabskaya folded before Flop (didn't bet)
Seat 5: bybaleh52 folded before Flop (didn't bet)
Seat 6: alienhack folded before Flop (didn't bet)



PokerStars Zoom Hand #177286139450:  Hold'em No Limit ($0.02/$0.05) - 2017/10/24 1:25:15 CCT [2017/10/23 13:25:15 ET]
Table 'Donati' 6-max Seat #1 is the button
Seat 1: SandersWar ($2.25 in chips) 
Seat 2: HubertusB ($7.40 in chips) 
Seat 3: muzy45 ($16.64 in chips) 
Seat 4: filipkost ($4.71 in chips) 
Seat 5: MR.LOCT ($4.76 in chips) 
Seat 6: Krutikova212 ($5.51 in chips) 
HubertusB: posts small blind $0.02
muzy45: posts big blind $0.05
*** HOLE CARDS ***
Dealt to HubertusB [Js 3s]
filipkost: folds 
MR.LOCT: folds 
Krutikova212: folds 
SandersWar: folds 
HubertusB: folds 
Uncalled bet ($0.03) returned to muzy45
muzy45 collected $0.04 from pot
muzy45: doesn't show hand 
*** SUMMARY ***
Total pot $0.04 | Rake $0 
Seat 1: SandersWar (button) folded before Flop (didn't bet)
Seat 2: HubertusB (small blind) folded before Flop
Seat 3: muzy45 (big blind) collected ($0.04)
Seat 4: filipkost folded before Flop (didn't bet)
Seat 5: MR.LOCT folded before Flop (didn't bet)
Seat 6: Krutikova212 folded before Flop (didn't bet)



PokerStars Zoom Hand #177286129549:  Hold'em No Limit ($0.02/$0.05) - 2017/10/24 1:25:02 CCT [2017/10/23 13:25:02 ET]
Table 'Donati' 6-max Seat #1 is the button
Seat 1: Rabbit488 ($5 in chips) 
Seat 2: Goakiller ($5 in chips) 
Seat 3: alex1148 ($4.22 in chips) 
Seat 4: Oliana88 ($5.43 in chips) 
Seat 5: dira86 ($5.22 in chips) 
Seat 6: HubertusB ($7.45 in chips) 
Goakiller: posts small blind $0.02
alex1148: posts big blind $0.05
*** HOLE CARDS ***
Dealt to HubertusB [4h Kd]
Oliana88: folds 
dira86: folds 
HubertusB: folds 
Rabbit488: raises $0.10 to $0.15
Goakiller: raises $0.35 to $0.50
alex1148: folds 
Rabbit488: calls $0.35
*** FLOP *** [6d 4s 6c]
Goakiller: bets $0.67
Rabbit488: folds 
Uncalled bet ($0.67) returned to Goakiller
Goakiller collected $1.01 from pot
Goakiller: doesn't show hand 
*** SUMMARY ***
Total pot $1.05 | Rake $0.04 
Board [6d 4s 6c]
Seat 1: Rabbit488 (button) folded on the Flop
Seat 2: Goakiller (small blind) collected ($1.01)
Seat 3: alex1148 (big blind) folded before Flop
Seat 4: Oliana88 folded before Flop (didn't bet)
Seat 5: dira86 folded before Flop (didn't bet)
Seat 6: HubertusB folded before Flop (didn't bet)



PokerStars Zoom Hand #177286143242:  Hold'em No Limit ($0.02/$0.05) - 2017/10/24 1:25:19 CCT [2017/10/23 13:25:19 ET]
Table 'Donati' 6-max Seat #1 is the button
Seat 1: nickspeedace ($6.80 in chips) 
Seat 2: MOROZ056 ($7.07 in chips) 
Seat 3: FarFromFish ($5.14 in chips) 
Seat 4: HubertusB ($7.38 in chips) 
Seat 5: Azamat446 ($4.76 in chips) 
Seat 6: numelen ($5.11 in chips) 
MOROZ056: posts small blind $0.02
FarFromFish: posts big blind $0.05
*** HOLE CARDS ***
Dealt to HubertusB [5s 3d]
HubertusB: folds 
Azamat446: folds 
numelen: folds 
nickspeedace: folds 
MOROZ056: folds 
Uncalled bet ($0.03) returned to FarFromFish
FarFromFish collected $0.04 from pot
FarFromFish: doesn't show hand 
*** SUMMARY ***
Total pot $0.04 | Rake $0 
Seat 1: nickspeedace (button) folded before Flop (didn't bet)
Seat 2: MOROZ056 (small blind) folded before Flop
Seat 3: FarFromFish (big blind) collected ($0.04)
Seat 4: HubertusB folded before Flop (didn't bet)
Seat 5: Azamat446 folded before Flop (didn't bet)
Seat 6: numelen folded before Flop (didn't bet)



PokerStars Zoom Hand #177286163676:  Hold'em No Limit ($0.02/$0.05) - 2017/10/24 1:25:47 CCT [2017/10/23 13:25:47 ET]
Table 'Donati' 6-max Seat #1 is the button
Seat 1: BPinholeworl ($8.61 in chips) 
Seat 2: ASUS04 ($5.68 in chips) 
Seat 3: HubertusB ($7.38 in chips) 
Seat 4: rimizak12 ($3.56 in chips) 
Seat 5: 81denis81 ($5.07 in chips) 
Seat 6: AlfonsoCap ($5.77 in chips) 
ASUS04: posts small blind $0.02
HubertusB: posts big blind $0.05
*** HOLE CARDS ***
Dealt to HubertusB [Qc 5s]
rimizak12: folds 
81denis81: folds 
AlfonsoCap: folds 
BPinholeworl: raises $0.05 to $0.10
ASUS04: folds 
HubertusB: folds 
Uncalled bet ($0.05) returned to BPinholeworl
BPinholeworl collected $0.12 from pot
BPinholeworl: doesn't show hand 
*** SUMMARY ***
Total pot $0.12 | Rake $0 
Seat 1: BPinholeworl (button) collected ($0.12)
Seat 2: ASUS04 (small blind) folded before Flop
Seat 3: HubertusB (big blind) folded before Flop
Seat 4: rimizak12 folded before Flop (didn't bet)
Seat 5: 81denis81 folded before Flop (didn't bet)
Seat 6: AlfonsoCap folded before Flop (didn't bet)



PokerStars Zoom Hand #177286158227:  Hold'em No Limit ($0.02/$0.05) - 2017/10/24 1:25:40 CCT [2017/10/23 13:25:40 ET]
Table 'Donati' 6-max Seat #1 is the button
Seat 1: drannod ($3.60 in chips) 
Seat 2: BPinholeworl ($8.63 in chips) 
Seat 3: ConnorM1888 ($7.64 in chips) 
Seat 4: TRUMPCARD111 ($2.61 in chips) 
Seat 5: Kerberus94 ($7.01 in chips) 
Seat 6: HubertusB ($7.38 in chips) 
BPinholeworl: posts small blind $0.02
ConnorM1888: posts big blind $0.05
*** HOLE CARDS ***
Dealt to HubertusB [5h 2d]
TRUMPCARD111: raises $0.10 to $0.15
Kerberus94: folds 
HubertusB: folds 
drannod: folds 
BPinholeworl: folds 
ConnorM1888: calls $0.10
*** FLOP *** [6d Ah 2s]
ConnorM1888: checks 
TRUMPCARD111: bets $0.15
ConnorM1888: calls $0.15
*** TURN *** [6d Ah 2s] [7d]
ConnorM1888: checks 
TRUMPCARD111: checks 
*** RIVER *** [6d Ah 2s 7d] [2c]
ConnorM1888: bets $0.26
TRUMPCARD111: calls $0.26
*** SHOW DOWN ***
ConnorM1888: shows [Jc Ac] (two pair, Aces and Deuces)
TRUMPCARD111: mucks hand 
ConnorM1888 collected $1.09 from pot
*** SUMMARY ***
Total pot $1.14 | Rake $0.05 
Board [6d Ah 2s 7d 2c]
Seat 1: drannod (button) folded before Flop (didn't bet)
Seat 2: BPinholeworl (small blind) folded before Flop
Seat 3: ConnorM1888 (big blind) showed [Jc Ac] and won ($1.09) with two pair, Aces and Deuces
Seat 4: TRUMPCARD111 mucked [Js Jh]
Seat 5: Kerberus94 folded before Flop (didn't bet)
Seat 6: HubertusB folded before Flop (didn't bet)



PokerStars Zoom Hand #177286154494:  Hold'em No Limit ($0.02/$0.05) - 2017/10/24 1:25:35 CCT [2017/10/23 13:25:35 ET]
Table 'Donati' 6-max Seat #1 is the button
Seat 1: l0luf0ld ($7.55 in chips) 
Seat 2: kid_28@0 ($7.35 in chips) 
Seat 3: Faied123 ($7.29 in chips) 
Seat 4: HubertusB ($7.38 in chips) 
Seat 5: 7maximus73 ($8.59 in chips) 
Seat 6: PonasAurimas ($14.97 in chips) 
kid_28@0: posts small blind $0.02
Faied123: posts big blind $0.05
*** HOLE CARDS ***
Dealt to HubertusB [8d 9h]
HubertusB: folds 
7maximus73: folds 
PonasAurimas: folds 
l0luf0ld: raises $0.10 to $0.15
kid_28@0: calls $0.13
Faied123: folds 
*** FLOP *** [3h 7d Jd]
kid_28@0: checks 
l0luf0ld: checks 
*** TURN *** [3h 7d Jd] [Js]
kid_28@0: checks 
l0luf0ld: checks 
*** RIVER *** [3h 7d Jd Js] [3d]
kid_28@0: bets $0.34
l0luf0ld: folds 
Uncalled bet ($0.34) returned to kid_28@0
kid_28@0 collected $0.34 from pot
kid_28@0: doesn't show hand 
*** SUMMARY ***
Total pot $0.35 | Rake $0.01 
Board [3h 7d Jd Js 3d]
Seat 1: l0luf0ld (button) folded on the River
Seat 2: kid_28@0 (small blind) collected ($0.34)
Seat 3: Faied123 (big blind) folded before Flop
Seat 4: HubertusB folded before Flop (didn't bet)
Seat 5: 7maximus73 folded before Flop (didn't bet)
Seat 6: PonasAurimas folded before Flop (didn't bet)



PokerStars Zoom Hand #177286169809:  Hold'em No Limit ($0.02/$0.05) - 2017/10/24 1:25:55 CCT [2017/10/23 13:25:55 ET]
Table 'Donati' 6-max Seat #1 is the button
Seat 1: 1DollarDude ($5 in chips) 
Seat 2: HubertusB ($7.33 in chips) 
Seat 3: tatarinnnn ($13.64 in chips) 
Seat 4: rack1777 ($5 in chips) 
Seat 5: Jajje7 ($5.16 in chips) 
Seat 6: xxxbohunxxx ($5 in chips) 
HubertusB: posts small blind $0.02
tatarinnnn: posts big blind $0.05
*** HOLE CARDS ***
Dealt to HubertusB [Qc As]
rack1777: folds 
Jajje7: folds 
xxxbohunxxx: folds 
1DollarDude: folds 
HubertusB: raises $0.05 to $0.10
tatarinnnn: folds 
Uncalled bet ($0.05) returned to HubertusB
HubertusB collected $0.10 from pot
HubertusB: doesn't show hand 
*** SUMMARY ***
Total pot $0.10 | Rake $0 
Seat 1: 1DollarDude (button) folded before Flop (didn't bet)
Seat 2: HubertusB (small blind) collected ($0.10)
Seat 3: tatarinnnn (big blind) folded before Flop
Seat 4: rack1777 folded before Flop (didn't bet)
Seat 5: Jajje7 folded before Flop (didn't bet)
Seat 6: xxxbohunxxx folded before Flop (didn't bet)



PokerStars Zoom Hand #177286146248:  Hold'em No Limit ($0.02/$0.05) - 2017/10/24 1:25:24 CCT [2017/10/23 13:25:24 ET]
Table 'Donati' 6-max Seat #1 is the button
Seat 1: HubertusB ($7.38 in chips) 
Seat 2: dbweb070 ($3.70 in chips) 
Seat 3: Dima Jetta ($5.58 in chips) 
Seat 4: kotopes24 ($5.13 in chips) 
Seat 5: Lednyas ($5.07 in chips) 
Seat 6: nickspeedace ($6.80 in chips) 
dbweb070: posts small blind $0.02
Dima Jetta: posts big blind $0.05
*** HOLE CARDS ***
Dealt to HubertusB [3h 6d]
kotopes24: folds 
Lednyas: folds 
nickspeedace: folds 
HubertusB: folds 
dbweb070: raises $0.05 to $0.10
Dima Jetta: calls $0.05
*** FLOP *** [5s 8d 4c]
dbweb070: bets $0.10
Dima Jetta: calls $0.10
*** TURN *** [5s 8d 4c] [Ac]
dbweb070: bets $0.10
Dima Jetta: folds 
Uncalled bet ($0.10) returned to dbweb070
dbweb070 collected $0.38 from pot
dbweb070: doesn't show hand 
*** SUMMARY ***
Total pot $0.40 | Rake $0.02 
Board [5s 8d 4c Ac]
Seat 1: HubertusB (button) folded before Flop (didn't bet)
Seat 2: dbweb070 (small blind) collected ($0.38)
Seat 3: Dima Jetta (big blind) folded on the Turn
Seat 4: kotopes24 folded before Flop (didn't bet)
Seat 5: Lednyas folded before Flop (didn't bet)
Seat 6: nickspeedace folded before Flop (didn't bet)



PokerStars Zoom Hand #177286188047:  Hold'em No Limit ($0.02/$0.05) - 2017/10/24 1:26:19 CCT [2017/10/23 13:26:19 ET]
Table 'Donati' 6-max Seat #1 is the button
Seat 1: HubertusB ($7.38 in chips) 
Seat 2: hugedkeyfish ($12.99 in chips) 
Seat 3: tintones ($5 in chips) 
Seat 4: BrainInstant ($0.94 in chips) 
Seat 5: m3ssy34 ($3.11 in chips) 
Seat 6: kailass ($5.66 in chips) 
hugedkeyfish: posts small blind $0.02
tintones: posts big blind $0.05
*** HOLE CARDS ***
Dealt to HubertusB [7d Qs]
BrainInstant: folds 
m3ssy34: folds 
kailass: folds 
HubertusB: raises $0.05 to $0.10
hugedkeyfish: folds 
tintones: folds 
Uncalled bet ($0.05) returned to HubertusB
HubertusB collected $0.12 from pot
HubertusB: doesn't show hand 
*** SUMMARY ***
Total pot $0.12 | Rake $0 
Seat 1: HubertusB (button) collected ($0.12)
Seat 2: hugedkeyfish (small blind) folded before Flop
Seat 3: tintones (big blind) folded before Flop
Seat 4: BrainInstant folded before Flop (didn't bet)
Seat 5: m3ssy34 folded before Flop (didn't bet)
Seat 6: kailass folded before Flop (didn't bet)



PokerStars Zoom Hand #177286201721:  Hold'em No Limit ($0.02/$0.05) - 2017/10/24 1:26:37 CCT [2017/10/23 13:26:37 ET]
Table 'Donati' 6-max Seat #1 is the button
Seat 1: lilasg ($5 in chips) 
Seat 2: maxinio2010 ($5.55 in chips) 
Seat 3: HubertusB ($7.45 in chips) 
Seat 4: ooiaooao ($13.51 in chips) 
Seat 5: rack1777 ($13.20 in chips) 
Seat 6: Papaya006 ($5.16 in chips) 
maxinio2010: posts small blind $0.02
HubertusB: posts big blind $0.05
*** HOLE CARDS ***
Dealt to HubertusB [5s 4h]
ooiaooao: folds 
rack1777: folds 
Papaya006: folds 
lilasg: folds 
maxinio2010: folds 
Uncalled bet ($0.03) returned to HubertusB
HubertusB collected $0.04 from pot
HubertusB: doesn't show hand 
*** SUMMARY ***
Total pot $0.04 | Rake $0 
Seat 1: lilasg (button) folded before Flop (didn't bet)
Seat 2: maxinio2010 (small blind) folded before Flop
Seat 3: HubertusB (big blind) collected ($0.04)
Seat 4: ooiaooao folded before Flop (didn't bet)
Seat 5: rack1777 folded before Flop (didn't bet)
Seat 6: Papaya006 folded before Flop (didn't bet)



PokerStars Zoom Hand #177286218331:  Hold'em No Limit ($0.02/$0.05) - 2017/10/24 1:26:59 CCT [2017/10/23 13:26:59 ET]
Table 'Donati' 6-max Seat #1 is the button
Seat 1: MusTer300 ($5.05 in chips) 
Seat 2: nathaniel158 ($16.36 in chips) 
Seat 3: MrInTerra ($4.90 in chips) 
Seat 4: anubis2008 ($6.21 in chips) 
Seat 5: HubertusB ($7.47 in chips) 
Seat 6: Alucard5077 ($14.16 in chips) 
nathaniel158: posts small blind $0.02
MrInTerra: posts big blind $0.05
*** HOLE CARDS ***
Dealt to HubertusB [7h 5c]
anubis2008: folds 
HubertusB: folds 
Alucard5077: folds 
MusTer300: folds 
nathaniel158: raises $0.10 to $0.15
MrInTerra: folds 
Uncalled bet ($0.10) returned to nathaniel158
nathaniel158 collected $0.10 from pot
nathaniel158: doesn't show hand 
*** SUMMARY ***
Total pot $0.10 | Rake $0 
Seat 1: MusTer300 (button) folded before Flop (didn't bet)
Seat 2: nathaniel158 (small blind) collected ($0.10)
Seat 3: MrInTerra (big blind) folded before Flop
Seat 4: anubis2008 folded before Flop (didn't bet)
Seat 5: HubertusB folded before Flop (didn't bet)
Seat 6: Alucard5077 folded before Flop (didn't bet)



PokerStars Zoom Hand #177286228924:  Hold'em No Limit ($0.02/$0.05) - 2017/10/24 1:27:12 CCT [2017/10/23 13:27:12 ET]
Table 'Donati' 6-max Seat #1 is the button
Seat 1: HubertusB ($7.47 in chips) 
Seat 2: drannod ($8 in chips) 
Seat 3: Jajje7 ($5 in chips) 
Seat 4: KissKopasz ($4.53 in chips) 
Seat 5: DoAlemao ($3.32 in chips) 
Seat 6: Azamat446 ($10.09 in chips) 
drannod: posts small blind $0.02
Jajje7: posts big blind $0.05
*** HOLE CARDS ***
Dealt to HubertusB [Kd 5s]
KissKopasz: folds 
DoAlemao: folds 
Azamat446: folds 
HubertusB: folds 
drannod: folds 
Uncalled bet ($0.03) returned to Jajje7
Jajje7 collected $0.04 from pot
Jajje7: doesn't show hand 
*** SUMMARY ***
Total pot $0.04 | Rake $0 
Seat 1: HubertusB (button) folded before Flop (didn't bet)
Seat 2: drannod (small blind) folded before Flop
Seat 3: Jajje7 (big blind) collected ($0.04)
Seat 4: KissKopasz folded before Flop (didn't bet)
Seat 5: DoAlemao folded before Flop (didn't bet)
Seat 6: Azamat446 folded before Flop (didn't bet)



PokerStars Zoom Hand #177286221377:  Hold'em No Limit ($0.02/$0.05) - 2017/10/24 1:27:03 CCT [2017/10/23 13:27:03 ET]
Table 'Donati' 6-max Seat #1 is the button
Seat 1: Dariev ($10.85 in chips) 
Seat 2: gurugeorge03 ($5 in chips) 
Seat 3: SkierisMaris ($5.66 in chips) 
Seat 4: sakamotoM ($5.51 in chips) 
Seat 5: Tchakka-BRA ($5.32 in chips) 
Seat 6: HubertusB ($7.47 in chips) 
gurugeorge03: posts small blind $0.02
SkierisMaris: posts big blind $0.05
*** HOLE CARDS ***
Dealt to HubertusB [Qc 9h]
sakamotoM: folds 
Tchakka-BRA: raises $0.10 to $0.15
HubertusB: folds 
Dariev: folds 
gurugeorge03: folds 
SkierisMaris: folds 
Uncalled bet ($0.10) returned to Tchakka-BRA
Tchakka-BRA collected $0.12 from pot
Tchakka-BRA: doesn't show hand 
*** SUMMARY ***
Total pot $0.12 | Rake $0 
Seat 1: Dariev (button) folded before Flop (didn't bet)
Seat 2: gurugeorge03 (small blind) folded before Flop
Seat 3: SkierisMaris (big blind) folded before Flop
Seat 4: sakamotoM folded before Flop (didn't bet)
Seat 5: Tchakka-BRA collected ($0.12)
Seat 6: HubertusB folded before Flop (didn't bet)



PokerStars Zoom Hand #177286236477:  Hold'em No Limit ($0.02/$0.05) - 2017/10/24 1:27:23 CCT [2017/10/23 13:27:23 ET]
Table 'Donati' 6-max Seat #1 is the button
Seat 1: gurugeorge03 ($5.07 in chips) 
Seat 2: P0KERB0Y ($6.25 in chips) 
Seat 3: Sarmatrus79 ($5.31 in chips) 
Seat 4: 500Ang ($6.37 in chips) 
Seat 5: Yarvolod ($5 in chips) 
Seat 6: HubertusB ($7.45 in chips) 
P0KERB0Y: posts small blind $0.02
Sarmatrus79: posts big blind $0.05
*** HOLE CARDS ***
Dealt to HubertusB [3s Kc]
500Ang: raises $0.10 to $0.15
Yarvolod: folds 
HubertusB: folds 
gurugeorge03: folds 
P0KERB0Y: folds 
Sarmatrus79: folds 
Uncalled bet ($0.10) returned to 500Ang
500Ang collected $0.12 from pot
500Ang: doesn't show hand 
*** SUMMARY ***
Total pot $0.12 | Rake $0 
Seat 1: gurugeorge03 (button) folded before Flop (didn't bet)
Seat 2: P0KERB0Y (small blind) folded before Flop
Seat 3: Sarmatrus79 (big blind) folded before Flop
Seat 4: 500Ang collected ($0.12)
Seat 5: Yarvolod folded before Flop (didn't bet)
Seat 6: HubertusB folded before Flop (didn't bet)



PokerStars Zoom Hand #177286232615:  Hold'em No Limit ($0.02/$0.05) - 2017/10/24 1:27:17 CCT [2017/10/23 13:27:17 ET]
Table 'Donati' 6-max Seat #1 is the button
Seat 1: nathaniel158 ($16.41 in chips) 
Seat 2: HubertusB ($7.47 in chips) 
Seat 3: alienhack ($23.43 in chips) 
Seat 4: R2R2806 ($5.02 in chips) 
Seat 5: fleassca ($11.71 in chips) 
Seat 6: Morgot339 ($5 in chips) 
HubertusB: posts small blind $0.02
alienhack: posts big blind $0.05
*** HOLE CARDS ***
Dealt to HubertusB [3s 8c]
R2R2806: folds 
fleassca: raises $0.10 to $0.15
Morgot339: folds 
nathaniel158: folds 
HubertusB: folds 
alienhack: folds 
Uncalled bet ($0.10) returned to fleassca
fleassca collected $0.12 from pot
fleassca: doesn't show hand 
*** SUMMARY ***
Total pot $0.12 | Rake $0 
Seat 1: nathaniel158 (button) folded before Flop (didn't bet)
Seat 2: HubertusB (small blind) folded before Flop
Seat 3: alienhack (big blind) folded before Flop
Seat 4: R2R2806 folded before Flop (didn't bet)
Seat 5: fleassca collected ($0.12)
Seat 6: Morgot339 folded before Flop (didn't bet)



PokerStars Zoom Hand #177286243350:  Hold'em No Limit ($0.02/$0.05) - 2017/10/24 1:27:32 CCT [2017/10/23 13:27:32 ET]
Table 'Donati' 6-max Seat #1 is the button
Seat 1: avraam84 ($9.81 in chips) 
Seat 2: Synelnikoff ($4.77 in chips) 
Seat 3: mst6 ($5.71 in chips) 
Seat 4: HubertusB ($7.45 in chips) 
Seat 5: CrazyFar ($4.95 in chips) 
Seat 6: HankChin822 ($6.41 in chips) 
Synelnikoff: posts small blind $0.02
mst6: posts big blind $0.05
*** HOLE CARDS ***
Dealt to HubertusB [9s 9d]
HubertusB: raises $0.05 to $0.10
CrazyFar: folds 
HankChin822: folds 
avraam84: folds 
Synelnikoff: folds 
mst6: folds 
Uncalled bet ($0.05) returned to HubertusB
HubertusB collected $0.12 from pot
HubertusB: doesn't show hand 
*** SUMMARY ***
Total pot $0.12 | Rake $0 
Seat 1: avraam84 (button) folded before Flop (didn't bet)
Seat 2: Synelnikoff (small blind) folded before Flop
Seat 3: mst6 (big blind) folded before Flop
Seat 4: HubertusB collected ($0.12)
Seat 5: CrazyFar folded before Flop (didn't bet)
Seat 6: HankChin822 folded before Flop (didn't bet)



PokerStars Zoom Hand #177286224436:  Hold'em No Limit ($0.02/$0.05) - 2017/10/24 1:27:07 CCT [2017/10/23 13:27:07 ET]
Table 'Donati' 6-max Seat #1 is the button
Seat 1: alex50k ($5.18 in chips) 
Seat 2: ALEX270483 ($7.47 in chips) 
Seat 3: sakamotoM ($5.51 in chips) 
Seat 4: Ignite13 ($12.26 in chips) 
Seat 5: HubertusB ($7.47 in chips) 
Seat 6: ralle0505 ($3.25 in chips) 
ALEX270483: posts small blind $0.02
sakamotoM: posts big blind $0.05
*** HOLE CARDS ***
Dealt to HubertusB [5h Js]
Ignite13: raises $0.10 to $0.15
HubertusB: folds 
ralle0505: folds 
alex50k: folds 
ALEX270483: calls $0.13
sakamotoM: folds 
*** FLOP *** [Ks 6d 3s]
ALEX270483: checks 
Ignite13: checks 
*** TURN *** [Ks 6d 3s] [Qs]
ALEX270483: checks 
Ignite13: bets $0.25
ALEX270483: calls $0.25
*** RIVER *** [Ks 6d 3s Qs] [Tc]
ALEX270483: checks 
Ignite13: bets $0.60
ALEX270483: folds 
Uncalled bet ($0.60) returned to Ignite13
Ignite13 collected $0.81 from pot
Ignite13: doesn't show hand 
*** SUMMARY ***
Total pot $0.85 | Rake $0.04 
Board [Ks 6d 3s Qs Tc]
Seat 1: alex50k (button) folded before Flop (didn't bet)
Seat 2: ALEX270483 (small blind) folded on the River
Seat 3: sakamotoM (big blind) folded before Flop
Seat 4: Ignite13 collected ($0.81)
Seat 5: HubertusB folded before Flop (didn't bet)
Seat 6: ralle0505 folded before Flop (didn't bet)



PokerStars Zoom Hand #177286253197:  Hold'em No Limit ($0.02/$0.05) - 2017/10/24 1:27:45 CCT [2017/10/23 13:27:45 ET]
Table 'Donati' 6-max Seat #1 is the button
Seat 1: Stijn3434 ($6.91 in chips) 
Seat 2: tintones ($5.02 in chips) 
Seat 3: HubertusB ($7.52 in chips) 
Seat 4: WisherBG ($5.26 in chips) 
Seat 5: Onsailc ($5 in chips) 
Seat 6: prochy1909 ($30.88 in chips) 
tintones: posts small blind $0.02
HubertusB: posts big blind $0.05
*** HOLE CARDS ***
Dealt to HubertusB [6h Jd]
WisherBG: folds 
Onsailc: folds 
prochy1909: folds 
Stijn3434: raises $0.10 to $0.15
tintones: folds 
HubertusB: folds 
Uncalled bet ($0.10) returned to Stijn3434
Stijn3434 collected $0.12 from pot
Stijn3434: doesn't show hand 
*** SUMMARY ***
Total pot $0.12 | Rake $0 
Seat 1: Stijn3434 (button) collected ($0.12)
Seat 2: tintones (small blind) folded before Flop
Seat 3: HubertusB (big blind) folded before Flop
Seat 4: WisherBG folded before Flop (didn't bet)
Seat 5: Onsailc folded before Flop (didn't bet)
Seat 6: prochy1909 folded before Flop (didn't bet)



PokerStars Zoom Hand #177286240277:  Hold'em No Limit ($0.02/$0.05) - 2017/10/24 1:27:27 CCT [2017/10/23 13:27:27 ET]
Table 'Donati' 6-max Seat #1 is the button
Seat 1: Ace Vinotnto ($6.75 in chips) 
Seat 2: prochy1909 ($21.93 in chips) 
Seat 3: ooiaooao ($28.98 in chips) 
Seat 4: FarFromFish ($6.81 in chips) 
Seat 5: HubertusB ($7.45 in chips) 
Seat 6: JTbukowski ($4.03 in chips) 
prochy1909: posts small blind $0.02
ooiaooao: posts big blind $0.05
*** HOLE CARDS ***
Dealt to HubertusB [9c 6d]
FarFromFish: raises $0.10 to $0.15
HubertusB: folds 
JTbukowski: calls $0.15
Ace Vinotnto: folds 
prochy1909: folds 
ooiaooao: folds 
*** FLOP *** [5d Th 4s]
FarFromFish: bets $0.17
JTbukowski: calls $0.17
*** TURN *** [5d Th 4s] [9h]
FarFromFish: checks 
JTbukowski: checks 
*** RIVER *** [5d Th 4s 9h] [5s]
FarFromFish: checks 
JTbukowski: checks 
*** SHOW DOWN ***
FarFromFish: shows [7c 7h] (two pair, Sevens and Fives)
JTbukowski: mucks hand 
FarFromFish collected $0.68 from pot
*** SUMMARY ***
Total pot $0.71 | Rake $0.03 
Board [5d Th 4s 9h 5s]
Seat 1: Ace Vinotnto (button) folded before Flop (didn't bet)
Seat 2: prochy1909 (small blind) folded before Flop
Seat 3: ooiaooao (big blind) folded before Flop
Seat 4: FarFromFish showed [7c 7h] and won ($0.68) with two pair, Sevens and Fives
Seat 5: HubertusB folded before Flop (didn't bet)
Seat 6: JTbukowski mucked [Ah Kh]



PokerStars Zoom Hand #177286262358:  Hold'em No Limit ($0.02/$0.05) - 2017/10/24 1:27:57 CCT [2017/10/23 13:27:57 ET]
Table 'Donati' 6-max Seat #1 is the button
Seat 1: 13addict13 ($12.81 in chips) 
Seat 2: HubertusB ($7.47 in chips) 
Seat 3: pedroaberger ($6.80 in chips) 
Seat 4: MrInTerra ($4.55 in chips) 
Seat 5: ScarantoLeo ($5.20 in chips) 
Seat 6: pagan01 ($16.17 in chips) 
HubertusB: posts small blind $0.02
pedroaberger: posts big blind $0.05
*** HOLE CARDS ***
Dealt to HubertusB [6d Td]
MrInTerra: folds 
ScarantoLeo: folds 
pagan01: raises $0.07 to $0.12
13addict13: folds 
HubertusB: folds 
pedroaberger: folds 
Uncalled bet ($0.07) returned to pagan01
pagan01 collected $0.12 from pot
pagan01: doesn't show hand 
*** SUMMARY ***
Total pot $0.12 | Rake $0 
Seat 1: 13addict13 (button) folded before Flop (didn't bet)
Seat 2: HubertusB (small blind) folded before Flop
Seat 3: pedroaberger (big blind) folded before Flop
Seat 4: MrInTerra folded before Flop (didn't bet)
Seat 5: ScarantoLeo folded before Flop (didn't bet)
Seat 6: pagan01 collected ($0.12)



PokerStars Zoom Hand #177286267654:  Hold'em No Limit ($0.02/$0.05) - 2017/10/24 1:28:04 CCT [2017/10/23 13:28:04 ET]
Table 'Donati' 6-max Seat #1 is the button
Seat 1: HubertusB ($7.45 in chips) 
Seat 2: P0KERB0Y ($6.25 in chips) 
Seat 3: kowal100 ($5.42 in chips) 
Seat 4: DavidR798 ($2.49 in chips) 
Seat 5: luckerStarss ($5.07 in chips) 
Seat 6: filipkost ($6.74 in chips) 
P0KERB0Y: posts small blind $0.02
kowal100: posts big blind $0.05
*** HOLE CARDS ***
Dealt to HubertusB [8s Th]
DavidR798: folds 
luckerStarss: folds 
filipkost: folds 
HubertusB: raises $0.06 to $0.11
P0KERB0Y: raises $0.34 to $0.45
kowal100: folds 
HubertusB: folds 
Uncalled bet ($0.34) returned to P0KERB0Y
P0KERB0Y collected $0.27 from pot
P0KERB0Y: doesn't show hand 
*** SUMMARY ***
Total pot $0.27 | Rake $0 
Seat 1: HubertusB (button) folded before Flop
Seat 2: P0KERB0Y (small blind) collected ($0.27)
Seat 3: kowal100 (big blind) folded before Flop
Seat 4: DavidR798 folded before Flop (didn't bet)
Seat 5: luckerStarss folded before Flop (didn't bet)
Seat 6: filipkost folded before Flop (didn't bet)



PokerStars Zoom Hand #177286258549:  Hold'em No Limit ($0.02/$0.05) - 2017/10/24 1:27:52 CCT [2017/10/23 13:27:52 ET]
Table 'Donati' 6-max Seat #1 is the button
Seat 1: Ronnie9813 ($3.21 in chips) 
Seat 2: gambler71rus ($5.07 in chips) 
Seat 3: chobusina ($7.33 in chips) 
Seat 4: HubertusB ($7.47 in chips) 
Seat 5: Kerberus94 ($5.86 in chips) 
Seat 6: Ignite13 ($5 in chips) 
gambler71rus: posts small blind $0.02
chobusina: posts big blind $0.05
*** HOLE CARDS ***
Dealt to HubertusB [Jd 2d]
HubertusB: folds 
Kerberus94: folds 
Ignite13: folds 
Ronnie9813: raises $0.10 to $0.15
gambler71rus: calls $0.13
chobusina: raises $0.45 to $0.60
Ronnie9813: folds 
gambler71rus: calls $0.45
*** FLOP *** [5h 4c 3h]
gambler71rus: checks 
chobusina: checks 
*** TURN *** [5h 4c 3h] [9s]
gambler71rus: checks 
chobusina: checks 
*** RIVER *** [5h 4c 3h 9s] [3s]
gambler71rus: bets $1.29
chobusina: folds 
Uncalled bet ($1.29) returned to gambler71rus
gambler71rus collected $1.29 from pot
gambler71rus: doesn't show hand 
*** SUMMARY ***
Total pot $1.35 | Rake $0.06 
Board [5h 4c 3h 9s 3s]
Seat 1: Ronnie9813 (button) folded before Flop
Seat 2: gambler71rus (small blind) collected ($1.29)
Seat 3: chobusina (big blind) folded on the River
Seat 4: HubertusB folded before Flop (didn't bet)
Seat 5: Kerberus94 folded before Flop (didn't bet)
Seat 6: Ignite13 folded before Flop (didn't bet)



PokerStars Zoom Hand #177286283759:  Hold'em No Limit ($0.02/$0.05) - 2017/10/24 1:28:25 CCT [2017/10/23 13:28:25 ET]
Table 'Donati' 6-max Seat #1 is the button
Seat 1: kuzebuy ($5.71 in chips) 
Seat 2: eurko6 ($5.15 in chips) 
Seat 3: Dafit83 ($5 in chips) 
Seat 4: KrisDimitrov ($6.43 in chips) 
Seat 5: HubertusB ($7.34 in chips) 
Seat 6: AndreiV34rus ($12.98 in chips) 
eurko6: posts small blind $0.02
Dafit83: posts big blind $0.05
*** HOLE CARDS ***
Dealt to HubertusB [3h 7h]
KrisDimitrov: folds 
HubertusB: folds 
AndreiV34rus: raises $0.07 to $0.12
kuzebuy: folds 
eurko6: folds 
Dafit83: folds 
Uncalled bet ($0.07) returned to AndreiV34rus
AndreiV34rus collected $0.12 from pot
AndreiV34rus: doesn't show hand 
*** SUMMARY ***
Total pot $0.12 | Rake $0 
Seat 1: kuzebuy (button) folded before Flop (didn't bet)
Seat 2: eurko6 (small blind) folded before Flop
Seat 3: Dafit83 (big blind) folded before Flop
Seat 4: KrisDimitrov folded before Flop (didn't bet)
Seat 5: HubertusB folded before Flop (didn't bet)
Seat 6: AndreiV34rus collected ($0.12)



PokerStars Zoom Hand #177286279901:  Hold'em No Limit ($0.02/$0.05) - 2017/10/24 1:28:20 CCT [2017/10/23 13:28:20 ET]
Table 'Donati' 6-max Seat #1 is the button
Seat 1: Lehi423 ($5 in chips) 
Seat 2: Azamat446 ($4.30 in chips) 
Seat 3: komarilio ($8.58 in chips) 
Seat 4: HubertusB ($7.34 in chips) 
Seat 5: serg.kholodn ($7.53 in chips) 
Seat 6: MR.LOCT ($5.94 in chips) 
Azamat446: posts small blind $0.02
komarilio: posts big blind $0.05
*** HOLE CARDS ***
Dealt to HubertusB [5h 4h]
HubertusB: folds 
serg.kholodn: folds 
MR.LOCT: raises $0.10 to $0.15
Lehi423: folds 
Azamat446: folds 
komarilio: calls $0.10
*** FLOP *** [5s Ks 4s]
komarilio: checks 
MR.LOCT: bets $0.30
komarilio: calls $0.30
*** TURN *** [5s Ks 4s] [7s]
komarilio: checks 
MR.LOCT: bets $0.55
komarilio: folds 
Uncalled bet ($0.55) returned to MR.LOCT
MR.LOCT collected $0.88 from pot
MR.LOCT: doesn't show hand 
*** SUMMARY ***
Total pot $0.92 | Rake $0.04 
Board [5s Ks 4s 7s]
Seat 1: Lehi423 (button) folded before Flop (didn't bet)
Seat 2: Azamat446 (small blind) folded before Flop
Seat 3: komarilio (big blind) folded on the Turn
Seat 4: HubertusB folded before Flop (didn't bet)
Seat 5: serg.kholodn folded before Flop (didn't bet)
Seat 6: MR.LOCT collected ($0.88)



PokerStars Zoom Hand #177286287434:  Hold'em No Limit ($0.02/$0.05) - 2017/10/24 1:28:30 CCT [2017/10/23 13:28:30 ET]
Table 'Donati' 6-max Seat #1 is the button
Seat 1: Nohall-God ($10.72 in chips) 
Seat 2: Makatic ($13.13 in chips) 
Seat 3: HubertusB ($7.34 in chips) 
Seat 4: SardonicusM ($15.67 in chips) 
Seat 5: CrawlForSun ($5 in chips) 
Seat 6: HankChin822 ($6.03 in chips) 
Makatic: posts small blind $0.02
HubertusB: posts big blind $0.05
*** HOLE CARDS ***
Dealt to HubertusB [8d 8c]
SardonicusM: folds 
CrawlForSun: folds 
HankChin822: folds 
Nohall-God: folds 
Makatic: raises $0.10 to $0.15
HubertusB: calls $0.10
*** FLOP *** [3d 4d Ah]
Makatic: bets $0.15
HubertusB: calls $0.15
*** TURN *** [3d 4d Ah] [6d]
Makatic: bets $0.29
HubertusB: calls $0.29
*** RIVER *** [3d 4d Ah 6d] [Th]
Makatic: checks 
HubertusB: checks 
*** SHOW DOWN ***
Makatic: shows [9d 8s] (high card Ace)
HubertusB: shows [8d 8c] (a pair of Eights)
HubertusB collected $1.13 from pot
*** SUMMARY ***
Total pot $1.18 | Rake $0.05 
Board [3d 4d Ah 6d Th]
Seat 1: Nohall-God (button) folded before Flop (didn't bet)
Seat 2: Makatic (small blind) showed [9d 8s] and lost with high card Ace
Seat 3: HubertusB (big blind) showed [8d 8c] and won ($1.13) with a pair of Eights
Seat 4: SardonicusM folded before Flop (didn't bet)
Seat 5: CrawlForSun folded before Flop (didn't bet)
Seat 6: HankChin822 folded before Flop (didn't bet)



PokerStars Zoom Hand #177286325939:  Hold'em No Limit ($0.02/$0.05) - 2017/10/24 1:29:21 CCT [2017/10/23 13:29:21 ET]
Table 'Donati' 6-max Seat #1 is the button
Seat 1: NoBluffs82 ($8.74 in chips) 
Seat 2: HubertusB ($7.88 in chips) 
Seat 3: Alucard5077 ($8.42 in chips) 
Seat 4: Shurik389 ($8.54 in chips) 
Seat 5: Ignite13 ($12.43 in chips) 
Seat 6: 81denis81 ($5 in chips) 
HubertusB: posts small blind $0.02
Alucard5077: posts big blind $0.05
*** HOLE CARDS ***
Dealt to HubertusB [Jd Th]
Shurik389: folds 
Ignite13: raises $0.10 to $0.15
81denis81: folds 
NoBluffs82: folds 
HubertusB: folds 
Alucard5077: folds 
Uncalled bet ($0.10) returned to Ignite13
Ignite13 collected $0.12 from pot
Ignite13: doesn't show hand 
*** SUMMARY ***
Total pot $0.12 | Rake $0 
Seat 1: NoBluffs82 (button) folded before Flop (didn't bet)
Seat 2: HubertusB (small blind) folded before Flop
Seat 3: Alucard5077 (big blind) folded before Flop
Seat 4: Shurik389 folded before Flop (didn't bet)
Seat 5: Ignite13 collected ($0.12)
Seat 6: 81denis81 folded before Flop (didn't bet)



PokerStars Zoom Hand #177286333514:  Hold'em No Limit ($0.02/$0.05) - 2017/10/24 1:29:31 CCT [2017/10/23 13:29:31 ET]
Table 'Donati' 6-max Seat #1 is the button
Seat 1: TitanX1 ($3.24 in chips) 
Seat 2: Romuks33 ($5 in chips) 
Seat 3: HubertusB ($7.86 in chips) 
Seat 4: eraser242 ($9.92 in chips) 
Seat 5: sakamotoM ($5.32 in chips) 
Seat 6: AlexBazMW ($4.93 in chips) 
Romuks33: posts small blind $0.02
HubertusB: posts big blind $0.05
*** HOLE CARDS ***
Dealt to HubertusB [8s 4s]
eraser242: folds 
sakamotoM: folds 
AlexBazMW: raises $0.10 to $0.15
TitanX1: folds 
Romuks33: folds 
HubertusB: folds 
Uncalled bet ($0.10) returned to AlexBazMW
AlexBazMW collected $0.12 from pot
AlexBazMW: doesn't show hand 
*** SUMMARY ***
Total pot $0.12 | Rake $0 
Seat 1: TitanX1 (button) folded before Flop (didn't bet)
Seat 2: Romuks33 (small blind) folded before Flop
Seat 3: HubertusB (big blind) folded before Flop
Seat 4: eraser242 folded before Flop (didn't bet)
Seat 5: sakamotoM folded before Flop (didn't bet)
Seat 6: AlexBazMW collected ($0.12)



PokerStars Zoom Hand #177286322896:  Hold'em No Limit ($0.02/$0.05) - 2017/10/24 1:29:17 CCT [2017/10/23 13:29:17 ET]
Table 'Donati' 6-max Seat #1 is the button
Seat 1: Makatic ($12.54 in chips) 
Seat 2: Bal87 ($5.28 in chips) 
Seat 3: Brosssea ($12.51 in chips) 
Seat 4: HubertusB ($7.88 in chips) 
Seat 5: eurko6 ($5.24 in chips) 
Seat 6: Kroll74 ($2.43 in chips) 
Bal87: posts small blind $0.02
Brosssea: posts big blind $0.05
*** HOLE CARDS ***
Dealt to HubertusB [8d 9s]
HubertusB: folds 
eurko6: folds 
Kroll74: calls $0.05
Makatic: folds 
Bal87: calls $0.03
Brosssea: checks 
*** FLOP *** [3s 5h Js]
Bal87: checks 
Brosssea: checks 
Kroll74: bets $0.10
Bal87: folds 
Brosssea: folds 
Uncalled bet ($0.10) returned to Kroll74
Kroll74 collected $0.14 from pot
Kroll74: doesn't show hand 
*** SUMMARY ***
Total pot $0.15 | Rake $0.01 
Board [3s 5h Js]
Seat 1: Makatic (button) folded before Flop (didn't bet)
Seat 2: Bal87 (small blind) folded on the Flop
Seat 3: Brosssea (big blind) folded on the Flop
Seat 4: HubertusB folded before Flop (didn't bet)
Seat 5: eurko6 folded before Flop (didn't bet)
Seat 6: Kroll74 collected ($0.14)



PokerStars Zoom Hand #177286329769:  Hold'em No Limit ($0.02/$0.05) - 2017/10/24 1:29:26 CCT [2017/10/23 13:29:26 ET]
Table 'Donati' 6-max Seat #1 is the button
Seat 1: Sharavik ($5.44 in chips) 
Seat 2: Kerberus94 ($7.24 in chips) 
Seat 3: coco1157 ($6.38 in chips) 
Seat 4: Luckerly ($9.66 in chips) 
Seat 5: sakamotoM ($5.32 in chips) 
Seat 6: HubertusB ($7.86 in chips) 
Kerberus94: posts small blind $0.02
coco1157: posts big blind $0.05
*** HOLE CARDS ***
Dealt to HubertusB [8s 5h]
Luckerly: folds 
sakamotoM: folds 
HubertusB: folds 
Sharavik: raises $0.05 to $0.10
Kerberus94: folds 
coco1157: calls $0.05
*** FLOP *** [4d 9s Ks]
coco1157: checks 
Sharavik: bets $0.12
coco1157: folds 
Uncalled bet ($0.12) returned to Sharavik
Sharavik collected $0.21 from pot
Sharavik: doesn't show hand 
*** SUMMARY ***
Total pot $0.22 | Rake $0.01 
Board [4d 9s Ks]
Seat 1: Sharavik (button) collected ($0.21)
Seat 2: Kerberus94 (small blind) folded before Flop
Seat 3: coco1157 (big blind) folded on the Flop
Seat 4: Luckerly folded before Flop (didn't bet)
Seat 5: sakamotoM folded before Flop (didn't bet)
Seat 6: HubertusB folded before Flop (didn't bet)



PokerStars Zoom Hand #177286341028:  Hold'em No Limit ($0.02/$0.05) - 2017/10/24 1:29:41 CCT [2017/10/23 13:29:41 ET]
Table 'Donati' 6-max Seat #1 is the button
Seat 1: HubertusB ($7.81 in chips) 
Seat 2: kotopes24 ($5.02 in chips) 
Seat 3: Dariev ($10.63 in chips) 
Seat 4: Krutikova212 ($10 in chips) 
Seat 5: masta_1011 ($5.74 in chips) 
Seat 6: junior_mamon ($4.11 in chips) 
kotopes24: posts small blind $0.02
Dariev: posts big blind $0.05
*** HOLE CARDS ***
Dealt to HubertusB [7c 2h]
Krutikova212: folds 
masta_1011: folds 
junior_mamon: raises $0.12 to $0.17
HubertusB: folds 
kotopes24: folds 
Dariev: folds 
Uncalled bet ($0.12) returned to junior_mamon
junior_mamon collected $0.12 from pot
junior_mamon: doesn't show hand 
*** SUMMARY ***
Total pot $0.12 | Rake $0 
Seat 1: HubertusB (button) folded before Flop (didn't bet)
Seat 2: kotopes24 (small blind) folded before Flop
Seat 3: Dariev (big blind) folded before Flop
Seat 4: Krutikova212 folded before Flop (didn't bet)
Seat 5: masta_1011 folded before Flop (didn't bet)
Seat 6: junior_mamon collected ($0.12)



PokerStars Zoom Hand #177286344862:  Hold'em No Limit ($0.02/$0.05) - 2017/10/24 1:29:46 CCT [2017/10/23 13:29:46 ET]
Table 'Donati' 6-max Seat #1 is the button
Seat 1: Bal87 ($5.23 in chips) 
Seat 2: Magz(vip) ($6.62 in chips) 
Seat 3: moneykeep ($4.63 in chips) 
Seat 4: kosta455 ($11.22 in chips) 
Seat 5: HubertusB ($7.81 in chips) 
Seat 6: SpaceSpinner ($8.09 in chips) 
Magz(vip): posts small blind $0.02
moneykeep: posts big blind $0.05
*** HOLE CARDS ***
Dealt to HubertusB [6c Kd]
kosta455: folds 
HubertusB: folds 
SpaceSpinner: folds 
Bal87: folds 
Magz(vip): raises $0.07 to $0.12
moneykeep: folds 
Uncalled bet ($0.07) returned to Magz(vip)
Magz(vip) collected $0.10 from pot
Magz(vip): doesn't show hand 
*** SUMMARY ***
Total pot $0.10 | Rake $0 
Seat 1: Bal87 (button) folded before Flop (didn't bet)
Seat 2: Magz(vip) (small blind) collected ($0.10)
Seat 3: moneykeep (big blind) folded before Flop
Seat 4: kosta455 folded before Flop (didn't bet)
Seat 5: HubertusB folded before Flop (didn't bet)
Seat 6: SpaceSpinner folded before Flop (didn't bet)



PokerStars Zoom Hand #177286348644:  Hold'em No Limit ($0.02/$0.05) - 2017/10/24 1:29:51 CCT [2017/10/23 13:29:51 ET]
Table 'Donati' 6-max Seat #1 is the button
Seat 1: EVGENY967 ($2.79 in chips) 
Seat 2: Njaaak666 ($2.58 in chips) 
Seat 3: Faied123 ($8.44 in chips) 
Seat 4: HubertusB ($7.81 in chips) 
Seat 5: Antash.RU ($4.83 in chips) 
Seat 6: thx_donkey ($5 in chips) 
Njaaak666: posts small blind $0.02
Faied123: posts big blind $0.05
*** HOLE CARDS ***
Dealt to HubertusB [6h 4c]
HubertusB: folds 
Antash.RU: folds 
thx_donkey: raises $0.12 to $0.17
EVGENY967: raises $2.62 to $2.79 and is all-in
Njaaak666: folds 
Faied123: folds 
thx_donkey: calls $2.62
*** FLOP *** [8s Qc As]
*** TURN *** [8s Qc As] [2c]
*** RIVER *** [8s Qc As 2c] [Jd]
*** SHOW DOWN ***
thx_donkey: shows [9h 9d] (a pair of Nines)
EVGENY967: shows [Ah Ad] (three of a kind, Aces)
EVGENY967 collected $5.42 from pot
*** SUMMARY ***
Total pot $5.65 | Rake $0.23 
Board [8s Qc As 2c Jd]
Seat 1: EVGENY967 (button) showed [Ah Ad] and won ($5.42) with three of a kind, Aces
Seat 2: Njaaak666 (small blind) folded before Flop
Seat 3: Faied123 (big blind) folded before Flop
Seat 4: HubertusB folded before Flop (didn't bet)
Seat 5: Antash.RU folded before Flop (didn't bet)
Seat 6: thx_donkey showed [9h 9d] and lost with a pair of Nines



PokerStars Zoom Hand #177286353970:  Hold'em No Limit ($0.02/$0.05) - 2017/10/24 1:29:58 CCT [2017/10/23 13:29:58 ET]
Table 'Donati' 6-max Seat #1 is the button
Seat 1: HubertusB ($7.81 in chips) 
Seat 2: sarabskaya ($13.01 in chips) 
Seat 3: Dima Jetta ($5 in chips) 
Seat 4: kailass ($6.18 in chips) 
Seat 5: gbarra2 ($5.24 in chips) 
Seat 6: Ronnie9813 ($2.89 in chips) 
sarabskaya: posts small blind $0.02
Dima Jetta: posts big blind $0.05
*** HOLE CARDS ***
Dealt to HubertusB [6c 3c]
kailass: folds 
gbarra2: folds 
Ronnie9813: folds 
HubertusB: raises $0.05 to $0.10
sarabskaya: folds 
Dima Jetta: calls $0.05
*** FLOP *** [Ks Tc 4c]
Dima Jetta: checks 
HubertusB: bets $0.10
Dima Jetta: calls $0.10
*** TURN *** [Ks Tc 4c] [2c]
Dima Jetta: checks 
HubertusB: bets $0.29
Dima Jetta: folds 
Uncalled bet ($0.29) returned to HubertusB
HubertusB collected $0.40 from pot
HubertusB: doesn't show hand 
*** SUMMARY ***
Total pot $0.42 | Rake $0.02 
Board [Ks Tc 4c 2c]
Seat 1: HubertusB (button) collected ($0.40)
Seat 2: sarabskaya (small blind) folded before Flop
Seat 3: Dima Jetta (big blind) folded on the Turn
Seat 4: kailass folded before Flop (didn't bet)
Seat 5: gbarra2 folded before Flop (didn't bet)
Seat 6: Ronnie9813 folded before Flop (didn't bet)



