PokerStars Zoom Hand #186646214290:  Hold'em No Limit ($0.02/$0.05) - 2018/05/20 21:45:49 CCT [2018/05/20 9:45:49 ET]
Table 'Donati' 6-max Seat #1 is the button
Seat 1: lovre_7 ($5.23 in chips) 
Seat 2: Staz893 ($3.56 in chips) 
Seat 3: HubertusB ($5 in chips) 
Seat 4: benigomu ($5.60 in chips) 
Seat 5: Exclusiveby ($6.32 in chips) 
Seat 6: AKKbank ($2.92 in chips) 
Staz893: posts small blind $0.02
HubertusB: posts big blind $0.05
*** HOLE CARDS ***
Dealt to HubertusB [2h 5s]
benigomu: folds 
Exclusiveby: raises $0.10 to $0.15
AKKbank: folds 
lovre_7: folds 
Staz893: folds 
HubertusB: folds 
Uncalled bet ($0.10) returned to Exclusiveby
Exclusiveby collected $0.12 from pot
Exclusiveby: doesn't show hand 
*** SUMMARY ***
Total pot $0.12 | Rake $0 
Seat 1: lovre_7 (button) folded before Flop (didn't bet)
Seat 2: Staz893 (small blind) folded before Flop
Seat 3: HubertusB (big blind) folded before Flop
Seat 4: benigomu folded before Flop (didn't bet)
Seat 5: Exclusiveby collected ($0.12)
Seat 6: AKKbank folded before Flop (didn't bet)



PokerStars Zoom Hand #186646220650:  Hold'em No Limit ($0.02/$0.05) - 2018/05/20 21:46:00 CCT [2018/05/20 9:46:00 ET]
Table 'Donati' 6-max Seat #1 is the button
Seat 1: withlove14 ($6.14 in chips) 
Seat 2: HubertusB ($4.95 in chips) 
Seat 3: El Hanni ($5.17 in chips) 
Seat 4: QWER7786 ($16.28 in chips) 
Seat 5: Julietta1997 ($4.93 in chips) 
Seat 6: kranovoy22 ($5.69 in chips) 
HubertusB: posts small blind $0.02
El Hanni: posts big blind $0.05
*** HOLE CARDS ***
Dealt to HubertusB [Th Ts]
QWER7786: folds 
Julietta1997: folds 
kranovoy22: folds 
withlove14: folds 
HubertusB: raises $0.10 to $0.15
El Hanni: calls $0.10
*** FLOP *** [6d 4s 3d]
HubertusB: bets $0.15
El Hanni: calls $0.15
*** TURN *** [6d 4s 3d] [Tc]
HubertusB: bets $0.35
El Hanni: folds 
Uncalled bet ($0.35) returned to HubertusB
HubertusB collected $0.58 from pot
HubertusB: doesn't show hand 
*** SUMMARY ***
Total pot $0.60 | Rake $0.02 
Board [6d 4s 3d Tc]
Seat 1: withlove14 (button) folded before Flop (didn't bet)
Seat 2: HubertusB (small blind) collected ($0.58)
Seat 3: El Hanni (big blind) folded on the Turn
Seat 4: QWER7786 folded before Flop (didn't bet)
Seat 5: Julietta1997 folded before Flop (didn't bet)
Seat 6: kranovoy22 folded before Flop (didn't bet)



PokerStars Zoom Hand #186646251976:  Hold'em No Limit ($0.02/$0.05) - 2018/05/20 21:46:53 CCT [2018/05/20 9:46:53 ET]
Table 'Donati' 6-max Seat #1 is the button
Seat 1: HubertusB ($5.23 in chips) 
Seat 2: LQ Wu ($8.89 in chips) 
Seat 3: Petrsberg ($5.11 in chips) 
Seat 4: Omicron333 ($5 in chips) 
Seat 5: tommy9985 ($12.43 in chips) 
Seat 6: Exclusiveby ($9.27 in chips) 
LQ Wu: posts small blind $0.02
Petrsberg: posts big blind $0.05
*** HOLE CARDS ***
Dealt to HubertusB [6h 9d]
Omicron333: folds 
tommy9985: raises $0.10 to $0.15
Exclusiveby: folds 
HubertusB: folds 
LQ Wu: folds 
Petrsberg: folds 
Uncalled bet ($0.10) returned to tommy9985
tommy9985 collected $0.12 from pot
tommy9985: doesn't show hand 
*** SUMMARY ***
Total pot $0.12 | Rake $0 
Seat 1: HubertusB (button) folded before Flop (didn't bet)
Seat 2: LQ Wu (small blind) folded before Flop
Seat 3: Petrsberg (big blind) folded before Flop
Seat 4: Omicron333 folded before Flop (didn't bet)
Seat 5: tommy9985 collected ($0.12)
Seat 6: Exclusiveby folded before Flop (didn't bet)



PokerStars Zoom Hand #186646259184:  Hold'em No Limit ($0.02/$0.05) - 2018/05/20 21:47:05 CCT [2018/05/20 9:47:05 ET]
Table 'Donati' 6-max Seat #1 is the button
Seat 1: poliars ($5 in chips) 
Seat 2: denshark1986 ($5 in chips) 
Seat 3: SPARRER75 ($1.95 in chips) 
Seat 4: And_Camargo ($5.28 in chips) 
Seat 5: Farad84 ($5.55 in chips) 
Seat 6: HubertusB ($5.23 in chips) 
denshark1986: posts small blind $0.02
SPARRER75: posts big blind $0.05
*** HOLE CARDS ***
Dealt to HubertusB [Jc Kc]
And_Camargo: raises $0.10 to $0.15
Farad84: folds 
HubertusB: calls $0.15
poliars: folds 
denshark1986: folds 
SPARRER75: folds 
*** FLOP *** [8d 9s 3h]
And_Camargo: checks 
HubertusB: checks 
*** TURN *** [8d 9s 3h] [Td]
And_Camargo: bets $0.17
HubertusB: calls $0.17
*** RIVER *** [8d 9s 3h Td] [7d]
And_Camargo: checks 
HubertusB: bets $0.35
And_Camargo: folds 
Uncalled bet ($0.35) returned to HubertusB
HubertusB collected $0.68 from pot
HubertusB: doesn't show hand 
*** SUMMARY ***
Total pot $0.71 | Rake $0.03 
Board [8d 9s 3h Td 7d]
Seat 1: poliars (button) folded before Flop (didn't bet)
Seat 2: denshark1986 (small blind) folded before Flop
Seat 3: SPARRER75 (big blind) folded before Flop
Seat 4: And_Camargo folded on the River
Seat 5: Farad84 folded before Flop (didn't bet)
Seat 6: HubertusB collected ($0.68)



PokerStars Zoom Hand #186646298293:  Hold'em No Limit ($0.02/$0.05) - 2018/05/20 21:48:11 CCT [2018/05/20 9:48:11 ET]
Table 'Donati' 6-max Seat #1 is the button
Seat 1: Clubberer80 ($8.47 in chips) 
Seat 2: chris011011 ($3.07 in chips) 
Seat 3: Kozak Sila ($2.44 in chips) 
Seat 4: UltraRunnerr ($7.94 in chips) 
Seat 5: PiNe4ppLe ($5 in chips) 
Seat 6: HubertusB ($5.59 in chips) 
chris011011: posts small blind $0.02
Kozak Sila: posts big blind $0.05
*** HOLE CARDS ***
Dealt to HubertusB [8h 4c]
UltraRunnerr: folds 
PiNe4ppLe: folds 
HubertusB: folds 
Clubberer80: raises $0.07 to $0.12
chris011011: calls $0.10
Kozak Sila: folds 
*** FLOP *** [5d Qs 3d]
chris011011: checks 
Clubberer80: bets $0.28
chris011011: folds 
Uncalled bet ($0.28) returned to Clubberer80
Clubberer80 collected $0.28 from pot
Clubberer80: doesn't show hand 
*** SUMMARY ***
Total pot $0.29 | Rake $0.01 
Board [5d Qs 3d]
Seat 1: Clubberer80 (button) collected ($0.28)
Seat 2: chris011011 (small blind) folded on the Flop
Seat 3: Kozak Sila (big blind) folded before Flop
Seat 4: UltraRunnerr folded before Flop (didn't bet)
Seat 5: PiNe4ppLe folded before Flop (didn't bet)
Seat 6: HubertusB folded before Flop (didn't bet)



PokerStars Zoom Hand #186646301224:  Hold'em No Limit ($0.02/$0.05) - 2018/05/20 21:48:16 CCT [2018/05/20 9:48:16 ET]
Table 'Donati' 6-max Seat #1 is the button
Seat 1: TheFibonachi ($4.02 in chips) 
Seat 2: HubertusB ($5.59 in chips) 
Seat 3: confirmedanc ($5 in chips) 
Seat 4: aitor1282 ($4.95 in chips) 
Seat 5: yurasulaev ($10.05 in chips) 
Seat 6: Ballistic sy ($4.39 in chips) 
HubertusB: posts small blind $0.02
confirmedanc: posts big blind $0.05
*** HOLE CARDS ***
Dealt to HubertusB [5d Ad]
aitor1282: calls $0.05
yurasulaev: folds 
Ballistic sy: folds 
TheFibonachi: folds 
HubertusB: calls $0.03
confirmedanc: checks 
*** FLOP *** [Ks 3h 9h]
HubertusB: checks 
confirmedanc: checks 
aitor1282: checks 
*** TURN *** [Ks 3h 9h] [9s]
HubertusB: checks 
confirmedanc: bets $0.09
aitor1282: folds 
HubertusB: folds 
Uncalled bet ($0.09) returned to confirmedanc
confirmedanc collected $0.14 from pot
confirmedanc: doesn't show hand 
*** SUMMARY ***
Total pot $0.15 | Rake $0.01 
Board [Ks 3h 9h 9s]
Seat 1: TheFibonachi (button) folded before Flop (didn't bet)
Seat 2: HubertusB (small blind) folded on the Turn
Seat 3: confirmedanc (big blind) collected ($0.14)
Seat 4: aitor1282 folded on the Turn
Seat 5: yurasulaev folded before Flop (didn't bet)
Seat 6: Ballistic sy folded before Flop (didn't bet)



PokerStars Zoom Hand #186646332679:  Hold'em No Limit ($0.02/$0.05) - 2018/05/20 21:49:09 CCT [2018/05/20 9:49:09 ET]
Table 'Donati' 6-max Seat #1 is the button
Seat 1: fivestart852 ($5.98 in chips) 
Seat 2: suger309 ($3.28 in chips) 
Seat 3: HubertusB ($5.54 in chips) 
Seat 4: Tuxui y)l(ac ($6.25 in chips) 
Seat 5: Janski90 ($12.83 in chips) 
Seat 6: SpurenIeger ($4.48 in chips) 
suger309: posts small blind $0.02
HubertusB: posts big blind $0.05
*** HOLE CARDS ***
Dealt to HubertusB [Tc Ks]
Tuxui y)l(ac: folds 
Janski90: folds 
SpurenIeger: folds 
fivestart852: raises $0.10 to $0.15
suger309: folds 
HubertusB: folds 
Uncalled bet ($0.10) returned to fivestart852
fivestart852 collected $0.12 from pot
fivestart852: doesn't show hand 
*** SUMMARY ***
Total pot $0.12 | Rake $0 
Seat 1: fivestart852 (button) collected ($0.12)
Seat 2: suger309 (small blind) folded before Flop
Seat 3: HubertusB (big blind) folded before Flop
Seat 4: Tuxui y)l(ac folded before Flop (didn't bet)
Seat 5: Janski90 folded before Flop (didn't bet)
Seat 6: SpurenIeger folded before Flop (didn't bet)



PokerStars Zoom Hand #186646340969:  Hold'em No Limit ($0.02/$0.05) - 2018/05/20 21:49:23 CCT [2018/05/20 9:49:23 ET]
Table 'Donati' 6-max Seat #1 is the button
Seat 1: Salmonnet ($5.79 in chips) 
Seat 2: Farad84 ($8.96 in chips) 
Seat 3: Janski90 ($9.66 in chips) 
Seat 4: xxKRACKxx ($6.36 in chips) 
Seat 5: HubertusB ($5.49 in chips) 
Seat 6: krp4 ($5 in chips) 
Farad84: posts small blind $0.02
Janski90: posts big blind $0.05
*** HOLE CARDS ***
Dealt to HubertusB [8h Kh]
xxKRACKxx: folds 
HubertusB: raises $0.10 to $0.15
krp4: folds 
Salmonnet: folds 
Farad84: folds 
Janski90: folds 
Uncalled bet ($0.10) returned to HubertusB
HubertusB collected $0.12 from pot
HubertusB: doesn't show hand 
*** SUMMARY ***
Total pot $0.12 | Rake $0 
Seat 1: Salmonnet (button) folded before Flop (didn't bet)
Seat 2: Farad84 (small blind) folded before Flop
Seat 3: Janski90 (big blind) folded before Flop
Seat 4: xxKRACKxx folded before Flop (didn't bet)
Seat 5: HubertusB collected ($0.12)
Seat 6: krp4 folded before Flop (didn't bet)



PokerStars Zoom Hand #186646356869:  Hold'em No Limit ($0.02/$0.05) - 2018/05/20 21:49:50 CCT [2018/05/20 9:49:50 ET]
Table 'Donati' 6-max Seat #1 is the button
Seat 1: Guernik ($5 in chips) 
Seat 2: GyNy1976 ($10.41 in chips) 
Seat 3: Alexxxo123 ($2.31 in chips) 
Seat 4: HubertusB ($5.56 in chips) 
Seat 5: thefr1ze ($7.02 in chips) 
Seat 6: kranovoy22 ($8.22 in chips) 
GyNy1976: posts small blind $0.02
Alexxxo123: posts big blind $0.05
*** HOLE CARDS ***
Dealt to HubertusB [3d 2s]
HubertusB: folds 
thefr1ze: folds 
kranovoy22: raises $0.07 to $0.12
Guernik: folds 
GyNy1976: folds 
Alexxxo123: folds 
Uncalled bet ($0.07) returned to kranovoy22
kranovoy22 collected $0.12 from pot
kranovoy22: doesn't show hand 
*** SUMMARY ***
Total pot $0.12 | Rake $0 
Seat 1: Guernik (button) folded before Flop (didn't bet)
Seat 2: GyNy1976 (small blind) folded before Flop
Seat 3: Alexxxo123 (big blind) folded before Flop
Seat 4: HubertusB folded before Flop (didn't bet)
Seat 5: thefr1ze folded before Flop (didn't bet)
Seat 6: kranovoy22 collected ($0.12)



PokerStars Zoom Hand #186646350427:  Hold'em No Limit ($0.02/$0.05) - 2018/05/20 21:49:39 CCT [2018/05/20 9:49:39 ET]
Table 'Donati' 6-max Seat #1 is the button
Seat 1: LQ Wu ($7.89 in chips) 
Seat 2: barbos2009 ($17.33 in chips) 
Seat 3: djnemesis101 ($13.72 in chips) 
Seat 4: BeatLimits ($5.22 in chips) 
Seat 5: HubertusB ($5.56 in chips) 
Seat 6: Romzes V ($5.07 in chips) 
barbos2009: posts small blind $0.02
djnemesis101: posts big blind $0.05
*** HOLE CARDS ***
Dealt to HubertusB [Kc 5d]
BeatLimits: folds 
HubertusB: folds 
Romzes V: folds 
LQ Wu: raises $0.10 to $0.15
barbos2009: calls $0.13
djnemesis101: calls $0.10
*** FLOP *** [7d Qc 3h]
barbos2009: checks 
djnemesis101: bets $0.26
LQ Wu: folds 
barbos2009: folds 
Uncalled bet ($0.26) returned to djnemesis101
djnemesis101 collected $0.43 from pot
djnemesis101: doesn't show hand 
*** SUMMARY ***
Total pot $0.45 | Rake $0.02 
Board [7d Qc 3h]
Seat 1: LQ Wu (button) folded on the Flop
Seat 2: barbos2009 (small blind) folded on the Flop
Seat 3: djnemesis101 (big blind) collected ($0.43)
Seat 4: BeatLimits folded before Flop (didn't bet)
Seat 5: HubertusB folded before Flop (didn't bet)
Seat 6: Romzes V folded before Flop (didn't bet)



PokerStars Zoom Hand #186646360374:  Hold'em No Limit ($0.02/$0.05) - 2018/05/20 21:49:56 CCT [2018/05/20 9:49:56 ET]
Table 'Donati' 6-max Seat #1 is the button
Seat 1: qperept ($2.50 in chips) 
Seat 2: And_Camargo ($5 in chips) 
Seat 3: barbos2009 ($27.27 in chips) 
Seat 4: ali3nt0mmy ($5.69 in chips) 
Seat 5: Voki871 ($5.25 in chips) 
Seat 6: HubertusB ($5.56 in chips) 
And_Camargo: posts small blind $0.02
barbos2009: posts big blind $0.05
*** HOLE CARDS ***
Dealt to HubertusB [9d 2h]
ali3nt0mmy: folds 
Voki871: raises $0.12 to $0.17
HubertusB: folds 
qperept: folds 
And_Camargo: folds 
barbos2009: folds 
Uncalled bet ($0.12) returned to Voki871
Voki871 collected $0.12 from pot
Voki871: doesn't show hand 
*** SUMMARY ***
Total pot $0.12 | Rake $0 
Seat 1: qperept (button) folded before Flop (didn't bet)
Seat 2: And_Camargo (small blind) folded before Flop
Seat 3: barbos2009 (big blind) folded before Flop
Seat 4: ali3nt0mmy folded before Flop (didn't bet)
Seat 5: Voki871 collected ($0.12)
Seat 6: HubertusB folded before Flop (didn't bet)



PokerStars Zoom Hand #186646353943:  Hold'em No Limit ($0.02/$0.05) - 2018/05/20 21:49:45 CCT [2018/05/20 9:49:45 ET]
Table 'Donati' 6-max Seat #1 is the button
Seat 1: HubertusB ($5.56 in chips) 
Seat 2: Azeng1994 ($7.83 in chips) 
Seat 3: alone.le ($4.26 in chips) 
Seat 4: umekichi88 ($3.91 in chips) 
Seat 5: NFS-BA ($9.45 in chips) 
Seat 6: BoSs00 ($6.83 in chips) 
Azeng1994: posts small blind $0.02
alone.le: posts big blind $0.05
*** HOLE CARDS ***
Dealt to HubertusB [3h 8c]
umekichi88: raises $0.10 to $0.15
NFS-BA: raises $0.40 to $0.55
BoSs00: folds 
HubertusB: folds 
Azeng1994: folds 
alone.le: folds 
umekichi88: folds 
Uncalled bet ($0.40) returned to NFS-BA
NFS-BA collected $0.37 from pot
NFS-BA: doesn't show hand 
*** SUMMARY ***
Total pot $0.37 | Rake $0 
Seat 1: HubertusB (button) folded before Flop (didn't bet)
Seat 2: Azeng1994 (small blind) folded before Flop
Seat 3: alone.le (big blind) folded before Flop
Seat 4: umekichi88 folded before Flop
Seat 5: NFS-BA collected ($0.37)
Seat 6: BoSs00 folded before Flop (didn't bet)



PokerStars Zoom Hand #186646363380:  Hold'em No Limit ($0.02/$0.05) - 2018/05/20 21:50:01 CCT [2018/05/20 9:50:01 ET]
Table 'Donati' 6-max Seat #1 is the button
Seat 1: eSSayL65 ($12.91 in chips) 
Seat 2: Kaizenja ($7.38 in chips) 
Seat 3: HubertusB ($5.56 in chips) 
Seat 4: E.Danilkin ($6.04 in chips) 
Seat 5: Snowy1984C ($5 in chips) 
Seat 6: KurpatovX ($7.59 in chips) 
Kaizenja: posts small blind $0.02
HubertusB: posts big blind $0.05
*** HOLE CARDS ***
Dealt to HubertusB [Kc Js]
E.Danilkin: folds 
Snowy1984C: folds 
KurpatovX: folds 
eSSayL65: calls $0.05
Kaizenja: raises $0.05 to $0.10
HubertusB: calls $0.05
eSSayL65: calls $0.05
*** FLOP *** [6h 2d 7h]
Kaizenja: bets $0.10
HubertusB: folds 
eSSayL65: folds 
Uncalled bet ($0.10) returned to Kaizenja
Kaizenja collected $0.29 from pot
Kaizenja: doesn't show hand 
*** SUMMARY ***
Total pot $0.30 | Rake $0.01 
Board [6h 2d 7h]
Seat 1: eSSayL65 (button) folded on the Flop
Seat 2: Kaizenja (small blind) collected ($0.29)
Seat 3: HubertusB (big blind) folded on the Flop
Seat 4: E.Danilkin folded before Flop (didn't bet)
Seat 5: Snowy1984C folded before Flop (didn't bet)
Seat 6: KurpatovX folded before Flop (didn't bet)



PokerStars Zoom Hand #186646374109:  Hold'em No Limit ($0.02/$0.05) - 2018/05/20 21:50:19 CCT [2018/05/20 9:50:19 ET]
Table 'Donati' 6-max Seat #1 is the button
Seat 1: confirmedanc ($5 in chips) 
Seat 2: HubertusB ($5.46 in chips) 
Seat 3: Guernik ($5 in chips) 
Seat 4: Krawicz ($5.23 in chips) 
Seat 5: haqpod ($5 in chips) 
Seat 6: 3btm ($5.05 in chips) 
HubertusB: posts small blind $0.02
Guernik: posts big blind $0.05
*** HOLE CARDS ***
Dealt to HubertusB [9d Tc]
Krawicz: folds 
haqpod: folds 
3btm: folds 
confirmedanc: raises $0.10 to $0.15
HubertusB: folds 
Guernik: folds 
Uncalled bet ($0.10) returned to confirmedanc
confirmedanc collected $0.12 from pot
confirmedanc: doesn't show hand 
*** SUMMARY ***
Total pot $0.12 | Rake $0 
Seat 1: confirmedanc (button) collected ($0.12)
Seat 2: HubertusB (small blind) folded before Flop
Seat 3: Guernik (big blind) folded before Flop
Seat 4: Krawicz folded before Flop (didn't bet)
Seat 5: haqpod folded before Flop (didn't bet)
Seat 6: 3btm folded before Flop (didn't bet)



PokerStars Zoom Hand #186646384759:  Hold'em No Limit ($0.02/$0.05) - 2018/05/20 21:50:37 CCT [2018/05/20 9:50:37 ET]
Table 'Donati' 6-max Seat #1 is the button
Seat 1: emanuelbecke ($4.66 in chips) 
Seat 2: confirmedanc ($6.04 in chips) 
Seat 3: jeffpig16 ($6.25 in chips) 
Seat 4: an2004 ($5 in chips) 
Seat 5: HubertusB ($5.44 in chips) 
Seat 6: xPeja ($5.05 in chips) 
confirmedanc: posts small blind $0.02
jeffpig16: posts big blind $0.05
*** HOLE CARDS ***
Dealt to HubertusB [As Ac]
an2004: folds 
HubertusB: raises $0.10 to $0.15
xPeja: folds 
emanuelbecke: folds 
confirmedanc: folds 
jeffpig16: folds 
Uncalled bet ($0.10) returned to HubertusB
HubertusB collected $0.12 from pot
HubertusB: doesn't show hand 
*** SUMMARY ***
Total pot $0.12 | Rake $0 
Seat 1: emanuelbecke (button) folded before Flop (didn't bet)
Seat 2: confirmedanc (small blind) folded before Flop
Seat 3: jeffpig16 (big blind) folded before Flop
Seat 4: an2004 folded before Flop (didn't bet)
Seat 5: HubertusB collected ($0.12)
Seat 6: xPeja folded before Flop (didn't bet)



PokerStars Zoom Hand #186646397144:  Hold'em No Limit ($0.02/$0.05) - 2018/05/20 21:50:58 CCT [2018/05/20 9:50:58 ET]
Table 'Donati' 6-max Seat #1 is the button
Seat 1: kot2772 ($6.32 in chips) 
Seat 2: kranovoy22 ($5.38 in chips) 
Seat 3: Janski90 ($7.21 in chips) 
Seat 4: RMESCU878 ($2.36 in chips) 
Seat 5: HubertusB ($5.51 in chips) 
Seat 6: Exclusiveby ($10.32 in chips) 
kranovoy22: posts small blind $0.02
Janski90: posts big blind $0.05
*** HOLE CARDS ***
Dealt to HubertusB [5s Ah]
RMESCU878: folds 
HubertusB: folds 
Exclusiveby: folds 
kot2772: folds 
kranovoy22: raises $0.07 to $0.12
Janski90: folds 
Uncalled bet ($0.07) returned to kranovoy22
kranovoy22 collected $0.10 from pot
kranovoy22: doesn't show hand 
*** SUMMARY ***
Total pot $0.10 | Rake $0 
Seat 1: kot2772 (button) folded before Flop (didn't bet)
Seat 2: kranovoy22 (small blind) collected ($0.10)
Seat 3: Janski90 (big blind) folded before Flop
Seat 4: RMESCU878 folded before Flop (didn't bet)
Seat 5: HubertusB folded before Flop (didn't bet)
Seat 6: Exclusiveby folded before Flop (didn't bet)



PokerStars Zoom Hand #186646400658:  Hold'em No Limit ($0.02/$0.05) - 2018/05/20 21:51:04 CCT [2018/05/20 9:51:04 ET]
Table 'Donati' 6-max Seat #1 is the button
Seat 1: cbiscuit1127 ($5.66 in chips) 
Seat 2: lzoflamingo ($4.75 in chips) 
Seat 3: Boba1888 ($5.68 in chips) 
Seat 4: HubertusB ($5.51 in chips) 
Seat 5: xxKRACKxx ($10.96 in chips) 
Seat 6: tatarin896 ($4.20 in chips) 
lzoflamingo: posts small blind $0.02
Boba1888: posts big blind $0.05
*** HOLE CARDS ***
Dealt to HubertusB [2h 3h]
HubertusB: folds 
xxKRACKxx: folds 
tatarin896: folds 
cbiscuit1127: raises $0.10 to $0.15
lzoflamingo: folds 
Boba1888: folds 
Uncalled bet ($0.10) returned to cbiscuit1127
cbiscuit1127 collected $0.12 from pot
cbiscuit1127: doesn't show hand 
*** SUMMARY ***
Total pot $0.12 | Rake $0 
Seat 1: cbiscuit1127 (button) collected ($0.12)
Seat 2: lzoflamingo (small blind) folded before Flop
Seat 3: Boba1888 (big blind) folded before Flop
Seat 4: HubertusB folded before Flop (didn't bet)
Seat 5: xxKRACKxx folded before Flop (didn't bet)
Seat 6: tatarin896 folded before Flop (didn't bet)



PokerStars Zoom Hand #186646381789:  Hold'em No Limit ($0.02/$0.05) - 2018/05/20 21:50:32 CCT [2018/05/20 9:50:32 ET]
Table 'Donati' 6-max Seat #1 is the button
Seat 1: HubertusB ($5.44 in chips) 
Seat 2: emalfa ($4.92 in chips) 
Seat 3: thekvlt ($5 in chips) 
Seat 4: MinouXYZ ($10.78 in chips) 
Seat 5: kranovoy22 ($5.36 in chips) 
Seat 6: krp4 ($5.02 in chips) 
emalfa: posts small blind $0.02
thekvlt: posts big blind $0.05
*** HOLE CARDS ***
Dealt to HubertusB [3s 5d]
MinouXYZ: folds 
kranovoy22: folds 
krp4: folds 
HubertusB: folds 
emalfa: calls $0.03
thekvlt: checks 
*** FLOP *** [6c 8d 6h]
emalfa: checks 
thekvlt: checks 
*** TURN *** [6c 8d 6h] [8h]
emalfa: bets $0.05
thekvlt: calls $0.05
*** RIVER *** [6c 8d 6h 8h] [2d]
emalfa: checks 
thekvlt: checks 
*** SHOW DOWN ***
emalfa: shows [3d Ad] (two pair, Eights and Sixes)
thekvlt: mucks hand 
emalfa collected $0.19 from pot
*** SUMMARY ***
Total pot $0.20 | Rake $0.01 
Board [6c 8d 6h 8h 2d]
Seat 1: HubertusB (button) folded before Flop (didn't bet)
Seat 2: emalfa (small blind) showed [3d Ad] and won ($0.19) with two pair, Eights and Sixes
Seat 3: thekvlt (big blind) mucked [Td Js]
Seat 4: MinouXYZ folded before Flop (didn't bet)
Seat 5: kranovoy22 folded before Flop (didn't bet)
Seat 6: krp4 folded before Flop (didn't bet)



PokerStars Zoom Hand #186646403583:  Hold'em No Limit ($0.02/$0.05) - 2018/05/20 21:51:09 CCT [2018/05/20 9:51:09 ET]
Table 'Donati' 6-max Seat #1 is the button
Seat 1: HubertusB ($5.51 in chips) 
Seat 2: TheLawyer73 ($12.09 in chips) 
Seat 3: limone314 ($5 in chips) 
Seat 4: El Hanni ($6.65 in chips) 
Seat 5: thefr1ze ($21.40 in chips) 
Seat 6: grunge&punk ($6.50 in chips) 
TheLawyer73: posts small blind $0.02
limone314: posts big blind $0.05
*** HOLE CARDS ***
Dealt to HubertusB [Th 5s]
El Hanni: folds 
thefr1ze: folds 
grunge&punk: folds 
HubertusB: folds 
TheLawyer73: folds 
Uncalled bet ($0.03) returned to limone314
limone314 collected $0.04 from pot
limone314: doesn't show hand 
*** SUMMARY ***
Total pot $0.04 | Rake $0 
Seat 1: HubertusB (button) folded before Flop (didn't bet)
Seat 2: TheLawyer73 (small blind) folded before Flop
Seat 3: limone314 (big blind) collected ($0.04)
Seat 4: El Hanni folded before Flop (didn't bet)
Seat 5: thefr1ze folded before Flop (didn't bet)
Seat 6: grunge&punk folded before Flop (didn't bet)



PokerStars Zoom Hand #186646408860:  Hold'em No Limit ($0.02/$0.05) - 2018/05/20 21:51:18 CCT [2018/05/20 9:51:18 ET]
Table 'Donati' 6-max Seat #1 is the button
Seat 1: Farad84 ($5 in chips) 
Seat 2: Roman197430 ($5.48 in chips) 
Seat 3: HubertusB ($5.51 in chips) 
Seat 4: Urisdep ($5.02 in chips) 
Seat 5: BigCat16Max ($4.89 in chips) 
Seat 6: Croo633 ($5 in chips) 
Roman197430: posts small blind $0.02
HubertusB: posts big blind $0.05
*** HOLE CARDS ***
Dealt to HubertusB [Ah 2h]
Urisdep: folds 
BigCat16Max: folds 
Croo633: folds 
Farad84: raises $0.05 to $0.10
Roman197430: folds 
HubertusB: raises $0.30 to $0.40
Farad84: folds 
Uncalled bet ($0.30) returned to HubertusB
HubertusB collected $0.22 from pot
HubertusB: doesn't show hand 
*** SUMMARY ***
Total pot $0.22 | Rake $0 
Seat 1: Farad84 (button) folded before Flop
Seat 2: Roman197430 (small blind) folded before Flop
Seat 3: HubertusB (big blind) collected ($0.22)
Seat 4: Urisdep folded before Flop (didn't bet)
Seat 5: BigCat16Max folded before Flop (didn't bet)
Seat 6: Croo633 folded before Flop (didn't bet)



PokerStars Zoom Hand #186646425717:  Hold'em No Limit ($0.02/$0.05) - 2018/05/20 21:51:47 CCT [2018/05/20 9:51:47 ET]
Table 'Donati' 6-max Seat #1 is the button
Seat 1: krp4 ($5.01 in chips) 
Seat 2: $ir_AleXXX ($5.20 in chips) 
Seat 3: denshark1986 ($4.72 in chips) 
Seat 4: HubertusB ($5.61 in chips) 
Seat 5: incorrect88 ($7.03 in chips) 
Seat 6: LingPro ($5.27 in chips) 
$ir_AleXXX: posts small blind $0.02
denshark1986: posts big blind $0.05
*** HOLE CARDS ***
Dealt to HubertusB [3s 2h]
HubertusB: folds 
incorrect88: folds 
LingPro: raises $0.05 to $0.10
krp4: folds 
$ir_AleXXX: folds 
denshark1986: folds 
Uncalled bet ($0.05) returned to LingPro
LingPro collected $0.12 from pot
LingPro: doesn't show hand 
*** SUMMARY ***
Total pot $0.12 | Rake $0 
Seat 1: krp4 (button) folded before Flop (didn't bet)
Seat 2: $ir_AleXXX (small blind) folded before Flop
Seat 3: denshark1986 (big blind) folded before Flop
Seat 4: HubertusB folded before Flop (didn't bet)
Seat 5: incorrect88 folded before Flop (didn't bet)
Seat 6: LingPro collected ($0.12)



PokerStars Zoom Hand #186646419325:  Hold'em No Limit ($0.02/$0.05) - 2018/05/20 21:51:36 CCT [2018/05/20 9:51:36 ET]
Table 'Donati' 6-max Seat #1 is the button
Seat 1: vitaha00007 ($10.23 in chips) 
Seat 2: HubertusB ($5.63 in chips) 
Seat 3: an2004 ($5 in chips) 
Seat 4: scels111 ($5.74 in chips) 
Seat 5: ramilsh91 ($8.78 in chips) 
Seat 6: Exclusiveby ($6.40 in chips) 
HubertusB: posts small blind $0.02
an2004: posts big blind $0.05
*** HOLE CARDS ***
Dealt to HubertusB [6s Kd]
scels111: calls $0.05
ramilsh91: folds 
Exclusiveby: folds 
vitaha00007: folds 
HubertusB: folds 
an2004: checks 
*** FLOP *** [Ad 6c Ah]
an2004: checks 
scels111: checks 
*** TURN *** [Ad 6c Ah] [7s]
an2004: checks 
scels111: bets $0.05
an2004: folds 
Uncalled bet ($0.05) returned to scels111
scels111 collected $0.12 from pot
scels111: doesn't show hand 
*** SUMMARY ***
Total pot $0.12 | Rake $0 
Board [Ad 6c Ah 7s]
Seat 1: vitaha00007 (button) folded before Flop (didn't bet)
Seat 2: HubertusB (small blind) folded before Flop
Seat 3: an2004 (big blind) folded on the Turn
Seat 4: scels111 collected ($0.12)
Seat 5: ramilsh91 folded before Flop (didn't bet)
Seat 6: Exclusiveby folded before Flop (didn't bet)



PokerStars Zoom Hand #186646431596:  Hold'em No Limit ($0.02/$0.05) - 2018/05/20 21:51:57 CCT [2018/05/20 9:51:57 ET]
Table 'Donati' 6-max Seat #1 is the button
Seat 1: Savavlad97 ($7.07 in chips) 
Seat 2: OsloVest ($4.72 in chips) 
Seat 3: HubertusB ($5.61 in chips) 
Seat 4: qwer9019 ($6.22 in chips) 
Seat 5: Piskonis ($5.23 in chips) 
Seat 6: Silencer91 ($8.59 in chips) 
OsloVest: posts small blind $0.02
HubertusB: posts big blind $0.05
*** HOLE CARDS ***
Dealt to HubertusB [4d 9c]
qwer9019: folds 
Piskonis: folds 
Silencer91: raises $0.10 to $0.15
Savavlad97: folds 
OsloVest: folds 
HubertusB: folds 
Uncalled bet ($0.10) returned to Silencer91
Silencer91 collected $0.12 from pot
Silencer91: doesn't show hand 
*** SUMMARY ***
Total pot $0.12 | Rake $0 
Seat 1: Savavlad97 (button) folded before Flop (didn't bet)
Seat 2: OsloVest (small blind) folded before Flop
Seat 3: HubertusB (big blind) folded before Flop
Seat 4: qwer9019 folded before Flop (didn't bet)
Seat 5: Piskonis folded before Flop (didn't bet)
Seat 6: Silencer91 collected ($0.12)



PokerStars Zoom Hand #186646422848:  Hold'em No Limit ($0.02/$0.05) - 2018/05/20 21:51:42 CCT [2018/05/20 9:51:42 ET]
Table 'Donati' 6-max Seat #1 is the button
Seat 1: Afan45 ($10.26 in chips) 
Seat 2: VLSALT ($6.93 in chips) 
Seat 3: suger309 ($3.26 in chips) 
Seat 4: Exclusiveby ($6.40 in chips) 
Seat 5: ANANATOR ($7.41 in chips) 
Seat 6: HubertusB ($5.61 in chips) 
VLSALT: posts small blind $0.02
suger309: posts big blind $0.05
*** HOLE CARDS ***
Dealt to HubertusB [3h 5d]
Exclusiveby: raises $0.10 to $0.15
ANANATOR: folds 
HubertusB: folds 
Afan45: raises $0.30 to $0.45
VLSALT: folds 
suger309: folds 
Exclusiveby: calls $0.30
*** FLOP *** [Kh 4c 9c]
Exclusiveby: checks 
Afan45: bets $0.28
Exclusiveby: folds 
Uncalled bet ($0.28) returned to Afan45
Afan45 collected $0.93 from pot
Afan45: doesn't show hand 
*** SUMMARY ***
Total pot $0.97 | Rake $0.04 
Board [Kh 4c 9c]
Seat 1: Afan45 (button) collected ($0.93)
Seat 2: VLSALT (small blind) folded before Flop
Seat 3: suger309 (big blind) folded before Flop
Seat 4: Exclusiveby folded on the Flop
Seat 5: ANANATOR folded before Flop (didn't bet)
Seat 6: HubertusB folded before Flop (didn't bet)



PokerStars Zoom Hand #186646428693:  Hold'em No Limit ($0.02/$0.05) - 2018/05/20 21:51:52 CCT [2018/05/20 9:51:52 ET]
Table 'Donati' 6-max Seat #1 is the button
Seat 1: trol_panda ($4.05 in chips) 
Seat 2: thefr1ze ($13.42 in chips) 
Seat 3: key555866 ($27.16 in chips) 
Seat 4: HubertusB ($5.61 in chips) 
Seat 5: 8951771975 ($1.88 in chips) 
Seat 6: edger4013 ($5.61 in chips) 
thefr1ze: posts small blind $0.02
key555866: posts big blind $0.05
*** HOLE CARDS ***
Dealt to HubertusB [3d 4h]
HubertusB: folds 
8951771975: folds 
edger4013: raises $0.10 to $0.15
trol_panda: calls $0.15
thefr1ze: folds 
key555866: calls $0.10
*** FLOP *** [Ac 2c 8d]
key555866: checks 
edger4013: bets $0.25
trol_panda: calls $0.25
key555866: folds 
*** TURN *** [Ac 2c 8d] [3c]
edger4013: bets $0.47
trol_panda: calls $0.47
*** RIVER *** [Ac 2c 8d 3c] [7d]
edger4013: bets $0.60
trol_panda: calls $0.60
*** SHOW DOWN ***
edger4013: shows [Kc Tc] (a flush, Ace high)
trol_panda: mucks hand 
edger4013 collected $2.98 from pot
*** SUMMARY ***
Total pot $3.11 | Rake $0.13 
Board [Ac 2c 8d 3c 7d]
Seat 1: trol_panda (button) mucked [As 2s]
Seat 2: thefr1ze (small blind) folded before Flop
Seat 3: key555866 (big blind) folded on the Flop
Seat 4: HubertusB folded before Flop (didn't bet)
Seat 5: 8951771975 folded before Flop (didn't bet)
Seat 6: edger4013 showed [Kc Tc] and won ($2.98) with a flush, Ace high



PokerStars Zoom Hand #186646439820:  Hold'em No Limit ($0.02/$0.05) - 2018/05/20 21:52:11 CCT [2018/05/20 9:52:11 ET]
Table 'Donati' 6-max Seat #1 is the button
Seat 1: TheFibonachi ($10.09 in chips) 
Seat 2: pauwl12 ($6.66 in chips) 
Seat 3: Krawicz ($5.23 in chips) 
Seat 4: ali3nt0mmy ($5.11 in chips) 
Seat 5: HubertusB ($5.56 in chips) 
Seat 6: Exclusiveby ($10.39 in chips) 
pauwl12: posts small blind $0.02
Krawicz: posts big blind $0.05
*** HOLE CARDS ***
Dealt to HubertusB [Kh 2d]
ali3nt0mmy: folds 
HubertusB: folds 
Exclusiveby: raises $0.07 to $0.12
TheFibonachi: folds 
pauwl12: folds 
Krawicz: raises $0.33 to $0.45
Exclusiveby: folds 
Uncalled bet ($0.33) returned to Krawicz
Krawicz collected $0.26 from pot
Krawicz: doesn't show hand 
*** SUMMARY ***
Total pot $0.26 | Rake $0 
Seat 1: TheFibonachi (button) folded before Flop (didn't bet)
Seat 2: pauwl12 (small blind) folded before Flop
Seat 3: Krawicz (big blind) collected ($0.26)
Seat 4: ali3nt0mmy folded before Flop (didn't bet)
Seat 5: HubertusB folded before Flop (didn't bet)
Seat 6: Exclusiveby folded before Flop



PokerStars Zoom Hand #186646442839:  Hold'em No Limit ($0.02/$0.05) - 2018/05/20 21:52:16 CCT [2018/05/20 9:52:16 ET]
Table 'Donati' 6-max Seat #1 is the button
Seat 1: HubertusB ($5.56 in chips) 
Seat 2: kayck07 ($8.87 in chips) 
Seat 3: TheFibonachi ($4.44 in chips) 
Seat 4: fbimerg86 ($10.63 in chips) 
Seat 5: WeakmindedV1 ($8.76 in chips) 
Seat 6: PrStalker ($8.63 in chips) 
kayck07: posts small blind $0.02
TheFibonachi: posts big blind $0.05
*** HOLE CARDS ***
Dealt to HubertusB [Ts Jd]
fbimerg86: folds 
WeakmindedV1: folds 
PrStalker: folds 
HubertusB: raises $0.10 to $0.15
kayck07: calls $0.13
TheFibonachi: folds 
*** FLOP *** [6d 9s Kd]
kayck07: checks 
HubertusB: checks 
*** TURN *** [6d 9s Kd] [3c]
kayck07: checks 
HubertusB: checks 
*** RIVER *** [6d 9s Kd 3c] [4h]
kayck07: bets $0.20
HubertusB: folds 
Uncalled bet ($0.20) returned to kayck07
kayck07 collected $0.34 from pot
kayck07: doesn't show hand 
*** SUMMARY ***
Total pot $0.35 | Rake $0.01 
Board [6d 9s Kd 3c 4h]
Seat 1: HubertusB (button) folded on the River
Seat 2: kayck07 (small blind) collected ($0.34)
Seat 3: TheFibonachi (big blind) folded before Flop
Seat 4: fbimerg86 folded before Flop (didn't bet)
Seat 5: WeakmindedV1 folded before Flop (didn't bet)
Seat 6: PrStalker folded before Flop (didn't bet)



PokerStars Zoom Hand #186646465119:  Hold'em No Limit ($0.02/$0.05) - 2018/05/20 21:52:54 CCT [2018/05/20 9:52:54 ET]
Table 'Donati' 6-max Seat #1 is the button
Seat 1: ThiagooPaiva ($5.09 in chips) 
Seat 2: incorrect88 ($13.32 in chips) 
Seat 3: PiNe4ppLe ($10.10 in chips) 
Seat 4: superRODRI ($5.12 in chips) 
Seat 5: ANANATOR ($5 in chips) 
Seat 6: HubertusB ($5.39 in chips) 
incorrect88: posts small blind $0.02
PiNe4ppLe: posts big blind $0.05
*** HOLE CARDS ***
Dealt to HubertusB [4d 8s]
superRODRI: raises $0.10 to $0.15
ANANATOR: folds 
HubertusB: folds 
ThiagooPaiva: folds 
incorrect88: folds 
PiNe4ppLe: folds 
Uncalled bet ($0.10) returned to superRODRI
superRODRI collected $0.12 from pot
superRODRI: doesn't show hand 
*** SUMMARY ***
Total pot $0.12 | Rake $0 
Seat 1: ThiagooPaiva (button) folded before Flop (didn't bet)
Seat 2: incorrect88 (small blind) folded before Flop
Seat 3: PiNe4ppLe (big blind) folded before Flop
Seat 4: superRODRI collected ($0.12)
Seat 5: ANANATOR folded before Flop (didn't bet)
Seat 6: HubertusB folded before Flop (didn't bet)



PokerStars Zoom Hand #186646472201:  Hold'em No Limit ($0.02/$0.05) - 2018/05/20 21:53:06 CCT [2018/05/20 9:53:06 ET]
Table 'Donati' 6-max Seat #1 is the button
Seat 1: Cipiku97 ($3.93 in chips) 
Seat 2: ansia171717 ($2.37 in chips) 
Seat 3: HubertusB ($5.39 in chips) 
Seat 4: Exclusiveby ($9.25 in chips) 
Seat 5: syrok17 ($2.37 in chips) 
Seat 6: baslim62 ($9.42 in chips) 
ansia171717: posts small blind $0.02
HubertusB: posts big blind $0.05
*** HOLE CARDS ***
Dealt to HubertusB [Ts Jc]
Exclusiveby: folds 
syrok17: folds 
baslim62: folds 
Cipiku97: folds 
ansia171717: folds 
Uncalled bet ($0.03) returned to HubertusB
HubertusB collected $0.04 from pot
HubertusB: doesn't show hand 
*** SUMMARY ***
Total pot $0.04 | Rake $0 
Seat 1: Cipiku97 (button) folded before Flop (didn't bet)
Seat 2: ansia171717 (small blind) folded before Flop
Seat 3: HubertusB (big blind) collected ($0.04)
Seat 4: Exclusiveby folded before Flop (didn't bet)
Seat 5: syrok17 folded before Flop (didn't bet)
Seat 6: baslim62 folded before Flop (didn't bet)



PokerStars Zoom Hand #186646468683:  Hold'em No Limit ($0.02/$0.05) - 2018/05/20 21:53:00 CCT [2018/05/20 9:53:00 ET]
Table 'Donati' 6-max Seat #1 is the button
Seat 1: Oleksii Voronin ($7.28 in chips) 
Seat 2: jeffpig16 ($6.94 in chips) 
Seat 3: WSlevinW ($2.69 in chips) 
Seat 4: Piskonis ($5.16 in chips) 
Seat 5: HubertusB ($5.39 in chips) 
Seat 6: TheFibonachi ($2.43 in chips) 
jeffpig16: posts small blind $0.02
WSlevinW: posts big blind $0.05
*** HOLE CARDS ***
Dealt to HubertusB [6c 5h]
Piskonis: folds 
HubertusB: folds 
TheFibonachi: folds 
Oleksii Voronin: folds 
jeffpig16: raises $0.07 to $0.12
WSlevinW: folds 
Uncalled bet ($0.07) returned to jeffpig16
jeffpig16 collected $0.10 from pot
jeffpig16: doesn't show hand 
*** SUMMARY ***
Total pot $0.10 | Rake $0 
Seat 1: Oleksii Voronin (button) folded before Flop (didn't bet)
Seat 2: jeffpig16 (small blind) collected ($0.10)
Seat 3: WSlevinW (big blind) folded before Flop
Seat 4: Piskonis folded before Flop (didn't bet)
Seat 5: HubertusB folded before Flop (didn't bet)
Seat 6: TheFibonachi folded before Flop (didn't bet)



PokerStars Zoom Hand #186646462095:  Hold'em No Limit ($0.02/$0.05) - 2018/05/20 21:52:49 CCT [2018/05/20 9:52:49 ET]
Table 'Donati' 6-max Seat #1 is the button
Seat 1: kurawara2701 ($5 in chips) 
Seat 2: HubertusB ($5.41 in chips) 
Seat 3: ILLi.oLL ($6.01 in chips) 
Seat 4: pannetje91 ($4.24 in chips) 
Seat 5: marfen7 ($5.05 in chips) 
Seat 6: BardJeka ($5.41 in chips) 
HubertusB: posts small blind $0.02
ILLi.oLL: posts big blind $0.05
*** HOLE CARDS ***
Dealt to HubertusB [9d 5h]
pannetje91: folds 
marfen7: folds 
BardJeka: folds 
kurawara2701: raises $0.10 to $0.15
HubertusB: folds 
ILLi.oLL: calls $0.10
*** FLOP *** [4h 6h 6c]
ILLi.oLL: bets $0.10
kurawara2701: calls $0.10
*** TURN *** [4h 6h 6c] [5d]
ILLi.oLL: bets $0.25
kurawara2701: calls $0.25
*** RIVER *** [4h 6h 6c 5d] [Jd]
ILLi.oLL: checks 
kurawara2701: checks 
*** SHOW DOWN ***
ILLi.oLL: shows [Tc Ts] (two pair, Tens and Sixes)
kurawara2701: mucks hand 
ILLi.oLL collected $0.98 from pot
*** SUMMARY ***
Total pot $1.02 | Rake $0.04 
Board [4h 6h 6c 5d Jd]
Seat 1: kurawara2701 (button) mucked [4s Ks]
Seat 2: HubertusB (small blind) folded before Flop
Seat 3: ILLi.oLL (big blind) showed [Tc Ts] and won ($0.98) with two pair, Tens and Sixes
Seat 4: pannetje91 folded before Flop (didn't bet)
Seat 5: marfen7 folded before Flop (didn't bet)
Seat 6: BardJeka folded before Flop (didn't bet)



PokerStars Zoom Hand #186646477463:  Hold'em No Limit ($0.02/$0.05) - 2018/05/20 21:53:15 CCT [2018/05/20 9:53:15 ET]
Table 'Donati' 6-max Seat #1 is the button
Seat 1: haqpod ($5.34 in chips) 
Seat 2: HubertusB ($5.41 in chips) 
Seat 3: chrapos ($9.53 in chips) 
Seat 4: $ir_AleXXX ($4.99 in chips) 
Seat 5: Goosich ($7.60 in chips) 
Seat 6: withlove14 ($6.26 in chips) 
HubertusB: posts small blind $0.02
chrapos: posts big blind $0.05
*** HOLE CARDS ***
Dealt to HubertusB [6h 5s]
$ir_AleXXX: folds 
Goosich: folds 
withlove14: folds 
haqpod: folds 
HubertusB: folds 
Uncalled bet ($0.03) returned to chrapos
chrapos collected $0.04 from pot
chrapos: doesn't show hand 
*** SUMMARY ***
Total pot $0.04 | Rake $0 
Seat 1: haqpod (button) folded before Flop (didn't bet)
Seat 2: HubertusB (small blind) folded before Flop
Seat 3: chrapos (big blind) collected ($0.04)
Seat 4: $ir_AleXXX folded before Flop (didn't bet)
Seat 5: Goosich folded before Flop (didn't bet)
Seat 6: withlove14 folded before Flop (didn't bet)



PokerStars Zoom Hand #186646479883:  Hold'em No Limit ($0.02/$0.05) - 2018/05/20 21:53:19 CCT [2018/05/20 9:53:19 ET]
Table 'Donati' 6-max Seat #1 is the button
Seat 1: ASSOSSPATH ($5.14 in chips) 
Seat 2: VLSALT ($15.73 in chips) 
Seat 3: QWER7786 ($13.33 in chips) 
Seat 4: thefr1ze ($13.21 in chips) 
Seat 5: DarkKnajt ($5 in chips) 
Seat 6: HubertusB ($5.39 in chips) 
VLSALT: posts small blind $0.02
QWER7786: posts big blind $0.05
*** HOLE CARDS ***
Dealt to HubertusB [Qd Th]
thefr1ze: folds 
DarkKnajt: folds 
HubertusB: raises $0.10 to $0.15
ASSOSSPATH: calls $0.15
VLSALT: folds 
QWER7786: folds 
*** FLOP *** [Js Jc Ts]
HubertusB: bets $0.15
ASSOSSPATH: calls $0.15
*** TURN *** [Js Jc Ts] [8s]
HubertusB: bets $0.35
ASSOSSPATH: folds 
Uncalled bet ($0.35) returned to HubertusB
HubertusB collected $0.64 from pot
HubertusB: doesn't show hand 
*** SUMMARY ***
Total pot $0.67 | Rake $0.03 
Board [Js Jc Ts 8s]
Seat 1: ASSOSSPATH (button) folded on the Turn
Seat 2: VLSALT (small blind) folded before Flop
Seat 3: QWER7786 (big blind) folded before Flop
Seat 4: thefr1ze folded before Flop (didn't bet)
Seat 5: DarkKnajt folded before Flop (didn't bet)
Seat 6: HubertusB collected ($0.64)



PokerStars Zoom Hand #186646492721:  Hold'em No Limit ($0.02/$0.05) - 2018/05/20 21:53:41 CCT [2018/05/20 9:53:41 ET]
Table 'Donati' 6-max Seat #1 is the button
Seat 1: HubertusB ($5.73 in chips) 
Seat 2: Voki871 ($10.51 in chips) 
Seat 3: Agno$tic ($17.16 in chips) 
Seat 4: omda.bhouri ($2.06 in chips) 
Seat 5: haqpod ($5.34 in chips) 
Seat 6: LingPro ($5.27 in chips) 
Voki871: posts small blind $0.02
Agno$tic: posts big blind $0.05
*** HOLE CARDS ***
Dealt to HubertusB [3h Ts]
omda.bhouri: folds 
haqpod: folds 
LingPro: folds 
HubertusB: folds 
Voki871: folds 
Uncalled bet ($0.03) returned to Agno$tic
Agno$tic collected $0.04 from pot
Agno$tic: doesn't show hand 
*** SUMMARY ***
Total pot $0.04 | Rake $0 
Seat 1: HubertusB (button) folded before Flop (didn't bet)
Seat 2: Voki871 (small blind) folded before Flop
Seat 3: Agno$tic (big blind) collected ($0.04)
Seat 4: omda.bhouri folded before Flop (didn't bet)
Seat 5: haqpod folded before Flop (didn't bet)
Seat 6: LingPro folded before Flop (didn't bet)



PokerStars Zoom Hand #186646498585:  Hold'em No Limit ($0.02/$0.05) - 2018/05/20 21:53:51 CCT [2018/05/20 9:53:51 ET]
Table 'Donati' 6-max Seat #1 is the button
Seat 1: sunao1983 ($1.61 in chips) 
Seat 2: Farad84 ($8.14 in chips) 
Seat 3: barbos2009 ($9.03 in chips) 
Seat 4: HubertusB ($5.73 in chips) 
Seat 5: Fredchie ($10.75 in chips) 
Seat 6: WSlevinW ($2.57 in chips) 
Farad84: posts small blind $0.02
barbos2009: posts big blind $0.05
*** HOLE CARDS ***
Dealt to HubertusB [8s 7h]
HubertusB: folds 
Fredchie: folds 
WSlevinW: folds 
sunao1983: folds 
Farad84: folds 
Uncalled bet ($0.03) returned to barbos2009
barbos2009 collected $0.04 from pot
barbos2009: doesn't show hand 
*** SUMMARY ***
Total pot $0.04 | Rake $0 
Seat 1: sunao1983 (button) folded before Flop (didn't bet)
Seat 2: Farad84 (small blind) folded before Flop
Seat 3: barbos2009 (big blind) collected ($0.04)
Seat 4: HubertusB folded before Flop (didn't bet)
Seat 5: Fredchie folded before Flop (didn't bet)
Seat 6: WSlevinW folded before Flop (didn't bet)



PokerStars Zoom Hand #186646496244:  Hold'em No Limit ($0.02/$0.05) - 2018/05/20 21:53:47 CCT [2018/05/20 9:53:47 ET]
Table 'Donati' 6-max Seat #1 is the button
Seat 1: jahnzy ($3.46 in chips) 
Seat 2: nakashi11 ($2.41 in chips) 
Seat 3: GyNy1976 ($6.27 in chips) 
Seat 4: HubertusB ($5.73 in chips) 
Seat 5: Krawicz ($5.84 in chips) 
Seat 6: Petrsberg ($6.38 in chips) 
nakashi11: posts small blind $0.02
GyNy1976: posts big blind $0.05
*** HOLE CARDS ***
Dealt to HubertusB [5d 2s]
HubertusB: folds 
Krawicz: folds 
Petrsberg: folds 
jahnzy: raises $0.10 to $0.15
nakashi11: folds 
GyNy1976: folds 
Uncalled bet ($0.10) returned to jahnzy
jahnzy collected $0.12 from pot
jahnzy: doesn't show hand 
*** SUMMARY ***
Total pot $0.12 | Rake $0 
Seat 1: jahnzy (button) collected ($0.12)
Seat 2: nakashi11 (small blind) folded before Flop
Seat 3: GyNy1976 (big blind) folded before Flop
Seat 4: HubertusB folded before Flop (didn't bet)
Seat 5: Krawicz folded before Flop (didn't bet)
Seat 6: Petrsberg folded before Flop (didn't bet)



PokerStars Zoom Hand #186646500983:  Hold'em No Limit ($0.02/$0.05) - 2018/05/20 21:53:55 CCT [2018/05/20 9:53:55 ET]
Table 'Donati' 6-max Seat #1 is the button
Seat 1: BoSs00 ($15.12 in chips) 
Seat 2: Faku710 ($5.12 in chips) 
Seat 3: HubertusB ($5.73 in chips) 
Seat 4: Voron9 ($4.33 in chips) 
Seat 5: fedyl78 ($4.76 in chips) 
Seat 6: sunao1983 ($4.86 in chips) 
Faku710: posts small blind $0.02
HubertusB: posts big blind $0.05
*** HOLE CARDS ***
Dealt to HubertusB [Kh 4d]
Voron9: raises $0.05 to $0.10
fedyl78: folds 
sunao1983: folds 
BoSs00: folds 
Faku710: folds 
HubertusB: folds 
Uncalled bet ($0.05) returned to Voron9
Voron9 collected $0.12 from pot
Voron9: doesn't show hand 
*** SUMMARY ***
Total pot $0.12 | Rake $0 
Seat 1: BoSs00 (button) folded before Flop (didn't bet)
Seat 2: Faku710 (small blind) folded before Flop
Seat 3: HubertusB (big blind) folded before Flop
Seat 4: Voron9 collected ($0.12)
Seat 5: fedyl78 folded before Flop (didn't bet)
Seat 6: sunao1983 folded before Flop (didn't bet)



PokerStars Zoom Hand #186646503848:  Hold'em No Limit ($0.02/$0.05) - 2018/05/20 21:54:00 CCT [2018/05/20 9:54:00 ET]
Table 'Donati' 6-max Seat #1 is the button
Seat 1: WhiteWolf459 ($6.73 in chips) 
Seat 2: upuxa ($6.47 in chips) 
Seat 3: El Hanni ($6.67 in chips) 
Seat 4: serg197211 ($5.39 in chips) 
Seat 5: olega2006 ($5.79 in chips) 
Seat 6: HubertusB ($5.68 in chips) 
upuxa: posts small blind $0.02
El Hanni: posts big blind $0.05
*** HOLE CARDS ***
Dealt to HubertusB [8d 9s]
serg197211: folds 
olega2006: folds 
HubertusB: folds 
WhiteWolf459: raises $0.07 to $0.12
upuxa: folds 
El Hanni: folds 
Uncalled bet ($0.07) returned to WhiteWolf459
WhiteWolf459 collected $0.12 from pot
WhiteWolf459: doesn't show hand 
*** SUMMARY ***
Total pot $0.12 | Rake $0 
Seat 1: WhiteWolf459 (button) collected ($0.12)
Seat 2: upuxa (small blind) folded before Flop
Seat 3: El Hanni (big blind) folded before Flop
Seat 4: serg197211 folded before Flop (didn't bet)
Seat 5: olega2006 folded before Flop (didn't bet)
Seat 6: HubertusB folded before Flop (didn't bet)



PokerStars Zoom Hand #186646506802:  Hold'em No Limit ($0.02/$0.05) - 2018/05/20 21:54:05 CCT [2018/05/20 9:54:05 ET]
Table 'Donati' 6-max Seat #1 is the button
Seat 1: sizuu1225 ($6.96 in chips) 
Seat 2: kranovoy22 ($6.13 in chips) 
Seat 3: Little Geewood ($5.39 in chips) 
Seat 4: cbiscuit1127 ($6.84 in chips) 
Seat 5: HubertusB ($5.68 in chips) 
Seat 6: sancho1870 ($5.25 in chips) 
kranovoy22: posts small blind $0.02
Little Geewood: posts big blind $0.05
*** HOLE CARDS ***
Dealt to HubertusB [4d 4h]
cbiscuit1127: folds 
HubertusB: raises $0.05 to $0.10
sancho1870: folds 
sizuu1225: folds 
kranovoy22: folds 
Little Geewood: folds 
Uncalled bet ($0.05) returned to HubertusB
HubertusB collected $0.12 from pot
HubertusB: doesn't show hand 
*** SUMMARY ***
Total pot $0.12 | Rake $0 
Seat 1: sizuu1225 (button) folded before Flop (didn't bet)
Seat 2: kranovoy22 (small blind) folded before Flop
Seat 3: Little Geewood (big blind) folded before Flop
Seat 4: cbiscuit1127 folded before Flop (didn't bet)
Seat 5: HubertusB collected ($0.12)
Seat 6: sancho1870 folded before Flop (didn't bet)



PokerStars Zoom Hand #186646515073:  Hold'em No Limit ($0.02/$0.05) - 2018/05/20 21:54:19 CCT [2018/05/20 9:54:19 ET]
Table 'Donati' 6-max Seat #1 is the button
Seat 1: Golodayushii ($11.08 in chips) 
Seat 2: HubertusB ($5.75 in chips) 
Seat 3: Sergei44427 ($5.30 in chips) 
Seat 4: Silencer91 ($7.07 in chips) 
Seat 5: seaman455 ($5.77 in chips) 
Seat 6: tatarin896 ($3.67 in chips) 
HubertusB: posts small blind $0.02
Sergei44427: posts big blind $0.05
*** HOLE CARDS ***
Dealt to HubertusB [2c 4c]
Silencer91: raises $0.10 to $0.15
seaman455: folds 
tatarin896: folds 
Golodayushii: folds 
HubertusB: folds 
Sergei44427: calls $0.10
*** FLOP *** [7h Ts Kd]
Sergei44427: checks 
Silencer91: bets $0.16
Sergei44427: calls $0.16
*** TURN *** [7h Ts Kd] [Ac]
Sergei44427: checks 
Silencer91: checks 
*** RIVER *** [7h Ts Kd Ac] [5d]
Sergei44427: bets $0.31
Silencer91: folds 
Uncalled bet ($0.31) returned to Sergei44427
Sergei44427 collected $0.61 from pot
Sergei44427: doesn't show hand 
*** SUMMARY ***
Total pot $0.64 | Rake $0.03 
Board [7h Ts Kd Ac 5d]
Seat 1: Golodayushii (button) folded before Flop (didn't bet)
Seat 2: HubertusB (small blind) folded before Flop
Seat 3: Sergei44427 (big blind) collected ($0.61)
Seat 4: Silencer91 folded on the River
Seat 5: seaman455 folded before Flop (didn't bet)
Seat 6: tatarin896 folded before Flop (didn't bet)



PokerStars Zoom Hand #186646521449:  Hold'em No Limit ($0.02/$0.05) - 2018/05/20 21:54:30 CCT [2018/05/20 9:54:30 ET]
Table 'Donati' 6-max Seat #1 is the button
Seat 1: HubertusB ($5.71 in chips) 
Seat 2: Julietta1997 ($4.43 in chips) 
Seat 3: spellwilli90 ($5.07 in chips) 
Seat 4: jepket1 ($1.60 in chips) 
Seat 5: alexey9210a ($5 in chips) 
Seat 6: TheLawyer73 ($12.23 in chips) 
Julietta1997: posts small blind $0.02
spellwilli90: posts big blind $0.05
*** HOLE CARDS ***
Dealt to HubertusB [4d 5h]
jepket1: folds 
alexey9210a: folds 
TheLawyer73: raises $0.10 to $0.15
HubertusB: folds 
Julietta1997: folds 
spellwilli90: folds 
Uncalled bet ($0.10) returned to TheLawyer73
TheLawyer73 collected $0.12 from pot
TheLawyer73: doesn't show hand 
*** SUMMARY ***
Total pot $0.12 | Rake $0 
Seat 1: HubertusB (button) folded before Flop (didn't bet)
Seat 2: Julietta1997 (small blind) folded before Flop
Seat 3: spellwilli90 (big blind) folded before Flop
Seat 4: jepket1 folded before Flop (didn't bet)
Seat 5: alexey9210a folded before Flop (didn't bet)
Seat 6: TheLawyer73 collected ($0.12)



PokerStars Zoom Hand #186646525018:  Hold'em No Limit ($0.02/$0.05) - 2018/05/20 21:54:36 CCT [2018/05/20 9:54:36 ET]
Table 'Donati' 6-max Seat #1 is the button
Seat 1: Youchern ($4.85 in chips) 
Seat 2: shichich94 ($2.51 in chips) 
Seat 3: TheFibonachi ($9.46 in chips) 
Seat 4: HubertusB ($5.71 in chips) 
Seat 5: VingadorV ($6.88 in chips) 
Seat 6: Guernik ($9.80 in chips) 
shichich94: posts small blind $0.02
TheFibonachi: posts big blind $0.05
*** HOLE CARDS ***
Dealt to HubertusB [Ks 4h]
HubertusB: folds 
VingadorV: folds 
Guernik: raises $0.10 to $0.15
Youchern: folds 
shichich94: calls $0.13
TheFibonachi: folds 
*** FLOP *** [5c 6c Kh]
shichich94: checks 
Guernik: bets $0.20
shichich94: folds 
Uncalled bet ($0.20) returned to Guernik
Guernik collected $0.34 from pot
Guernik: doesn't show hand 
*** SUMMARY ***
Total pot $0.35 | Rake $0.01 
Board [5c 6c Kh]
Seat 1: Youchern (button) folded before Flop (didn't bet)
Seat 2: shichich94 (small blind) folded on the Flop
Seat 3: TheFibonachi (big blind) folded before Flop
Seat 4: HubertusB folded before Flop (didn't bet)
Seat 5: VingadorV folded before Flop (didn't bet)
Seat 6: Guernik collected ($0.34)



PokerStars Zoom Hand #186646527332:  Hold'em No Limit ($0.02/$0.05) - 2018/05/20 21:54:40 CCT [2018/05/20 9:54:40 ET]
Table 'Donati' 6-max Seat #1 is the button
Seat 1: Pregos1 ($3.41 in chips) 
Seat 2: haqpod ($5.27 in chips) 
Seat 3: HubertusB ($5.71 in chips) 
Seat 4: jahnzy ($3.36 in chips) 
Seat 5: Landmark7 ($7.57 in chips) 
Seat 6: Croo633 ($5.19 in chips) 
haqpod: posts small blind $0.02
HubertusB: posts big blind $0.05
*** HOLE CARDS ***
Dealt to HubertusB [6h Tc]
jahnzy: folds 
Landmark7: folds 
Croo633: raises $0.09 to $0.14
Pregos1: folds 
haqpod: folds 
HubertusB: folds 
Uncalled bet ($0.09) returned to Croo633
Croo633 collected $0.12 from pot
Croo633: doesn't show hand 
*** SUMMARY ***
Total pot $0.12 | Rake $0 
Seat 1: Pregos1 (button) folded before Flop (didn't bet)
Seat 2: haqpod (small blind) folded before Flop
Seat 3: HubertusB (big blind) folded before Flop
Seat 4: jahnzy folded before Flop (didn't bet)
Seat 5: Landmark7 folded before Flop (didn't bet)
Seat 6: Croo633 collected ($0.12)



PokerStars Zoom Hand #186646517943:  Hold'em No Limit ($0.02/$0.05) - 2018/05/20 21:54:24 CCT [2018/05/20 9:54:24 ET]
Table 'Donati' 6-max Seat #1 is the button
Seat 1: Marian V. 31 ($5.17 in chips) 
Seat 2: HubertusB ($5.73 in chips) 
Seat 3: Clubberer80 ($5 in chips) 
Seat 4: edger4013 ($7.21 in chips) 
Seat 5: Omicron333 ($8.14 in chips) 
Seat 6: CAYROS ($11.16 in chips) 
HubertusB: posts small blind $0.02
Clubberer80: posts big blind $0.05
*** HOLE CARDS ***
Dealt to HubertusB [Js 6d]
edger4013: folds 
Omicron333: raises $0.10 to $0.15
CAYROS: folds 
Marian V. 31: folds 
HubertusB: folds 
Clubberer80: calls $0.10
*** FLOP *** [2c 3h 5c]
Clubberer80: checks 
Omicron333: bets $0.20
Clubberer80: folds 
Uncalled bet ($0.20) returned to Omicron333
Omicron333 collected $0.31 from pot
Omicron333: doesn't show hand 
*** SUMMARY ***
Total pot $0.32 | Rake $0.01 
Board [2c 3h 5c]
Seat 1: Marian V. 31 (button) folded before Flop (didn't bet)
Seat 2: HubertusB (small blind) folded before Flop
Seat 3: Clubberer80 (big blind) folded on the Flop
Seat 4: edger4013 folded before Flop (didn't bet)
Seat 5: Omicron333 collected ($0.31)
Seat 6: CAYROS folded before Flop (didn't bet)



PokerStars Zoom Hand #186646533118:  Hold'em No Limit ($0.02/$0.05) - 2018/05/20 21:54:50 CCT [2018/05/20 9:54:50 ET]
Table 'Donati' 6-max Seat #1 is the button
Seat 1: eSSayL65 ($13.06 in chips) 
Seat 2: BardJeka ($5.23 in chips) 
Seat 3: bober2702 ($3.67 in chips) 
Seat 4: saha555 ($5.94 in chips) 
Seat 5: ninix17 ($7.33 in chips) 
Seat 6: HubertusB ($5.66 in chips) 
BardJeka: posts small blind $0.02
bober2702: posts big blind $0.05
*** HOLE CARDS ***
Dealt to HubertusB [Qd As]
saha555: folds 
ninix17: folds 
HubertusB: raises $0.10 to $0.15
eSSayL65: folds 
BardJeka: raises $0.35 to $0.50
bober2702: folds 
HubertusB: calls $0.35
*** FLOP *** [3c 6s 2d]
BardJeka: bets $0.60
HubertusB: folds 
Uncalled bet ($0.60) returned to BardJeka
BardJeka collected $1.01 from pot
BardJeka: doesn't show hand 
*** SUMMARY ***
Total pot $1.05 | Rake $0.04 
Board [3c 6s 2d]
Seat 1: eSSayL65 (button) folded before Flop (didn't bet)
Seat 2: BardJeka (small blind) collected ($1.01)
Seat 3: bober2702 (big blind) folded before Flop
Seat 4: saha555 folded before Flop (didn't bet)
Seat 5: ninix17 folded before Flop (didn't bet)
Seat 6: HubertusB folded on the Flop



PokerStars Zoom Hand #186646550080:  Hold'em No Limit ($0.02/$0.05) - 2018/05/20 21:55:21 CCT [2018/05/20 9:55:21 ET]
Table 'Donati' 6-max Seat #1 is the button
Seat 1: OsloVest ($8.69 in chips) 
Seat 2: jason032323 ($6.40 in chips) 
Seat 3: ninix17 ($6.50 in chips) 
Seat 4: SeblSebowski ($6.20 in chips) 
Seat 5: HubertusB ($5.16 in chips) 
Seat 6: Mr.Nuttts ($5.58 in chips) 
jason032323: posts small blind $0.02
ninix17: posts big blind $0.05
*** HOLE CARDS ***
Dealt to HubertusB [5c 8h]
SeblSebowski: folds 
HubertusB: folds 
Mr.Nuttts: raises $0.10 to $0.15
OsloVest: folds 
jason032323: folds 
ninix17: folds 
Uncalled bet ($0.10) returned to Mr.Nuttts
Mr.Nuttts collected $0.12 from pot
Mr.Nuttts: doesn't show hand 
*** SUMMARY ***
Total pot $0.12 | Rake $0 
Seat 1: OsloVest (button) folded before Flop (didn't bet)
Seat 2: jason032323 (small blind) folded before Flop
Seat 3: ninix17 (big blind) folded before Flop
Seat 4: SeblSebowski folded before Flop (didn't bet)
Seat 5: HubertusB folded before Flop (didn't bet)
Seat 6: Mr.Nuttts collected ($0.12)



PokerStars Zoom Hand #186646552291:  Hold'em No Limit ($0.02/$0.05) - 2018/05/20 21:55:26 CCT [2018/05/20 9:55:26 ET]
Table 'Donati' 6-max Seat #1 is the button
Seat 1: HubertusB ($5.16 in chips) 
Seat 2: dato5557 ($7.12 in chips) 
Seat 3: rizotto ($13.52 in chips) 
Seat 4: adytoditza ($6.11 in chips) 
Seat 5: krp4 ($6.29 in chips) 
Seat 6: cazzzwell ($5 in chips) 
dato5557: posts small blind $0.02
rizotto: posts big blind $0.05
*** HOLE CARDS ***
Dealt to HubertusB [5h 5s]
adytoditza: folds 
krp4: folds 
cazzzwell: raises $0.07 to $0.12
HubertusB: calls $0.12
dato5557: calls $0.10
rizotto: folds 
*** FLOP *** [8h Qd Ad]
dato5557: checks 
cazzzwell: bets $0.26
HubertusB: folds 
dato5557: calls $0.26
*** TURN *** [8h Qd Ad] [Kc]
dato5557: checks 
cazzzwell: bets $0.59
dato5557: folds 
Uncalled bet ($0.59) returned to cazzzwell
cazzzwell collected $0.89 from pot
cazzzwell: doesn't show hand 
*** SUMMARY ***
Total pot $0.93 | Rake $0.04 
Board [8h Qd Ad Kc]
Seat 1: HubertusB (button) folded on the Flop
Seat 2: dato5557 (small blind) folded on the Turn
Seat 3: rizotto (big blind) folded before Flop
Seat 4: adytoditza folded before Flop (didn't bet)
Seat 5: krp4 folded before Flop (didn't bet)
Seat 6: cazzzwell collected ($0.89)



PokerStars Zoom Hand #186646563164:  Hold'em No Limit ($0.02/$0.05) - 2018/05/20 21:55:50 CCT [2018/05/20 9:55:50 ET]
Table 'Donati' 6-max Seat #1 is the button
Seat 1: kranovoy22 ($7.30 in chips) 
Seat 2: nalt69 ($3.83 in chips) 
Seat 3: emanuelbecke ($5.23 in chips) 
Seat 4: HubertusB ($5.04 in chips) 
Seat 5: chips010 ($3.48 in chips) 
Seat 6: geworik ($5 in chips) 
nalt69: posts small blind $0.02
emanuelbecke: posts big blind $0.05
*** HOLE CARDS ***
Dealt to HubertusB [Qh Jd]
HubertusB: raises $0.10 to $0.15
chips010: folds 
geworik: folds 
kranovoy22: folds 
nalt69: calls $0.13
emanuelbecke: folds 
*** FLOP *** [2d Jc Kc]
nalt69: checks 
HubertusB: bets $0.17
nalt69: folds 
Uncalled bet ($0.17) returned to HubertusB
HubertusB collected $0.34 from pot
HubertusB: doesn't show hand 
*** SUMMARY ***
Total pot $0.35 | Rake $0.01 
Board [2d Jc Kc]
Seat 1: kranovoy22 (button) folded before Flop (didn't bet)
Seat 2: nalt69 (small blind) folded on the Flop
Seat 3: emanuelbecke (big blind) folded before Flop
Seat 4: HubertusB collected ($0.34)
Seat 5: chips010 folded before Flop (didn't bet)
Seat 6: geworik folded before Flop (didn't bet)



PokerStars Zoom Hand #186646573087:  Hold'em No Limit ($0.02/$0.05) - 2018/05/20 21:56:12 CCT [2018/05/20 9:56:12 ET]
Table 'Donati' 6-max Seat #1 is the button
Seat 1: superRODRI ($5 in chips) 
Seat 2: Boba1888 ($12.21 in chips) 
Seat 3: HubertusB ($5.23 in chips) 
Seat 4: HonMax ($5.16 in chips) 
Seat 5: El Hanni ($9.33 in chips) 
Seat 6: YuPayMeIn$$ ($2.75 in chips) 
Boba1888: posts small blind $0.02
HubertusB: posts big blind $0.05
*** HOLE CARDS ***
Dealt to HubertusB [8s Jh]
HonMax: folds 
El Hanni: raises $0.10 to $0.15
YuPayMeIn$$: folds 
superRODRI: folds 
Boba1888: folds 
HubertusB: folds 
Uncalled bet ($0.10) returned to El Hanni
El Hanni collected $0.12 from pot
El Hanni: doesn't show hand 
*** SUMMARY ***
Total pot $0.12 | Rake $0 
Seat 1: superRODRI (button) folded before Flop (didn't bet)
Seat 2: Boba1888 (small blind) folded before Flop
Seat 3: HubertusB (big blind) folded before Flop
Seat 4: HonMax folded before Flop (didn't bet)
Seat 5: El Hanni collected ($0.12)
Seat 6: YuPayMeIn$$ folded before Flop (didn't bet)



PokerStars Zoom Hand #186646627334:  Hold'em No Limit ($0.02/$0.05) - 2018/05/20 21:58:10 CCT [2018/05/20 9:58:10 ET]
Table 'Donati' 6-max Seat #1 is the button
Seat 1: nick235711 ($5 in chips) 
Seat 2: TheFibonachi ($9.22 in chips) 
Seat 3: jason032323 ($9.66 in chips) 
Seat 4: yuu0914 ($5.02 in chips) 
Seat 5: HubertusB ($5.18 in chips) 
Seat 6: sunao1983 ($1.61 in chips) 
TheFibonachi: posts small blind $0.02
jason032323: posts big blind $0.05
*** HOLE CARDS ***
Dealt to HubertusB [4h Kd]
yuu0914: folds 
HubertusB: folds 
sunao1983: folds 
nick235711: folds 
TheFibonachi: raises $0.07 to $0.12
jason032323: folds 
Uncalled bet ($0.07) returned to TheFibonachi
TheFibonachi collected $0.10 from pot
TheFibonachi: doesn't show hand 
*** SUMMARY ***
Total pot $0.10 | Rake $0 
Seat 1: nick235711 (button) folded before Flop (didn't bet)
Seat 2: TheFibonachi (small blind) collected ($0.10)
Seat 3: jason032323 (big blind) folded before Flop
Seat 4: yuu0914 folded before Flop (didn't bet)
Seat 5: HubertusB folded before Flop (didn't bet)
Seat 6: sunao1983 folded before Flop (didn't bet)



PokerStars Zoom Hand #186646629655:  Hold'em No Limit ($0.02/$0.05) - 2018/05/20 21:58:15 CCT [2018/05/20 9:58:15 ET]
Table 'Donati' 6-max Seat #1 is the button
Seat 1: cct918 ($5.33 in chips) 
Seat 2: HubertusB ($5.18 in chips) 
Seat 3: uspih ($3.32 in chips) 
Seat 4: whitewhisper ($5.18 in chips) 
Seat 5: $ir_AleXXX ($5.14 in chips) 
Seat 6: Shaftey11 ($11.74 in chips) 
HubertusB: posts small blind $0.02
uspih: posts big blind $0.05
*** HOLE CARDS ***
Dealt to HubertusB [9d Kd]
whitewhisper: folds 
$ir_AleXXX: folds 
Shaftey11: folds 
cct918: folds 
HubertusB: raises $0.10 to $0.15
uspih: folds 
Uncalled bet ($0.10) returned to HubertusB
HubertusB collected $0.10 from pot
HubertusB: doesn't show hand 
*** SUMMARY ***
Total pot $0.10 | Rake $0 
Seat 1: cct918 (button) folded before Flop (didn't bet)
Seat 2: HubertusB (small blind) collected ($0.10)
Seat 3: uspih (big blind) folded before Flop
Seat 4: whitewhisper folded before Flop (didn't bet)
Seat 5: $ir_AleXXX folded before Flop (didn't bet)
Seat 6: Shaftey11 folded before Flop (didn't bet)



PokerStars Zoom Hand #186646640861:  Hold'em No Limit ($0.02/$0.05) - 2018/05/20 21:58:39 CCT [2018/05/20 9:58:39 ET]
Table 'Donati' 6-max Seat #1 is the button
Seat 1: Parjato ($5 in chips) 
Seat 2: UltraRunnerr ($5.99 in chips) 
Seat 3: confirmedanc ($5 in chips) 
Seat 4: HubertusB ($5.23 in chips) 
Seat 5: vitaha00007 ($10.30 in chips) 
Seat 6: Omicron333 ($5 in chips) 
UltraRunnerr: posts small blind $0.02
confirmedanc: posts big blind $0.05
*** HOLE CARDS ***
Dealt to HubertusB [2s 2h]
HubertusB: folds 
vitaha00007: raises $0.10 to $0.15
Omicron333: folds 
Parjato: folds 
UltraRunnerr: folds 
confirmedanc: folds 
Uncalled bet ($0.10) returned to vitaha00007
vitaha00007 collected $0.12 from pot
vitaha00007: doesn't show hand 
*** SUMMARY ***
Total pot $0.12 | Rake $0 
Seat 1: Parjato (button) folded before Flop (didn't bet)
Seat 2: UltraRunnerr (small blind) folded before Flop
Seat 3: confirmedanc (big blind) folded before Flop
Seat 4: HubertusB folded before Flop (didn't bet)
Seat 5: vitaha00007 collected ($0.12)
Seat 6: Omicron333 folded before Flop (didn't bet)



PokerStars Zoom Hand #186646643594:  Hold'em No Limit ($0.02/$0.05) - 2018/05/20 21:58:45 CCT [2018/05/20 9:58:45 ET]
Table 'Donati' 6-max Seat #1 is the button
Seat 1: HubertusB ($5.23 in chips) 
Seat 2: OIegan™ ($5.02 in chips) 
Seat 3: Clubberer80 ($5.12 in chips) 
Seat 4: Palandr ($7.31 in chips) 
Seat 5: Salmonnet ($4.43 in chips) 
Seat 6: Omicron333 ($8.13 in chips) 
OIegan™: posts small blind $0.02
Clubberer80: posts big blind $0.05
*** HOLE CARDS ***
Dealt to HubertusB [7s 9c]
Palandr: folds 
Salmonnet: raises $0.07 to $0.12
Omicron333: folds 
HubertusB: folds 
OIegan™: folds 
Clubberer80: folds 
Uncalled bet ($0.07) returned to Salmonnet
Salmonnet collected $0.12 from pot
Salmonnet: doesn't show hand 
*** SUMMARY ***
Total pot $0.12 | Rake $0 
Seat 1: HubertusB (button) folded before Flop (didn't bet)
Seat 2: OIegan™ (small blind) folded before Flop
Seat 3: Clubberer80 (big blind) folded before Flop
Seat 4: Palandr folded before Flop (didn't bet)
Seat 5: Salmonnet collected ($0.12)
Seat 6: Omicron333 folded before Flop (didn't bet)



PokerStars Zoom Hand #186646650989:  Hold'em No Limit ($0.02/$0.05) - 2018/05/20 21:59:01 CCT [2018/05/20 9:59:01 ET]
Table 'Donati' 6-max Seat #1 is the button
Seat 1: nervhy ($3.54 in chips) 
Seat 2: tumo1326 ($14.93 in chips) 
Seat 3: 90_Dustin_90 ($6.95 in chips) 
Seat 4: Mr. Roquim ($8.52 in chips) 
Seat 5: Voki871 ($5 in chips) 
Seat 6: HubertusB ($5.21 in chips) 
tumo1326: posts small blind $0.02
90_Dustin_90: posts big blind $0.05
*** HOLE CARDS ***
Dealt to HubertusB [5c 8c]
Mr. Roquim: raises $0.10 to $0.15
Voki871: folds 
HubertusB: folds 
nervhy: folds 
tumo1326: folds 
90_Dustin_90: folds 
Uncalled bet ($0.10) returned to Mr. Roquim
Mr. Roquim collected $0.12 from pot
Mr. Roquim: doesn't show hand 
*** SUMMARY ***
Total pot $0.12 | Rake $0 
Seat 1: nervhy (button) folded before Flop (didn't bet)
Seat 2: tumo1326 (small blind) folded before Flop
Seat 3: 90_Dustin_90 (big blind) folded before Flop
Seat 4: Mr. Roquim collected ($0.12)
Seat 5: Voki871 folded before Flop (didn't bet)
Seat 6: HubertusB folded before Flop (didn't bet)



PokerStars Zoom Hand #186646655163:  Hold'em No Limit ($0.02/$0.05) - 2018/05/20 21:59:10 CCT [2018/05/20 9:59:10 ET]
Table 'Donati' 6-max Seat #1 is the button
Seat 1: tandl2015 ($3.04 in chips) 
Seat 2: VovaV ($5 in chips) 
Seat 3: HubertusB ($5.21 in chips) 
Seat 4: marfen7 ($4.80 in chips) 
Seat 5: VingadorV ($6.30 in chips) 
Seat 6: syrok17 ($6.68 in chips) 
VovaV: posts small blind $0.02
HubertusB: posts big blind $0.05
*** HOLE CARDS ***
Dealt to HubertusB [Ac 9h]
marfen7: folds 
VingadorV: folds 
syrok17: folds 
tandl2015: folds 
VovaV: folds 
Uncalled bet ($0.03) returned to HubertusB
HubertusB collected $0.04 from pot
HubertusB: doesn't show hand 
*** SUMMARY ***
Total pot $0.04 | Rake $0 
Seat 1: tandl2015 (button) folded before Flop (didn't bet)
Seat 2: VovaV (small blind) folded before Flop
Seat 3: HubertusB (big blind) collected ($0.04)
Seat 4: marfen7 folded before Flop (didn't bet)
Seat 5: VingadorV folded before Flop (didn't bet)
Seat 6: syrok17 folded before Flop (didn't bet)



PokerStars Zoom Hand #186646659843:  Hold'em No Limit ($0.02/$0.05) - 2018/05/20 21:59:20 CCT [2018/05/20 9:59:20 ET]
Table 'Donati' 6-max Seat #1 is the button
Seat 1: benigomu ($5 in chips) 
Seat 2: celams ($5.11 in chips) 
Seat 3: tanya1004 ($2.86 in chips) 
Seat 4: krp4 ($6.39 in chips) 
Seat 5: HubertusB ($5.23 in chips) 
Seat 6: Sonoionin ($5.87 in chips) 
celams: posts small blind $0.02
tanya1004: posts big blind $0.05
*** HOLE CARDS ***
Dealt to HubertusB [5d Ks]
krp4: folds 
HubertusB: folds 
Sonoionin: folds 
benigomu: folds 
celams: folds 
Uncalled bet ($0.03) returned to tanya1004
tanya1004 collected $0.04 from pot
tanya1004: doesn't show hand 
*** SUMMARY ***
Total pot $0.04 | Rake $0 
Seat 1: benigomu (button) folded before Flop (didn't bet)
Seat 2: celams (small blind) folded before Flop
Seat 3: tanya1004 (big blind) collected ($0.04)
Seat 4: krp4 folded before Flop (didn't bet)
Seat 5: HubertusB folded before Flop (didn't bet)
Seat 6: Sonoionin folded before Flop (didn't bet)



PokerStars Zoom Hand #186646648214:  Hold'em No Limit ($0.02/$0.05) - 2018/05/20 21:58:55 CCT [2018/05/20 9:58:55 ET]
Table 'Donati' 6-max Seat #1 is the button
Seat 1: joriksatana ($6.18 in chips) 
Seat 2: HubertusB ($5.23 in chips) 
Seat 3: WSlevinW ($2.62 in chips) 
Seat 4: Julietta1997 ($8.02 in chips) 
Seat 5: Golodayushii ($5.09 in chips) 
Seat 6: ThomaSs223 ($5 in chips) 
HubertusB: posts small blind $0.02
WSlevinW: posts big blind $0.05
*** HOLE CARDS ***
Dealt to HubertusB [6d 9s]
Julietta1997: folds 
Golodayushii: folds 
ThomaSs223: raises $0.07 to $0.12
joriksatana: calls $0.12
HubertusB: folds 
WSlevinW: folds 
*** FLOP *** [9h Ac Qd]
ThomaSs223: bets $0.14
joriksatana: calls $0.14
*** TURN *** [9h Ac Qd] [4c]
ThomaSs223: bets $0.27
joriksatana: calls $0.27
*** RIVER *** [9h Ac Qd 4c] [8c]
ThomaSs223: checks 
joriksatana: bets $0.65
ThomaSs223: folds 
Uncalled bet ($0.65) returned to joriksatana
joriksatana collected $1.08 from pot
joriksatana: doesn't show hand 
*** SUMMARY ***
Total pot $1.13 | Rake $0.05 
Board [9h Ac Qd 4c 8c]
Seat 1: joriksatana (button) collected ($1.08)
Seat 2: HubertusB (small blind) folded before Flop
Seat 3: WSlevinW (big blind) folded before Flop
Seat 4: Julietta1997 folded before Flop (didn't bet)
Seat 5: Golodayushii folded before Flop (didn't bet)
Seat 6: ThomaSs223 folded on the River



PokerStars Zoom Hand #186646670190:  Hold'em No Limit ($0.02/$0.05) - 2018/05/20 21:59:42 CCT [2018/05/20 9:59:42 ET]
Table 'Donati' 6-max Seat #1 is the button
Seat 1: HubertusB ($5.21 in chips) 
Seat 2: LeGingy182 ($5 in chips) 
Seat 3: pannetje91 ($3.21 in chips) 
Seat 4: Krawicz ($5.73 in chips) 
Seat 5: 30NIKI30 ($3.74 in chips) 
Seat 6: key555866 ($28.17 in chips) 
LeGingy182: posts small blind $0.02
pannetje91: posts big blind $0.05
*** HOLE CARDS ***
Dealt to HubertusB [9c Jd]
Krawicz: folds 
30NIKI30: folds 
key555866: raises $0.10 to $0.15
HubertusB: folds 
LeGingy182: folds 
pannetje91: folds 
Uncalled bet ($0.10) returned to key555866
key555866 collected $0.12 from pot
key555866: doesn't show hand 
*** SUMMARY ***
Total pot $0.12 | Rake $0 
Seat 1: HubertusB (button) folded before Flop (didn't bet)
Seat 2: LeGingy182 (small blind) folded before Flop
Seat 3: pannetje91 (big blind) folded before Flop
Seat 4: Krawicz folded before Flop (didn't bet)
Seat 5: 30NIKI30 folded before Flop (didn't bet)
Seat 6: key555866 collected ($0.12)



PokerStars Zoom Hand #186646672538:  Hold'em No Limit ($0.02/$0.05) - 2018/05/20 21:59:47 CCT [2018/05/20 9:59:47 ET]
Table 'Donati' 6-max Seat #1 is the button
Seat 1: whitewhisper ($5 in chips) 
Seat 2: benigomu ($5 in chips) 
Seat 3: HubertusB ($5.21 in chips) 
Seat 4: ANDREYShaykh ($3.98 in chips) 
Seat 5: thekvlt ($6.18 in chips) 
Seat 6: SRD03 ($6.50 in chips) 
benigomu: posts small blind $0.02
HubertusB: posts big blind $0.05
*** HOLE CARDS ***
Dealt to HubertusB [8s 4h]
ANDREYShaykh: raises $0.10 to $0.15
thekvlt: folds 
SRD03: folds 
whitewhisper: folds 
benigomu: folds 
HubertusB: folds 
Uncalled bet ($0.10) returned to ANDREYShaykh
ANDREYShaykh collected $0.12 from pot
ANDREYShaykh: doesn't show hand 
*** SUMMARY ***
Total pot $0.12 | Rake $0 
Seat 1: whitewhisper (button) folded before Flop (didn't bet)
Seat 2: benigomu (small blind) folded before Flop
Seat 3: HubertusB (big blind) folded before Flop
Seat 4: ANDREYShaykh collected ($0.12)
Seat 5: thekvlt folded before Flop (didn't bet)
Seat 6: SRD03 folded before Flop (didn't bet)



PokerStars Zoom Hand #186646662690:  Hold'em No Limit ($0.02/$0.05) - 2018/05/20 21:59:26 CCT [2018/05/20 9:59:26 ET]
Table 'Donati' 6-max Seat #1 is the button
Seat 1: Afan45 ($5.02 in chips) 
Seat 2: 1857Dan ($7.40 in chips) 
Seat 3: Omicron333 ($5.05 in chips) 
Seat 4: PVKMSSSSR ($5 in chips) 
Seat 5: romkamolod ($6.26 in chips) 
Seat 6: HubertusB ($5.23 in chips) 
1857Dan: posts small blind $0.02
Omicron333: posts big blind $0.05
*** HOLE CARDS ***
Dealt to HubertusB [4c Qd]
PVKMSSSSR: folds 
romkamolod: raises $0.10 to $0.15
HubertusB: folds 
Afan45: folds 
1857Dan: folds 
Omicron333: raises $0.44 to $0.59
romkamolod: calls $0.44
*** FLOP *** [4d 6d Jh]
Omicron333: bets $0.70
romkamolod: calls $0.70
*** TURN *** [4d 6d Jh] [Tc]
Omicron333: bets $1.64
romkamolod: calls $1.64
*** RIVER *** [4d 6d Jh Tc] [Kd]
Omicron333: bets $2.12 and is all-in
romkamolod: calls $2.12
*** SHOW DOWN ***
Omicron333: shows [Ad Ks] (a pair of Kings)
romkamolod: shows [9s Js] (a pair of Jacks)
Omicron333 collected $9.70 from pot
*** SUMMARY ***
Total pot $10.12 | Rake $0.42 
Board [4d 6d Jh Tc Kd]
Seat 1: Afan45 (button) folded before Flop (didn't bet)
Seat 2: 1857Dan (small blind) folded before Flop
Seat 3: Omicron333 (big blind) showed [Ad Ks] and won ($9.70) with a pair of Kings
Seat 4: PVKMSSSSR folded before Flop (didn't bet)
Seat 5: romkamolod showed [9s Js] and lost with a pair of Jacks
Seat 6: HubertusB folded before Flop (didn't bet)



PokerStars Zoom Hand #186646676254:  Hold'em No Limit ($0.02/$0.05) - 2018/05/20 21:59:55 CCT [2018/05/20 9:59:55 ET]
Table 'Donati' 6-max Seat #1 is the button
Seat 1: HubertusB ($5.16 in chips) 
Seat 2: confirmedanc ($5 in chips) 
Seat 3: ANN11061962 ($3.65 in chips) 
Seat 4: TheFibonachi ($2.87 in chips) 
Seat 5: tpk0813 ($3.19 in chips) 
Seat 6: Parjato ($8.35 in chips) 
confirmedanc: posts small blind $0.02
ANN11061962: posts big blind $0.05
*** HOLE CARDS ***
Dealt to HubertusB [6h Kh]
TheFibonachi: folds 
tpk0813: folds 
Parjato: folds 
HubertusB: raises $0.05 to $0.10
confirmedanc: raises $0.20 to $0.30
ANN11061962: folds 
HubertusB: folds 
Uncalled bet ($0.20) returned to confirmedanc
confirmedanc collected $0.25 from pot
confirmedanc: doesn't show hand 
*** SUMMARY ***
Total pot $0.25 | Rake $0 
Seat 1: HubertusB (button) folded before Flop
Seat 2: confirmedanc (small blind) collected ($0.25)
Seat 3: ANN11061962 (big blind) folded before Flop
Seat 4: TheFibonachi folded before Flop (didn't bet)
Seat 5: tpk0813 folded before Flop (didn't bet)
Seat 6: Parjato folded before Flop (didn't bet)



PokerStars Zoom Hand #186646687243:  Hold'em No Limit ($0.02/$0.05) - 2018/05/20 22:00:18 CCT [2018/05/20 10:00:18 ET]
Table 'Donati' 6-max Seat #1 is the button
Seat 1: GyNy1976 ($9.66 in chips) 
Seat 2: beluci1 ($9.25 in chips) 
Seat 3: PERKASRAK ($2.69 in chips) 
Seat 4: superRODRI ($5 in chips) 
Seat 5: serge87100 ($6.70 in chips) 
Seat 6: HubertusB ($5.06 in chips) 
beluci1: posts small blind $0.02
PERKASRAK: posts big blind $0.05
*** HOLE CARDS ***
Dealt to HubertusB [4d 2c]
superRODRI: folds 
serge87100: folds 
HubertusB: folds 
GyNy1976: folds 
beluci1: folds 
Uncalled bet ($0.03) returned to PERKASRAK
PERKASRAK collected $0.04 from pot
PERKASRAK: doesn't show hand 
*** SUMMARY ***
Total pot $0.04 | Rake $0 
Seat 1: GyNy1976 (button) folded before Flop (didn't bet)
Seat 2: beluci1 (small blind) folded before Flop
Seat 3: PERKASRAK (big blind) collected ($0.04)
Seat 4: superRODRI folded before Flop (didn't bet)
Seat 5: serge87100 folded before Flop (didn't bet)
Seat 6: HubertusB folded before Flop (didn't bet)



PokerStars Zoom Hand #186646689730:  Hold'em No Limit ($0.02/$0.05) - 2018/05/20 22:00:23 CCT [2018/05/20 10:00:23 ET]
Table 'Donati' 6-max Seat #1 is the button
Seat 1: esratrams ($2.25 in chips) 
Seat 2: syrok17 ($6.91 in chips) 
Seat 3: KPVMB ($0.93 in chips) 
Seat 4: QWER7786 ($10.66 in chips) 
Seat 5: HubertusB ($5.06 in chips) 
Seat 6: kappasummer ($4.47 in chips) 
syrok17: posts small blind $0.02
KPVMB: posts big blind $0.05
*** HOLE CARDS ***
Dealt to HubertusB [Ac 2s]
QWER7786: folds 
HubertusB: folds 
kappasummer: folds 
esratrams: calls $0.05
syrok17: folds 
KPVMB: checks 
*** FLOP *** [Ts 5d 7d]
KPVMB: bets $0.05
esratrams: folds 
Uncalled bet ($0.05) returned to KPVMB
KPVMB collected $0.12 from pot
KPVMB: doesn't show hand 
*** SUMMARY ***
Total pot $0.12 | Rake $0 
Board [Ts 5d 7d]
Seat 1: esratrams (button) folded on the Flop
Seat 2: syrok17 (small blind) folded before Flop
Seat 3: KPVMB (big blind) collected ($0.12)
Seat 4: QWER7786 folded before Flop (didn't bet)
Seat 5: HubertusB folded before Flop (didn't bet)
Seat 6: kappasummer folded before Flop (didn't bet)



PokerStars Zoom Hand #186646667332:  Hold'em No Limit ($0.02/$0.05) - 2018/05/20 21:59:36 CCT [2018/05/20 9:59:36 ET]
Table 'Donati' 6-max Seat #1 is the button
Seat 1: jason032323 ($6.41 in chips) 
Seat 2: HubertusB ($5.23 in chips) 
Seat 3: maminsibe601 ($2.43 in chips) 
Seat 4: BardJeka ($5.16 in chips) 
Seat 5: lzoflamingo ($5.13 in chips) 
Seat 6: serge87100 ($6.75 in chips) 
HubertusB: posts small blind $0.02
maminsibe601: posts big blind $0.05
*** HOLE CARDS ***
Dealt to HubertusB [6d 3s]
BardJeka: raises $0.10 to $0.15
lzoflamingo: folds 
serge87100: folds 
jason032323: folds 
HubertusB: folds 
maminsibe601: calls $0.10
*** FLOP *** [6c Ad 5c]
maminsibe601: checks 
BardJeka: bets $0.25
maminsibe601: calls $0.25
*** TURN *** [6c Ad 5c] [4s]
maminsibe601: checks 
BardJeka: bets $0.70
maminsibe601: raises $1.33 to $2.03 and is all-in
BardJeka: calls $1.33
*** RIVER *** [6c Ad 5c 4s] [Ah]
*** SHOW DOWN ***
maminsibe601: shows [2h 3h] (a straight, Deuce to Six)
BardJeka: shows [5d 5s] (a full house, Fives full of Aces)
BardJeka collected $4.68 from pot
*** SUMMARY ***
Total pot $4.88 | Rake $0.20 
Board [6c Ad 5c 4s Ah]
Seat 1: jason032323 (button) folded before Flop (didn't bet)
Seat 2: HubertusB (small blind) folded before Flop
Seat 3: maminsibe601 (big blind) showed [2h 3h] and lost with a straight, Deuce to Six
Seat 4: BardJeka showed [5d 5s] and won ($4.68) with a full house, Fives full of Aces
Seat 5: lzoflamingo folded before Flop (didn't bet)
Seat 6: serge87100 folded before Flop (didn't bet)



PokerStars Zoom Hand #186646692656:  Hold'em No Limit ($0.02/$0.05) - 2018/05/20 22:00:29 CCT [2018/05/20 10:00:29 ET]
Table 'Donati' 6-max Seat #1 is the button
Seat 1: OsloVest ($13.10 in chips) 
Seat 2: Egozocker ($5.71 in chips) 
Seat 3: Zheka-Alaei ($5.95 in chips) 
Seat 4: HubertusB ($5.06 in chips) 
Seat 5: MinouXYZ ($3.30 in chips) 
Seat 6: celams ($5.04 in chips) 
Egozocker: posts small blind $0.02
Zheka-Alaei: posts big blind $0.05
*** HOLE CARDS ***
Dealt to HubertusB [3s 7c]
HubertusB: folds 
MinouXYZ: folds 
celams: folds 
OsloVest: folds 
Egozocker: raises $0.10 to $0.15
Zheka-Alaei: calls $0.10
*** FLOP *** [5h Qc 3h]
Egozocker: bets $0.22
Zheka-Alaei: folds 
Uncalled bet ($0.22) returned to Egozocker
Egozocker collected $0.29 from pot
Egozocker: doesn't show hand 
*** SUMMARY ***
Total pot $0.30 | Rake $0.01 
Board [5h Qc 3h]
Seat 1: OsloVest (button) folded before Flop (didn't bet)
Seat 2: Egozocker (small blind) collected ($0.29)
Seat 3: Zheka-Alaei (big blind) folded on the Flop
Seat 4: HubertusB folded before Flop (didn't bet)
Seat 5: MinouXYZ folded before Flop (didn't bet)
Seat 6: celams folded before Flop (didn't bet)



PokerStars Zoom Hand #186646698215:  Hold'em No Limit ($0.02/$0.05) - 2018/05/20 22:00:40 CCT [2018/05/20 10:00:40 ET]
Table 'Donati' 6-max Seat #1 is the button
Seat 1: RedBullRobi ($2.50 in chips) 
Seat 2: eSSayL65 ($13.13 in chips) 
Seat 3: seaman455 ($6.11 in chips) 
Seat 4: andy000223 ($5.07 in chips) 
Seat 5: HubertusB ($5.04 in chips) 
Seat 6: VLSALT ($8.60 in chips) 
eSSayL65: posts small blind $0.02
seaman455: posts big blind $0.05
*** HOLE CARDS ***
Dealt to HubertusB [Tc 6c]
andy000223: folds 
HubertusB: folds 
VLSALT: folds 
RedBullRobi: folds 
eSSayL65: calls $0.03
seaman455: checks 
*** FLOP *** [Qs Kc Js]
eSSayL65: checks 
seaman455: checks 
*** TURN *** [Qs Kc Js] [2h]
eSSayL65: checks 
seaman455: bets $0.05
eSSayL65: calls $0.05
*** RIVER *** [Qs Kc Js 2h] [5s]
eSSayL65: checks 
seaman455: bets $0.10
eSSayL65: folds 
Uncalled bet ($0.10) returned to seaman455
seaman455 collected $0.19 from pot
seaman455: doesn't show hand 
*** SUMMARY ***
Total pot $0.20 | Rake $0.01 
Board [Qs Kc Js 2h 5s]
Seat 1: RedBullRobi (button) folded before Flop (didn't bet)
Seat 2: eSSayL65 (small blind) folded on the River
Seat 3: seaman455 (big blind) collected ($0.19)
Seat 4: andy000223 folded before Flop (didn't bet)
Seat 5: HubertusB folded before Flop (didn't bet)
Seat 6: VLSALT folded before Flop (didn't bet)



PokerStars Zoom Hand #186646695675:  Hold'em No Limit ($0.02/$0.05) - 2018/05/20 22:00:35 CCT [2018/05/20 10:00:35 ET]
Table 'Donati' 6-max Seat #1 is the button
Seat 1: ninix17 ($8.80 in chips) 
Seat 2: HubertusB ($5.06 in chips) 
Seat 3: archibald129 ($5 in chips) 
Seat 4: Julietta1997 ($7.22 in chips) 
Seat 5: ccwolf7 ($2.48 in chips) 
Seat 6: nick235711 ($5 in chips) 
HubertusB: posts small blind $0.02
archibald129: posts big blind $0.05
*** HOLE CARDS ***
Dealt to HubertusB [2h 5c]
Julietta1997: folds 
ccwolf7: folds 
nick235711: raises $0.10 to $0.15
ninix17: calls $0.15
HubertusB: folds 
archibald129: folds 
*** FLOP *** [3d Ad 4h]
nick235711: bets $0.15
ninix17: calls $0.15
*** TURN *** [3d Ad 4h] [Th]
nick235711: checks 
ninix17: bets $0.43
nick235711: folds 
Uncalled bet ($0.43) returned to ninix17
ninix17 collected $0.64 from pot
ninix17: doesn't show hand 
*** SUMMARY ***
Total pot $0.67 | Rake $0.03 
Board [3d Ad 4h Th]
Seat 1: ninix17 (button) collected ($0.64)
Seat 2: HubertusB (small blind) folded before Flop
Seat 3: archibald129 (big blind) folded before Flop
Seat 4: Julietta1997 folded before Flop (didn't bet)
Seat 5: ccwolf7 folded before Flop (didn't bet)
Seat 6: nick235711 folded on the Turn



PokerStars Zoom Hand #186646700679:  Hold'em No Limit ($0.02/$0.05) - 2018/05/20 22:00:45 CCT [2018/05/20 10:00:45 ET]
Table 'Donati' 6-max Seat #1 is the button
Seat 1: Farad84 ($5.43 in chips) 
Seat 2: alex280183 ($1.32 in chips) 
Seat 3: HubertusB ($5.04 in chips) 
Seat 4: Manolo19765 ($2.95 in chips) 
Seat 5: $ir_AleXXX ($5.45 in chips) 
Seat 6: OIegan™ ($5.11 in chips) 
alex280183: posts small blind $0.02
HubertusB: posts big blind $0.05
*** HOLE CARDS ***
Dealt to HubertusB [Th 6s]
Manolo19765: folds 
$ir_AleXXX: folds 
OIegan™: folds 
Farad84: raises $0.05 to $0.10
alex280183: calls $0.08
HubertusB: folds 
*** FLOP *** [7h 4s Qc]
alex280183: checks 
Farad84: checks 
*** TURN *** [7h 4s Qc] [Kd]
alex280183: checks 
Farad84: checks 
*** RIVER *** [7h 4s Qc Kd] [9d]
alex280183: checks 
Farad84: checks 
*** SHOW DOWN ***
alex280183: shows [Ac 4c] (a pair of Fours)
Farad84: shows [9h Ad] (a pair of Nines)
Farad84 collected $0.24 from pot
*** SUMMARY ***
Total pot $0.25 | Rake $0.01 
Board [7h 4s Qc Kd 9d]
Seat 1: Farad84 (button) showed [9h Ad] and won ($0.24) with a pair of Nines
Seat 2: alex280183 (small blind) showed [Ac 4c] and lost with a pair of Fours
Seat 3: HubertusB (big blind) folded before Flop
Seat 4: Manolo19765 folded before Flop (didn't bet)
Seat 5: $ir_AleXXX folded before Flop (didn't bet)
Seat 6: OIegan™ folded before Flop (didn't bet)



PokerStars Zoom Hand #186646709454:  Hold'em No Limit ($0.02/$0.05) - 2018/05/20 22:01:02 CCT [2018/05/20 10:01:02 ET]
Table 'Donati' 6-max Seat #1 is the button
Seat 1: coper42 ($2.86 in chips) 
Seat 2: seaman455 ($5.90 in chips) 
Seat 3: Alexkazanec ($5.17 in chips) 
Seat 4: WhiteWolf459 ($5.52 in chips) 
Seat 5: 21127788 ($5.97 in chips) 
Seat 6: HubertusB ($4.99 in chips) 
seaman455: posts small blind $0.02
Alexkazanec: posts big blind $0.05
*** HOLE CARDS ***
Dealt to HubertusB [8s 8d]
WhiteWolf459: folds 
21127788: folds 
HubertusB: raises $0.10 to $0.15
coper42: folds 
seaman455: raises $0.30 to $0.45
Alexkazanec: folds 
HubertusB: raises $0.70 to $1.15
seaman455: raises $1.70 to $2.85
HubertusB: folds 
Uncalled bet ($1.70) returned to seaman455
seaman455 collected $2.35 from pot
seaman455: doesn't show hand 
*** SUMMARY ***
Total pot $2.35 | Rake $0 
Seat 1: coper42 (button) folded before Flop (didn't bet)
Seat 2: seaman455 (small blind) collected ($2.35)
Seat 3: Alexkazanec (big blind) folded before Flop
Seat 4: WhiteWolf459 folded before Flop (didn't bet)
Seat 5: 21127788 folded before Flop (didn't bet)
Seat 6: HubertusB folded before Flop



PokerStars Zoom Hand #186646737210:  Hold'em No Limit ($0.02/$0.05) - 2018/05/20 22:01:54 CCT [2018/05/20 10:01:54 ET]
Table 'Donati' 6-max Seat #1 is the button
Seat 1: yuki0824 ($6.23 in chips) 
Seat 2: nick235711 ($5 in chips) 
Seat 3: DCove ($5 in chips) 
Seat 4: HubertusB ($3.84 in chips) 
Seat 5: PirateOfArrr ($6.08 in chips) 
Seat 6: Narchx ($4.39 in chips) 
nick235711: posts small blind $0.02
DCove: posts big blind $0.05
*** HOLE CARDS ***
Dealt to HubertusB [Jd 3s]
HubertusB: folds 
PirateOfArrr: folds 
Narchx: folds 
yuki0824: raises $0.10 to $0.15
nick235711: folds 
DCove: folds 
Uncalled bet ($0.10) returned to yuki0824
yuki0824 collected $0.12 from pot
yuki0824: doesn't show hand 
*** SUMMARY ***
Total pot $0.12 | Rake $0 
Seat 1: yuki0824 (button) collected ($0.12)
Seat 2: nick235711 (small blind) folded before Flop
Seat 3: DCove (big blind) folded before Flop
Seat 4: HubertusB folded before Flop (didn't bet)
Seat 5: PirateOfArrr folded before Flop (didn't bet)
Seat 6: Narchx folded before Flop (didn't bet)



PokerStars Zoom Hand #186646743366:  Hold'em No Limit ($0.02/$0.05) - 2018/05/20 22:02:05 CCT [2018/05/20 10:02:05 ET]
Table 'Donati' 6-max Seat #1 is the button
Seat 1: Exclusiveby ($6.09 in chips) 
Seat 2: <Bogolal> ($5.41 in chips) 
Seat 3: olega2006 ($7.52 in chips) 
Seat 4: HubertusB ($3.84 in chips) 
Seat 5: kranovoy22 ($5 in chips) 
Seat 6: kurawara2701 ($5.74 in chips) 
<Bogolal>: posts small blind $0.02
olega2006: posts big blind $0.05
*** HOLE CARDS ***
Dealt to HubertusB [8s Qs]
HubertusB: raises $0.10 to $0.15
kranovoy22: folds 
kurawara2701: folds 
Exclusiveby: folds 
<Bogolal>: folds 
olega2006: folds 
Uncalled bet ($0.10) returned to HubertusB
HubertusB collected $0.12 from pot
HubertusB: doesn't show hand 
*** SUMMARY ***
Total pot $0.12 | Rake $0 
Seat 1: Exclusiveby (button) folded before Flop (didn't bet)
Seat 2: <Bogolal> (small blind) folded before Flop
Seat 3: olega2006 (big blind) folded before Flop
Seat 4: HubertusB collected ($0.12)
Seat 5: kranovoy22 folded before Flop (didn't bet)
Seat 6: kurawara2701 folded before Flop (didn't bet)



PokerStars Zoom Hand #186646750611:  Hold'em No Limit ($0.02/$0.05) - 2018/05/20 22:02:18 CCT [2018/05/20 10:02:18 ET]
Table 'Donati' 6-max Seat #1 is the button
Seat 1: umekichi88 ($7.70 in chips) 
Seat 2: beluci1 ($5.06 in chips) 
Seat 3: serg197211 ($5.80 in chips) 
Seat 4: HubertusB ($3.91 in chips) 
Seat 5: Siorassc ($5 in chips) 
Seat 6: VLSALT ($5.16 in chips) 
beluci1: posts small blind $0.02
serg197211: posts big blind $0.05
*** HOLE CARDS ***
Dealt to HubertusB [7c Tc]
HubertusB: folds 
Siorassc: folds 
VLSALT: folds 
umekichi88: folds 
beluci1: folds 
Uncalled bet ($0.03) returned to serg197211
serg197211 collected $0.04 from pot
serg197211: doesn't show hand 
*** SUMMARY ***
Total pot $0.04 | Rake $0 
Seat 1: umekichi88 (button) folded before Flop (didn't bet)
Seat 2: beluci1 (small blind) folded before Flop
Seat 3: serg197211 (big blind) collected ($0.04)
Seat 4: HubertusB folded before Flop (didn't bet)
Seat 5: Siorassc folded before Flop (didn't bet)
Seat 6: VLSALT folded before Flop (didn't bet)



PokerStars Zoom Hand #186646740413:  Hold'em No Limit ($0.02/$0.05) - 2018/05/20 22:02:00 CCT [2018/05/20 10:02:00 ET]
Table 'Donati' 6-max Seat #1 is the button
Seat 1: HubertusB ($3.84 in chips) 
Seat 2: RedBullRobi ($3.90 in chips) 
Seat 3: jason032323 ($6.54 in chips) 
Seat 4: jeffpig16 ($5.07 in chips) 
Seat 5: Little Geewood ($6.18 in chips) 
Seat 6: fivestart852 ($6.49 in chips) 
RedBullRobi: posts small blind $0.02
jason032323: posts big blind $0.05
*** HOLE CARDS ***
Dealt to HubertusB [5s Jc]
jeffpig16: folds 
Little Geewood: folds 
fivestart852: folds 
HubertusB: folds 
RedBullRobi: raises $0.05 to $0.10
jason032323: calls $0.05
*** FLOP *** [Jd Kh Td]
RedBullRobi: checks 
jason032323: checks 
*** TURN *** [Jd Kh Td] [8s]
RedBullRobi: checks 
jason032323: checks 
*** RIVER *** [Jd Kh Td 8s] [7d]
RedBullRobi: checks 
jason032323: bets $0.14
RedBullRobi: folds 
Uncalled bet ($0.14) returned to jason032323
jason032323 collected $0.19 from pot
jason032323: doesn't show hand 
*** SUMMARY ***
Total pot $0.20 | Rake $0.01 
Board [Jd Kh Td 8s 7d]
Seat 1: HubertusB (button) folded before Flop (didn't bet)
Seat 2: RedBullRobi (small blind) folded on the River
Seat 3: jason032323 (big blind) collected ($0.19)
Seat 4: jeffpig16 folded before Flop (didn't bet)
Seat 5: Little Geewood folded before Flop (didn't bet)
Seat 6: fivestart852 folded before Flop (didn't bet)



PokerStars Zoom Hand #186646757778:  Hold'em No Limit ($0.02/$0.05) - 2018/05/20 22:02:29 CCT [2018/05/20 10:02:29 ET]
Table 'Donati' 6-max Seat #1 is the button
Seat 1: ptolemaios99 ($17.28 in chips) 
Seat 2: adytoditza ($6.14 in chips) 
Seat 3: HubertusB ($3.89 in chips) 
Seat 4: PhilBrock ($6.10 in chips) 
Seat 5: Fish @ China ($5.07 in chips) 
Seat 6: TheFibonachi ($2.61 in chips) 
adytoditza: posts small blind $0.02
HubertusB: posts big blind $0.05
*** HOLE CARDS ***
Dealt to HubertusB [Js 4h]
PhilBrock: folds 
Fish @ China: folds 
TheFibonachi: raises $0.07 to $0.12
ptolemaios99: folds 
adytoditza: folds 
HubertusB: folds 
Uncalled bet ($0.07) returned to TheFibonachi
TheFibonachi collected $0.12 from pot
TheFibonachi: doesn't show hand 
*** SUMMARY ***
Total pot $0.12 | Rake $0 
Seat 1: ptolemaios99 (button) folded before Flop (didn't bet)
Seat 2: adytoditza (small blind) folded before Flop
Seat 3: HubertusB (big blind) folded before Flop
Seat 4: PhilBrock folded before Flop (didn't bet)
Seat 5: Fish @ China folded before Flop (didn't bet)
Seat 6: TheFibonachi collected ($0.12)



PokerStars Zoom Hand #186646753876:  Hold'em No Limit ($0.02/$0.05) - 2018/05/20 22:02:24 CCT [2018/05/20 10:02:24 ET]
Table 'Donati' 6-max Seat #1 is the button
Seat 1: beluci1 ($5.04 in chips) 
Seat 2: HubertusB ($3.91 in chips) 
Seat 3: DenBeetle ($2.42 in chips) 
Seat 4: Guernik ($8.08 in chips) 
Seat 5: gto4012 ($7.14 in chips) 
Seat 6: svetazar88 ($4.08 in chips) 
HubertusB: posts small blind $0.02
DenBeetle: posts big blind $0.05
*** HOLE CARDS ***
Dealt to HubertusB [Jd 7c]
Guernik: folds 
gto4012: folds 
svetazar88 has timed out
svetazar88: folds 
beluci1: raises $0.10 to $0.15
HubertusB: folds 
DenBeetle: folds 
Uncalled bet ($0.10) returned to beluci1
beluci1 collected $0.12 from pot
beluci1: doesn't show hand 
*** SUMMARY ***
Total pot $0.12 | Rake $0 
Seat 1: beluci1 (button) collected ($0.12)
Seat 2: HubertusB (small blind) folded before Flop
Seat 3: DenBeetle (big blind) folded before Flop
Seat 4: Guernik folded before Flop (didn't bet)
Seat 5: gto4012 folded before Flop (didn't bet)
Seat 6: svetazar88 folded before Flop (didn't bet)



PokerStars Zoom Hand #186646765976:  Hold'em No Limit ($0.02/$0.05) - 2018/05/20 22:02:44 CCT [2018/05/20 10:02:44 ET]
Table 'Donati' 6-max Seat #1 is the button
Seat 1: depotapo ($5.59 in chips) 
Seat 2: yurasulaev ($8.25 in chips) 
Seat 3: bidipro ($5 in chips) 
Seat 4: Mr.Nuttts ($5.21 in chips) 
Seat 5: AnalFire999 ($2.94 in chips) 
Seat 6: HubertusB ($3.84 in chips) 
yurasulaev: posts small blind $0.02
bidipro: posts big blind $0.05
*** HOLE CARDS ***
Dealt to HubertusB [7h Ks]
Mr.Nuttts: folds 
AnalFire999: folds 
HubertusB: folds 
depotapo: folds 
yurasulaev: raises $0.10 to $0.15
bidipro: raises $0.30 to $0.45
yurasulaev: folds 
Uncalled bet ($0.30) returned to bidipro
bidipro collected $0.30 from pot
bidipro: doesn't show hand 
*** SUMMARY ***
Total pot $0.30 | Rake $0 
Seat 1: depotapo (button) folded before Flop (didn't bet)
Seat 2: yurasulaev (small blind) folded before Flop
Seat 3: bidipro (big blind) collected ($0.30)
Seat 4: Mr.Nuttts folded before Flop (didn't bet)
Seat 5: AnalFire999 folded before Flop (didn't bet)
Seat 6: HubertusB folded before Flop (didn't bet)



PokerStars Zoom Hand #186646763698:  Hold'em No Limit ($0.02/$0.05) - 2018/05/20 22:02:40 CCT [2018/05/20 10:02:40 ET]
Table 'Donati' 6-max Seat #1 is the button
Seat 1: HubertusB ($3.84 in chips) 
Seat 2: opopo0009 ($5.14 in chips) 
Seat 3: VingadorV ($5.68 in chips) 
Seat 4: aaw990619 ($6.29 in chips) 
Seat 5: Faku710 ($5.68 in chips) 
Seat 6: Clubberer80 ($5 in chips) 
opopo0009: posts small blind $0.02
VingadorV: posts big blind $0.05
*** HOLE CARDS ***
Dealt to HubertusB [4c 2s]
aaw990619: folds 
Faku710: folds 
Clubberer80: folds 
HubertusB: folds 
opopo0009: raises $0.10 to $0.15
VingadorV: calls $0.10
*** FLOP *** [6d 9d 7d]
opopo0009: bets $0.10
VingadorV: calls $0.10
*** TURN *** [6d 9d 7d] [Ad]
opopo0009: checks 
VingadorV: checks 
*** RIVER *** [6d 9d 7d Ad] [Kc]
opopo0009: checks 
VingadorV: checks 
*** SHOW DOWN ***
opopo0009: shows [As 8h] (a pair of Aces)
VingadorV: shows [6c 9c] (two pair, Nines and Sixes)
VingadorV collected $0.48 from pot
*** SUMMARY ***
Total pot $0.50 | Rake $0.02 
Board [6d 9d 7d Ad Kc]
Seat 1: HubertusB (button) folded before Flop (didn't bet)
Seat 2: opopo0009 (small blind) showed [As 8h] and lost with a pair of Aces
Seat 3: VingadorV (big blind) showed [6c 9c] and won ($0.48) with two pair, Nines and Sixes
Seat 4: aaw990619 folded before Flop (didn't bet)
Seat 5: Faku710 folded before Flop (didn't bet)
Seat 6: Clubberer80 folded before Flop (didn't bet)



PokerStars Zoom Hand #186646768779:  Hold'em No Limit ($0.02/$0.05) - 2018/05/20 22:02:49 CCT [2018/05/20 10:02:49 ET]
Table 'Donati' 6-max Seat #1 is the button
Seat 1: julehjuleh ($5.24 in chips) 
Seat 2: Palandr ($7.24 in chips) 
Seat 3: Fredchie ($13.57 in chips) 
Seat 4: thekvlt ($5 in chips) 
Seat 5: HubertusB ($3.84 in chips) 
Seat 6: DCove ($5.07 in chips) 
Palandr: posts small blind $0.02
Fredchie: posts big blind $0.05
*** HOLE CARDS ***
Dealt to HubertusB [Kd Ac]
thekvlt: folds 
HubertusB: raises $0.10 to $0.15
DCove has timed out
DCove: folds 
julehjuleh: folds 
Palandr: folds 
Fredchie: calls $0.10
*** FLOP *** [Qd 8d 9s]
Fredchie: checks 
HubertusB: checks 
*** TURN *** [Qd 8d 9s] [Jc]
Fredchie: checks 
HubertusB: checks 
*** RIVER *** [Qd 8d 9s Jc] [2s]
Fredchie: checks 
HubertusB: checks 
*** SHOW DOWN ***
Fredchie: shows [Jh Ks] (a pair of Jacks)
HubertusB: mucks hand 
Fredchie collected $0.31 from pot
*** SUMMARY ***
Total pot $0.32 | Rake $0.01 
Board [Qd 8d 9s Jc 2s]
Seat 1: julehjuleh (button) folded before Flop (didn't bet)
Seat 2: Palandr (small blind) folded before Flop
Seat 3: Fredchie (big blind) showed [Jh Ks] and won ($0.31) with a pair of Jacks
Seat 4: thekvlt folded before Flop (didn't bet)
Seat 5: HubertusB mucked [Kd Ac]
Seat 6: DCove folded before Flop (didn't bet)



PokerStars Zoom Hand #186646794847:  Hold'em No Limit ($0.02/$0.05) - 2018/05/20 22:03:32 CCT [2018/05/20 10:03:32 ET]
Table 'Donati' 6-max Seat #1 is the button
Seat 1: ConQuRoR25 ($2.25 in chips) 
Seat 2: HubertusB ($3.69 in chips) 
Seat 3: PhilBrock ($5.19 in chips) 
Seat 4: an2004 ($6.63 in chips) 
Seat 5: Vajdalf92 ($2.52 in chips) 
Seat 6: PirateOfArrr ($6.61 in chips) 
HubertusB: posts small blind $0.02
PhilBrock: posts big blind $0.05
*** HOLE CARDS ***
Dealt to HubertusB [Kh 2c]
an2004: folds 
Vajdalf92: folds 
PirateOfArrr: folds 
ConQuRoR25: folds 
HubertusB: folds 
Uncalled bet ($0.03) returned to PhilBrock
PhilBrock collected $0.04 from pot
PhilBrock: doesn't show hand 
*** SUMMARY ***
Total pot $0.04 | Rake $0 
Seat 1: ConQuRoR25 (button) folded before Flop (didn't bet)
Seat 2: HubertusB (small blind) folded before Flop
Seat 3: PhilBrock (big blind) collected ($0.04)
Seat 4: an2004 folded before Flop (didn't bet)
Seat 5: Vajdalf92 folded before Flop (didn't bet)
Seat 6: PirateOfArrr folded before Flop (didn't bet)



PokerStars Zoom Hand #186646805744:  Hold'em No Limit ($0.02/$0.05) - 2018/05/20 22:03:50 CCT [2018/05/20 10:03:50 ET]
Table 'Donati' 6-max Seat #1 is the button
Seat 1: Manolo19765 ($2.77 in chips) 
Seat 2: 3ta2wki ($5 in chips) 
Seat 3: HubertusB ($3.67 in chips) 
Seat 4: KPVMB ($1.46 in chips) 
Seat 5: VovaV ($6.91 in chips) 
Seat 6: Palandr ($7.93 in chips) 
3ta2wki: posts small blind $0.02
HubertusB: posts big blind $0.05
*** HOLE CARDS ***
Dealt to HubertusB [4d Jd]
KPVMB: raises $0.05 to $0.10
VovaV: folds 
Palandr: folds 
Manolo19765: folds 
3ta2wki: folds 
HubertusB: folds 
Uncalled bet ($0.05) returned to KPVMB
KPVMB collected $0.12 from pot
KPVMB: doesn't show hand 
*** SUMMARY ***
Total pot $0.12 | Rake $0 
Seat 1: Manolo19765 (button) folded before Flop (didn't bet)
Seat 2: 3ta2wki (small blind) folded before Flop
Seat 3: HubertusB (big blind) folded before Flop
Seat 4: KPVMB collected ($0.12)
Seat 5: VovaV folded before Flop (didn't bet)
Seat 6: Palandr folded before Flop (didn't bet)



PokerStars Zoom Hand #186646812235:  Hold'em No Limit ($0.02/$0.05) - 2018/05/20 22:04:01 CCT [2018/05/20 10:04:01 ET]
Table 'Donati' 6-max Seat #1 is the button
Seat 1: HubertusB ($3.62 in chips) 
Seat 2: TiKovKa ($6.42 in chips) 
Seat 3: denshark1986 ($6.31 in chips) 
Seat 4: ptolemaios99 ($17.65 in chips) 
Seat 5: sizuu1225 ($9.42 in chips) 
Seat 6: Siorassc ($5 in chips) 
TiKovKa: posts small blind $0.02
denshark1986: posts big blind $0.05
*** HOLE CARDS ***
Dealt to HubertusB [Ah Ks]
ptolemaios99: raises $0.10 to $0.15
sizuu1225: folds 
Siorassc: folds 
HubertusB: raises $0.55 to $0.70
TiKovKa: folds 
denshark1986: folds 
ptolemaios99: folds 
Uncalled bet ($0.55) returned to HubertusB
HubertusB collected $0.37 from pot
HubertusB: doesn't show hand 
*** SUMMARY ***
Total pot $0.37 | Rake $0 
Seat 1: HubertusB (button) collected ($0.37)
Seat 2: TiKovKa (small blind) folded before Flop
Seat 3: denshark1986 (big blind) folded before Flop
Seat 4: ptolemaios99 folded before Flop
Seat 5: sizuu1225 folded before Flop (didn't bet)
Seat 6: Siorassc folded before Flop (didn't bet)



PokerStars Zoom Hand #186646799600:  Hold'em No Limit ($0.02/$0.05) - 2018/05/20 22:03:40 CCT [2018/05/20 10:03:40 ET]
Table 'Donati' 6-max Seat #1 is the button
Seat 1: Andranik23ru ($1.52 in chips) 
Seat 2: And_Camargo ($5 in chips) 
Seat 3: fedkAa ($10.46 in chips) 
Seat 4: Voki871 ($5.15 in chips) 
Seat 5: DenBeetle ($2.67 in chips) 
Seat 6: HubertusB ($3.67 in chips) 
And_Camargo: posts small blind $0.02
fedkAa: posts big blind $0.05
*** HOLE CARDS ***
Dealt to HubertusB [Jh 4s]
Voki871: raises $0.12 to $0.17
DenBeetle: calls $0.17
HubertusB: folds 
Andranik23ru: folds 
And_Camargo: folds 
fedkAa: folds 
*** FLOP *** [Ad 3c Ac]
Voki871: checks 
DenBeetle: bets $0.05
Voki871: calls $0.05
*** TURN *** [Ad 3c Ac] [Ah]
Voki871: bets $0.49
DenBeetle: calls $0.49
*** RIVER *** [Ad 3c Ac Ah] [5d]
Voki871: checks 
DenBeetle: bets $1.43
Voki871: calls $1.43
*** SHOW DOWN ***
DenBeetle: shows [Th As] (four of a kind, Aces)
Voki871: mucks hand 
DenBeetle collected $4.17 from pot
*** SUMMARY ***
Total pot $4.35 | Rake $0.18 
Board [Ad 3c Ac Ah 5d]
Seat 1: Andranik23ru (button) folded before Flop (didn't bet)
Seat 2: And_Camargo (small blind) folded before Flop
Seat 3: fedkAa (big blind) folded before Flop
Seat 4: Voki871 mucked [9s 9d]
Seat 5: DenBeetle showed [Th As] and won ($4.17) with four of a kind, Aces
Seat 6: HubertusB folded before Flop (didn't bet)



PokerStars Zoom Hand #186646824887:  Hold'em No Limit ($0.02/$0.05) - 2018/05/20 22:04:22 CCT [2018/05/20 10:04:22 ET]
Table 'Donati' 6-max Seat #1 is the button
Seat 1: OIegan™ ($5.02 in chips) 
Seat 2: VovaV ($6.91 in chips) 
Seat 3: converse12 ($2.50 in chips) 
Seat 4: HubertusB ($3.84 in chips) 
Seat 5: planejack ($7.13 in chips) 
Seat 6: Yamma18 ($7.58 in chips) 
VovaV: posts small blind $0.02
converse12: posts big blind $0.05
*** HOLE CARDS ***
Dealt to HubertusB [5h 4s]
HubertusB: folds 
planejack: folds 
Yamma18: folds 
OIegan™: folds 
VovaV: raises $0.10 to $0.15
converse12: calls $0.10
*** FLOP *** [8c 3s Ac]
VovaV: bets $0.15
converse12: folds 
Uncalled bet ($0.15) returned to VovaV
VovaV collected $0.29 from pot
VovaV: doesn't show hand 
*** SUMMARY ***
Total pot $0.30 | Rake $0.01 
Board [8c 3s Ac]
Seat 1: OIegan™ (button) folded before Flop (didn't bet)
Seat 2: VovaV (small blind) collected ($0.29)
Seat 3: converse12 (big blind) folded on the Flop
Seat 4: HubertusB folded before Flop (didn't bet)
Seat 5: planejack folded before Flop (didn't bet)
Seat 6: Yamma18 folded before Flop (didn't bet)



PokerStars Zoom Hand #186646827876:  Hold'em No Limit ($0.02/$0.05) - 2018/05/20 22:04:27 CCT [2018/05/20 10:04:27 ET]
Table 'Donati' 6-max Seat #1 is the button
Seat 1: tumo1326 ($17.20 in chips) 
Seat 2: PiNe4ppLe ($9.60 in chips) 
Seat 3: confirmedanc ($5.24 in chips) 
Seat 4: HubertusB ($3.84 in chips) 
Seat 5: grunge&punk ($8.02 in chips) 
Seat 6: nerox09 ($5.19 in chips) 
PiNe4ppLe: posts small blind $0.02
confirmedanc: posts big blind $0.05
*** HOLE CARDS ***
Dealt to HubertusB [7d 5d]
HubertusB: raises $0.15 to $0.20
grunge&punk: folds 
nerox09: calls $0.20
tumo1326: folds 
PiNe4ppLe: folds 
confirmedanc: folds 
*** FLOP *** [5c 8d 4h]
HubertusB: bets $0.31
nerox09: calls $0.31
*** TURN *** [5c 8d 4h] [Th]
HubertusB: bets $0.85
nerox09: raises $3.83 to $4.68 and is all-in
HubertusB: folds 
Uncalled bet ($3.83) returned to nerox09
nerox09 collected $2.67 from pot
nerox09: doesn't show hand 
*** SUMMARY ***
Total pot $2.79 | Rake $0.12 
Board [5c 8d 4h Th]
Seat 1: tumo1326 (button) folded before Flop (didn't bet)
Seat 2: PiNe4ppLe (small blind) folded before Flop
Seat 3: confirmedanc (big blind) folded before Flop
Seat 4: HubertusB folded on the Turn
Seat 5: grunge&punk folded before Flop (didn't bet)
Seat 6: nerox09 collected ($2.67)



PokerStars Zoom Hand #186646809245:  Hold'em No Limit ($0.02/$0.05) - 2018/05/20 22:03:56 CCT [2018/05/20 10:03:56 ET]
Table 'Donati' 6-max Seat #1 is the button
Seat 1: taypan101 ($5.48 in chips) 
Seat 2: Yense ($4.95 in chips) 
Seat 3: eyopokki ($5.07 in chips) 
Seat 4: celams ($5.82 in chips) 
Seat 5: HubertusB ($3.62 in chips) 
Seat 6: And_Camargo ($5 in chips) 
Yense: posts small blind $0.02
eyopokki: posts big blind $0.05
*** HOLE CARDS ***
Dealt to HubertusB [4d 7h]
celams: folds 
HubertusB: folds 
And_Camargo: raises $0.10 to $0.15
taypan101: folds 
Yense: calls $0.13
eyopokki: folds 
*** FLOP *** [Js 8s 5d]
Yense: checks 
And_Camargo: bets $0.12
Yense: calls $0.12
*** TURN *** [Js 8s 5d] [4c]
Yense: checks 
And_Camargo: checks 
*** RIVER *** [Js 8s 5d 4c] [As]
Yense: checks 
And_Camargo: bets $0.20
Yense: calls $0.20
*** SHOW DOWN ***
And_Camargo: shows [Td Ah] (a pair of Aces)
Yense: mucks hand 
And_Camargo collected $0.95 from pot
*** SUMMARY ***
Total pot $0.99 | Rake $0.04 
Board [Js 8s 5d 4c As]
Seat 1: taypan101 (button) folded before Flop (didn't bet)
Seat 2: Yense (small blind) mucked [Jc Qc]
Seat 3: eyopokki (big blind) folded before Flop
Seat 4: celams folded before Flop (didn't bet)
Seat 5: HubertusB folded before Flop (didn't bet)
Seat 6: And_Camargo showed [Td Ah] and won ($0.95) with a pair of Aces



PokerStars Zoom Hand #186646856215:  Hold'em No Limit ($0.02/$0.05) - 2018/05/20 22:05:14 CCT [2018/05/20 10:05:14 ET]
Table 'Donati' 6-max Seat #1 is the button
Seat 1: Spookie_1980 ($16.07 in chips) 
Seat 2: nakashi11 ($1.68 in chips) 
Seat 3: HubertusB ($2.48 in chips) 
Seat 4: PERKASRAK ($3.37 in chips) 
Seat 5: And_Camargo ($5.23 in chips) 
Seat 6: Roman197430 ($3.43 in chips) 
nakashi11: posts small blind $0.02
HubertusB: posts big blind $0.05
*** HOLE CARDS ***
Dealt to HubertusB [Kc 4h]
PERKASRAK: folds 
And_Camargo: folds 
Roman197430: raises $0.05 to $0.10
Spookie_1980: folds 
nakashi11: folds 
HubertusB: folds 
Uncalled bet ($0.05) returned to Roman197430
Roman197430 collected $0.12 from pot
Roman197430: doesn't show hand 
*** SUMMARY ***
Total pot $0.12 | Rake $0 
Seat 1: Spookie_1980 (button) folded before Flop (didn't bet)
Seat 2: nakashi11 (small blind) folded before Flop
Seat 3: HubertusB (big blind) folded before Flop
Seat 4: PERKASRAK folded before Flop (didn't bet)
Seat 5: And_Camargo folded before Flop (didn't bet)
Seat 6: Roman197430 collected ($0.12)



PokerStars Zoom Hand #186646866016:  Hold'em No Limit ($0.02/$0.05) - 2018/05/20 22:05:30 CCT [2018/05/20 10:05:30 ET]
Table 'Donati' 6-max Seat #1 is the button
Seat 1: Fredchie ($13.94 in chips) 
Seat 2: HubertusB ($2.43 in chips) 
Seat 3: flyingwoodz ($4.10 in chips) 
Seat 4: uspih ($4.66 in chips) 
Seat 5: Danil548 ($5.99 in chips) 
Seat 6: 3ta2wki ($6.95 in chips) 
HubertusB: posts small blind $0.02
flyingwoodz: posts big blind $0.05
*** HOLE CARDS ***
Dealt to HubertusB [Jc 9c]
uspih: raises $0.10 to $0.15
Danil548: folds 
3ta2wki: folds 
Fredchie: folds 
HubertusB: calls $0.13
flyingwoodz: folds 
*** FLOP *** [Qc 5s As]
HubertusB: checks 
uspih: bets $0.35
HubertusB: folds 
Uncalled bet ($0.35) returned to uspih
uspih collected $0.34 from pot
uspih: doesn't show hand 
*** SUMMARY ***
Total pot $0.35 | Rake $0.01 
Board [Qc 5s As]
Seat 1: Fredchie (button) folded before Flop (didn't bet)
Seat 2: HubertusB (small blind) folded on the Flop
Seat 3: flyingwoodz (big blind) folded before Flop
Seat 4: uspih collected ($0.34)
Seat 5: Danil548 folded before Flop (didn't bet)
Seat 6: 3ta2wki folded before Flop (didn't bet)



PokerStars Zoom Hand #186646879911:  Hold'em No Limit ($0.02/$0.05) - 2018/05/20 22:05:53 CCT [2018/05/20 10:05:53 ET]
Table 'Donati' 6-max Seat #1 is the button
Seat 1: Andranik23ru ($2.05 in chips) 
Seat 2: SeblSebowski ($12.06 in chips) 
Seat 3: Zheka-Alaei ($5 in chips) 
Seat 4: Clubberer80 ($6.46 in chips) 
Seat 5: haqpod ($5.49 in chips) 
Seat 6: HubertusB ($2.28 in chips) 
SeblSebowski: posts small blind $0.02
Zheka-Alaei: posts big blind $0.05
*** HOLE CARDS ***
Dealt to HubertusB [2c 9c]
Clubberer80: folds 
haqpod: folds 
HubertusB: folds 
Andranik23ru: folds 
SeblSebowski: raises $0.10 to $0.15
Zheka-Alaei: folds 
Uncalled bet ($0.10) returned to SeblSebowski
SeblSebowski collected $0.10 from pot
SeblSebowski: doesn't show hand 
*** SUMMARY ***
Total pot $0.10 | Rake $0 
Seat 1: Andranik23ru (button) folded before Flop (didn't bet)
Seat 2: SeblSebowski (small blind) collected ($0.10)
Seat 3: Zheka-Alaei (big blind) folded before Flop
Seat 4: Clubberer80 folded before Flop (didn't bet)
Seat 5: haqpod folded before Flop (didn't bet)
Seat 6: HubertusB folded before Flop (didn't bet)



PokerStars Zoom Hand #186646882274:  Hold'em No Limit ($0.02/$0.05) - 2018/05/20 22:05:57 CCT [2018/05/20 10:05:57 ET]
Table 'Donati' 6-max Seat #1 is the button
Seat 1: yuu0914 ($7.05 in chips) 
Seat 2: Valerik_P ($5.91 in chips) 
Seat 3: PirateOfArrr ($6.46 in chips) 
Seat 4: yurasulaev ($7.87 in chips) 
Seat 5: HubertusB ($2.28 in chips) 
Seat 6: Marian V. 31 ($5 in chips) 
Valerik_P: posts small blind $0.02
PirateOfArrr: posts big blind $0.05
*** HOLE CARDS ***
Dealt to HubertusB [6h 6c]
yurasulaev: folds 
HubertusB: raises $0.10 to $0.15
Marian V. 31: folds 
yuu0914: folds 
Valerik_P: folds 
PirateOfArrr: folds 
Uncalled bet ($0.10) returned to HubertusB
HubertusB collected $0.12 from pot
HubertusB: doesn't show hand 
*** SUMMARY ***
Total pot $0.12 | Rake $0 
Seat 1: yuu0914 (button) folded before Flop (didn't bet)
Seat 2: Valerik_P (small blind) folded before Flop
Seat 3: PirateOfArrr (big blind) folded before Flop
Seat 4: yurasulaev folded before Flop (didn't bet)
Seat 5: HubertusB collected ($0.12)
Seat 6: Marian V. 31 folded before Flop (didn't bet)



PokerStars Zoom Hand #186646894277:  Hold'em No Limit ($0.02/$0.05) - 2018/05/20 22:06:17 CCT [2018/05/20 10:06:17 ET]
Table 'Donati' 6-max Seat #1 is the button
Seat 1: HubertusB ($2.35 in chips) 
Seat 2: Mr.Nuttts ($5.60 in chips) 
Seat 3: Shalev7 ($6.75 in chips) 
Seat 4: Afan45 ($10.47 in chips) 
Seat 5: tommy9985 ($11.30 in chips) 
Seat 6: MLombardelli ($6.38 in chips) 
Mr.Nuttts: posts small blind $0.02
Shalev7: posts big blind $0.05
*** HOLE CARDS ***
Dealt to HubertusB [As 5s]
Afan45: raises $0.07 to $0.12
tommy9985: calls $0.12
MLombardelli: folds 
HubertusB: calls $0.12
Mr.Nuttts: folds 
Shalev7: folds 
*** FLOP *** [Jd 4c 8d]
Afan45: checks 
tommy9985: checks 
HubertusB: checks 
*** TURN *** [Jd 4c 8d] [6c]
Afan45: bets $0.21
tommy9985: folds 
HubertusB: folds 
Uncalled bet ($0.21) returned to Afan45
Afan45 collected $0.41 from pot
Afan45: doesn't show hand 
*** SUMMARY ***
Total pot $0.43 | Rake $0.02 
Board [Jd 4c 8d 6c]
Seat 1: HubertusB (button) folded on the Turn
Seat 2: Mr.Nuttts (small blind) folded before Flop
Seat 3: Shalev7 (big blind) folded before Flop
Seat 4: Afan45 collected ($0.41)
Seat 5: tommy9985 folded on the Turn
Seat 6: MLombardelli folded before Flop (didn't bet)



PokerStars Zoom Hand #186646911754:  Hold'em No Limit ($0.02/$0.05) - 2018/05/20 22:06:46 CCT [2018/05/20 10:06:46 ET]
Table 'Donati' 6-max Seat #1 is the button
Seat 1: superRODRI ($5 in chips) 
Seat 2: kurawara2701 ($5 in chips) 
Seat 3: dtjbg ($1.64 in chips) 
Seat 4: Arrenea ($6.21 in chips) 
Seat 5: HubertusB ($2.23 in chips) 
Seat 6: tpk0813 ($3.79 in chips) 
kurawara2701: posts small blind $0.02
dtjbg: posts big blind $0.05
*** HOLE CARDS ***
Dealt to HubertusB [Ad As]
Arrenea: raises $0.08 to $0.13
HubertusB: raises $0.22 to $0.35
tpk0813: folds 
superRODRI: folds 
kurawara2701: folds 
dtjbg: folds 
Arrenea: calls $0.22
*** FLOP *** [Ac 6h 5d]
Arrenea: checks 
HubertusB: bets $0.10
Arrenea: folds 
Uncalled bet ($0.10) returned to HubertusB
HubertusB collected $0.74 from pot
HubertusB: doesn't show hand 
*** SUMMARY ***
Total pot $0.77 | Rake $0.03 
Board [Ac 6h 5d]
Seat 1: superRODRI (button) folded before Flop (didn't bet)
Seat 2: kurawara2701 (small blind) folded before Flop
Seat 3: dtjbg (big blind) folded before Flop
Seat 4: Arrenea folded on the Flop
Seat 5: HubertusB collected ($0.74)
Seat 6: tpk0813 folded before Flop (didn't bet)



PokerStars Zoom Hand #186646927854:  Hold'em No Limit ($0.02/$0.05) - 2018/05/20 22:07:13 CCT [2018/05/20 10:07:13 ET]
Table 'Donati' 6-max Seat #1 is the button
Seat 1: LeGingy182 ($4.82 in chips) 
Seat 2: Romzes V ($5.26 in chips) 
Seat 3: HubertusB ($2.62 in chips) 
Seat 4: haqpod ($15.95 in chips) 
Seat 5: sepik200 ($2.98 in chips) 
Seat 6: gerochka ($5.13 in chips) 
Romzes V: posts small blind $0.02
HubertusB: posts big blind $0.05
*** HOLE CARDS ***
Dealt to HubertusB [3c 6h]
haqpod: folds 
sepik200: folds 
gerochka: folds 
LeGingy182: raises $0.10 to $0.15
Romzes V: folds 
HubertusB: folds 
Uncalled bet ($0.10) returned to LeGingy182
LeGingy182 collected $0.12 from pot
LeGingy182: doesn't show hand 
*** SUMMARY ***
Total pot $0.12 | Rake $0 
Seat 1: LeGingy182 (button) collected ($0.12)
Seat 2: Romzes V (small blind) folded before Flop
Seat 3: HubertusB (big blind) folded before Flop
Seat 4: haqpod folded before Flop (didn't bet)
Seat 5: sepik200 folded before Flop (didn't bet)
Seat 6: gerochka folded before Flop (didn't bet)



PokerStars Zoom Hand #186646935653:  Hold'em No Limit ($0.02/$0.05) - 2018/05/20 22:07:26 CCT [2018/05/20 10:07:26 ET]
Table 'Donati' 6-max Seat #1 is the button
Seat 1: BeatLimits ($5 in chips) 
Seat 2: HubertusB ($2.57 in chips) 
Seat 3: Make6666 ($5 in chips) 
Seat 4: superRODRI ($5.05 in chips) 
Seat 5: bybybkas ($5.07 in chips) 
Seat 6: kurawara2701 ($5.15 in chips) 
HubertusB: posts small blind $0.02
Make6666: posts big blind $0.05
*** HOLE CARDS ***
Dealt to HubertusB [Kd Qd]
superRODRI: folds 
bybybkas: raises $0.07 to $0.12
kurawara2701: folds 
BeatLimits: folds 
HubertusB: raises $0.29 to $0.41
Make6666: folds 
bybybkas: folds 
Uncalled bet ($0.29) returned to HubertusB
HubertusB collected $0.29 from pot
HubertusB: doesn't show hand 
*** SUMMARY ***
Total pot $0.29 | Rake $0 
Seat 1: BeatLimits (button) folded before Flop (didn't bet)
Seat 2: HubertusB (small blind) collected ($0.29)
Seat 3: Make6666 (big blind) folded before Flop
Seat 4: superRODRI folded before Flop (didn't bet)
Seat 5: bybybkas folded before Flop
Seat 6: kurawara2701 folded before Flop (didn't bet)



PokerStars Zoom Hand #186646955048:  Hold'em No Limit ($0.02/$0.05) - 2018/05/20 22:07:58 CCT [2018/05/20 10:07:58 ET]
Table 'Donati' 6-max Seat #1 is the button
Seat 1: HubertusB ($2.74 in chips) 
Seat 2: tumo1326 ($17.65 in chips) 
Seat 3: bober2702 ($3.27 in chips) 
Seat 4: qperept ($1.90 in chips) 
Seat 5: VingadorV ($11.44 in chips) 
Seat 6: gerochka ($5.13 in chips) 
tumo1326: posts small blind $0.02
bober2702: posts big blind $0.05
*** HOLE CARDS ***
Dealt to HubertusB [Jh 2d]
qperept: folds 
VingadorV: folds 
gerochka: folds 
HubertusB: folds 
tumo1326: raises $0.10 to $0.15
bober2702: calls $0.10
*** FLOP *** [Jd Th 6h]
tumo1326: bets $0.15
bober2702: folds 
Uncalled bet ($0.15) returned to tumo1326
tumo1326 collected $0.29 from pot
tumo1326: doesn't show hand 
*** SUMMARY ***
Total pot $0.30 | Rake $0.01 
Board [Jd Th 6h]
Seat 1: HubertusB (button) folded before Flop (didn't bet)
Seat 2: tumo1326 (small blind) collected ($0.29)
Seat 3: bober2702 (big blind) folded on the Flop
Seat 4: qperept folded before Flop (didn't bet)
Seat 5: VingadorV folded before Flop (didn't bet)
Seat 6: gerochka folded before Flop (didn't bet)



PokerStars Zoom Hand #186646962767:  Hold'em No Limit ($0.02/$0.05) - 2018/05/20 22:08:11 CCT [2018/05/20 10:08:11 ET]
Table 'Donati' 6-max Seat #1 is the button
Seat 1: bober2702 ($8.55 in chips) 
Seat 2: erhan001111 ($11.39 in chips) 
Seat 3: Valerik_P ($5.07 in chips) 
Seat 4: ILLi.oLL ($3.76 in chips) 
Seat 5: Vajdalf92 ($1.41 in chips) 
Seat 6: HubertusB ($2.74 in chips) 
erhan001111: posts small blind $0.02
Valerik_P: posts big blind $0.05
*** HOLE CARDS ***
Dealt to HubertusB [Ks 5s]
ILLi.oLL: folds 
Vajdalf92: folds 
HubertusB: folds 
bober2702: raises $0.10 to $0.15
erhan001111: folds 
Valerik_P: folds 
Uncalled bet ($0.10) returned to bober2702
bober2702 collected $0.12 from pot
bober2702: doesn't show hand 
*** SUMMARY ***
Total pot $0.12 | Rake $0 
Seat 1: bober2702 (button) collected ($0.12)
Seat 2: erhan001111 (small blind) folded before Flop
Seat 3: Valerik_P (big blind) folded before Flop
Seat 4: ILLi.oLL folded before Flop (didn't bet)
Seat 5: Vajdalf92 folded before Flop (didn't bet)
Seat 6: HubertusB folded before Flop (didn't bet)



PokerStars Zoom Hand #186646958679:  Hold'em No Limit ($0.02/$0.05) - 2018/05/20 22:08:04 CCT [2018/05/20 10:08:04 ET]
Table 'Donati' 6-max Seat #1 is the button
Seat 1: Mr. Roquim ($6.45 in chips) 
Seat 2: PiNe4ppLe ($22.94 in chips) 
Seat 3: nick235711 ($6.34 in chips) 
Seat 4: HubertusB ($2.74 in chips) 
Seat 5: Golodayushii ($16.32 in chips) 
Seat 6: VLSALT ($8.59 in chips) 
PiNe4ppLe: posts small blind $0.02
nick235711: posts big blind $0.05
*** HOLE CARDS ***
Dealt to HubertusB [Th 3h]
HubertusB: folds 
Golodayushii: folds 
VLSALT: folds 
Mr. Roquim: raises $0.07 to $0.12
PiNe4ppLe: raises $0.28 to $0.40
nick235711: folds 
Mr. Roquim: folds 
Uncalled bet ($0.28) returned to PiNe4ppLe
PiNe4ppLe collected $0.29 from pot
PiNe4ppLe: doesn't show hand 
*** SUMMARY ***
Total pot $0.29 | Rake $0 
Seat 1: Mr. Roquim (button) folded before Flop
Seat 2: PiNe4ppLe (small blind) collected ($0.29)
Seat 3: nick235711 (big blind) folded before Flop
Seat 4: HubertusB folded before Flop (didn't bet)
Seat 5: Golodayushii folded before Flop (didn't bet)
Seat 6: VLSALT folded before Flop (didn't bet)



PokerStars Zoom Hand #186646952019:  Hold'em No Limit ($0.02/$0.05) - 2018/05/20 22:07:53 CCT [2018/05/20 10:07:53 ET]
Table 'Donati' 6-max Seat #1 is the button
Seat 1: superRODRI ($5 in chips) 
Seat 2: kurawara2701 ($6.32 in chips) 
Seat 3: KurpatovX ($6.21 in chips) 
Seat 4: ansia171717 ($4.88 in chips) 
Seat 5: SRD03 ($7.12 in chips) 
Seat 6: HubertusB ($2.74 in chips) 
kurawara2701: posts small blind $0.02
KurpatovX: posts big blind $0.05
*** HOLE CARDS ***
Dealt to HubertusB [Jc 4s]
ansia171717: folds 
SRD03: folds 
HubertusB: folds 
superRODRI: raises $0.10 to $0.15
kurawara2701: folds 
KurpatovX: raises $0.35 to $0.50
superRODRI: calls $0.35
*** FLOP *** [2c Qs 5h]
KurpatovX: checks 
superRODRI: bets $0.61
KurpatovX: calls $0.61
*** TURN *** [2c Qs 5h] [Js]
KurpatovX: checks 
superRODRI: checks 
*** RIVER *** [2c Qs 5h Js] [8s]
KurpatovX: bets $1.51
superRODRI: folds 
Uncalled bet ($1.51) returned to KurpatovX
KurpatovX collected $2.15 from pot
KurpatovX: doesn't show hand 
*** SUMMARY ***
Total pot $2.24 | Rake $0.09 
Board [2c Qs 5h Js 8s]
Seat 1: superRODRI (button) folded on the River
Seat 2: kurawara2701 (small blind) folded before Flop
Seat 3: KurpatovX (big blind) collected ($2.15)
Seat 4: ansia171717 folded before Flop (didn't bet)
Seat 5: SRD03 folded before Flop (didn't bet)
Seat 6: HubertusB folded before Flop (didn't bet)



PokerStars Zoom Hand #186646971967:  Hold'em No Limit ($0.02/$0.05) - 2018/05/20 22:08:26 CCT [2018/05/20 10:08:26 ET]
Table 'Donati' 6-max Seat #1 is the button
Seat 1: HubertusB ($2.69 in chips) 
Seat 2: RedBullRobi ($2.79 in chips) 
Seat 3: Siorassc ($7.01 in chips) 
Seat 4: jojovu ($5.20 in chips) 
Seat 5: ninix17 ($7.83 in chips) 
Seat 6: Faku710 ($5.93 in chips) 
RedBullRobi: posts small blind $0.02
Siorassc: posts big blind $0.05
*** HOLE CARDS ***
Dealt to HubertusB [6h 6s]
jojovu: folds 
ninix17: folds 
Faku710: folds 
HubertusB: raises $0.10 to $0.15
RedBullRobi: folds 
Siorassc: folds 
Uncalled bet ($0.10) returned to HubertusB
HubertusB collected $0.12 from pot
HubertusB: doesn't show hand 
*** SUMMARY ***
Total pot $0.12 | Rake $0 
Seat 1: HubertusB (button) collected ($0.12)
Seat 2: RedBullRobi (small blind) folded before Flop
Seat 3: Siorassc (big blind) folded before Flop
Seat 4: jojovu folded before Flop (didn't bet)
Seat 5: ninix17 folded before Flop (didn't bet)
Seat 6: Faku710 folded before Flop (didn't bet)



PokerStars Zoom Hand #186646988271:  Hold'em No Limit ($0.02/$0.05) - 2018/05/20 22:08:53 CCT [2018/05/20 10:08:53 ET]
Table 'Donati' 6-max Seat #1 is the button
Seat 1: AnalFire999 ($4.02 in chips) 
Seat 2: HubertusB ($2.76 in chips) 
Seat 3: BIGIGOR320 ($15.38 in chips) 
Seat 4: Den_Ekb.ru ($2.93 in chips) 
Seat 5: SeblSebowski ($6.27 in chips) 
Seat 6: Florea2312 ($5 in chips) 
HubertusB: posts small blind $0.02
BIGIGOR320: posts big blind $0.05
*** HOLE CARDS ***
Dealt to HubertusB [5d 7s]
Den_Ekb.ru: folds 
SeblSebowski: folds 
Florea2312: folds 
AnalFire999: folds 
HubertusB: folds 
Uncalled bet ($0.03) returned to BIGIGOR320
BIGIGOR320 collected $0.04 from pot
BIGIGOR320: doesn't show hand 
*** SUMMARY ***
Total pot $0.04 | Rake $0 
Seat 1: AnalFire999 (button) folded before Flop (didn't bet)
Seat 2: HubertusB (small blind) folded before Flop
Seat 3: BIGIGOR320 (big blind) collected ($0.04)
Seat 4: Den_Ekb.ru folded before Flop (didn't bet)
Seat 5: SeblSebowski folded before Flop (didn't bet)
Seat 6: Florea2312 folded before Flop (didn't bet)



PokerStars Zoom Hand #186646990669:  Hold'em No Limit ($0.02/$0.05) - 2018/05/20 22:08:57 CCT [2018/05/20 10:08:57 ET]
Table 'Donati' 6-max Seat #1 is the button
Seat 1: Chunichi ($5 in chips) 
Seat 2: Yamma18 ($5.70 in chips) 
Seat 3: joycer85 ($5.64 in chips) 
Seat 4: PoidaTheGreat ($3.88 in chips) 
Seat 5: HubertusB ($2.74 in chips) 
Seat 6: Fr3dST ($6 in chips) 
Yamma18: posts small blind $0.02
joycer85: posts big blind $0.05
*** HOLE CARDS ***
Dealt to HubertusB [5s 2c]
PoidaTheGreat: folds 
HubertusB: folds 
Fr3dST: raises $0.10 to $0.15
Chunichi: folds 
Yamma18: folds 
joycer85: folds 
Uncalled bet ($0.10) returned to Fr3dST
Fr3dST collected $0.12 from pot
Fr3dST: doesn't show hand 
*** SUMMARY ***
Total pot $0.12 | Rake $0 
Seat 1: Chunichi (button) folded before Flop (didn't bet)
Seat 2: Yamma18 (small blind) folded before Flop
Seat 3: joycer85 (big blind) folded before Flop
Seat 4: PoidaTheGreat folded before Flop (didn't bet)
Seat 5: HubertusB folded before Flop (didn't bet)
Seat 6: Fr3dST collected ($0.12)



PokerStars Zoom Hand #186646993677:  Hold'em No Limit ($0.02/$0.05) - 2018/05/20 22:09:02 CCT [2018/05/20 10:09:02 ET]
Table 'Donati' 6-max Seat #1 is the button
Seat 1: KurpatovX ($7.18 in chips) 
Seat 2: Valerik_P ($6.07 in chips) 
Seat 3: Detrin-rus ($4.89 in chips) 
Seat 4: chrapos ($11.83 in chips) 
Seat 5: HubertusB ($2.74 in chips) 
Seat 6: na_onda ($5 in chips) 
Valerik_P: posts small blind $0.02
Detrin-rus: posts big blind $0.05
*** HOLE CARDS ***
Dealt to HubertusB [3s 5h]
chrapos: folds 
HubertusB: folds 
na_onda: folds 
KurpatovX: folds 
Valerik_P: folds 
Uncalled bet ($0.03) returned to Detrin-rus
Detrin-rus collected $0.04 from pot
Detrin-rus: doesn't show hand 
*** SUMMARY ***
Total pot $0.04 | Rake $0 
Seat 1: KurpatovX (button) folded before Flop (didn't bet)
Seat 2: Valerik_P (small blind) folded before Flop
Seat 3: Detrin-rus (big blind) collected ($0.04)
Seat 4: chrapos folded before Flop (didn't bet)
Seat 5: HubertusB folded before Flop (didn't bet)
Seat 6: na_onda folded before Flop (didn't bet)



PokerStars Zoom Hand #186646996619:  Hold'em No Limit ($0.02/$0.05) - 2018/05/20 22:09:07 CCT [2018/05/20 10:09:07 ET]
Table 'Donati' 6-max Seat #1 is the button
Seat 1: gerochka ($5 in chips) 
Seat 2: oOps_2206 ($4.95 in chips) 
Seat 3: BardJeka ($5 in chips) 
Seat 4: HubertusB ($2.74 in chips) 
Seat 5: PiNe4ppLe ($9.58 in chips) 
Seat 6: class29 ($9.17 in chips) 
oOps_2206: posts small blind $0.02
BardJeka: posts big blind $0.05
*** HOLE CARDS ***
Dealt to HubertusB [5s 7h]
HubertusB: folds 
PiNe4ppLe: raises $0.10 to $0.15
class29: folds 
gerochka: folds 
oOps_2206: folds 
BardJeka: folds 
Uncalled bet ($0.10) returned to PiNe4ppLe
PiNe4ppLe collected $0.12 from pot
PiNe4ppLe: doesn't show hand 
*** SUMMARY ***
Total pot $0.12 | Rake $0 
Seat 1: gerochka (button) folded before Flop (didn't bet)
Seat 2: oOps_2206 (small blind) folded before Flop
Seat 3: BardJeka (big blind) folded before Flop
Seat 4: HubertusB folded before Flop (didn't bet)
Seat 5: PiNe4ppLe collected ($0.12)
Seat 6: class29 folded before Flop (didn't bet)



PokerStars Zoom Hand #186647000238:  Hold'em No Limit ($0.02/$0.05) - 2018/05/20 22:09:13 CCT [2018/05/20 10:09:13 ET]
Table 'Donati' 6-max Seat #1 is the button
Seat 1: maltrine ($5.12 in chips) 
Seat 2: MinouXYZ ($3.36 in chips) 
Seat 3: LogenX ($8.45 in chips) 
Seat 4: Egozocker ($6.71 in chips) 
Seat 5: incorrect88 ($5.96 in chips) 
Seat 6: HubertusB ($2.74 in chips) 
MinouXYZ: posts small blind $0.02
LogenX: posts big blind $0.05
*** HOLE CARDS ***
Dealt to HubertusB [7c Th]
Egozocker: folds 
incorrect88: folds 
HubertusB: folds 
maltrine: folds 
MinouXYZ: calls $0.03
LogenX: checks 
*** FLOP *** [4s Qd 2c]
MinouXYZ: checks 
LogenX: bets $0.05
MinouXYZ: folds 
Uncalled bet ($0.05) returned to LogenX
LogenX collected $0.10 from pot
LogenX: doesn't show hand 
*** SUMMARY ***
Total pot $0.10 | Rake $0 
Board [4s Qd 2c]
Seat 1: maltrine (button) folded before Flop (didn't bet)
Seat 2: MinouXYZ (small blind) folded on the Flop
Seat 3: LogenX (big blind) collected ($0.10)
Seat 4: Egozocker folded before Flop (didn't bet)
Seat 5: incorrect88 folded before Flop (didn't bet)
Seat 6: HubertusB folded before Flop (didn't bet)



PokerStars Zoom Hand #186647003891:  Hold'em No Limit ($0.02/$0.05) - 2018/05/20 22:09:19 CCT [2018/05/20 10:09:19 ET]
Table 'Donati' 6-max Seat #1 is the button
Seat 1: TheFibonachi ($5.62 in chips) 
Seat 2: VingadorV ($18.44 in chips) 
Seat 3: HubertusB ($2.74 in chips) 
Seat 4: Mr.Nuttts ($5 in chips) 
Seat 5: Goosich ($12.02 in chips) 
Seat 6: Make6666 ($5.20 in chips) 
VingadorV: posts small blind $0.02
HubertusB: posts big blind $0.05
*** HOLE CARDS ***
Dealt to HubertusB [Qh Tc]
Mr.Nuttts: folds 
Goosich: folds 
Make6666: folds 
TheFibonachi: folds 
VingadorV: raises $0.10 to $0.15
HubertusB: folds 
Uncalled bet ($0.10) returned to VingadorV
VingadorV collected $0.10 from pot
VingadorV: doesn't show hand 
*** SUMMARY ***
Total pot $0.10 | Rake $0 
Seat 1: TheFibonachi (button) folded before Flop (didn't bet)
Seat 2: VingadorV (small blind) collected ($0.10)
Seat 3: HubertusB (big blind) folded before Flop
Seat 4: Mr.Nuttts folded before Flop (didn't bet)
Seat 5: Goosich folded before Flop (didn't bet)
Seat 6: Make6666 folded before Flop (didn't bet)



PokerStars Zoom Hand #186646965919:  Hold'em No Limit ($0.02/$0.05) - 2018/05/20 22:08:16 CCT [2018/05/20 10:08:16 ET]
Table 'Donati' 6-max Seat #1 is the button
Seat 1: Big Rig Stu ($5 in chips) 
Seat 2: confirmedanc ($5.02 in chips) 
Seat 3: HubertusB ($2.74 in chips) 
Seat 4: Kozak Sila ($2.29 in chips) 
Seat 5: kayck07 ($6.44 in chips) 
Seat 6: ThiagooPaiva ($5 in chips) 
confirmedanc: posts small blind $0.02
HubertusB: posts big blind $0.05
*** HOLE CARDS ***
Dealt to HubertusB [3d Qs]
Kozak Sila: calls $0.05
kayck07: folds 
ThiagooPaiva: folds 
Big Rig Stu: folds 
confirmedanc: raises $0.15 to $0.20
HubertusB: folds 
Kozak Sila: calls $0.15
*** FLOP *** [4d 2d Qc]
confirmedanc: checks 
Kozak Sila has timed out
Kozak Sila: checks 
*** TURN *** [4d 2d Qc] [5h]
confirmedanc: checks 
Kozak Sila: bets $0.05
confirmedanc: folds 
Uncalled bet ($0.05) returned to Kozak Sila
Kozak Sila collected $0.43 from pot
Kozak Sila: doesn't show hand 
*** SUMMARY ***
Total pot $0.45 | Rake $0.02 
Board [4d 2d Qc 5h]
Seat 1: Big Rig Stu (button) folded before Flop (didn't bet)
Seat 2: confirmedanc (small blind) folded on the Turn
Seat 3: HubertusB (big blind) folded before Flop
Seat 4: Kozak Sila collected ($0.43)
Seat 5: kayck07 folded before Flop (didn't bet)
Seat 6: ThiagooPaiva folded before Flop (didn't bet)



PokerStars Zoom Hand #186647011016:  Hold'em No Limit ($0.02/$0.05) - 2018/05/20 22:09:31 CCT [2018/05/20 10:09:31 ET]
Table 'Donati' 6-max Seat #1 is the button
Seat 1: joekor00 ($3.17 in chips) 
Seat 2: GOLDEVG ($5.06 in chips) 
Seat 3: KurpatovX ($7.23 in chips) 
Seat 4: HubertusB ($2.69 in chips) 
Seat 5: ivan 1987465 ($4.62 in chips) 
Seat 6: Urisdep ($6.17 in chips) 
GOLDEVG: posts small blind $0.02
KurpatovX: posts big blind $0.05
*** HOLE CARDS ***
Dealt to HubertusB [Qs Jd]
HubertusB: raises $0.10 to $0.15
ivan 1987465: calls $0.15
Urisdep: folds 
joekor00: folds 
GOLDEVG: folds 
KurpatovX: folds 
*** FLOP *** [8s Kh 8c]
HubertusB: checks 
ivan 1987465: checks 
*** TURN *** [8s Kh 8c] [6s]
HubertusB: checks 
ivan 1987465: bets $0.18
HubertusB: folds 
Uncalled bet ($0.18) returned to ivan 1987465
ivan 1987465 collected $0.35 from pot
ivan 1987465: doesn't show hand 
*** SUMMARY ***
Total pot $0.37 | Rake $0.02 
Board [8s Kh 8c 6s]
Seat 1: joekor00 (button) folded before Flop (didn't bet)
Seat 2: GOLDEVG (small blind) folded before Flop
Seat 3: KurpatovX (big blind) folded before Flop
Seat 4: HubertusB folded on the Turn
Seat 5: ivan 1987465 collected ($0.35)
Seat 6: Urisdep folded before Flop (didn't bet)



PokerStars Zoom Hand #186647022410:  Hold'em No Limit ($0.02/$0.05) - 2018/05/20 22:09:50 CCT [2018/05/20 10:09:50 ET]
Table 'Donati' 6-max Seat #1 is the button
Seat 1: Janski90 ($5.84 in chips) 
Seat 2: HubertusB ($2.54 in chips) 
Seat 3: kurawara2701 ($7.19 in chips) 
Seat 4: yuu0914 ($5.82 in chips) 
Seat 5: ArgusLL ($1.70 in chips) 
Seat 6: thekvlt ($5.08 in chips) 
HubertusB: posts small blind $0.02
kurawara2701: posts big blind $0.05
*** HOLE CARDS ***
Dealt to HubertusB [Kh Jh]
yuu0914: raises $0.10 to $0.15
ArgusLL: folds 
thekvlt: folds 
Janski90: folds 
HubertusB: calls $0.13
kurawara2701: folds 
*** FLOP *** [Kd As 3d]
HubertusB: checks 
yuu0914: bets $0.24
HubertusB: calls $0.24
*** TURN *** [Kd As 3d] [4d]
HubertusB: checks 
yuu0914: bets $0.40
HubertusB: folds 
Uncalled bet ($0.40) returned to yuu0914
yuu0914 collected $0.80 from pot
yuu0914: doesn't show hand 
*** SUMMARY ***
Total pot $0.83 | Rake $0.03 
Board [Kd As 3d 4d]
Seat 1: Janski90 (button) folded before Flop (didn't bet)
Seat 2: HubertusB (small blind) folded on the Turn
Seat 3: kurawara2701 (big blind) folded before Flop
Seat 4: yuu0914 collected ($0.80)
Seat 5: ArgusLL folded before Flop (didn't bet)
Seat 6: thekvlt folded before Flop (didn't bet)



PokerStars Zoom Hand #186647041802:  Hold'em No Limit ($0.02/$0.05) - 2018/05/20 22:10:22 CCT [2018/05/20 10:10:22 ET]
Table 'Donati' 6-max Seat #1 is the button
Seat 1: poliars ($5.60 in chips) 
Seat 2: Danil548 ($5.21 in chips) 
Seat 3: kranovoy22 ($5 in chips) 
Seat 4: HubertusB ($2.15 in chips) 
Seat 5: AnalFire999 ($4.51 in chips) 
Seat 6: DCove ($5.31 in chips) 
Danil548: posts small blind $0.02
kranovoy22: posts big blind $0.05
*** HOLE CARDS ***
Dealt to HubertusB [5d 9d]
HubertusB: folds 
AnalFire999: folds 
DCove: folds 
poliars: folds 
Danil548: raises $0.07 to $0.12
kranovoy22: folds 
Uncalled bet ($0.07) returned to Danil548
Danil548 collected $0.10 from pot
Danil548: doesn't show hand 
*** SUMMARY ***
Total pot $0.10 | Rake $0 
Seat 1: poliars (button) folded before Flop (didn't bet)
Seat 2: Danil548 (small blind) collected ($0.10)
Seat 3: kranovoy22 (big blind) folded before Flop
Seat 4: HubertusB folded before Flop (didn't bet)
Seat 5: AnalFire999 folded before Flop (didn't bet)
Seat 6: DCove folded before Flop (didn't bet)



PokerStars Zoom Hand #186647045397:  Hold'em No Limit ($0.02/$0.05) - 2018/05/20 22:10:28 CCT [2018/05/20 10:10:28 ET]
Table 'Donati' 6-max Seat #1 is the button
Seat 1: kagurasiori ($8.62 in chips) 
Seat 2: Little Geewood ($8.17 in chips) 
Seat 3: Goosich ($9.92 in chips) 
Seat 4: yurasulaev ($12.06 in chips) 
Seat 5: grunge&punk ($14.43 in chips) 
Seat 6: HubertusB ($2.15 in chips) 
Little Geewood: posts small blind $0.02
Goosich: posts big blind $0.05
*** HOLE CARDS ***
Dealt to HubertusB [Kd 9s]
yurasulaev: folds 
grunge&punk: folds 
HubertusB: folds 
kagurasiori: folds 
Little Geewood: folds 
Uncalled bet ($0.03) returned to Goosich
Goosich collected $0.04 from pot
Goosich: doesn't show hand 
*** SUMMARY ***
Total pot $0.04 | Rake $0 
Seat 1: kagurasiori (button) folded before Flop (didn't bet)
Seat 2: Little Geewood (small blind) folded before Flop
Seat 3: Goosich (big blind) collected ($0.04)
Seat 4: yurasulaev folded before Flop (didn't bet)
Seat 5: grunge&punk folded before Flop (didn't bet)
Seat 6: HubertusB folded before Flop (didn't bet)



PokerStars Zoom Hand #186647039379:  Hold'em No Limit ($0.02/$0.05) - 2018/05/20 22:10:18 CCT [2018/05/20 10:10:18 ET]
Table 'Donati' 6-max Seat #1 is the button
Seat 1: HubertusB ($2.15 in chips) 
Seat 2: rino803 ($5.57 in chips) 
Seat 3: Douugler ($5 in chips) 
Seat 4: <Bogolal> ($8.99 in chips) 
Seat 5: bober2702 ($3.19 in chips) 
Seat 6: AnalFire999 ($4.51 in chips) 
rino803: posts small blind $0.02
Douugler: posts big blind $0.05
*** HOLE CARDS ***
Dealt to HubertusB [Qs 6h]
<Bogolal>: folds 
bober2702: folds 
AnalFire999: folds 
HubertusB: folds 
rino803: raises $0.07 to $0.12
Douugler: folds 
Uncalled bet ($0.07) returned to rino803
rino803 collected $0.10 from pot
rino803: doesn't show hand 
*** SUMMARY ***
Total pot $0.10 | Rake $0 
Seat 1: HubertusB (button) folded before Flop (didn't bet)
Seat 2: rino803 (small blind) collected ($0.10)
Seat 3: Douugler (big blind) folded before Flop
Seat 4: <Bogolal> folded before Flop (didn't bet)
Seat 5: bober2702 folded before Flop (didn't bet)
Seat 6: AnalFire999 folded before Flop (didn't bet)



PokerStars Zoom Hand #186647049741:  Hold'em No Limit ($0.02/$0.05) - 2018/05/20 22:10:35 CCT [2018/05/20 10:10:35 ET]
Table 'Donati' 6-max Seat #1 is the button
Seat 1: Mr. Roquim ($6.25 in chips) 
Seat 2: BoSs00 ($9.02 in chips) 
Seat 3: scels111 ($7.54 in chips) 
Seat 4: nerox09 ($6.40 in chips) 
Seat 5: HubertusB ($2.15 in chips) 
Seat 6: julehjuleh ($5 in chips) 
BoSs00: posts small blind $0.02
scels111: posts big blind $0.05
*** HOLE CARDS ***
Dealt to HubertusB [6c 2s]
nerox09: folds 
HubertusB: folds 
julehjuleh: folds 
Mr. Roquim: folds 
BoSs00: folds 
Uncalled bet ($0.03) returned to scels111
scels111 collected $0.04 from pot
scels111: doesn't show hand 
*** SUMMARY ***
Total pot $0.04 | Rake $0 
Seat 1: Mr. Roquim (button) folded before Flop (didn't bet)
Seat 2: BoSs00 (small blind) folded before Flop
Seat 3: scels111 (big blind) collected ($0.04)
Seat 4: nerox09 folded before Flop (didn't bet)
Seat 5: HubertusB folded before Flop (didn't bet)
Seat 6: julehjuleh folded before Flop (didn't bet)



PokerStars Zoom Hand #186647057008:  Hold'em No Limit ($0.02/$0.05) - 2018/05/20 22:10:47 CCT [2018/05/20 10:10:47 ET]
Table 'Donati' 6-max Seat #1 is the button
Seat 1: Ballistic sy ($4.86 in chips) 
Seat 2: haqpod ($5.59 in chips) 
Seat 3: HubertusB ($2.13 in chips) 
Seat 4: ArgusLL ($1.63 in chips) 
Seat 5: Mr. Roquim ($6.25 in chips) 
Seat 6: tpk0813 ($4.49 in chips) 
haqpod: posts small blind $0.02
HubertusB: posts big blind $0.05
*** HOLE CARDS ***
Dealt to HubertusB [Ah 2c]
ArgusLL: folds 
Mr. Roquim: folds 
tpk0813: folds 
Ballistic sy: raises $0.10 to $0.15
haqpod: folds 
HubertusB: folds 
Uncalled bet ($0.10) returned to Ballistic sy
Ballistic sy collected $0.12 from pot
Ballistic sy: doesn't show hand 
*** SUMMARY ***
Total pot $0.12 | Rake $0 
Seat 1: Ballistic sy (button) collected ($0.12)
Seat 2: haqpod (small blind) folded before Flop
Seat 3: HubertusB (big blind) folded before Flop
Seat 4: ArgusLL folded before Flop (didn't bet)
Seat 5: Mr. Roquim folded before Flop (didn't bet)
Seat 6: tpk0813 folded before Flop (didn't bet)



PokerStars Zoom Hand #186647053998:  Hold'em No Limit ($0.02/$0.05) - 2018/05/20 22:10:42 CCT [2018/05/20 10:10:42 ET]
Table 'Donati' 6-max Seat #1 is the button
Seat 1: SpurenIeger ($3.98 in chips) 
Seat 2: HubertusB ($2.15 in chips) 
Seat 3: Mendeer ($5 in chips) 
Seat 4: GyNy1976 ($9.73 in chips) 
Seat 5: pizzapan53 ($8.49 in chips) 
Seat 6: Oleksii Voronin ($6.24 in chips) 
HubertusB: posts small blind $0.02
Mendeer: posts big blind $0.05
*** HOLE CARDS ***
Dealt to HubertusB [5d Js]
GyNy1976: raises $0.10 to $0.15
pizzapan53: folds 
Oleksii Voronin: folds 
SpurenIeger: calls $0.15
HubertusB: folds 
Mendeer: folds 
*** FLOP *** [Qc 4c 7s]
GyNy1976: bets $0.21
SpurenIeger: calls $0.21
*** TURN *** [Qc 4c 7s] [2c]
GyNy1976: checks 
SpurenIeger: checks 
*** RIVER *** [Qc 4c 7s 2c] [4d]
GyNy1976: checks 
SpurenIeger: checks 
*** SHOW DOWN ***
GyNy1976: shows [Jc Jd] (two pair, Jacks and Fours)
SpurenIeger: mucks hand 
GyNy1976 collected $0.76 from pot
*** SUMMARY ***
Total pot $0.79 | Rake $0.03 
Board [Qc 4c 7s 2c 4d]
Seat 1: SpurenIeger (button) mucked [Kh As]
Seat 2: HubertusB (small blind) folded before Flop
Seat 3: Mendeer (big blind) folded before Flop
Seat 4: GyNy1976 showed [Jc Jd] and won ($0.76) with two pair, Jacks and Fours
Seat 5: pizzapan53 folded before Flop (didn't bet)
Seat 6: Oleksii Voronin folded before Flop (didn't bet)



PokerStars Zoom Hand #186647067297:  Hold'em No Limit ($0.02/$0.05) - 2018/05/20 22:11:04 CCT [2018/05/20 10:11:04 ET]
Table 'Donati' 6-max Seat #1 is the button
Seat 1: MiHCeLL ($9.47 in chips) 
Seat 2: syrok17 ($6.25 in chips) 
Seat 3: sizuu1225 ($8.91 in chips) 
Seat 4: BardJeka ($5 in chips) 
Seat 5: kirilin.ru ($22.92 in chips) 
Seat 6: HubertusB ($2.08 in chips) 
syrok17: posts small blind $0.02
sizuu1225: posts big blind $0.05
*** HOLE CARDS ***
Dealt to HubertusB [Js 4d]
BardJeka: folds 
kirilin.ru: folds 
HubertusB: folds 
MiHCeLL: folds 
syrok17: folds 
Uncalled bet ($0.03) returned to sizuu1225
sizuu1225 collected $0.04 from pot
sizuu1225: doesn't show hand 
*** SUMMARY ***
Total pot $0.04 | Rake $0 
Seat 1: MiHCeLL (button) folded before Flop (didn't bet)
Seat 2: syrok17 (small blind) folded before Flop
Seat 3: sizuu1225 (big blind) collected ($0.04)
Seat 4: BardJeka folded before Flop (didn't bet)
Seat 5: kirilin.ru folded before Flop (didn't bet)
Seat 6: HubertusB folded before Flop (didn't bet)



PokerStars Zoom Hand #186647070943:  Hold'em No Limit ($0.02/$0.05) - 2018/05/20 22:11:10 CCT [2018/05/20 10:11:10 ET]
Table 'Donati' 6-max Seat #1 is the button
Seat 1: BardJeka ($5 in chips) 
Seat 2: ccwolf7 ($4.27 in chips) 
Seat 3: HubertusB ($2.08 in chips) 
Seat 4: Arrenea ($17.53 in chips) 
Seat 5: Agno$tic ($10.42 in chips) 
Seat 6: lukemeisterz ($8.46 in chips) 
ccwolf7: posts small blind $0.02
HubertusB: posts big blind $0.05
*** HOLE CARDS ***
Dealt to HubertusB [5s 2c]
Arrenea: folds 
Agno$tic: folds 
lukemeisterz: folds 
BardJeka: folds 
ccwolf7: folds 
Uncalled bet ($0.03) returned to HubertusB
HubertusB collected $0.04 from pot
HubertusB: doesn't show hand 
*** SUMMARY ***
Total pot $0.04 | Rake $0 
Seat 1: BardJeka (button) folded before Flop (didn't bet)
Seat 2: ccwolf7 (small blind) folded before Flop
Seat 3: HubertusB (big blind) collected ($0.04)
Seat 4: Arrenea folded before Flop (didn't bet)
Seat 5: Agno$tic folded before Flop (didn't bet)
Seat 6: lukemeisterz folded before Flop (didn't bet)



PokerStars Zoom Hand #186647064253:  Hold'em No Limit ($0.02/$0.05) - 2018/05/20 22:10:59 CCT [2018/05/20 10:10:59 ET]
Table 'Donati' 6-max Seat #1 is the button
Seat 1: HubertusB ($2.08 in chips) 
Seat 2: ILLi.oLL ($1.67 in chips) 
Seat 3: Yamma18 ($5.53 in chips) 
Seat 4: syrok17 ($6.25 in chips) 
Seat 5: MiHCeLL ($9.47 in chips) 
Seat 6: Savavlad97 ($7.67 in chips) 
ILLi.oLL: posts small blind $0.02
Yamma18: posts big blind $0.05
*** HOLE CARDS ***
Dealt to HubertusB [Qh Td]
syrok17: folds 
MiHCeLL: folds 
Savavlad97: raises $0.07 to $0.12
HubertusB: folds 
ILLi.oLL: calls $0.10
Yamma18: folds 
*** FLOP *** [9s 5d 4h]
ILLi.oLL: bets $0.15
Savavlad97: folds 
Uncalled bet ($0.15) returned to ILLi.oLL
ILLi.oLL collected $0.28 from pot
ILLi.oLL: doesn't show hand 
*** SUMMARY ***
Total pot $0.29 | Rake $0.01 
Board [9s 5d 4h]
Seat 1: HubertusB (button) folded before Flop (didn't bet)
Seat 2: ILLi.oLL (small blind) collected ($0.28)
Seat 3: Yamma18 (big blind) folded before Flop
Seat 4: syrok17 folded before Flop (didn't bet)
Seat 5: MiHCeLL folded before Flop (didn't bet)
Seat 6: Savavlad97 folded on the Flop



PokerStars Zoom Hand #186647080092:  Hold'em No Limit ($0.02/$0.05) - 2018/05/20 22:11:25 CCT [2018/05/20 10:11:25 ET]
Table 'Donati' 6-max Seat #1 is the button
Seat 1: Voron9 ($5.97 in chips) 
Seat 2: urahayanagi ($14.42 in chips) 
Seat 3: doc potman ($4.88 in chips) 
Seat 4: Clubberer80 ($5.55 in chips) 
Seat 5: HubertusB ($2.08 in chips) 
Seat 6: aForrester ($5.22 in chips) 
urahayanagi: posts small blind $0.02
doc potman: posts big blind $0.05
*** HOLE CARDS ***
Dealt to HubertusB [4s 5h]
Clubberer80: folds 
HubertusB: folds 
aForrester: folds 
Voron9: raises $0.05 to $0.10
urahayanagi: folds 
doc potman: folds 
Uncalled bet ($0.05) returned to Voron9
Voron9 collected $0.12 from pot
Voron9: doesn't show hand 
*** SUMMARY ***
Total pot $0.12 | Rake $0 
Seat 1: Voron9 (button) collected ($0.12)
Seat 2: urahayanagi (small blind) folded before Flop
Seat 3: doc potman (big blind) folded before Flop
Seat 4: Clubberer80 folded before Flop (didn't bet)
Seat 5: HubertusB folded before Flop (didn't bet)
Seat 6: aForrester folded before Flop (didn't bet)



PokerStars Zoom Hand #186647083065:  Hold'em No Limit ($0.02/$0.05) - 2018/05/20 22:11:30 CCT [2018/05/20 10:11:30 ET]
Table 'Donati' 6-max Seat #1 is the button
Seat 1: HubertusB ($2.08 in chips) 
Seat 2: ThiagooPaiva ($5 in chips) 
Seat 3: alleck31 ($4.96 in chips) 
Seat 4: PiNe4ppLe ($13.98 in chips) 
Seat 5: Roryy3 ($4.90 in chips) 
Seat 6: OsloVest ($13.11 in chips) 
ThiagooPaiva: posts small blind $0.02
alleck31: posts big blind $0.05
*** HOLE CARDS ***
Dealt to HubertusB [2d 4h]
PiNe4ppLe: folds 
Roryy3: folds 
OsloVest: folds 
HubertusB: folds 
ThiagooPaiva: folds 
Uncalled bet ($0.03) returned to alleck31
alleck31 collected $0.04 from pot
alleck31: doesn't show hand 
*** SUMMARY ***
Total pot $0.04 | Rake $0 
Seat 1: HubertusB (button) folded before Flop (didn't bet)
Seat 2: ThiagooPaiva (small blind) folded before Flop
Seat 3: alleck31 (big blind) collected ($0.04)
Seat 4: PiNe4ppLe folded before Flop (didn't bet)
Seat 5: Roryy3 folded before Flop (didn't bet)
Seat 6: OsloVest folded before Flop (didn't bet)



PokerStars Zoom Hand #186647086083:  Hold'em No Limit ($0.02/$0.05) - 2018/05/20 22:11:35 CCT [2018/05/20 10:11:35 ET]
Table 'Donati' 6-max Seat #1 is the button
Seat 1: blazeitf4g ($5.74 in chips) 
Seat 2: jojovu ($5.01 in chips) 
Seat 3: Golodayushii ($4.56 in chips) 
Seat 4: HubertusB ($2.08 in chips) 
Seat 5: Tub1610 ($5 in chips) 
Seat 6: zwetok ($5.18 in chips) 
jojovu: posts small blind $0.02
Golodayushii: posts big blind $0.05
*** HOLE CARDS ***
Dealt to HubertusB [7h Qd]
HubertusB: folds 
Tub1610: folds 
zwetok: raises $0.06 to $0.11
blazeitf4g: calls $0.11
jojovu: folds 
Golodayushii: folds 
*** FLOP *** [9c 5h 6h]
zwetok: bets $0.23
blazeitf4g: folds 
Uncalled bet ($0.23) returned to zwetok
zwetok collected $0.28 from pot
zwetok: doesn't show hand 
*** SUMMARY ***
Total pot $0.29 | Rake $0.01 
Board [9c 5h 6h]
Seat 1: blazeitf4g (button) folded on the Flop
Seat 2: jojovu (small blind) folded before Flop
Seat 3: Golodayushii (big blind) folded before Flop
Seat 4: HubertusB folded before Flop (didn't bet)
Seat 5: Tub1610 folded before Flop (didn't bet)
Seat 6: zwetok collected ($0.28)



PokerStars Zoom Hand #186647092668:  Hold'em No Limit ($0.02/$0.05) - 2018/05/20 22:11:46 CCT [2018/05/20 10:11:46 ET]
Table 'Donati' 6-max Seat #1 is the button
Seat 1: LogenX ($7.18 in chips) 
Seat 2: GyNy1976 ($10.03 in chips) 
Seat 3: MinouXYZ ($3.29 in chips) 
Seat 4: Syuan123 ($8.87 in chips) 
Seat 5: chrapos ($9 in chips) 
Seat 6: HubertusB ($2.08 in chips) 
GyNy1976: posts small blind $0.02
MinouXYZ: posts big blind $0.05
*** HOLE CARDS ***
Dealt to HubertusB [4c 7h]
Syuan123: folds 
chrapos: raises $0.10 to $0.15
HubertusB: folds 
LogenX: folds 
GyNy1976: folds 
MinouXYZ: folds 
Uncalled bet ($0.10) returned to chrapos
chrapos collected $0.12 from pot
chrapos: doesn't show hand 
*** SUMMARY ***
Total pot $0.12 | Rake $0 
Seat 1: LogenX (button) folded before Flop (didn't bet)
Seat 2: GyNy1976 (small blind) folded before Flop
Seat 3: MinouXYZ (big blind) folded before Flop
Seat 4: Syuan123 folded before Flop (didn't bet)
Seat 5: chrapos collected ($0.12)
Seat 6: HubertusB folded before Flop (didn't bet)



PokerStars Zoom Hand #186647076504:  Hold'em No Limit ($0.02/$0.05) - 2018/05/20 22:11:19 CCT [2018/05/20 10:11:19 ET]
Table 'Donati' 6-max Seat #1 is the button
Seat 1: bober2702 ($4.53 in chips) 
Seat 2: HubertusB ($2.10 in chips) 
Seat 3: AbraRoy ($5 in chips) 
Seat 4: FeaRShoot23 ($5.87 in chips) 
Seat 5: AnalFire999 ($4.39 in chips) 
Seat 6: RedBullRobi ($2.65 in chips) 
HubertusB: posts small blind $0.02
AbraRoy: posts big blind $0.05
*** HOLE CARDS ***
Dealt to HubertusB [2c Ts]
FeaRShoot23: folds 
AnalFire999: raises $0.10 to $0.15
RedBullRobi: folds 
bober2702: folds 
HubertusB: folds 
AbraRoy: raises $0.30 to $0.45
AnalFire999: calls $0.30
*** FLOP *** [5s 2s Kc]
AbraRoy: bets $0.35
AnalFire999: calls $0.35
*** TURN *** [5s 2s Kc] [2d]
AbraRoy: checks 
AnalFire999: bets $0.78
AbraRoy: folds 
Uncalled bet ($0.78) returned to AnalFire999
AnalFire999 collected $1.55 from pot
AnalFire999: doesn't show hand 
*** SUMMARY ***
Total pot $1.62 | Rake $0.07 
Board [5s 2s Kc 2d]
Seat 1: bober2702 (button) folded before Flop (didn't bet)
Seat 2: HubertusB (small blind) folded before Flop
Seat 3: AbraRoy (big blind) folded on the Turn
Seat 4: FeaRShoot23 folded before Flop (didn't bet)
Seat 5: AnalFire999 collected ($1.55)
Seat 6: RedBullRobi folded before Flop (didn't bet)



PokerStars Zoom Hand #186647089730:  Hold'em No Limit ($0.02/$0.05) - 2018/05/20 22:11:41 CCT [2018/05/20 10:11:41 ET]
Table 'Donati' 6-max Seat #1 is the button
Seat 1: depotapo ($5.06 in chips) 
Seat 2: LogenX ($5.80 in chips) 
Seat 3: Goosich ($8.03 in chips) 
Seat 4: HubertusB ($2.08 in chips) 
Seat 5: KurpatovX ($8.72 in chips) 
Seat 6: Make6666 ($5 in chips) 
LogenX: posts small blind $0.02
Goosich: posts big blind $0.05
*** HOLE CARDS ***
Dealt to HubertusB [Kh 8d]
HubertusB: folds 
KurpatovX: raises $0.07 to $0.12
Make6666: folds 
depotapo has timed out
depotapo: folds 
LogenX: folds 
Goosich: folds 
Uncalled bet ($0.07) returned to KurpatovX
KurpatovX collected $0.12 from pot
KurpatovX: doesn't show hand 
*** SUMMARY ***
Total pot $0.12 | Rake $0 
Seat 1: depotapo (button) folded before Flop (didn't bet)
Seat 2: LogenX (small blind) folded before Flop
Seat 3: Goosich (big blind) folded before Flop
Seat 4: HubertusB folded before Flop (didn't bet)
Seat 5: KurpatovX collected ($0.12)
Seat 6: Make6666 folded before Flop (didn't bet)



PokerStars Zoom Hand #186647095725:  Hold'em No Limit ($0.02/$0.05) - 2018/05/20 22:11:51 CCT [2018/05/20 10:11:51 ET]
Table 'Donati' 6-max Seat #1 is the button
Seat 1: Yense ($4.88 in chips) 
Seat 2: HubertusB ($2.08 in chips) 
Seat 3: Siebren-K. ($4.97 in chips) 
Seat 4: aForrester ($5.20 in chips) 
Seat 5: Douugler ($4.27 in chips) 
Seat 6: schnubbiAA ($5.17 in chips) 
HubertusB: posts small blind $0.02
Siebren-K.: posts big blind $0.05
*** HOLE CARDS ***
Dealt to HubertusB [9h 5s]
aForrester: folds 
Douugler: folds 
schnubbiAA: folds 
Yense: folds 
HubertusB: folds 
Uncalled bet ($0.03) returned to Siebren-K.
Siebren-K. collected $0.04 from pot
Siebren-K.: doesn't show hand 
*** SUMMARY ***
Total pot $0.04 | Rake $0 
Seat 1: Yense (button) folded before Flop (didn't bet)
Seat 2: HubertusB (small blind) folded before Flop
Seat 3: Siebren-K. (big blind) collected ($0.04)
Seat 4: aForrester folded before Flop (didn't bet)
Seat 5: Douugler folded before Flop (didn't bet)
Seat 6: schnubbiAA folded before Flop (didn't bet)



PokerStars Zoom Hand #186647098806:  Hold'em No Limit ($0.02/$0.05) - 2018/05/20 22:11:56 CCT [2018/05/20 10:11:56 ET]
Table 'Donati' 6-max Seat #1 is the button
Seat 1: taypan101 ($5.33 in chips) 
Seat 2: ThugSnake ($4.80 in chips) 
Seat 3: HubertusB ($2.06 in chips) 
Seat 4: denshark1986 ($5.60 in chips) 
Seat 5: nick235711 ($6.24 in chips) 
Seat 6: Goodsmack78 ($3.50 in chips) 
ThugSnake: posts small blind $0.02
HubertusB: posts big blind $0.05
*** HOLE CARDS ***
Dealt to HubertusB [4d 6h]
denshark1986: folds 
nick235711: folds 
Goodsmack78: calls $0.05
taypan101: folds 
ThugSnake: folds 
HubertusB: checks 
*** FLOP *** [9d 7c 8h]
HubertusB: checks 
Goodsmack78: bets $0.05
HubertusB: calls $0.05
*** TURN *** [9d 7c 8h] [5h]
HubertusB: checks 
Goodsmack78: bets $0.11
HubertusB: calls $0.11
*** RIVER *** [9d 7c 8h 5h] [8d]
HubertusB: checks 
Goodsmack78: bets $0.21
HubertusB: raises $0.21 to $0.42
Goodsmack78: calls $0.21
*** SHOW DOWN ***
HubertusB: shows [4d 6h] (a straight, Five to Nine)
Goodsmack78: shows [6s 6d] (a straight, Five to Nine)
HubertusB collected $0.62 from pot
Goodsmack78 collected $0.61 from pot
*** SUMMARY ***
Total pot $1.28 | Rake $0.05 
Board [9d 7c 8h 5h 8d]
Seat 1: taypan101 (button) folded before Flop (didn't bet)
Seat 2: ThugSnake (small blind) folded before Flop
Seat 3: HubertusB (big blind) showed [4d 6h] and won ($0.62) with a straight, Five to Nine
Seat 4: denshark1986 folded before Flop (didn't bet)
Seat 5: nick235711 folded before Flop (didn't bet)
Seat 6: Goodsmack78 showed [6s 6d] and won ($0.61) with a straight, Five to Nine



PokerStars Zoom Hand #186647125047:  Hold'em No Limit ($0.02/$0.05) - 2018/05/20 22:12:39 CCT [2018/05/20 10:12:39 ET]
Table 'Donati' 6-max Seat #1 is the button
Seat 1: Shwippin ($5.62 in chips) 
Seat 2: vitaha00007 ($10.06 in chips) 
Seat 3: randeil19 ($5.93 in chips) 
Seat 4: ThiagooPaiva ($5 in chips) 
Seat 5: HubertusB ($2.05 in chips) 
Seat 6: qwer9019 ($5 in chips) 
vitaha00007: posts small blind $0.02
randeil19: posts big blind $0.05
*** HOLE CARDS ***
Dealt to HubertusB [2h 7c]
ThiagooPaiva: folds 
HubertusB: folds 
qwer9019: raises $0.10 to $0.15
Shwippin: folds 
vitaha00007: folds 
randeil19: folds 
Uncalled bet ($0.10) returned to qwer9019
qwer9019 collected $0.12 from pot
qwer9019: doesn't show hand 
*** SUMMARY ***
Total pot $0.12 | Rake $0 
Seat 1: Shwippin (button) folded before Flop (didn't bet)
Seat 2: vitaha00007 (small blind) folded before Flop
Seat 3: randeil19 (big blind) folded before Flop
Seat 4: ThiagooPaiva folded before Flop (didn't bet)
Seat 5: HubertusB folded before Flop (didn't bet)
Seat 6: qwer9019 collected ($0.12)



PokerStars Zoom Hand #186647128073:  Hold'em No Limit ($0.02/$0.05) - 2018/05/20 22:12:44 CCT [2018/05/20 10:12:44 ET]
Table 'Donati' 6-max Seat #1 is the button
Seat 1: HubertusB ($2.05 in chips) 
Seat 2: cazzzwell ($5 in chips) 
Seat 3: AnalFire999 ($5 in chips) 
Seat 4: iDmitriy91 ($2.40 in chips) 
Seat 5: an2004 ($7.82 in chips) 
Seat 6: kayck07 ($7.53 in chips) 
cazzzwell: posts small blind $0.02
AnalFire999: posts big blind $0.05
*** HOLE CARDS ***
Dealt to HubertusB [6s 4d]
iDmitriy91: folds 
an2004: folds 
kayck07: folds 
HubertusB: folds 
cazzzwell: folds 
Uncalled bet ($0.03) returned to AnalFire999
AnalFire999 collected $0.04 from pot
AnalFire999: doesn't show hand 
*** SUMMARY ***
Total pot $0.04 | Rake $0 
Seat 1: HubertusB (button) folded before Flop (didn't bet)
Seat 2: cazzzwell (small blind) folded before Flop
Seat 3: AnalFire999 (big blind) collected ($0.04)
Seat 4: iDmitriy91 folded before Flop (didn't bet)
Seat 5: an2004 folded before Flop (didn't bet)
Seat 6: kayck07 folded before Flop (didn't bet)



PokerStars Zoom Hand #186647137316:  Hold'em No Limit ($0.02/$0.05) - 2018/05/20 22:12:59 CCT [2018/05/20 10:12:59 ET]
Table 'Donati' 6-max Seat #1 is the button
Seat 1: Mr.Nuttts ($5.25 in chips) 
Seat 2: Kozak Sila ($6.65 in chips) 
Seat 3: lzoflamingo ($5.11 in chips) 
Seat 4: HubertusB ($2.05 in chips) 
Seat 5: trol_panda ($4.50 in chips) 
Seat 6: whitewhisper ($5.07 in chips) 
Kozak Sila: posts small blind $0.02
lzoflamingo: posts big blind $0.05
*** HOLE CARDS ***
Dealt to HubertusB [6d Ks]
HubertusB: folds 
trol_panda: folds 
whitewhisper: raises $0.10 to $0.15
Mr.Nuttts: folds 
Kozak Sila: folds 
lzoflamingo: folds 
Uncalled bet ($0.10) returned to whitewhisper
whitewhisper collected $0.12 from pot
whitewhisper: doesn't show hand 
*** SUMMARY ***
Total pot $0.12 | Rake $0 
Seat 1: Mr.Nuttts (button) folded before Flop (didn't bet)
Seat 2: Kozak Sila (small blind) folded before Flop
Seat 3: lzoflamingo (big blind) folded before Flop
Seat 4: HubertusB folded before Flop (didn't bet)
Seat 5: trol_panda folded before Flop (didn't bet)
Seat 6: whitewhisper collected ($0.12)



PokerStars Zoom Hand #186647140995:  Hold'em No Limit ($0.02/$0.05) - 2018/05/20 22:13:05 CCT [2018/05/20 10:13:05 ET]
Table 'Donati' 6-max Seat #1 is the button
Seat 1: kayck07 ($16.42 in chips) 
Seat 2: Krawicz ($5.32 in chips) 
Seat 3: HubertusB ($2.05 in chips) 
Seat 4: sizuu1225 ($7.19 in chips) 
Seat 5: Siorassc ($7.42 in chips) 
Seat 6: Guernik ($5.98 in chips) 
Krawicz: posts small blind $0.02
HubertusB: posts big blind $0.05
*** HOLE CARDS ***
Dealt to HubertusB [4s 5c]
sizuu1225: folds 
Siorassc: folds 
Guernik: raises $0.10 to $0.15
kayck07: folds 
Krawicz: folds 
HubertusB: folds 
Uncalled bet ($0.10) returned to Guernik
Guernik collected $0.12 from pot
Guernik: doesn't show hand 
*** SUMMARY ***
Total pot $0.12 | Rake $0 
Seat 1: kayck07 (button) folded before Flop (didn't bet)
Seat 2: Krawicz (small blind) folded before Flop
Seat 3: HubertusB (big blind) folded before Flop
Seat 4: sizuu1225 folded before Flop (didn't bet)
Seat 5: Siorassc folded before Flop (didn't bet)
Seat 6: Guernik collected ($0.12)



PokerStars Zoom Hand #186647132373:  Hold'em No Limit ($0.02/$0.05) - 2018/05/20 22:12:51 CCT [2018/05/20 10:12:51 ET]
Table 'Donati' 6-max Seat #1 is the button
Seat 1: Goodsmack78 ($3.46 in chips) 
Seat 2: Zheka-Alaei ($7.17 in chips) 
Seat 3: Arrenea ($6.66 in chips) 
Seat 4: HubertusB ($2.05 in chips) 
Seat 5: superfluxo ($4.04 in chips) 
Seat 6: Oleksii Voronin ($5.88 in chips) 
Zheka-Alaei: posts small blind $0.02
Arrenea: posts big blind $0.05
*** HOLE CARDS ***
Dealt to HubertusB [3c 2h]
HubertusB: folds 
superfluxo: folds 
Oleksii Voronin: raises $0.10 to $0.15
Goodsmack78: calls $0.15
Zheka-Alaei: folds 
Arrenea: folds 
*** FLOP *** [Ts 7h 6s]
Oleksii Voronin: checks 
Goodsmack78: checks 
*** TURN *** [Ts 7h 6s] [4c]
Oleksii Voronin: bets $0.22
Goodsmack78: folds 
Uncalled bet ($0.22) returned to Oleksii Voronin
Oleksii Voronin collected $0.35 from pot
Oleksii Voronin: doesn't show hand 
*** SUMMARY ***
Total pot $0.37 | Rake $0.02 
Board [Ts 7h 6s 4c]
Seat 1: Goodsmack78 (button) folded on the Turn
Seat 2: Zheka-Alaei (small blind) folded before Flop
Seat 3: Arrenea (big blind) folded before Flop
Seat 4: HubertusB folded before Flop (didn't bet)
Seat 5: superfluxo folded before Flop (didn't bet)
Seat 6: Oleksii Voronin collected ($0.35)



PokerStars Zoom Hand #186647150226:  Hold'em No Limit ($0.02/$0.05) - 2018/05/20 22:13:20 CCT [2018/05/20 10:13:20 ET]
Table 'Donati' 6-max Seat #1 is the button
Seat 1: positano7373 ($4.65 in chips) 
Seat 2: HubertusB ($2 in chips) 
Seat 3: Siorassc ($5.66 in chips) 
Seat 4: Valerik_P ($5.93 in chips) 
Seat 5: poliars ($6.81 in chips) 
Seat 6: MLombardelli ($8.85 in chips) 
HubertusB: posts small blind $0.02
Siorassc: posts big blind $0.05
*** HOLE CARDS ***
Dealt to HubertusB [2h 7c]
Valerik_P: folds 
poliars: folds 
MLombardelli: folds 
positano7373: raises $0.10 to $0.15
HubertusB: folds 
Siorassc: folds 
Uncalled bet ($0.10) returned to positano7373
positano7373 collected $0.12 from pot
positano7373: doesn't show hand 
*** SUMMARY ***
Total pot $0.12 | Rake $0 
Seat 1: positano7373 (button) collected ($0.12)
Seat 2: HubertusB (small blind) folded before Flop
Seat 3: Siorassc (big blind) folded before Flop
Seat 4: Valerik_P folded before Flop (didn't bet)
Seat 5: poliars folded before Flop (didn't bet)
Seat 6: MLombardelli folded before Flop (didn't bet)



PokerStars Zoom Hand #186647153940:  Hold'em No Limit ($0.02/$0.05) - 2018/05/20 22:13:26 CCT [2018/05/20 10:13:26 ET]
Table 'Donati' 6-max Seat #1 is the button
Seat 1: Blackantz ($5.31 in chips) 
Seat 2: kappasummer ($4.36 in chips) 
Seat 3: gerochka ($6.26 in chips) 
Seat 4: blazeitf4g ($5.07 in chips) 
Seat 5: Mr.Nuttts ($5 in chips) 
Seat 6: HubertusB ($1.98 in chips) 
kappasummer: posts small blind $0.02
gerochka: posts big blind $0.05
*** HOLE CARDS ***
Dealt to HubertusB [9d Qd]
blazeitf4g: folds 
Mr.Nuttts: folds 
HubertusB: raises $0.05 to $0.10
Blackantz: folds 
kappasummer: folds 
gerochka: folds 
Uncalled bet ($0.05) returned to HubertusB
HubertusB collected $0.12 from pot
HubertusB: doesn't show hand 
*** SUMMARY ***
Total pot $0.12 | Rake $0 
Seat 1: Blackantz (button) folded before Flop (didn't bet)
Seat 2: kappasummer (small blind) folded before Flop
Seat 3: gerochka (big blind) folded before Flop
Seat 4: blazeitf4g folded before Flop (didn't bet)
Seat 5: Mr.Nuttts folded before Flop (didn't bet)
Seat 6: HubertusB collected ($0.12)



PokerStars Zoom Hand #186647165574:  Hold'em No Limit ($0.02/$0.05) - 2018/05/20 22:13:45 CCT [2018/05/20 10:13:45 ET]
Table 'Donati' 6-max Seat #1 is the button
Seat 1: PiNe4ppLe ($12.76 in chips) 
Seat 2: yuu0914 ($7.99 in chips) 
Seat 3: eellee60 ($2.36 in chips) 
Seat 4: blazeitf4g ($5.12 in chips) 
Seat 5: HubertusB ($2.05 in chips) 
Seat 6: incorrect88 ($6.43 in chips) 
yuu0914: posts small blind $0.02
eellee60: posts big blind $0.05
*** HOLE CARDS ***
Dealt to HubertusB [9d Ks]
blazeitf4g: folds 
HubertusB: folds 
incorrect88: folds 
PiNe4ppLe: folds 
yuu0914: folds 
Uncalled bet ($0.03) returned to eellee60
eellee60 collected $0.04 from pot
eellee60: doesn't show hand 
*** SUMMARY ***
Total pot $0.04 | Rake $0 
Seat 1: PiNe4ppLe (button) folded before Flop (didn't bet)
Seat 2: yuu0914 (small blind) folded before Flop
Seat 3: eellee60 (big blind) collected ($0.04)
Seat 4: blazeitf4g folded before Flop (didn't bet)
Seat 5: HubertusB folded before Flop (didn't bet)
Seat 6: incorrect88 folded before Flop (didn't bet)



PokerStars Zoom Hand #186647170391:  Hold'em No Limit ($0.02/$0.05) - 2018/05/20 22:13:53 CCT [2018/05/20 10:13:53 ET]
Table 'Donati' 6-max Seat #1 is the button
Seat 1: HubertusB ($2.05 in chips) 
Seat 2: OsloVest ($14.45 in chips) 
Seat 3: Urisdep ($5.45 in chips) 
Seat 4: chrapos ($8.08 in chips) 
Seat 5: taypan101 ($5 in chips) 
Seat 6: BardJeka ($5 in chips) 
OsloVest: posts small blind $0.02
Urisdep: posts big blind $0.05
*** HOLE CARDS ***
Dealt to HubertusB [8s 2d]
chrapos: folds 
taypan101: folds 
BardJeka: folds 
HubertusB: folds 
OsloVest: folds 
Uncalled bet ($0.03) returned to Urisdep
Urisdep collected $0.04 from pot
Urisdep: doesn't show hand 
*** SUMMARY ***
Total pot $0.04 | Rake $0 
Seat 1: HubertusB (button) folded before Flop (didn't bet)
Seat 2: OsloVest (small blind) folded before Flop
Seat 3: Urisdep (big blind) collected ($0.04)
Seat 4: chrapos folded before Flop (didn't bet)
Seat 5: taypan101 folded before Flop (didn't bet)
Seat 6: BardJeka folded before Flop (didn't bet)



PokerStars Zoom Hand #186647174160:  Hold'em No Limit ($0.02/$0.05) - 2018/05/20 22:13:59 CCT [2018/05/20 10:13:59 ET]
Table 'Donati' 6-max Seat #1 is the button
Seat 1: maxgild85 ($5.02 in chips) 
Seat 2: beluci1 ($6.45 in chips) 
Seat 3: kranovoy22 ($6.80 in chips) 
Seat 4: leo2030 ($9.72 in chips) 
Seat 5: HubertusB ($2.05 in chips) 
Seat 6: syrok17 ($6.36 in chips) 
beluci1: posts small blind $0.02
kranovoy22: posts big blind $0.05
*** HOLE CARDS ***
Dealt to HubertusB [4s 3h]
leo2030: folds 
HubertusB: folds 
syrok17: folds 
maxgild85: folds 
beluci1: folds 
Uncalled bet ($0.03) returned to kranovoy22
kranovoy22 collected $0.04 from pot
kranovoy22: doesn't show hand 
*** SUMMARY ***
Total pot $0.04 | Rake $0 
Seat 1: maxgild85 (button) folded before Flop (didn't bet)
Seat 2: beluci1 (small blind) folded before Flop
Seat 3: kranovoy22 (big blind) collected ($0.04)
Seat 4: leo2030 folded before Flop (didn't bet)
Seat 5: HubertusB folded before Flop (didn't bet)
Seat 6: syrok17 folded before Flop (didn't bet)



PokerStars Zoom Hand #186647177223:  Hold'em No Limit ($0.02/$0.05) - 2018/05/20 22:14:04 CCT [2018/05/20 10:14:04 ET]
Table 'Donati' 6-max Seat #1 is the button
Seat 1: bybybkas ($5.41 in chips) 
Seat 2: eSSayL65 ($15.37 in chips) 
Seat 3: HubertusB ($2.05 in chips) 
Seat 4: blazeitf4g ($5.08 in chips) 
Seat 5: Chunichi ($6.63 in chips) 
Seat 6: taypan101 ($5 in chips) 
eSSayL65: posts small blind $0.02
HubertusB: posts big blind $0.05
*** HOLE CARDS ***
Dealt to HubertusB [9d 5d]
blazeitf4g: folds 
Chunichi: folds 
taypan101: raises $0.09 to $0.14
bybybkas: folds 
eSSayL65: folds 
HubertusB: folds 
Uncalled bet ($0.09) returned to taypan101
taypan101 collected $0.12 from pot
taypan101: doesn't show hand 
*** SUMMARY ***
Total pot $0.12 | Rake $0 
Seat 1: bybybkas (button) folded before Flop (didn't bet)
Seat 2: eSSayL65 (small blind) folded before Flop
Seat 3: HubertusB (big blind) folded before Flop
Seat 4: blazeitf4g folded before Flop (didn't bet)
Seat 5: Chunichi folded before Flop (didn't bet)
Seat 6: taypan101 collected ($0.12)



PokerStars Zoom Hand #186647182741:  Hold'em No Limit ($0.02/$0.05) - 2018/05/20 22:14:13 CCT [2018/05/20 10:14:13 ET]
Table 'Donati' 6-max Seat #1 is the button
Seat 1: HubertusB ($2 in chips) 
Seat 2: Croo633 ($5.60 in chips) 
Seat 3: Afan45 ($11.25 in chips) 
Seat 4: bronson220 ($6.02 in chips) 
Seat 5: WhiteWolf459 ($6.82 in chips) 
Seat 6: Make6666 ($5 in chips) 
Croo633: posts small blind $0.02
Afan45: posts big blind $0.05
*** HOLE CARDS ***
Dealt to HubertusB [5d Ad]
bronson220: folds 
WhiteWolf459: folds 
Make6666: folds 
HubertusB: raises $0.10 to $0.15
Croo633: folds 
Afan45: folds 
Uncalled bet ($0.10) returned to HubertusB
HubertusB collected $0.12 from pot
HubertusB: doesn't show hand 
*** SUMMARY ***
Total pot $0.12 | Rake $0 
Seat 1: HubertusB (button) collected ($0.12)
Seat 2: Croo633 (small blind) folded before Flop
Seat 3: Afan45 (big blind) folded before Flop
Seat 4: bronson220 folded before Flop (didn't bet)
Seat 5: WhiteWolf459 folded before Flop (didn't bet)
Seat 6: Make6666 folded before Flop (didn't bet)



PokerStars Zoom Hand #186647204834:  Hold'em No Limit ($0.02/$0.05) - 2018/05/20 22:14:49 CCT [2018/05/20 10:14:49 ET]
Table 'Donati' 6-max Seat #1 is the button
Seat 1: Danil548 ($6.06 in chips) 
Seat 2: jojovu ($5.25 in chips) 
Seat 3: KurpatovX ($8.07 in chips) 
Seat 4: lzoflamingo ($7.71 in chips) 
Seat 5: vitaha00007 ($10.15 in chips) 
Seat 6: HubertusB ($2.05 in chips) 
jojovu: posts small blind $0.02
KurpatovX: posts big blind $0.05
*** HOLE CARDS ***
Dealt to HubertusB [8d As]
lzoflamingo: folds 
vitaha00007: folds 
HubertusB: folds 
Danil548: folds 
jojovu: raises $0.10 to $0.15
KurpatovX: folds 
Uncalled bet ($0.10) returned to jojovu
jojovu collected $0.10 from pot
jojovu: doesn't show hand 
*** SUMMARY ***
Total pot $0.10 | Rake $0 
Seat 1: Danil548 (button) folded before Flop (didn't bet)
Seat 2: jojovu (small blind) collected ($0.10)
Seat 3: KurpatovX (big blind) folded before Flop
Seat 4: lzoflamingo folded before Flop (didn't bet)
Seat 5: vitaha00007 folded before Flop (didn't bet)
Seat 6: HubertusB folded before Flop (didn't bet)



PokerStars Zoom Hand #186647196808:  Hold'em No Limit ($0.02/$0.05) - 2018/05/20 22:14:36 CCT [2018/05/20 10:14:36 ET]
Table 'Donati' 6-max Seat #1 is the button
Seat 1: Apotiks ($7.82 in chips) 
Seat 2: HubertusB ($2.07 in chips) 
Seat 3: Douugler ($4.43 in chips) 
Seat 4: GOLDEVG ($2.25 in chips) 
Seat 5: Zheka-Alaei ($5 in chips) 
Seat 6: barbos2009 ($9.93 in chips) 
HubertusB: posts small blind $0.02
Douugler: posts big blind $0.05
*** HOLE CARDS ***
Dealt to HubertusB [5c 3s]
GOLDEVG: folds 
Zheka-Alaei: folds 
barbos2009: raises $0.10 to $0.15
Apotiks: folds 
HubertusB: folds 
Douugler: calls $0.10
*** FLOP *** [Ks 3c 9s]
Douugler: checks 
barbos2009: bets $0.23
Douugler: folds 
Uncalled bet ($0.23) returned to barbos2009
barbos2009 collected $0.31 from pot
barbos2009: doesn't show hand 
*** SUMMARY ***
Total pot $0.32 | Rake $0.01 
Board [Ks 3c 9s]
Seat 1: Apotiks (button) folded before Flop (didn't bet)
Seat 2: HubertusB (small blind) folded before Flop
Seat 3: Douugler (big blind) folded on the Flop
Seat 4: GOLDEVG folded before Flop (didn't bet)
Seat 5: Zheka-Alaei folded before Flop (didn't bet)
Seat 6: barbos2009 collected ($0.31)



PokerStars Zoom Hand #186647199968:  Hold'em No Limit ($0.02/$0.05) - 2018/05/20 22:14:41 CCT [2018/05/20 10:14:41 ET]
Table 'Donati' 6-max Seat #1 is the button
Seat 1: db.myers ($5.57 in chips) 
Seat 2: GambWithMe ($5.13 in chips) 
Seat 3: BigEd2006 ($8.37 in chips) 
Seat 4: nakashi11 ($7.26 in chips) 
Seat 5: Oleksii Voronin ($6.99 in chips) 
Seat 6: HubertusB ($2.05 in chips) 
GambWithMe: posts small blind $0.02
BigEd2006: posts big blind $0.05
*** HOLE CARDS ***
Dealt to HubertusB [Jc 2c]
nakashi11: folds 
Oleksii Voronin: folds 
HubertusB: folds 
db.myers: folds 
GambWithMe: raises $0.05 to $0.10
BigEd2006: calls $0.05
*** FLOP *** [Js Qh Ad]
GambWithMe: bets $0.10
BigEd2006: calls $0.10
*** TURN *** [Js Qh Ad] [Ts]
GambWithMe: bets $0.20
BigEd2006: calls $0.20
*** RIVER *** [Js Qh Ad Ts] [3s]
GambWithMe: bets $0.45
BigEd2006: folds 
Uncalled bet ($0.45) returned to GambWithMe
GambWithMe collected $0.77 from pot
GambWithMe: doesn't show hand 
*** SUMMARY ***
Total pot $0.80 | Rake $0.03 
Board [Js Qh Ad Ts 3s]
Seat 1: db.myers (button) folded before Flop (didn't bet)
Seat 2: GambWithMe (small blind) collected ($0.77)
Seat 3: BigEd2006 (big blind) folded on the River
Seat 4: nakashi11 folded before Flop (didn't bet)
Seat 5: Oleksii Voronin folded before Flop (didn't bet)
Seat 6: HubertusB folded before Flop (didn't bet)



PokerStars Zoom Hand #186647209098:  Hold'em No Limit ($0.02/$0.05) - 2018/05/20 22:14:56 CCT [2018/05/20 10:14:56 ET]
Table 'Donati' 6-max Seat #1 is the button
Seat 1: aaw990619 ($4.48 in chips) 
Seat 2: zmey797 ($3.97 in chips) 
Seat 3: spellwilli90 ($7.89 in chips) 
Seat 4: kranovoy22 ($6.80 in chips) 
Seat 5: HubertusB ($2.05 in chips) 
Seat 6: Vakaris22 ($4.64 in chips) 
zmey797: posts small blind $0.02
spellwilli90: posts big blind $0.05
*** HOLE CARDS ***
Dealt to HubertusB [Kd 2d]
kranovoy22: folds 
HubertusB: folds 
Vakaris22: raises $0.05 to $0.10
aaw990619: folds 
zmey797: raises $0.15 to $0.25
spellwilli90: folds 
Vakaris22: calls $0.15
*** FLOP *** [8c 3c 5d]
zmey797: bets $0.27
Vakaris22: folds 
Uncalled bet ($0.27) returned to zmey797
zmey797 collected $0.53 from pot
zmey797: doesn't show hand 
*** SUMMARY ***
Total pot $0.55 | Rake $0.02 
Board [8c 3c 5d]
Seat 1: aaw990619 (button) folded before Flop (didn't bet)
Seat 2: zmey797 (small blind) collected ($0.53)
Seat 3: spellwilli90 (big blind) folded before Flop
Seat 4: kranovoy22 folded before Flop (didn't bet)
Seat 5: HubertusB folded before Flop (didn't bet)
Seat 6: Vakaris22 folded on the Flop



PokerStars Zoom Hand #186647211635:  Hold'em No Limit ($0.02/$0.05) - 2018/05/20 22:15:00 CCT [2018/05/20 10:15:00 ET]
Table 'Donati' 6-max Seat #1 is the button
Seat 1: Tha_Sneakery ($10.06 in chips) 
Seat 2: alleck31 ($4.17 in chips) 
Seat 3: HubertusB ($2.05 in chips) 
Seat 4: simfilu ($10.13 in chips) 
Seat 5: thekvlt ($6.49 in chips) 
Seat 6: cazzzwell ($5.02 in chips) 
alleck31: posts small blind $0.02
HubertusB: posts big blind $0.05
*** HOLE CARDS ***
Dealt to HubertusB [7s Kh]
simfilu: folds 
thekvlt: folds 
cazzzwell: folds 
Tha_Sneakery: calls $0.05
alleck31: calls $0.03
HubertusB: checks 
*** FLOP *** [Jh 8h 8c]
alleck31: checks 
HubertusB: checks 
Tha_Sneakery: bets $0.05
alleck31: folds 
HubertusB: folds 
Uncalled bet ($0.05) returned to Tha_Sneakery
Tha_Sneakery collected $0.14 from pot
Tha_Sneakery: doesn't show hand 
*** SUMMARY ***
Total pot $0.15 | Rake $0.01 
Board [Jh 8h 8c]
Seat 1: Tha_Sneakery (button) collected ($0.14)
Seat 2: alleck31 (small blind) folded on the Flop
Seat 3: HubertusB (big blind) folded on the Flop
Seat 4: simfilu folded before Flop (didn't bet)
Seat 5: thekvlt folded before Flop (didn't bet)
Seat 6: cazzzwell folded before Flop (didn't bet)



PokerStars Zoom Hand #186647235463:  Hold'em No Limit ($0.02/$0.05) - 2018/05/20 22:15:38 CCT [2018/05/20 10:15:38 ET]
Table 'Donati' 6-max Seat #1 is the button
Seat 1: UltraRunnerr ($6.63 in chips) 
Seat 2: urahayanagi ($8.30 in chips) 
Seat 3: Siorassc ($7.48 in chips) 
Seat 4: HubertusB ($2 in chips) 
Seat 5: gefecker ($5.16 in chips) 
Seat 6: Daemon'sKiss ($5 in chips) 
urahayanagi: posts small blind $0.02
Siorassc: posts big blind $0.05
*** HOLE CARDS ***
Dealt to HubertusB [As 4d]
HubertusB: folds 
gefecker: folds 
Daemon'sKiss: folds 
UltraRunnerr: folds 
urahayanagi: raises $0.07 to $0.12
Siorassc: calls $0.07
*** FLOP *** [6h 7c 6s]
urahayanagi: bets $0.08
Siorassc: calls $0.08
*** TURN *** [6h 7c 6s] [9c]
urahayanagi: bets $0.25
Siorassc: folds 
Uncalled bet ($0.25) returned to urahayanagi
urahayanagi collected $0.38 from pot
urahayanagi: doesn't show hand 
*** SUMMARY ***
Total pot $0.40 | Rake $0.02 
Board [6h 7c 6s 9c]
Seat 1: UltraRunnerr (button) folded before Flop (didn't bet)
Seat 2: urahayanagi (small blind) collected ($0.38)
Seat 3: Siorassc (big blind) folded on the Turn
Seat 4: HubertusB folded before Flop (didn't bet)
Seat 5: gefecker folded before Flop (didn't bet)
Seat 6: Daemon'sKiss folded before Flop (didn't bet)



PokerStars Zoom Hand #186647242005:  Hold'em No Limit ($0.02/$0.05) - 2018/05/20 22:15:48 CCT [2018/05/20 10:15:48 ET]
Table 'Donati' 6-max Seat #1 is the button
Seat 1: HubertusB ($1.98 in chips) 
Seat 2: BEPA4KAps ($5.02 in chips) 
Seat 3: shuhratk2016 ($1.68 in chips) 
Seat 4: GyNy1976 ($5 in chips) 
Seat 5: pizzapan53 ($9.11 in chips) 
Seat 6: Egozocker ($5.83 in chips) 
BEPA4KAps: posts small blind $0.02
shuhratk2016: posts big blind $0.05
*** HOLE CARDS ***
Dealt to HubertusB [9c As]
GyNy1976: folds 
pizzapan53: raises $0.10 to $0.15
Egozocker: folds 
HubertusB: folds 
BEPA4KAps: calls $0.13
shuhratk2016: folds 
*** FLOP *** [3s 7c Ks]
BEPA4KAps: checks 
pizzapan53: bets $0.15
BEPA4KAps: calls $0.15
*** TURN *** [3s 7c Ks] [Qs]
BEPA4KAps: checks 
pizzapan53: bets $0.30
BEPA4KAps: raises $0.35 to $0.65
pizzapan53: calls $0.35
*** RIVER *** [3s 7c Ks Qs] [8s]
BEPA4KAps: checks 
pizzapan53: checks 
*** SHOW DOWN ***
BEPA4KAps: shows [Js Ts] (a flush, King high)
pizzapan53: mucks hand 
BEPA4KAps collected $1.87 from pot
*** SUMMARY ***
Total pot $1.95 | Rake $0.08 
Board [3s 7c Ks Qs 8s]
Seat 1: HubertusB (button) folded before Flop (didn't bet)
Seat 2: BEPA4KAps (small blind) showed [Js Ts] and won ($1.87) with a flush, King high
Seat 3: shuhratk2016 (big blind) folded before Flop
Seat 4: GyNy1976 folded before Flop (didn't bet)
Seat 5: pizzapan53 mucked [Ac Kh]
Seat 6: Egozocker folded before Flop (didn't bet)



PokerStars Zoom Hand #186647238853:  Hold'em No Limit ($0.02/$0.05) - 2018/05/20 22:15:43 CCT [2018/05/20 10:15:43 ET]
Table 'Donati' 6-max Seat #1 is the button
Seat 1: Danil548 ($6.06 in chips) 
Seat 2: HubertusB ($2 in chips) 
Seat 3: N.Pashinyan ($5.75 in chips) 
Seat 4: QWER7786 ($8.46 in chips) 
Seat 5: Fr3dST ($8.59 in chips) 
Seat 6: 3ta2wki ($8.28 in chips) 
HubertusB: posts small blind $0.02
N.Pashinyan: posts big blind $0.05
*** HOLE CARDS ***
Dealt to HubertusB [Tc 2h]
QWER7786: folds 
Fr3dST: raises $0.10 to $0.15
3ta2wki: calls $0.15
Danil548: folds 
HubertusB: folds 
N.Pashinyan: calls $0.10
*** FLOP *** [Kd 8s Ah]
N.Pashinyan: checks 
Fr3dST: checks 
3ta2wki: checks 
*** TURN *** [Kd 8s Ah] [2c]
N.Pashinyan: checks 
Fr3dST: checks 
3ta2wki: checks 
*** RIVER *** [Kd 8s Ah 2c] [8h]
N.Pashinyan: bets $0.24
Fr3dST: folds 
3ta2wki: folds 
Uncalled bet ($0.24) returned to N.Pashinyan
N.Pashinyan collected $0.45 from pot
N.Pashinyan: doesn't show hand 
*** SUMMARY ***
Total pot $0.47 | Rake $0.02 
Board [Kd 8s Ah 2c 8h]
Seat 1: Danil548 (button) folded before Flop (didn't bet)
Seat 2: HubertusB (small blind) folded before Flop
Seat 3: N.Pashinyan (big blind) collected ($0.45)
Seat 4: QWER7786 folded before Flop (didn't bet)
Seat 5: Fr3dST folded on the River
Seat 6: 3ta2wki folded on the River



PokerStars Zoom Hand #186647247522:  Hold'em No Limit ($0.02/$0.05) - 2018/05/20 22:15:57 CCT [2018/05/20 10:15:57 ET]
Table 'Donati' 6-max Seat #1 is the button
Seat 1: LogenX ($7.63 in chips) 
Seat 2: gerochka ($7.62 in chips) 
Seat 3: MetaTrader4 ($6.12 in chips) 
Seat 4: HubertusB ($1.98 in chips) 
Seat 5: Youchern ($6.41 in chips) 
Seat 6: Michel Mata ($5.22 in chips) 
gerochka: posts small blind $0.02
MetaTrader4: posts big blind $0.05
*** HOLE CARDS ***
Dealt to HubertusB [7d 6d]
HubertusB: raises $0.10 to $0.15
Youchern: folds 
Michel Mata: folds 
LogenX: folds 
gerochka: folds 
MetaTrader4: calls $0.10
*** FLOP *** [7h 8d Qs]
MetaTrader4: checks 
HubertusB: bets $0.16
MetaTrader4: calls $0.16
*** TURN *** [7h 8d Qs] [9s]
MetaTrader4: checks 
HubertusB: checks 
*** RIVER *** [7h 8d Qs 9s] [2d]
MetaTrader4: checks 
HubertusB: checks 
*** SHOW DOWN ***
MetaTrader4: shows [Ad 9d] (a pair of Nines)
HubertusB: mucks hand 
MetaTrader4 collected $0.61 from pot
*** SUMMARY ***
Total pot $0.64 | Rake $0.03 
Board [7h 8d Qs 9s 2d]
Seat 1: LogenX (button) folded before Flop (didn't bet)
Seat 2: gerochka (small blind) folded before Flop
Seat 3: MetaTrader4 (big blind) showed [Ad 9d] and won ($0.61) with a pair of Nines
Seat 4: HubertusB mucked [7d 6d]
Seat 5: Youchern folded before Flop (didn't bet)
Seat 6: Michel Mata folded before Flop (didn't bet)



PokerStars Zoom Hand #186647283409:  Hold'em No Limit ($0.02/$0.05) - 2018/05/20 22:16:54 CCT [2018/05/20 10:16:54 ET]
Table 'Donati' 6-max Seat #1 is the button
Seat 1: MetaTrader4 ($8.40 in chips) 
Seat 2: edger4013 ($11.53 in chips) 
Seat 3: HubertusB ($1.67 in chips) 
Seat 4: barbos2009 ($10.45 in chips) 
Seat 5: znos ($5.77 in chips) 
Seat 6: N.Pashinyan ($6.05 in chips) 
edger4013: posts small blind $0.02
HubertusB: posts big blind $0.05
*** HOLE CARDS ***
Dealt to HubertusB [5s Tc]
barbos2009: folds 
znos: folds 
N.Pashinyan: folds 
MetaTrader4: raises $0.07 to $0.12
edger4013: folds 
HubertusB: folds 
Uncalled bet ($0.07) returned to MetaTrader4
MetaTrader4 collected $0.12 from pot
MetaTrader4: doesn't show hand 
*** SUMMARY ***
Total pot $0.12 | Rake $0 
Seat 1: MetaTrader4 (button) collected ($0.12)
Seat 2: edger4013 (small blind) folded before Flop
Seat 3: HubertusB (big blind) folded before Flop
Seat 4: barbos2009 folded before Flop (didn't bet)
Seat 5: znos folded before Flop (didn't bet)
Seat 6: N.Pashinyan folded before Flop (didn't bet)



PokerStars Zoom Hand #186647293410:  Hold'em No Limit ($0.02/$0.05) - 2018/05/20 22:17:10 CCT [2018/05/20 10:17:10 ET]
Table 'Donati' 6-max Seat #1 is the button
Seat 1: trol_panda ($4.26 in chips) 
Seat 2: zwetok ($5.44 in chips) 
Seat 3: lzoflamingo ($7.24 in chips) 
Seat 4: Janski90 ($6.75 in chips) 
Seat 5: PVKMSSSSR ($17.20 in chips) 
Seat 6: HubertusB ($1.62 in chips) 
zwetok: posts small blind $0.02
lzoflamingo: posts big blind $0.05
*** HOLE CARDS ***
Dealt to HubertusB [Ac Kd]
Janski90: folds 
PVKMSSSSR: raises $0.10 to $0.15
HubertusB: raises $1.47 to $1.62 and is all-in
trol_panda: folds 
zwetok: folds 
lzoflamingo: folds 
PVKMSSSSR: folds 
Uncalled bet ($1.47) returned to HubertusB
HubertusB collected $0.37 from pot
HubertusB: doesn't show hand 
*** SUMMARY ***
Total pot $0.37 | Rake $0 
Seat 1: trol_panda (button) folded before Flop (didn't bet)
Seat 2: zwetok (small blind) folded before Flop
Seat 3: lzoflamingo (big blind) folded before Flop
Seat 4: Janski90 folded before Flop (didn't bet)
Seat 5: PVKMSSSSR folded before Flop
Seat 6: HubertusB collected ($0.37)



PokerStars Zoom Hand #186647290286:  Hold'em No Limit ($0.02/$0.05) - 2018/05/20 22:17:05 CCT [2018/05/20 10:17:05 ET]
Table 'Donati' 6-max Seat #1 is the button
Seat 1: thekvlt ($5 in chips) 
Seat 2: Guernik ($5 in chips) 
Seat 3: sunao1983 ($5.13 in chips) 
Seat 4: HubertusB ($1.62 in chips) 
Seat 5: ivan 1987465 ($5.07 in chips) 
Seat 6: gerochka ($5 in chips) 
Guernik: posts small blind $0.02
sunao1983: posts big blind $0.05
*** HOLE CARDS ***
Dealt to HubertusB [Qh 4c]
HubertusB: folds 
ivan 1987465: folds 
gerochka: folds 
thekvlt: raises $0.10 to $0.15
Guernik: folds 
sunao1983: calls $0.10
*** FLOP *** [3s 6c 7s]
sunao1983: checks 
thekvlt: bets $0.24
sunao1983: calls $0.24
*** TURN *** [3s 6c 7s] [8c]
sunao1983: bets $0.40
thekvlt: calls $0.40
*** RIVER *** [3s 6c 7s 8c] [5s]
sunao1983: bets $0.40
thekvlt: calls $0.40
*** SHOW DOWN ***
sunao1983: shows [8h 7h] (two pair, Eights and Sevens)
thekvlt: shows [9c 8s] (a straight, Five to Nine)
thekvlt collected $2.30 from pot
*** SUMMARY ***
Total pot $2.40 | Rake $0.10 
Board [3s 6c 7s 8c 5s]
Seat 1: thekvlt (button) showed [9c 8s] and won ($2.30) with a straight, Five to Nine
Seat 2: Guernik (small blind) folded before Flop
Seat 3: sunao1983 (big blind) showed [8h 7h] and lost with two pair, Eights and Sevens
Seat 4: HubertusB folded before Flop (didn't bet)
Seat 5: ivan 1987465 folded before Flop (didn't bet)
Seat 6: gerochka folded before Flop (didn't bet)



PokerStars Zoom Hand #186647311750:  Hold'em No Limit ($0.02/$0.05) - 2018/05/20 22:17:39 CCT [2018/05/20 10:17:39 ET]
Table 'Donati' 6-max Seat #1 is the button
Seat 1: HubertusB ($1.82 in chips) 
Seat 2: Sergei44427 ($10.76 in chips) 
Seat 3: Molesterx ($5 in chips) 
Seat 4: db.myers ($10.29 in chips) 
Seat 5: Siorassc ($5.27 in chips) 
Seat 6: angelmonteza ($3.50 in chips) 
Sergei44427: posts small blind $0.02
Molesterx: posts big blind $0.05
*** HOLE CARDS ***
Dealt to HubertusB [Ks 2s]
db.myers: folds 
Siorassc: raises $0.07 to $0.12
angelmonteza: folds 
HubertusB: folds 
Sergei44427: folds 
Molesterx: folds 
Uncalled bet ($0.07) returned to Siorassc
Siorassc collected $0.12 from pot
Siorassc: doesn't show hand 
*** SUMMARY ***
Total pot $0.12 | Rake $0 
Seat 1: HubertusB (button) folded before Flop (didn't bet)
Seat 2: Sergei44427 (small blind) folded before Flop
Seat 3: Molesterx (big blind) folded before Flop
Seat 4: db.myers folded before Flop (didn't bet)
Seat 5: Siorassc collected ($0.12)
Seat 6: angelmonteza folded before Flop (didn't bet)



PokerStars Zoom Hand #186647317992:  Hold'em No Limit ($0.02/$0.05) - 2018/05/20 22:17:49 CCT [2018/05/20 10:17:49 ET]
Table 'Donati' 6-max Seat #1 is the button
Seat 1: adnana14 ($4.10 in chips) 
Seat 2: RedBullRobi ($2.83 in chips) 
Seat 3: alleck31 ($4.52 in chips) 
Seat 4: urahayanagi ($8.48 in chips) 
Seat 5: astap50 ($4.94 in chips) 
Seat 6: HubertusB ($1.82 in chips) 
RedBullRobi: posts small blind $0.02
alleck31: posts big blind $0.05
*** HOLE CARDS ***
Dealt to HubertusB [8d Kc]
urahayanagi: folds 
astap50: folds 
HubertusB: folds 
adnana14: folds 
RedBullRobi: folds 
Uncalled bet ($0.03) returned to alleck31
alleck31 collected $0.04 from pot
alleck31: doesn't show hand 
*** SUMMARY ***
Total pot $0.04 | Rake $0 
Seat 1: adnana14 (button) folded before Flop (didn't bet)
Seat 2: RedBullRobi (small blind) folded before Flop
Seat 3: alleck31 (big blind) collected ($0.04)
Seat 4: urahayanagi folded before Flop (didn't bet)
Seat 5: astap50 folded before Flop (didn't bet)
Seat 6: HubertusB folded before Flop (didn't bet)



PokerStars Zoom Hand #186647314877:  Hold'em No Limit ($0.02/$0.05) - 2018/05/20 22:17:44 CCT [2018/05/20 10:17:44 ET]
Table 'Donati' 6-max Seat #1 is the button
Seat 1: surfer-kgs ($4.93 in chips) 
Seat 2: Yamma18 ($6.38 in chips) 
Seat 3: sunao1983 ($2 in chips) 
Seat 4: VLSALT ($6.97 in chips) 
Seat 5: HubertusB ($1.82 in chips) 
Seat 6: dyuh555 ($4.53 in chips) 
Yamma18: posts small blind $0.02
sunao1983: posts big blind $0.05
*** HOLE CARDS ***
Dealt to HubertusB [4h 5s]
VLSALT: folds 
HubertusB: folds 
dyuh555: folds 
surfer-kgs: raises $0.10 to $0.15
Yamma18: folds 
sunao1983: folds 
Uncalled bet ($0.10) returned to surfer-kgs
surfer-kgs collected $0.12 from pot
surfer-kgs: doesn't show hand 
*** SUMMARY ***
Total pot $0.12 | Rake $0 
Seat 1: surfer-kgs (button) collected ($0.12)
Seat 2: Yamma18 (small blind) folded before Flop
Seat 3: sunao1983 (big blind) folded before Flop
Seat 4: VLSALT folded before Flop (didn't bet)
Seat 5: HubertusB folded before Flop (didn't bet)
Seat 6: dyuh555 folded before Flop (didn't bet)



PokerStars Zoom Hand #186647321202:  Hold'em No Limit ($0.02/$0.05) - 2018/05/20 22:17:54 CCT [2018/05/20 10:17:54 ET]
Table 'Donati' 6-max Seat #1 is the button
Seat 1: Karlyvzla27 ($4.10 in chips) 
Seat 2: WeakmindedV1 ($10.78 in chips) 
Seat 3: HubertusB ($1.82 in chips) 
Seat 4: ThiagooPaiva ($6.45 in chips) 
Seat 5: zavodlera ($0.27 in chips) 
Seat 6: Ezhewika ($1.58 in chips) 
WeakmindedV1: posts small blind $0.02
HubertusB: posts big blind $0.05
*** HOLE CARDS ***
Dealt to HubertusB [3c Qc]
ThiagooPaiva: folds 
zavodlera: folds 
Ezhewika: folds 
Karlyvzla27: folds 
WeakmindedV1: folds 
Uncalled bet ($0.03) returned to HubertusB
HubertusB collected $0.04 from pot
HubertusB: doesn't show hand 
*** SUMMARY ***
Total pot $0.04 | Rake $0 
Seat 1: Karlyvzla27 (button) folded before Flop (didn't bet)
Seat 2: WeakmindedV1 (small blind) folded before Flop
Seat 3: HubertusB (big blind) collected ($0.04)
Seat 4: ThiagooPaiva folded before Flop (didn't bet)
Seat 5: zavodlera folded before Flop (didn't bet)
Seat 6: Ezhewika folded before Flop (didn't bet)



PokerStars Zoom Hand #186647309190:  Hold'em No Limit ($0.02/$0.05) - 2018/05/20 22:17:35 CCT [2018/05/20 10:17:35 ET]
Table 'Donati' 6-max Seat #1 is the button
Seat 1: Genal55 ($7.60 in chips) 
Seat 2: HubertusB ($1.84 in chips) 
Seat 3: Apotiks ($5.29 in chips) 
Seat 4: sunao1983 ($2 in chips) 
Seat 5: algor67 ($3.68 in chips) 
Seat 6: Golodayushii ($16.29 in chips) 
HubertusB: posts small blind $0.02
Apotiks: posts big blind $0.05
*** HOLE CARDS ***
Dealt to HubertusB [Tc 5d]
sunao1983: folds 
algor67: raises $0.10 to $0.15
Golodayushii: calls $0.15
Genal55: folds 
HubertusB: folds 
Apotiks: folds 
*** FLOP *** [8s Th 6d]
algor67: bets $0.23
Golodayushii: calls $0.23
*** TURN *** [8s Th 6d] [9d]
algor67: checks 
Golodayushii: checks 
*** RIVER *** [8s Th 6d 9d] [7d]
algor67: checks 
Golodayushii: checks 
*** SHOW DOWN ***
algor67: shows [2d 2h] (a straight, Six to Ten)
Golodayushii: shows [8c 9c] (a straight, Six to Ten)
algor67 collected $0.40 from pot
Golodayushii collected $0.40 from pot
*** SUMMARY ***
Total pot $0.83 | Rake $0.03 
Board [8s Th 6d 9d 7d]
Seat 1: Genal55 (button) folded before Flop (didn't bet)
Seat 2: HubertusB (small blind) folded before Flop
Seat 3: Apotiks (big blind) folded before Flop
Seat 4: sunao1983 folded before Flop (didn't bet)
Seat 5: algor67 showed [2d 2h] and won ($0.40) with a straight, Six to Ten
Seat 6: Golodayushii showed [8c 9c] and won ($0.40) with a straight, Six to Ten



PokerStars Zoom Hand #186647329938:  Hold'em No Limit ($0.02/$0.05) - 2018/05/20 22:18:08 CCT [2018/05/20 10:18:08 ET]
Table 'Donati' 6-max Seat #1 is the button
Seat 1: Zheka-Alaei ($10.33 in chips) 
Seat 2: HubertusB ($1.84 in chips) 
Seat 3: BigCat16Max ($1.44 in chips) 
Seat 4: edger4013 ($5.96 in chips) 
Seat 5: Harry0509 ($4.51 in chips) 
Seat 6: Afan45 ($10.49 in chips) 
HubertusB: posts small blind $0.02
BigCat16Max: posts big blind $0.05
*** HOLE CARDS ***
Dealt to HubertusB [Ac 2c]
edger4013: raises $0.10 to $0.15
Harry0509: folds 
Afan45: folds 
Zheka-Alaei: calls $0.15
HubertusB: calls $0.13
BigCat16Max: folds 
*** FLOP *** [3d Qh Qs]
HubertusB: checks 
edger4013: checks 
Zheka-Alaei: bets $0.32
HubertusB: folds 
edger4013: calls $0.32
*** TURN *** [3d Qh Qs] [Ts]
edger4013: checks 
Zheka-Alaei: bets $0.38
edger4013: calls $0.38
*** RIVER *** [3d Qh Qs Ts] [Jh]
edger4013: checks 
Zheka-Alaei: bets $1.37
edger4013: calls $1.37
*** SHOW DOWN ***
Zheka-Alaei: shows [9c Qc] (three of a kind, Queens)
edger4013: shows [As Qd] (three of a kind, Queens - Ace kicker)
edger4013 collected $4.45 from pot
*** SUMMARY ***
Total pot $4.64 | Rake $0.19 
Board [3d Qh Qs Ts Jh]
Seat 1: Zheka-Alaei (button) showed [9c Qc] and lost with three of a kind, Queens
Seat 2: HubertusB (small blind) folded on the Flop
Seat 3: BigCat16Max (big blind) folded before Flop
Seat 4: edger4013 showed [As Qd] and won ($4.45) with three of a kind, Queens
Seat 5: Harry0509 folded before Flop (didn't bet)
Seat 6: Afan45 folded before Flop (didn't bet)



PokerStars Zoom Hand #186647351262:  Hold'em No Limit ($0.02/$0.05) - 2018/05/20 22:18:42 CCT [2018/05/20 10:18:42 ET]
Table 'Donati' 6-max Seat #1 is the button
Seat 1: Tub1610 ($8.20 in chips) 
Seat 2: randeil19 ($5 in chips) 
Seat 3: ansia171717 ($4.15 in chips) 
Seat 4: Zheka-Alaei ($5 in chips) 
Seat 5: HubertusB ($1.69 in chips) 
Seat 6: LogenX ($8.32 in chips) 
randeil19: posts small blind $0.02
ansia171717: posts big blind $0.05
*** HOLE CARDS ***
Dealt to HubertusB [Qh Ac]
Zheka-Alaei: folds 
HubertusB: raises $0.10 to $0.15
LogenX: folds 
Tub1610: folds 
randeil19: raises $0.35 to $0.50
ansia171717: folds 
HubertusB: raises $1.19 to $1.69 and is all-in
randeil19: calls $1.19
*** FLOP *** [6c 9s 3c]
*** TURN *** [6c 9s 3c] [Tc]
*** RIVER *** [6c 9s 3c Tc] [3h]
*** SHOW DOWN ***
randeil19: shows [As Kh] (a pair of Threes)
HubertusB: shows [Qh Ac] (a pair of Threes - lower kicker)
randeil19 collected $3.29 from pot
*** SUMMARY ***
Total pot $3.43 | Rake $0.14 
Board [6c 9s 3c Tc 3h]
Seat 1: Tub1610 (button) folded before Flop (didn't bet)
Seat 2: randeil19 (small blind) showed [As Kh] and won ($3.29) with a pair of Threes
Seat 3: ansia171717 (big blind) folded before Flop
Seat 4: Zheka-Alaei folded before Flop (didn't bet)
Seat 5: HubertusB showed [Qh Ac] and lost with a pair of Threes
Seat 6: LogenX folded before Flop (didn't bet)



PokerStars Zoom Hand #186647375100:  Hold'em No Limit ($0.02/$0.05) - 2018/05/20 22:19:20 CCT [2018/05/20 10:19:20 ET]
Table 'Donati' 6-max Seat #1 is the button
Seat 1: HubertusB ($5 in chips) 
Seat 2: galina817 ($5.66 in chips) 
Seat 3: alleck31 ($4.38 in chips) 
Seat 4: beluci1 ($5.36 in chips) 
Seat 5: adnana14 ($5.79 in chips) 
Seat 6: JayEmBee420 ($2.53 in chips) 
galina817: posts small blind $0.02
alleck31: posts big blind $0.05
*** HOLE CARDS ***
Dealt to HubertusB [4c Kc]
beluci1: folds 
adnana14: folds 
JayEmBee420: folds 
HubertusB: folds 
galina817: folds 
Uncalled bet ($0.03) returned to alleck31
alleck31 collected $0.04 from pot
alleck31: doesn't show hand 
*** SUMMARY ***
Total pot $0.04 | Rake $0 
Seat 1: HubertusB (button) folded before Flop (didn't bet)
Seat 2: galina817 (small blind) folded before Flop
Seat 3: alleck31 (big blind) collected ($0.04)
Seat 4: beluci1 folded before Flop (didn't bet)
Seat 5: adnana14 folded before Flop (didn't bet)
Seat 6: JayEmBee420 folded before Flop (didn't bet)



PokerStars Zoom Hand #186647378973:  Hold'em No Limit ($0.02/$0.05) - 2018/05/20 22:19:26 CCT [2018/05/20 10:19:26 ET]
Table 'Donati' 6-max Seat #1 is the button
Seat 1: AAkagerAA ($4.83 in chips) 
Seat 2: sizuu1225 ($6.96 in chips) 
Seat 3: oOps_2206 ($3.78 in chips) 
Seat 4: HubertusB ($5 in chips) 
Seat 5: Janski90 ($9.90 in chips) 
Seat 6: tzrgamma ($3.24 in chips) 
sizuu1225: posts small blind $0.02
oOps_2206: posts big blind $0.05
*** HOLE CARDS ***
Dealt to HubertusB [5d Kd]
HubertusB: folds 
Janski90: folds 
tzrgamma: folds 
AAkagerAA: folds 
sizuu1225: folds 
Uncalled bet ($0.03) returned to oOps_2206
oOps_2206 collected $0.04 from pot
oOps_2206: doesn't show hand 
*** SUMMARY ***
Total pot $0.04 | Rake $0 
Seat 1: AAkagerAA (button) folded before Flop (didn't bet)
Seat 2: sizuu1225 (small blind) folded before Flop
Seat 3: oOps_2206 (big blind) collected ($0.04)
Seat 4: HubertusB folded before Flop (didn't bet)
Seat 5: Janski90 folded before Flop (didn't bet)
Seat 6: tzrgamma folded before Flop (didn't bet)



PokerStars Zoom Hand #186647371362:  Hold'em No Limit ($0.02/$0.05) - 2018/05/20 22:19:14 CCT [2018/05/20 10:19:14 ET]
Table 'Donati' 6-max Seat #1 is the button
Seat 1: TheFibonachi ($8.02 in chips) 
Seat 2: BEPA4KAps ($6.02 in chips) 
Seat 3: cct918 ($4.75 in chips) 
Seat 4: Afan45 ($7.58 in chips) 
Seat 5: HubertusB ($5 in chips) 
Seat 6: MetaTrader4 ($6.22 in chips) 
BEPA4KAps: posts small blind $0.02
cct918: posts big blind $0.05
*** HOLE CARDS ***
Dealt to HubertusB [4h 6s]
Afan45: folds 
HubertusB: folds 
MetaTrader4: folds 
TheFibonachi: raises $0.07 to $0.12
BEPA4KAps: folds 
cct918: calls $0.07
*** FLOP *** [8c Td 9h]
cct918: bets $0.15
TheFibonachi: folds 
Uncalled bet ($0.15) returned to cct918
cct918 collected $0.25 from pot
cct918: doesn't show hand 
*** SUMMARY ***
Total pot $0.26 | Rake $0.01 
Board [8c Td 9h]
Seat 1: TheFibonachi (button) folded on the Flop
Seat 2: BEPA4KAps (small blind) folded before Flop
Seat 3: cct918 (big blind) collected ($0.25)
Seat 4: Afan45 folded before Flop (didn't bet)
Seat 5: HubertusB folded before Flop (didn't bet)
Seat 6: MetaTrader4 folded before Flop (didn't bet)



PokerStars Zoom Hand #186647385208:  Hold'em No Limit ($0.02/$0.05) - 2018/05/20 22:19:36 CCT [2018/05/20 10:19:36 ET]
Table 'Donati' 6-max Seat #1 is the button
Seat 1: WhiteWolf459 ($5 in chips) 
Seat 2: Fish @ China ($5.04 in chips) 
Seat 3: HubertusB ($5 in chips) 
Seat 4: Sergei44427 ($9.84 in chips) 
Seat 5: oOps_2206 ($5 in chips) 
Seat 6: Yptom ($5.76 in chips) 
Fish @ China: posts small blind $0.02
HubertusB: posts big blind $0.05
*** HOLE CARDS ***
Dealt to HubertusB [3c 9h]
Sergei44427: folds 
oOps_2206: folds 
Yptom: folds 
WhiteWolf459: folds 
Fish @ China: folds 
Uncalled bet ($0.03) returned to HubertusB
HubertusB collected $0.04 from pot
HubertusB: doesn't show hand 
*** SUMMARY ***
Total pot $0.04 | Rake $0 
Seat 1: WhiteWolf459 (button) folded before Flop (didn't bet)
Seat 2: Fish @ China (small blind) folded before Flop
Seat 3: HubertusB (big blind) collected ($0.04)
Seat 4: Sergei44427 folded before Flop (didn't bet)
Seat 5: oOps_2206 folded before Flop (didn't bet)
Seat 6: Yptom folded before Flop (didn't bet)



PokerStars Zoom Hand #186647382117:  Hold'em No Limit ($0.02/$0.05) - 2018/05/20 22:19:31 CCT [2018/05/20 10:19:31 ET]
Table 'Donati' 6-max Seat #1 is the button
Seat 1: Molesterx ($5.14 in chips) 
Seat 2: LeetSkilz ($5 in chips) 
Seat 3: Zheka-Alaei ($8.09 in chips) 
Seat 4: HubertusB ($5 in chips) 
Seat 5: LogenX ($3.45 in chips) 
Seat 6: bidipro ($6.91 in chips) 
LeetSkilz: posts small blind $0.02
Zheka-Alaei: posts big blind $0.05
*** HOLE CARDS ***
Dealt to HubertusB [6d Ts]
HubertusB: folds 
LogenX: raises $0.10 to $0.15
bidipro: folds 
Molesterx: folds 
LeetSkilz: folds 
Zheka-Alaei: calls $0.10
*** FLOP *** [2c Qd 7c]
Zheka-Alaei: checks 
LogenX: checks 
*** TURN *** [2c Qd 7c] [4d]
Zheka-Alaei: checks 
LogenX: checks 
*** RIVER *** [2c Qd 7c 4d] [Tc]
Zheka-Alaei: checks 
LogenX: checks 
*** SHOW DOWN ***
Zheka-Alaei: shows [3h 4h] (a pair of Fours)
LogenX: shows [9c 9h] (a pair of Nines)
LogenX collected $0.31 from pot
*** SUMMARY ***
Total pot $0.32 | Rake $0.01 
Board [2c Qd 7c 4d Tc]
Seat 1: Molesterx (button) folded before Flop (didn't bet)
Seat 2: LeetSkilz (small blind) folded before Flop
Seat 3: Zheka-Alaei (big blind) showed [3h 4h] and lost with a pair of Fours
Seat 4: HubertusB folded before Flop (didn't bet)
Seat 5: LogenX showed [9c 9h] and won ($0.31) with a pair of Nines
Seat 6: bidipro folded before Flop (didn't bet)



PokerStars Zoom Hand #186647396001:  Hold'em No Limit ($0.02/$0.05) - 2018/05/20 22:19:53 CCT [2018/05/20 10:19:53 ET]
Table 'Donati' 6-max Seat #1 is the button
Seat 1: Vakaris22 ($3.95 in chips) 
Seat 2: DylanMoran ($5.40 in chips) 
Seat 3: volodymyr546 ($4.50 in chips) 
Seat 4: Blackantz ($6.14 in chips) 
Seat 5: serg197211 ($7.69 in chips) 
Seat 6: HubertusB ($5.02 in chips) 
DylanMoran: posts small blind $0.02
volodymyr546: posts big blind $0.05
*** HOLE CARDS ***
Dealt to HubertusB [Kh 8d]
Blackantz: raises $0.09 to $0.14
serg197211: folds 
HubertusB: folds 
Vakaris22: folds 
DylanMoran: folds 
volodymyr546: folds 
Uncalled bet ($0.09) returned to Blackantz
Blackantz collected $0.12 from pot
Blackantz: doesn't show hand 
*** SUMMARY ***
Total pot $0.12 | Rake $0 
Seat 1: Vakaris22 (button) folded before Flop (didn't bet)
Seat 2: DylanMoran (small blind) folded before Flop
Seat 3: volodymyr546 (big blind) folded before Flop
Seat 4: Blackantz collected ($0.12)
Seat 5: serg197211 folded before Flop (didn't bet)
Seat 6: HubertusB folded before Flop (didn't bet)



PokerStars Zoom Hand #186647399205:  Hold'em No Limit ($0.02/$0.05) - 2018/05/20 22:19:58 CCT [2018/05/20 10:19:58 ET]
Table 'Donati' 6-max Seat #1 is the button
Seat 1: leo2030 ($10.65 in chips) 
Seat 2: HubertusB ($5.02 in chips) 
Seat 3: $ir_AleXXX ($5.42 in chips) 
Seat 4: Egozocker ($5 in chips) 
Seat 5: opopo0009 ($5 in chips) 
Seat 6: poliars ($6.93 in chips) 
HubertusB: posts small blind $0.02
$ir_AleXXX: posts big blind $0.05
*** HOLE CARDS ***
Dealt to HubertusB [Tc 2h]
Egozocker: folds 
opopo0009: folds 
poliars: raises $0.10 to $0.15
leo2030: folds 
HubertusB: folds 
$ir_AleXXX: folds 
Uncalled bet ($0.10) returned to poliars
poliars collected $0.12 from pot
poliars: doesn't show hand 
*** SUMMARY ***
Total pot $0.12 | Rake $0 
Seat 1: leo2030 (button) folded before Flop (didn't bet)
Seat 2: HubertusB (small blind) folded before Flop
Seat 3: $ir_AleXXX (big blind) folded before Flop
Seat 4: Egozocker folded before Flop (didn't bet)
Seat 5: opopo0009 folded before Flop (didn't bet)
Seat 6: poliars collected ($0.12)



PokerStars Zoom Hand #186647402366:  Hold'em No Limit ($0.02/$0.05) - 2018/05/20 22:20:03 CCT [2018/05/20 10:20:03 ET]
Table 'Donati' 6-max Seat #1 is the button
Seat 1: HubertusB ($5 in chips) 
Seat 2: kayck07 ($5 in chips) 
Seat 3: filifera ($4.31 in chips) 
Seat 4: Sonoionin ($8.24 in chips) 
Seat 5: Guernik ($6.34 in chips) 
Seat 6: Syuan123 ($5 in chips) 
kayck07: posts small blind $0.02
filifera: posts big blind $0.05
*** HOLE CARDS ***
Dealt to HubertusB [7d 9s]
Sonoionin: folds 
Guernik: folds 
Syuan123: folds 
HubertusB: folds 
kayck07: folds 
Uncalled bet ($0.03) returned to filifera
filifera collected $0.04 from pot
filifera: doesn't show hand 
*** SUMMARY ***
Total pot $0.04 | Rake $0 
Seat 1: HubertusB (button) folded before Flop (didn't bet)
Seat 2: kayck07 (small blind) folded before Flop
Seat 3: filifera (big blind) collected ($0.04)
Seat 4: Sonoionin folded before Flop (didn't bet)
Seat 5: Guernik folded before Flop (didn't bet)
Seat 6: Syuan123 folded before Flop (didn't bet)



PokerStars Zoom Hand #186647405541:  Hold'em No Limit ($0.02/$0.05) - 2018/05/20 22:20:08 CCT [2018/05/20 10:20:08 ET]
Table 'Donati' 6-max Seat #1 is the button
Seat 1: celams ($5.25 in chips) 
Seat 2: PiNe4ppLe ($9.37 in chips) 
Seat 3: Zheka-Alaei ($6.55 in chips) 
Seat 4: JayEmBee420 ($2.46 in chips) 
Seat 5: urahayanagi ($9.32 in chips) 
Seat 6: HubertusB ($5 in chips) 
PiNe4ppLe: posts small blind $0.02
Zheka-Alaei: posts big blind $0.05
*** HOLE CARDS ***
Dealt to HubertusB [2d 9h]
JayEmBee420: folds 
urahayanagi: folds 
HubertusB: folds 
celams: raises $0.07 to $0.12
PiNe4ppLe: folds 
Zheka-Alaei: folds 
Uncalled bet ($0.07) returned to celams
celams collected $0.12 from pot
celams: doesn't show hand 
*** SUMMARY ***
Total pot $0.12 | Rake $0 
Seat 1: celams (button) collected ($0.12)
Seat 2: PiNe4ppLe (small blind) folded before Flop
Seat 3: Zheka-Alaei (big blind) folded before Flop
Seat 4: JayEmBee420 folded before Flop (didn't bet)
Seat 5: urahayanagi folded before Flop (didn't bet)
Seat 6: HubertusB folded before Flop (didn't bet)



PokerStars Zoom Hand #186647409280:  Hold'em No Limit ($0.02/$0.05) - 2018/05/20 22:20:14 CCT [2018/05/20 10:20:14 ET]
Table 'Donati' 6-max Seat #1 is the button
Seat 1: falcao991 ($12.31 in chips) 
Seat 2: Retsrollp ($5.31 in chips) 
Seat 3: bronson220 ($4.88 in chips) 
Seat 4: DarkKnajt ($5 in chips) 
Seat 5: HubertusB ($5 in chips) 
Seat 6: Kaizenja ($3.50 in chips) 
Retsrollp: posts small blind $0.02
bronson220: posts big blind $0.05
*** HOLE CARDS ***
Dealt to HubertusB [8d 8s]
DarkKnajt: folds 
HubertusB: raises $0.10 to $0.15
Kaizenja: folds 
falcao991: folds 
Retsrollp: calls $0.13
bronson220: folds 
*** FLOP *** [2d 5c Td]
Retsrollp: checks 
HubertusB: checks 
*** TURN *** [2d 5c Td] [Th]
Retsrollp: checks 
HubertusB: bets $0.15
Retsrollp: folds 
Uncalled bet ($0.15) returned to HubertusB
HubertusB collected $0.34 from pot
HubertusB: doesn't show hand 
*** SUMMARY ***
Total pot $0.35 | Rake $0.01 
Board [2d 5c Td Th]
Seat 1: falcao991 (button) folded before Flop (didn't bet)
Seat 2: Retsrollp (small blind) folded on the Turn
Seat 3: bronson220 (big blind) folded before Flop
Seat 4: DarkKnajt folded before Flop (didn't bet)
Seat 5: HubertusB collected ($0.34)
Seat 6: Kaizenja folded before Flop (didn't bet)



PokerStars Zoom Hand #186647422737:  Hold'em No Limit ($0.02/$0.05) - 2018/05/20 22:20:36 CCT [2018/05/20 10:20:36 ET]
Table 'Donati' 6-max Seat #1 is the button
Seat 1: Krawicz ($5.59 in chips) 
Seat 2: HubertusB ($5.19 in chips) 
Seat 3: randeil19 ($5 in chips) 
Seat 4: converse12 ($2.21 in chips) 
Seat 5: ptolemaios99 ($18.34 in chips) 
Seat 6: Savavlad97 ($5.32 in chips) 
HubertusB: posts small blind $0.02
randeil19: posts big blind $0.05
*** HOLE CARDS ***
Dealt to HubertusB [5s 4c]
converse12: raises $0.05 to $0.10
ptolemaios99: raises $0.20 to $0.30
Savavlad97: folds 
Krawicz: calls $0.30
HubertusB: folds 
randeil19: folds 
converse12: calls $0.20
*** FLOP *** [3h 3s Kd]
converse12: checks 
ptolemaios99: checks 
Krawicz: checks 
*** TURN *** [3h 3s Kd] [6c]
converse12: checks 
ptolemaios99: bets $0.45
Krawicz: calls $0.45
converse12: folds 
*** RIVER *** [3h 3s Kd 6c] [3c]
ptolemaios99: bets $0.55
Krawicz: calls $0.55
*** SHOW DOWN ***
ptolemaios99: shows [Kh Ah] (a full house, Threes full of Kings)
Krawicz: mucks hand 
ptolemaios99 collected $2.85 from pot
*** SUMMARY ***
Total pot $2.97 | Rake $0.12 
Board [3h 3s Kd 6c 3c]
Seat 1: Krawicz (button) mucked [Js Jh]
Seat 2: HubertusB (small blind) folded before Flop
Seat 3: randeil19 (big blind) folded before Flop
Seat 4: converse12 folded on the Turn
Seat 5: ptolemaios99 showed [Kh Ah] and won ($2.85) with a full house, Threes full of Kings
Seat 6: Savavlad97 folded before Flop (didn't bet)



PokerStars Zoom Hand #186647752350:  Hold'em No Limit ($0.02/$0.05) - 2018/05/20 22:29:20 CCT [2018/05/20 10:29:20 ET]
Table 'Donati' 6-max Seat #1 is the button
Seat 1: youri1961 ($4.07 in chips) 
Seat 2: Syuan123 ($8.65 in chips) 
Seat 3: HubertusB ($5.17 in chips) 
Seat 4: incorrect88 ($7.46 in chips) 
Seat 5: cazzzwell ($5 in chips) 
Seat 6: U_RULIA ($5 in chips) 
Syuan123: posts small blind $0.02
HubertusB: posts big blind $0.05
*** HOLE CARDS ***
Dealt to HubertusB [8c 2h]
incorrect88: folds 
cazzzwell: raises $0.10 to $0.15
U_RULIA: folds 
youri1961: folds 
Syuan123: folds 
HubertusB: folds 
Uncalled bet ($0.10) returned to cazzzwell
cazzzwell collected $0.12 from pot
cazzzwell: doesn't show hand 
*** SUMMARY ***
Total pot $0.12 | Rake $0 
Seat 1: youri1961 (button) folded before Flop (didn't bet)
Seat 2: Syuan123 (small blind) folded before Flop
Seat 3: HubertusB (big blind) folded before Flop
Seat 4: incorrect88 folded before Flop (didn't bet)
Seat 5: cazzzwell collected ($0.12)
Seat 6: U_RULIA folded before Flop (didn't bet)



PokerStars Zoom Hand #186647756812:  Hold'em No Limit ($0.02/$0.05) - 2018/05/20 22:29:27 CCT [2018/05/20 10:29:27 ET]
Table 'Donati' 6-max Seat #1 is the button
Seat 1: Bolnisi68 ($5.45 in chips) 
Seat 2: ninix17 ($6.11 in chips) 
Seat 3: kurawara2701 ($5.02 in chips) 
Seat 4: Genal55 ($3.58 in chips) 
Seat 5: funfun55 ($5.19 in chips) 
Seat 6: HubertusB ($5.12 in chips) 
ninix17: posts small blind $0.02
kurawara2701: posts big blind $0.05
*** HOLE CARDS ***
Dealt to HubertusB [Kh 9d]
Genal55: folds 
funfun55: folds 
HubertusB: folds 
Bolnisi68: folds 
ninix17: raises $0.07 to $0.12
kurawara2701: folds 
Uncalled bet ($0.07) returned to ninix17
ninix17 collected $0.10 from pot
ninix17: doesn't show hand 
*** SUMMARY ***
Total pot $0.10 | Rake $0 
Seat 1: Bolnisi68 (button) folded before Flop (didn't bet)
Seat 2: ninix17 (small blind) collected ($0.10)
Seat 3: kurawara2701 (big blind) folded before Flop
Seat 4: Genal55 folded before Flop (didn't bet)
Seat 5: funfun55 folded before Flop (didn't bet)
Seat 6: HubertusB folded before Flop (didn't bet)



PokerStars Zoom Hand #186647761184:  Hold'em No Limit ($0.02/$0.05) - 2018/05/20 22:29:34 CCT [2018/05/20 10:29:34 ET]
Table 'Donati' 6-max Seat #1 is the button
Seat 1: HubertusB ($5.12 in chips) 
Seat 2: funfun55 ($5.19 in chips) 
Seat 3: Roman197430 ($3.86 in chips) 
Seat 4: ivan 1987465 ($7.61 in chips) 
Seat 5: CANYA_V ($2.67 in chips) 
Seat 6: filifera ($5.22 in chips) 
funfun55: posts small blind $0.02
Roman197430: posts big blind $0.05
*** HOLE CARDS ***
Dealt to HubertusB [Qh 3c]
ivan 1987465: folds 
CANYA_V: folds 
filifera: folds 
HubertusB: folds 
funfun55: raises $0.10 to $0.15
Roman197430: folds 
Uncalled bet ($0.10) returned to funfun55
funfun55 collected $0.10 from pot
funfun55: doesn't show hand 
*** SUMMARY ***
Total pot $0.10 | Rake $0 
Seat 1: HubertusB (button) folded before Flop (didn't bet)
Seat 2: funfun55 (small blind) collected ($0.10)
Seat 3: Roman197430 (big blind) folded before Flop
Seat 4: ivan 1987465 folded before Flop (didn't bet)
Seat 5: CANYA_V folded before Flop (didn't bet)
Seat 6: filifera folded before Flop (didn't bet)



PokerStars Zoom Hand #186647770105:  Hold'em No Limit ($0.02/$0.05) - 2018/05/20 22:29:48 CCT [2018/05/20 10:29:48 ET]
Table 'Donati' 6-max Seat #1 is the button
Seat 1: luka1981good ($5 in chips) 
Seat 2: slob43.ru ($5.50 in chips) 
Seat 3: randeil19 ($5.75 in chips) 
Seat 4: HubertusB ($5.12 in chips) 
Seat 5: BlackMoon57 ($5.21 in chips) 
Seat 6: Julietta1997 ($4.93 in chips) 
slob43.ru: posts small blind $0.02
randeil19: posts big blind $0.05
*** HOLE CARDS ***
Dealt to HubertusB [2c 4d]
HubertusB: folds 
BlackMoon57: folds 
Julietta1997: folds 
luka1981good: folds 
slob43.ru: folds 
Uncalled bet ($0.03) returned to randeil19
randeil19 collected $0.04 from pot
randeil19: doesn't show hand 
*** SUMMARY ***
Total pot $0.04 | Rake $0 
Seat 1: luka1981good (button) folded before Flop (didn't bet)
Seat 2: slob43.ru (small blind) folded before Flop
Seat 3: randeil19 (big blind) collected ($0.04)
Seat 4: HubertusB folded before Flop (didn't bet)
Seat 5: BlackMoon57 folded before Flop (didn't bet)
Seat 6: Julietta1997 folded before Flop (didn't bet)



PokerStars Zoom Hand #186647765642:  Hold'em No Limit ($0.02/$0.05) - 2018/05/20 22:29:41 CCT [2018/05/20 10:29:41 ET]
Table 'Donati' 6-max Seat #1 is the button
Seat 1: Julietta1997 ($4.93 in chips) 
Seat 2: Kenichi Liu ($5.02 in chips) 
Seat 3: tpk0813 ($3.93 in chips) 
Seat 4: vlsm1 ($3.60 in chips) 
Seat 5: HubertusB ($5.12 in chips) 
Seat 6: axilleas33 ($5.83 in chips) 
Kenichi Liu: posts small blind $0.02
tpk0813: posts big blind $0.05
*** HOLE CARDS ***
Dealt to HubertusB [7c 4h]
vlsm1: folds 
HubertusB: folds 
axilleas33: folds 
Julietta1997: folds 
Kenichi Liu: raises $0.10 to $0.15
tpk0813: folds 
Uncalled bet ($0.10) returned to Kenichi Liu
Kenichi Liu collected $0.10 from pot
Kenichi Liu: doesn't show hand 
*** SUMMARY ***
Total pot $0.10 | Rake $0 
Seat 1: Julietta1997 (button) folded before Flop (didn't bet)
Seat 2: Kenichi Liu (small blind) collected ($0.10)
Seat 3: tpk0813 (big blind) folded before Flop
Seat 4: vlsm1 folded before Flop (didn't bet)
Seat 5: HubertusB folded before Flop (didn't bet)
Seat 6: axilleas33 folded before Flop (didn't bet)



PokerStars Zoom Hand #186647784503:  Hold'em No Limit ($0.02/$0.05) - 2018/05/20 22:30:11 CCT [2018/05/20 10:30:11 ET]
Table 'Donati' 6-max Seat #1 is the button
Seat 1: PasQueroz ($2.22 in chips) 
Seat 2: LeetSkilz ($5 in chips) 
Seat 3: Clubberer80 ($5.36 in chips) 
Seat 4: GOLDEVG ($1.53 in chips) 
Seat 5: HubertusB ($5.07 in chips) 
Seat 6: Hunter152327 ($5.07 in chips) 
LeetSkilz: posts small blind $0.02
Clubberer80: posts big blind $0.05
*** HOLE CARDS ***
Dealt to HubertusB [4d 9d]
GOLDEVG: folds 
HubertusB: folds 
Hunter152327: folds 
PasQueroz: folds 
LeetSkilz: folds 
Uncalled bet ($0.03) returned to Clubberer80
Clubberer80 collected $0.04 from pot
Clubberer80: doesn't show hand 
*** SUMMARY ***
Total pot $0.04 | Rake $0 
Seat 1: PasQueroz (button) folded before Flop (didn't bet)
Seat 2: LeetSkilz (small blind) folded before Flop
Seat 3: Clubberer80 (big blind) collected ($0.04)
Seat 4: GOLDEVG folded before Flop (didn't bet)
Seat 5: HubertusB folded before Flop (didn't bet)
Seat 6: Hunter152327 folded before Flop (didn't bet)



PokerStars Zoom Hand #186647775795:  Hold'em No Limit ($0.02/$0.05) - 2018/05/20 22:29:57 CCT [2018/05/20 10:29:57 ET]
Table 'Donati' 6-max Seat #1 is the button
Seat 1: falcao991 ($20 in chips) 
Seat 2: jiangshanlan_dg ($5.21 in chips) 
Seat 3: HubertusB ($5.12 in chips) 
Seat 4: Valerik_P ($5.48 in chips) 
Seat 5: Gennadich80 ($4.73 in chips) 
Seat 6: luka1981good ($5 in chips) 
jiangshanlan_dg: posts small blind $0.02
HubertusB: posts big blind $0.05
*** HOLE CARDS ***
Dealt to HubertusB [5s Ah]
Valerik_P: folds 
Gennadich80: raises $0.10 to $0.15
luka1981good: folds 
falcao991: folds 
jiangshanlan_dg: calls $0.13
HubertusB: folds 
*** FLOP *** [8c 2s 4c]
jiangshanlan_dg: checks 
Gennadich80: bets $0.15
jiangshanlan_dg: calls $0.15
*** TURN *** [8c 2s 4c] [Qc]
jiangshanlan_dg: checks 
Gennadich80: checks 
*** RIVER *** [8c 2s 4c Qc] [5c]
jiangshanlan_dg: checks 
Gennadich80: bets $0.60
jiangshanlan_dg: calls $0.60
*** SHOW DOWN ***
Gennadich80: shows [Ac Ks] (a flush, Ace high)
jiangshanlan_dg: mucks hand 
Gennadich80 collected $1.77 from pot
*** SUMMARY ***
Total pot $1.85 | Rake $0.08 
Board [8c 2s 4c Qc 5c]
Seat 1: falcao991 (button) folded before Flop (didn't bet)
Seat 2: jiangshanlan_dg (small blind) mucked [7d 5d]
Seat 3: HubertusB (big blind) folded before Flop
Seat 4: Valerik_P folded before Flop (didn't bet)
Seat 5: Gennadich80 showed [Ac Ks] and won ($1.77) with a flush, Ace high
Seat 6: luka1981good folded before Flop (didn't bet)



PokerStars Zoom Hand #186647781399:  Hold'em No Limit ($0.02/$0.05) - 2018/05/20 22:30:06 CCT [2018/05/20 10:30:06 ET]
Table 'Donati' 6-max Seat #1 is the button
Seat 1: lzoflamingo ($4.17 in chips) 
Seat 2: Big Rig Stu ($5.81 in chips) 
Seat 3: Hunter152327 ($8.28 in chips) 
Seat 4: HubertusB ($5.07 in chips) 
Seat 5: 4emoDan4ik ($4.97 in chips) 
Seat 6: antonull ($5.07 in chips) 
Big Rig Stu: posts small blind $0.02
Hunter152327: posts big blind $0.05
*** HOLE CARDS ***
Dealt to HubertusB [9d 3c]
HubertusB: folds 
4emoDan4ik: calls $0.05
antonull: folds 
lzoflamingo: raises $0.15 to $0.20
Big Rig Stu: folds 
Hunter152327: folds 
4emoDan4ik: folds 
Uncalled bet ($0.15) returned to lzoflamingo
lzoflamingo collected $0.17 from pot
lzoflamingo: doesn't show hand 
*** SUMMARY ***
Total pot $0.17 | Rake $0 
Seat 1: lzoflamingo (button) collected ($0.17)
Seat 2: Big Rig Stu (small blind) folded before Flop
Seat 3: Hunter152327 (big blind) folded before Flop
Seat 4: HubertusB folded before Flop (didn't bet)
Seat 5: 4emoDan4ik folded before Flop
Seat 6: antonull folded before Flop (didn't bet)



PokerStars Zoom Hand #186647803733:  Hold'em No Limit ($0.02/$0.05) - 2018/05/20 22:30:41 CCT [2018/05/20 10:30:41 ET]
Table 'Donati' 6-max Seat #1 is the button
Seat 1: rdleitao ($5.12 in chips) 
Seat 2: AnalFire999 ($11.48 in chips) 
Seat 3: putya-putya ($4.31 in chips) 
Seat 4: MetaTrader4 ($5.67 in chips) 
Seat 5: barbos2009 ($9.76 in chips) 
Seat 6: HubertusB ($5.05 in chips) 
AnalFire999: posts small blind $0.02
putya-putya: posts big blind $0.05
*** HOLE CARDS ***
Dealt to HubertusB [Ks 2h]
MetaTrader4: folds 
barbos2009: folds 
HubertusB: folds 
rdleitao: raises $0.10 to $0.15
AnalFire999: folds 
putya-putya: folds 
Uncalled bet ($0.10) returned to rdleitao
rdleitao collected $0.12 from pot
rdleitao: doesn't show hand 
*** SUMMARY ***
Total pot $0.12 | Rake $0 
Seat 1: rdleitao (button) collected ($0.12)
Seat 2: AnalFire999 (small blind) folded before Flop
Seat 3: putya-putya (big blind) folded before Flop
Seat 4: MetaTrader4 folded before Flop (didn't bet)
Seat 5: barbos2009 folded before Flop (didn't bet)
Seat 6: HubertusB folded before Flop (didn't bet)



PokerStars Zoom Hand #186647788293:  Hold'em No Limit ($0.02/$0.05) - 2018/05/20 22:30:17 CCT [2018/05/20 10:30:17 ET]
Table 'Donati' 6-max Seat #1 is the button
Seat 1: Hunter152327 ($6.57 in chips) 
Seat 2: HubertusB ($5.07 in chips) 
Seat 3: Syuan123 ($4.59 in chips) 
Seat 4: Mr. Roquim ($6.50 in chips) 
Seat 5: slob43.ru ($4.95 in chips) 
Seat 6: SanSanF55 ($4.95 in chips) 
HubertusB: posts small blind $0.02
Syuan123: posts big blind $0.05
*** HOLE CARDS ***
Dealt to HubertusB [6d 5s]
Mr. Roquim: folds 
slob43.ru: raises $0.10 to $0.15
SanSanF55: folds 
Hunter152327: folds 
HubertusB: folds 
Syuan123: raises $0.20 to $0.35
slob43.ru: calls $0.20
*** FLOP *** [Qd 2c Th]
Syuan123: checks 
slob43.ru: bets $0.35
Syuan123: calls $0.35
*** TURN *** [Qd 2c Th] [3s]
Syuan123: bets $0.70
slob43.ru: folds 
Uncalled bet ($0.70) returned to Syuan123
Syuan123 collected $1.36 from pot
Syuan123: doesn't show hand 
*** SUMMARY ***
Total pot $1.42 | Rake $0.06 
Board [Qd 2c Th 3s]
Seat 1: Hunter152327 (button) folded before Flop (didn't bet)
Seat 2: HubertusB (small blind) folded before Flop
Seat 3: Syuan123 (big blind) collected ($1.36)
Seat 4: Mr. Roquim folded before Flop (didn't bet)
Seat 5: slob43.ru folded on the Turn
Seat 6: SanSanF55 folded before Flop (didn't bet)



PokerStars Zoom Hand #186647807443:  Hold'em No Limit ($0.02/$0.05) - 2018/05/20 22:30:47 CCT [2018/05/20 10:30:47 ET]
Table 'Donati' 6-max Seat #1 is the button
Seat 1: rino803 ($6.07 in chips) 
Seat 2: Dutarr ($5 in chips) 
Seat 3: BardJeka ($5 in chips) 
Seat 4: HubertusB ($5.05 in chips) 
Seat 5: trenerok ($5 in chips) 
Seat 6: wasay565 ($1.67 in chips) 
Dutarr: posts small blind $0.02
BardJeka: posts big blind $0.05
*** HOLE CARDS ***
Dealt to HubertusB [5s 6c]
HubertusB: folds 
trenerok: folds 
wasay565: raises $0.10 to $0.15
rino803: folds 
Dutarr: folds 
BardJeka: folds 
Uncalled bet ($0.10) returned to wasay565
wasay565 collected $0.12 from pot
wasay565: doesn't show hand 
*** SUMMARY ***
Total pot $0.12 | Rake $0 
Seat 1: rino803 (button) folded before Flop (didn't bet)
Seat 2: Dutarr (small blind) folded before Flop
Seat 3: BardJeka (big blind) folded before Flop
Seat 4: HubertusB folded before Flop (didn't bet)
Seat 5: trenerok folded before Flop (didn't bet)
Seat 6: wasay565 collected ($0.12)



PokerStars Zoom Hand #186647810460:  Hold'em No Limit ($0.02/$0.05) - 2018/05/20 22:30:52 CCT [2018/05/20 10:30:52 ET]
Table 'Donati' 6-max Seat #1 is the button
Seat 1: -Z3RO_DAY- ($6.65 in chips) 
Seat 2: kranovoy22 ($6.38 in chips) 
Seat 3: HubertusB ($5.05 in chips) 
Seat 4: Lenno187 ($2.72 in chips) 
Seat 5: Hanart ($5.02 in chips) 
Seat 6: LEGAL3D ($6.53 in chips) 
kranovoy22: posts small blind $0.02
HubertusB: posts big blind $0.05
*** HOLE CARDS ***
Dealt to HubertusB [4h 3s]
Lenno187: folds 
Hanart: folds 
LEGAL3D: raises $0.05 to $0.10
-Z3RO_DAY-: folds 
kranovoy22: folds 
HubertusB: folds 
Uncalled bet ($0.05) returned to LEGAL3D
LEGAL3D collected $0.12 from pot
LEGAL3D: doesn't show hand 
*** SUMMARY ***
Total pot $0.12 | Rake $0 
Seat 1: -Z3RO_DAY- (button) folded before Flop (didn't bet)
Seat 2: kranovoy22 (small blind) folded before Flop
Seat 3: HubertusB (big blind) folded before Flop
Seat 4: Lenno187 folded before Flop (didn't bet)
Seat 5: Hanart folded before Flop (didn't bet)
Seat 6: LEGAL3D collected ($0.12)



PokerStars Zoom Hand #186647819954:  Hold'em No Limit ($0.02/$0.05) - 2018/05/20 22:31:07 CCT [2018/05/20 10:31:07 ET]
Table 'Donati' 6-max Seat #1 is the button
Seat 1: kranovoy22 ($12.52 in chips) 
Seat 2: suger309 ($4.91 in chips) 
Seat 3: kalmyk ($6.06 in chips) 
Seat 4: Daemon'sKiss ($5.43 in chips) 
Seat 5: HubertusB ($5 in chips) 
Seat 6: MiHCeLL ($9.43 in chips) 
suger309: posts small blind $0.02
kalmyk: posts big blind $0.05
*** HOLE CARDS ***
Dealt to HubertusB [Jh Ts]
Daemon'sKiss: raises $0.10 to $0.15
HubertusB: folds 
MiHCeLL: folds 
kranovoy22: folds 
suger309: folds 
kalmyk: folds 
Uncalled bet ($0.10) returned to Daemon'sKiss
Daemon'sKiss collected $0.12 from pot
Daemon'sKiss: doesn't show hand 
*** SUMMARY ***
Total pot $0.12 | Rake $0 
Seat 1: kranovoy22 (button) folded before Flop (didn't bet)
Seat 2: suger309 (small blind) folded before Flop
Seat 3: kalmyk (big blind) folded before Flop
Seat 4: Daemon'sKiss collected ($0.12)
Seat 5: HubertusB folded before Flop (didn't bet)
Seat 6: MiHCeLL folded before Flop (didn't bet)



PokerStars Zoom Hand #186647827679:  Hold'em No Limit ($0.02/$0.05) - 2018/05/20 22:31:19 CCT [2018/05/20 10:31:19 ET]
Table 'Donati' 6-max Seat #1 is the button
Seat 1: HubertusB ($4.98 in chips) 
Seat 2: VingadorV ($18.10 in chips) 
Seat 3: superfluxo ($2.57 in chips) 
Seat 4: syrok17 ($6.49 in chips) 
Seat 5: electrikfeo ($2.74 in chips) 
Seat 6: trenerok ($5.03 in chips) 
VingadorV: posts small blind $0.02
superfluxo: posts big blind $0.05
*** HOLE CARDS ***
Dealt to HubertusB [Ks 4h]
syrok17: folds 
electrikfeo: folds 
trenerok: folds 
HubertusB: folds 
VingadorV: folds 
Uncalled bet ($0.03) returned to superfluxo
superfluxo collected $0.04 from pot
superfluxo: doesn't show hand 
*** SUMMARY ***
Total pot $0.04 | Rake $0 
Seat 1: HubertusB (button) folded before Flop (didn't bet)
Seat 2: VingadorV (small blind) folded before Flop
Seat 3: superfluxo (big blind) collected ($0.04)
Seat 4: syrok17 folded before Flop (didn't bet)
Seat 5: electrikfeo folded before Flop (didn't bet)
Seat 6: trenerok folded before Flop (didn't bet)



PokerStars Zoom Hand #186647796078:  Hold'em No Limit ($0.02/$0.05) - 2018/05/20 22:30:29 CCT [2018/05/20 10:30:29 ET]
Table 'Donati' 6-max Seat #1 is the button
Seat 1: HubertusB ($5.05 in chips) 
Seat 2: tpk0813 ($5 in chips) 
Seat 3: Gennadich80 ($5.60 in chips) 
Seat 4: DMB291184 ($4.33 in chips) 
Seat 5: Artem191197 ($2.11 in chips) 
Seat 6: grzywekkk ($5.10 in chips) 
tpk0813: posts small blind $0.02
Gennadich80: posts big blind $0.05
*** HOLE CARDS ***
Dealt to HubertusB [6d 2h]
DMB291184: folds 
Artem191197: calls $0.05
grzywekkk: raises $0.20 to $0.25
HubertusB: folds 
tpk0813: folds 
Gennadich80: folds 
Artem191197: calls $0.20
*** FLOP *** [Ad Kd Qs]
Artem191197: bets $0.20
grzywekkk: calls $0.20
*** TURN *** [Ad Kd Qs] [Td]
Artem191197: bets $0.25
grzywekkk: calls $0.25
*** RIVER *** [Ad Kd Qs Td] [Ts]
Artem191197: bets $0.35
grzywekkk: calls $0.35
*** SHOW DOWN ***
Artem191197: shows [Th Ac] (a full house, Tens full of Aces)
grzywekkk: mucks hand 
Artem191197 collected $2.08 from pot
*** SUMMARY ***
Total pot $2.17 | Rake $0.09 
Board [Ad Kd Qs Td Ts]
Seat 1: HubertusB (button) folded before Flop (didn't bet)
Seat 2: tpk0813 (small blind) folded before Flop
Seat 3: Gennadich80 (big blind) folded before Flop
Seat 4: DMB291184 folded before Flop (didn't bet)
Seat 5: Artem191197 showed [Th Ac] and won ($2.08) with a full house, Tens full of Aces
Seat 6: grzywekkk mucked [Kc Ah]



PokerStars Zoom Hand #186647823857:  Hold'em No Limit ($0.02/$0.05) - 2018/05/20 22:31:13 CCT [2018/05/20 10:31:13 ET]
Table 'Donati' 6-max Seat #1 is the button
Seat 1: scels111 ($4.59 in chips) 
Seat 2: HubertusB ($5 in chips) 
Seat 3: Julietta1997 ($4.86 in chips) 
Seat 4: falcao991 ($6.23 in chips) 
Seat 5: axilleas33 ($5 in chips) 
Seat 6: tommy9985 ($10.31 in chips) 
HubertusB: posts small blind $0.02
Julietta1997: posts big blind $0.05
*** HOLE CARDS ***
Dealt to HubertusB [2d Kc]
falcao991: folds 
axilleas33: raises $0.07 to $0.12
tommy9985: folds 
scels111: folds 
HubertusB: folds 
Julietta1997: folds 
Uncalled bet ($0.07) returned to axilleas33
axilleas33 collected $0.12 from pot
axilleas33: doesn't show hand 
*** SUMMARY ***
Total pot $0.12 | Rake $0 
Seat 1: scels111 (button) folded before Flop (didn't bet)
Seat 2: HubertusB (small blind) folded before Flop
Seat 3: Julietta1997 (big blind) folded before Flop
Seat 4: falcao991 folded before Flop (didn't bet)
Seat 5: axilleas33 collected ($0.12)
Seat 6: tommy9985 folded before Flop (didn't bet)



PokerStars Zoom Hand #186647831452:  Hold'em No Limit ($0.02/$0.05) - 2018/05/20 22:31:25 CCT [2018/05/20 10:31:25 ET]
Table 'Donati' 6-max Seat #1 is the button
Seat 1: Siorassc ($5.67 in chips) 
Seat 2: zwetok ($6.51 in chips) 
Seat 3: aForrester ($5.17 in chips) 
Seat 4: scels111 ($4.59 in chips) 
Seat 5: HubertusB ($4.98 in chips) 
Seat 6: pannetje91 ($2.70 in chips) 
zwetok: posts small blind $0.02
aForrester: posts big blind $0.05
*** HOLE CARDS ***
Dealt to HubertusB [6h Qs]
scels111: folds 
HubertusB: folds 
pannetje91: folds 
Siorassc: folds 
zwetok: raises $0.06 to $0.11
aForrester: raises $0.29 to $0.40
zwetok: folds 
Uncalled bet ($0.29) returned to aForrester
aForrester collected $0.22 from pot
aForrester: doesn't show hand 
*** SUMMARY ***
Total pot $0.22 | Rake $0 
Seat 1: Siorassc (button) folded before Flop (didn't bet)
Seat 2: zwetok (small blind) folded before Flop
Seat 3: aForrester (big blind) collected ($0.22)
Seat 4: scels111 folded before Flop (didn't bet)
Seat 5: HubertusB folded before Flop (didn't bet)
Seat 6: pannetje91 folded before Flop (didn't bet)



PokerStars Zoom Hand #186647835216:  Hold'em No Limit ($0.02/$0.05) - 2018/05/20 22:31:31 CCT [2018/05/20 10:31:31 ET]
Table 'Donati' 6-max Seat #1 is the button
Seat 1: U_RULIA ($5.16 in chips) 
Seat 2: Blackantz ($5 in chips) 
Seat 3: dee222 ($8.28 in chips) 
Seat 4: HubertusB ($4.98 in chips) 
Seat 5: geass0621 ($16.86 in chips) 
Seat 6: Yamma18 ($15.22 in chips) 
Blackantz: posts small blind $0.02
dee222: posts big blind $0.05
*** HOLE CARDS ***
Dealt to HubertusB [6d 7c]
HubertusB: folds 
geass0621: folds 
Yamma18: raises $0.05 to $0.10
U_RULIA: folds 
Blackantz: folds 
dee222: folds 
Uncalled bet ($0.05) returned to Yamma18
Yamma18 collected $0.12 from pot
Yamma18: doesn't show hand 
*** SUMMARY ***
Total pot $0.12 | Rake $0 
Seat 1: U_RULIA (button) folded before Flop (didn't bet)
Seat 2: Blackantz (small blind) folded before Flop
Seat 3: dee222 (big blind) folded before Flop
Seat 4: HubertusB folded before Flop (didn't bet)
Seat 5: geass0621 folded before Flop (didn't bet)
Seat 6: Yamma18 collected ($0.12)



PokerStars Zoom Hand #186647838958:  Hold'em No Limit ($0.02/$0.05) - 2018/05/20 22:31:37 CCT [2018/05/20 10:31:37 ET]
Table 'Donati' 6-max Seat #1 is the button
Seat 1: Kenichi Liu ($5.09 in chips) 
Seat 2: rino803 ($8.01 in chips) 
Seat 3: HubertusB ($4.98 in chips) 
Seat 4: newf5959 ($3.14 in chips) 
Seat 5: galina817 ($5.07 in chips) 
Seat 6: probil777a ($3.23 in chips) 
rino803: posts small blind $0.02
HubertusB: posts big blind $0.05
*** HOLE CARDS ***
Dealt to HubertusB [2d 7d]
newf5959: calls $0.05
galina817: folds 
probil777a: folds 
Kenichi Liu: folds 
rino803: folds 
HubertusB: checks 
*** FLOP *** [Qs Jh 2c]
HubertusB: checks 
newf5959: bets $0.05
HubertusB: folds 
Uncalled bet ($0.05) returned to newf5959
newf5959 collected $0.12 from pot
newf5959: doesn't show hand 
*** SUMMARY ***
Total pot $0.12 | Rake $0 
Board [Qs Jh 2c]
Seat 1: Kenichi Liu (button) folded before Flop (didn't bet)
Seat 2: rino803 (small blind) folded before Flop
Seat 3: HubertusB (big blind) folded on the Flop
Seat 4: newf5959 collected ($0.12)
Seat 5: galina817 folded before Flop (didn't bet)
Seat 6: probil777a folded before Flop (didn't bet)



PokerStars Zoom Hand #186647860245:  Hold'em No Limit ($0.02/$0.05) - 2018/05/20 22:32:11 CCT [2018/05/20 10:32:11 ET]
Table 'Donati' 6-max Seat #1 is the button
Seat 1: HubertusB ($4.91 in chips) 
Seat 2: TalksAlot86 ($1.77 in chips) 
Seat 3: falcao991 ($6.28 in chips) 
Seat 4: shogi17 ($4.67 in chips) 
Seat 5: QUAD_D4M4GE ($10.90 in chips) 
Seat 6: probil777a ($3.23 in chips) 
TalksAlot86: posts small blind $0.02
falcao991: posts big blind $0.05
*** HOLE CARDS ***
Dealt to HubertusB [Th 6s]
shogi17: folds 
QUAD_D4M4GE: folds 
probil777a: folds 
HubertusB: folds 
TalksAlot86: folds 
Uncalled bet ($0.03) returned to falcao991
falcao991 collected $0.04 from pot
falcao991: doesn't show hand 
*** SUMMARY ***
Total pot $0.04 | Rake $0 
Seat 1: HubertusB (button) folded before Flop (didn't bet)
Seat 2: TalksAlot86 (small blind) folded before Flop
Seat 3: falcao991 (big blind) collected ($0.04)
Seat 4: shogi17 folded before Flop (didn't bet)
Seat 5: QUAD_D4M4GE folded before Flop (didn't bet)
Seat 6: probil777a folded before Flop (didn't bet)



PokerStars Zoom Hand #186647856559:  Hold'em No Limit ($0.02/$0.05) - 2018/05/20 22:32:05 CCT [2018/05/20 10:32:05 ET]
Table 'Donati' 6-max Seat #1 is the button
Seat 1: Brofessor123 ($3.53 in chips) 
Seat 2: HubertusB ($4.93 in chips) 
Seat 3: galina817 ($6.49 in chips) 
Seat 4: Apotiks ($12 in chips) 
Seat 5: Gabos27809 ($3.39 in chips) 
Seat 6: ghost1que ($5.93 in chips) 
HubertusB: posts small blind $0.02
galina817: posts big blind $0.05
*** HOLE CARDS ***
Dealt to HubertusB [4h Tc]
Apotiks: raises $0.10 to $0.15
Gabos27809: folds 
ghost1que: folds 
Brofessor123: folds 
HubertusB: folds 
galina817: folds 
Uncalled bet ($0.10) returned to Apotiks
Apotiks collected $0.12 from pot
Apotiks: doesn't show hand 
*** SUMMARY ***
Total pot $0.12 | Rake $0 
Seat 1: Brofessor123 (button) folded before Flop (didn't bet)
Seat 2: HubertusB (small blind) folded before Flop
Seat 3: galina817 (big blind) folded before Flop
Seat 4: Apotiks collected ($0.12)
Seat 5: Gabos27809 folded before Flop (didn't bet)
Seat 6: ghost1que folded before Flop (didn't bet)



PokerStars Zoom Hand #186647869141:  Hold'em No Limit ($0.02/$0.05) - 2018/05/20 22:32:25 CCT [2018/05/20 10:32:25 ET]
Table 'Donati' 6-max Seat #1 is the button
Seat 1: Silencer91 ($5 in chips) 
Seat 2: barbos2009 ($11.35 in chips) 
Seat 3: incorrect88 ($10.02 in chips) 
Seat 4: HubertusB ($4.91 in chips) 
Seat 5: Little Geewood ($5 in chips) 
Seat 6: ghost1que ($5.86 in chips) 
barbos2009: posts small blind $0.02
incorrect88: posts big blind $0.05
*** HOLE CARDS ***
Dealt to HubertusB [4h Jd]
HubertusB: folds 
Little Geewood: folds 
ghost1que: folds 
Silencer91: folds 
barbos2009: folds 
Uncalled bet ($0.03) returned to incorrect88
incorrect88 collected $0.04 from pot
incorrect88: doesn't show hand 
*** SUMMARY ***
Total pot $0.04 | Rake $0 
Seat 1: Silencer91 (button) folded before Flop (didn't bet)
Seat 2: barbos2009 (small blind) folded before Flop
Seat 3: incorrect88 (big blind) collected ($0.04)
Seat 4: HubertusB folded before Flop (didn't bet)
Seat 5: Little Geewood folded before Flop (didn't bet)
Seat 6: ghost1que folded before Flop (didn't bet)



PokerStars Zoom Hand #186647865285:  Hold'em No Limit ($0.02/$0.05) - 2018/05/20 22:32:19 CCT [2018/05/20 10:32:19 ET]
Table 'Donati' 6-max Seat #1 is the button
Seat 1: Little Geewood ($5 in chips) 
Seat 2: aForrester ($5 in chips) 
Seat 3: slob43.ru ($4.18 in chips) 
Seat 4: keyJo10 ($4.46 in chips) 
Seat 5: Papa_Prey ($6.45 in chips) 
Seat 6: HubertusB ($4.91 in chips) 
aForrester: posts small blind $0.02
slob43.ru: posts big blind $0.05
*** HOLE CARDS ***
Dealt to HubertusB [6d Qh]
keyJo10: folds 
Papa_Prey: calls $0.05
HubertusB: folds 
Little Geewood: folds 
aForrester: folds 
slob43.ru: checks 
*** FLOP *** [9c 9s 3s]
slob43.ru: checks 
Papa_Prey: checks 
*** TURN *** [9c 9s 3s] [Js]
slob43.ru: bets $0.05
Papa_Prey: calls $0.05
*** RIVER *** [9c 9s 3s Js] [4d]
slob43.ru: checks 
Papa_Prey: checks 
*** SHOW DOWN ***
slob43.ru: shows [Jc 3h] (two pair, Jacks and Nines)
Papa_Prey: mucks hand 
slob43.ru collected $0.21 from pot
*** SUMMARY ***
Total pot $0.22 | Rake $0.01 
Board [9c 9s 3s Js 4d]
Seat 1: Little Geewood (button) folded before Flop (didn't bet)
Seat 2: aForrester (small blind) folded before Flop
Seat 3: slob43.ru (big blind) showed [Jc 3h] and won ($0.21) with two pair, Jacks and Nines
Seat 4: keyJo10 folded before Flop (didn't bet)
Seat 5: Papa_Prey mucked [3d 7s]
Seat 6: HubertusB folded before Flop (didn't bet)



PokerStars Zoom Hand #186647873582:  Hold'em No Limit ($0.02/$0.05) - 2018/05/20 22:32:32 CCT [2018/05/20 10:32:32 ET]
Table 'Donati' 6-max Seat #1 is the button
Seat 1: Brofessor123 ($4.71 in chips) 
Seat 2: Blackantz ($5 in chips) 
Seat 3: Mr. Roquim ($5 in chips) 
Seat 4: HubertusB ($4.91 in chips) 
Seat 5: Khyira ($5 in chips) 
Seat 6: Silencer91 ($5.16 in chips) 
Blackantz: posts small blind $0.02
Mr. Roquim: posts big blind $0.05
*** HOLE CARDS ***
Dealt to HubertusB [7s 7d]
HubertusB: raises $0.10 to $0.15
Khyira: folds 
Silencer91: calls $0.15
Brofessor123: folds 
Blackantz: folds 
Mr. Roquim: folds 
*** FLOP *** [9c Ts 2h]
HubertusB: checks 
Silencer91: bets $0.20
HubertusB: calls $0.20
*** TURN *** [9c Ts 2h] [4c]
HubertusB: checks 
Silencer91: bets $0.45
HubertusB: calls $0.45
*** RIVER *** [9c Ts 2h 4c] [2c]
HubertusB: checks 
Silencer91: bets $1.05
HubertusB: folds 
Uncalled bet ($1.05) returned to Silencer91
Silencer91 collected $1.60 from pot
Silencer91: doesn't show hand 
*** SUMMARY ***
Total pot $1.67 | Rake $0.07 
Board [9c Ts 2h 4c 2c]
Seat 1: Brofessor123 (button) folded before Flop (didn't bet)
Seat 2: Blackantz (small blind) folded before Flop
Seat 3: Mr. Roquim (big blind) folded before Flop
Seat 4: HubertusB folded on the River
Seat 5: Khyira folded before Flop (didn't bet)
Seat 6: Silencer91 collected ($1.60)



PokerStars Zoom Hand #186647906986:  Hold'em No Limit ($0.02/$0.05) - 2018/05/20 22:33:25 CCT [2018/05/20 10:33:25 ET]
Table 'Donati' 6-max Seat #1 is the button
Seat 1: HubertusB ($4.11 in chips) 
Seat 2: $ir_AleXXX ($5 in chips) 
Seat 3: Siorassc ($5 in chips) 
Seat 4: Smoula2 ($5 in chips) 
Seat 5: Scotty20664 ($5.50 in chips) 
Seat 6: m4ri4kky ($4.86 in chips) 
$ir_AleXXX: posts small blind $0.02
Siorassc: posts big blind $0.05
*** HOLE CARDS ***
Dealt to HubertusB [Ac Kh]
Smoula2: folds 
Scotty20664: folds 
m4ri4kky: folds 
HubertusB: raises $0.10 to $0.15
$ir_AleXXX: calls $0.13
Siorassc: calls $0.10
*** FLOP *** [5s 5h Qc]
$ir_AleXXX: checks 
Siorassc: checks 
HubertusB: checks 
*** TURN *** [5s 5h Qc] [Ad]
$ir_AleXXX: checks 
Siorassc: checks 
HubertusB: bets $0.29
$ir_AleXXX: folds 
Siorassc: folds 
Uncalled bet ($0.29) returned to HubertusB
HubertusB collected $0.43 from pot
HubertusB: doesn't show hand 
*** SUMMARY ***
Total pot $0.45 | Rake $0.02 
Board [5s 5h Qc Ad]
Seat 1: HubertusB (button) collected ($0.43)
Seat 2: $ir_AleXXX (small blind) folded on the Turn
Seat 3: Siorassc (big blind) folded on the Turn
Seat 4: Smoula2 folded before Flop (didn't bet)
Seat 5: Scotty20664 folded before Flop (didn't bet)
Seat 6: m4ri4kky folded before Flop (didn't bet)



PokerStars Zoom Hand #186647940605:  Hold'em No Limit ($0.02/$0.05) - 2018/05/20 22:34:18 CCT [2018/05/20 10:34:18 ET]
Table 'Donati' 6-max Seat #1 is the button
Seat 1: Seregam98 ($5.02 in chips) 
Seat 2: dato5557 ($3.29 in chips) 
Seat 3: HubertusB ($4.39 in chips) 
Seat 4: MinouXYZ ($3.09 in chips) 
Seat 5: youri1961 ($5.28 in chips) 
Seat 6: galina817 ($10.24 in chips) 
dato5557: posts small blind $0.02
HubertusB: posts big blind $0.05
*** HOLE CARDS ***
Dealt to HubertusB [5s 7c]
MinouXYZ: folds 
youri1961: folds 
galina817: folds 
Seregam98: raises $0.10 to $0.15
dato5557: folds 
HubertusB: folds 
Uncalled bet ($0.10) returned to Seregam98
Seregam98 collected $0.12 from pot
Seregam98: doesn't show hand 
*** SUMMARY ***
Total pot $0.12 | Rake $0 
Seat 1: Seregam98 (button) collected ($0.12)
Seat 2: dato5557 (small blind) folded before Flop
Seat 3: HubertusB (big blind) folded before Flop
Seat 4: MinouXYZ folded before Flop (didn't bet)
Seat 5: youri1961 folded before Flop (didn't bet)
Seat 6: galina817 folded before Flop (didn't bet)



PokerStars Zoom Hand #186647947525:  Hold'em No Limit ($0.02/$0.05) - 2018/05/20 22:34:29 CCT [2018/05/20 10:34:29 ET]
Table 'Donati' 6-max Seat #1 is the button
Seat 1: PM17Lev ($5.04 in chips) 
Seat 2: Bane91 ($5.51 in chips) 
Seat 3: DCove ($5.12 in chips) 
Seat 4: BigCat16Max ($2.28 in chips) 
Seat 5: Efimov07 ($5.05 in chips) 
Seat 6: HubertusB ($4.34 in chips) 
Bane91: posts small blind $0.02
DCove: posts big blind $0.05
*** HOLE CARDS ***
Dealt to HubertusB [Jh Ac]
BigCat16Max: folds 
Efimov07: folds 
HubertusB: raises $0.10 to $0.15
PM17Lev: folds 
Bane91: calls $0.13
DCove: calls $0.10
*** FLOP *** [6s Kd Qs]
Bane91: checks 
DCove: checks 
HubertusB: bets $0.20
Bane91: folds 
DCove: calls $0.20
*** TURN *** [6s Kd Qs] [2h]
DCove: checks 
HubertusB: checks 
*** RIVER *** [6s Kd Qs 2h] [Ts]
DCove: bets $0.54
HubertusB: calls $0.54
*** SHOW DOWN ***
DCove: shows [Jc Tc] (a pair of Tens)
HubertusB: shows [Jh Ac] (a straight, Ten to Ace)
HubertusB collected $1.85 from pot
*** SUMMARY ***
Total pot $1.93 | Rake $0.08 
Board [6s Kd Qs 2h Ts]
Seat 1: PM17Lev (button) folded before Flop (didn't bet)
Seat 2: Bane91 (small blind) folded on the Flop
Seat 3: DCove (big blind) showed [Jc Tc] and lost with a pair of Tens
Seat 4: BigCat16Max folded before Flop (didn't bet)
Seat 5: Efimov07 folded before Flop (didn't bet)
Seat 6: HubertusB showed [Jh Ac] and won ($1.85) with a straight, Ten to Ace



PokerStars Zoom Hand #186647981818:  Hold'em No Limit ($0.02/$0.05) - 2018/05/20 22:35:23 CCT [2018/05/20 10:35:23 ET]
Table 'Donati' 6-max Seat #1 is the button
Seat 1: surfer-kgs ($5.46 in chips) 
Seat 2: HubertusB ($5.30 in chips) 
Seat 3: Valerik_P ($7.65 in chips) 
Seat 4: falcao991 ($6.08 in chips) 
Seat 5: U_RULIA ($5.27 in chips) 
Seat 6: maxgild85 ($5 in chips) 
HubertusB: posts small blind $0.02
Valerik_P: posts big blind $0.05
*** HOLE CARDS ***
Dealt to HubertusB [8c 3s]
falcao991: folds 
U_RULIA: folds 
maxgild85: folds 
surfer-kgs: raises $0.10 to $0.15
HubertusB: folds 
Valerik_P: folds 
Uncalled bet ($0.10) returned to surfer-kgs
surfer-kgs collected $0.12 from pot
surfer-kgs: doesn't show hand 
*** SUMMARY ***
Total pot $0.12 | Rake $0 
Seat 1: surfer-kgs (button) collected ($0.12)
Seat 2: HubertusB (small blind) folded before Flop
Seat 3: Valerik_P (big blind) folded before Flop
Seat 4: falcao991 folded before Flop (didn't bet)
Seat 5: U_RULIA folded before Flop (didn't bet)
Seat 6: maxgild85 folded before Flop (didn't bet)



PokerStars Zoom Hand #186647986250:  Hold'em No Limit ($0.02/$0.05) - 2018/05/20 22:35:30 CCT [2018/05/20 10:35:30 ET]
Table 'Donati' 6-max Seat #1 is the button
Seat 1: jandsonpower ($5 in chips) 
Seat 2: zwetok ($5.45 in chips) 
Seat 3: WhiteWolf459 ($5 in chips) 
Seat 4: bober2702 ($7.11 in chips) 
Seat 5: HubertusB ($5.28 in chips) 
Seat 6: trenerok ($7.39 in chips) 
zwetok: posts small blind $0.02
WhiteWolf459: posts big blind $0.05
*** HOLE CARDS ***
Dealt to HubertusB [Qh 5h]
bober2702: folds 
HubertusB: folds 
trenerok: folds 
jandsonpower: raises $0.07 to $0.12
zwetok: folds 
WhiteWolf459: calls $0.07
*** FLOP *** [6c 4d 3c]
WhiteWolf459: checks 
jandsonpower: bets $0.13
WhiteWolf459: folds 
Uncalled bet ($0.13) returned to jandsonpower
jandsonpower collected $0.25 from pot
jandsonpower: doesn't show hand 
*** SUMMARY ***
Total pot $0.26 | Rake $0.01 
Board [6c 4d 3c]
Seat 1: jandsonpower (button) collected ($0.25)
Seat 2: zwetok (small blind) folded before Flop
Seat 3: WhiteWolf459 (big blind) folded on the Flop
Seat 4: bober2702 folded before Flop (didn't bet)
Seat 5: HubertusB folded before Flop (didn't bet)
Seat 6: trenerok folded before Flop (didn't bet)



PokerStars Zoom Hand #186647990046:  Hold'em No Limit ($0.02/$0.05) - 2018/05/20 22:35:36 CCT [2018/05/20 10:35:36 ET]
Table 'Donati' 6-max Seat #1 is the button
Seat 1: fedyl78 ($4.88 in chips) 
Seat 2: BlackMoon57 ($4.84 in chips) 
Seat 3: apadis ($3.07 in chips) 
Seat 4: kingreigns ($5 in chips) 
Seat 5: HubertusB ($5.28 in chips) 
Seat 6: Karlyvzla27 ($4.74 in chips) 
BlackMoon57: posts small blind $0.02
apadis: posts big blind $0.05
*** HOLE CARDS ***
Dealt to HubertusB [3c 5s]
kingreigns: folds 
HubertusB: folds 
Karlyvzla27: folds 
fedyl78: raises $0.07 to $0.12
BlackMoon57: folds 
apadis: folds 
Uncalled bet ($0.07) returned to fedyl78
fedyl78 collected $0.12 from pot
fedyl78: doesn't show hand 
*** SUMMARY ***
Total pot $0.12 | Rake $0 
Seat 1: fedyl78 (button) collected ($0.12)
Seat 2: BlackMoon57 (small blind) folded before Flop
Seat 3: apadis (big blind) folded before Flop
Seat 4: kingreigns folded before Flop (didn't bet)
Seat 5: HubertusB folded before Flop (didn't bet)
Seat 6: Karlyvzla27 folded before Flop (didn't bet)



PokerStars Zoom Hand #186648004596:  Hold'em No Limit ($0.02/$0.05) - 2018/05/20 22:35:59 CCT [2018/05/20 10:35:59 ET]
Table 'Donati' 6-max Seat #1 is the button
Seat 1: class29 ($15.74 in chips) 
Seat 2: Clubberer80 ($6.13 in chips) 
Seat 3: HubertusB ($5.28 in chips) 
Seat 4: Valerik_P ($4.18 in chips) 
Seat 5: rino803 ($5.26 in chips) 
Seat 6: leo2030 ($10.68 in chips) 
Clubberer80: posts small blind $0.02
HubertusB: posts big blind $0.05
*** HOLE CARDS ***
Dealt to HubertusB [Qd 9h]
Valerik_P: raises $0.10 to $0.15
rino803: folds 
leo2030: folds 
class29: folds 
Clubberer80: folds 
HubertusB: folds 
Uncalled bet ($0.10) returned to Valerik_P
Valerik_P collected $0.12 from pot
Valerik_P: doesn't show hand 
*** SUMMARY ***
Total pot $0.12 | Rake $0 
Seat 1: class29 (button) folded before Flop (didn't bet)
Seat 2: Clubberer80 (small blind) folded before Flop
Seat 3: HubertusB (big blind) folded before Flop
Seat 4: Valerik_P collected ($0.12)
Seat 5: rino803 folded before Flop (didn't bet)
Seat 6: leo2030 folded before Flop (didn't bet)



PokerStars Zoom Hand #186648014226:  Hold'em No Limit ($0.02/$0.05) - 2018/05/20 22:36:14 CCT [2018/05/20 10:36:14 ET]
Table 'Donati' 6-max Seat #1 is the button
Seat 1: CANYA_V ($2.74 in chips) 
Seat 2: HubertusB ($5.23 in chips) 
Seat 3: kuka9999 ($6.52 in chips) 
Seat 4: sunao1983 ($4.08 in chips) 
Seat 5: t123t684 ($6.07 in chips) 
Seat 6: zwetok ($8.91 in chips) 
HubertusB: posts small blind $0.02
kuka9999: posts big blind $0.05
*** HOLE CARDS ***
Dealt to HubertusB [Kh 8d]
sunao1983: folds 
t123t684: folds 
zwetok: raises $0.06 to $0.11
CANYA_V: folds 
HubertusB: folds 
kuka9999: calls $0.06
*** FLOP *** [Qd 4h 7c]
kuka9999: checks 
zwetok: bets $0.11
kuka9999: folds 
Uncalled bet ($0.11) returned to zwetok
zwetok collected $0.23 from pot
zwetok: doesn't show hand 
*** SUMMARY ***
Total pot $0.24 | Rake $0.01 
Board [Qd 4h 7c]
Seat 1: CANYA_V (button) folded before Flop (didn't bet)
Seat 2: HubertusB (small blind) folded before Flop
Seat 3: kuka9999 (big blind) folded on the Flop
Seat 4: sunao1983 folded before Flop (didn't bet)
Seat 5: t123t684 folded before Flop (didn't bet)
Seat 6: zwetok collected ($0.23)



PokerStars Zoom Hand #186647995133:  Hold'em No Limit ($0.02/$0.05) - 2018/05/20 22:35:44 CCT [2018/05/20 10:35:44 ET]
Table 'Donati' 6-max Seat #1 is the button
Seat 1: HubertusB ($5.28 in chips) 
Seat 2: Siorassc ($5 in chips) 
Seat 3: kingreigns ($5 in chips) 
Seat 4: t123t684 ($6.24 in chips) 
Seat 5: LEGAL3D ($2.47 in chips) 
Seat 6: Demyosaur ($9.10 in chips) 
Siorassc: posts small blind $0.02
kingreigns: posts big blind $0.05
*** HOLE CARDS ***
Dealt to HubertusB [8s Kh]
t123t684: folds 
LEGAL3D: raises $0.10 to $0.15
Demyosaur: folds 
HubertusB: folds 
Siorassc: folds 
kingreigns: calls $0.10
*** FLOP *** [4d Tc 9c]
kingreigns: checks 
LEGAL3D: checks 
*** TURN *** [4d Tc 9c] [Th]
kingreigns: bets $0.11
LEGAL3D: calls $0.11
*** RIVER *** [4d Tc 9c Th] [9s]
kingreigns: bets $0.18
LEGAL3D: folds 
Uncalled bet ($0.18) returned to kingreigns
kingreigns collected $0.52 from pot
kingreigns: doesn't show hand 
*** SUMMARY ***
Total pot $0.54 | Rake $0.02 
Board [4d Tc 9c Th 9s]
Seat 1: HubertusB (button) folded before Flop (didn't bet)
Seat 2: Siorassc (small blind) folded before Flop
Seat 3: kingreigns (big blind) collected ($0.52)
Seat 4: t123t684 folded before Flop (didn't bet)
Seat 5: LEGAL3D folded on the River
Seat 6: Demyosaur folded before Flop (didn't bet)



PokerStars Zoom Hand #186648026950:  Hold'em No Limit ($0.02/$0.05) - 2018/05/20 22:36:34 CCT [2018/05/20 10:36:34 ET]
Table 'Donati' 6-max Seat #1 is the button
Seat 1: Best5555 ($6.12 in chips) 
Seat 2: Valerik_P ($7.45 in chips) 
Seat 3: LeGingy182 ($5.71 in chips) 
Seat 4: HubertusB ($5.21 in chips) 
Seat 5: trenerok ($7.39 in chips) 
Seat 6: ivan 1987465 ($3.72 in chips) 
Valerik_P: posts small blind $0.02
LeGingy182: posts big blind $0.05
*** HOLE CARDS ***
Dealt to HubertusB [4c Js]
HubertusB: folds 
trenerok: raises $0.10 to $0.15
ivan 1987465: folds 
Best5555: folds 
Valerik_P: folds 
LeGingy182: folds 
Uncalled bet ($0.10) returned to trenerok
trenerok collected $0.12 from pot
trenerok: doesn't show hand 
*** SUMMARY ***
Total pot $0.12 | Rake $0 
Seat 1: Best5555 (button) folded before Flop (didn't bet)
Seat 2: Valerik_P (small blind) folded before Flop
Seat 3: LeGingy182 (big blind) folded before Flop
Seat 4: HubertusB folded before Flop (didn't bet)
Seat 5: trenerok collected ($0.12)
Seat 6: ivan 1987465 folded before Flop (didn't bet)



PokerStars Zoom Hand #186648021836:  Hold'em No Limit ($0.02/$0.05) - 2018/05/20 22:36:26 CCT [2018/05/20 10:36:26 ET]
Table 'Donati' 6-max Seat #1 is the button
Seat 1: funfun55 ($5.27 in chips) 
Seat 2: DMB291184 ($5.47 in chips) 
Seat 3: marinesko1984 ($8.65 in chips) 
Seat 4: HubertusB ($5.21 in chips) 
Seat 5: Siorassc ($5.34 in chips) 
Seat 6: Sipa333 ($2.84 in chips) 
DMB291184: posts small blind $0.02
marinesko1984: posts big blind $0.05
*** HOLE CARDS ***
Dealt to HubertusB [8h 4d]
HubertusB: folds 
Siorassc: folds 
Sipa333: folds 
funfun55: folds 
DMB291184: raises $0.10 to $0.15
marinesko1984: calls $0.10
*** FLOP *** [Qc Qd Js]
DMB291184: checks 
marinesko1984: checks 
*** TURN *** [Qc Qd Js] [Jc]
DMB291184: checks 
marinesko1984: checks 
*** RIVER *** [Qc Qd Js Jc] [2d]
DMB291184: checks 
marinesko1984: checks 
*** SHOW DOWN ***
DMB291184: shows [Th 7h] (two pair, Queens and Jacks)
marinesko1984: shows [Ad 9h] (two pair, Queens and Jacks - Ace kicker)
marinesko1984 collected $0.29 from pot
*** SUMMARY ***
Total pot $0.30 | Rake $0.01 
Board [Qc Qd Js Jc 2d]
Seat 1: funfun55 (button) folded before Flop (didn't bet)
Seat 2: DMB291184 (small blind) showed [Th 7h] and lost with two pair, Queens and Jacks
Seat 3: marinesko1984 (big blind) showed [Ad 9h] and won ($0.29) with two pair, Queens and Jacks
Seat 4: HubertusB folded before Flop (didn't bet)
Seat 5: Siorassc folded before Flop (didn't bet)
Seat 6: Sipa333 folded before Flop (didn't bet)



PokerStars Zoom Hand #186648018031:  Hold'em No Limit ($0.02/$0.05) - 2018/05/20 22:36:20 CCT [2018/05/20 10:36:20 ET]
Table 'Donati' 6-max Seat #1 is the button
Seat 1: kirilin.ru ($6.50 in chips) 
Seat 2: Silencer91 ($5.64 in chips) 
Seat 3: squ33z3r ($5.38 in chips) 
Seat 4: antonull ($9.11 in chips) 
Seat 5: Krawicz ($5 in chips) 
Seat 6: HubertusB ($5.21 in chips) 
Silencer91: posts small blind $0.02
squ33z3r: posts big blind $0.05
*** HOLE CARDS ***
Dealt to HubertusB [3s Js]
antonull: folds 
Krawicz: raises $0.10 to $0.15
HubertusB: folds 
kirilin.ru: folds 
Silencer91: raises $0.35 to $0.50
squ33z3r: folds 
Krawicz: calls $0.35
*** FLOP *** [Ad 8d 9h]
Silencer91: bets $0.55
Krawicz: calls $0.55
*** TURN *** [Ad 8d 9h] [Qh]
Silencer91: bets $1.15
Krawicz: folds 
Uncalled bet ($1.15) returned to Silencer91
Silencer91 collected $2.06 from pot
Silencer91: doesn't show hand 
*** SUMMARY ***
Total pot $2.15 | Rake $0.09 
Board [Ad 8d 9h Qh]
Seat 1: kirilin.ru (button) folded before Flop (didn't bet)
Seat 2: Silencer91 (small blind) collected ($2.06)
Seat 3: squ33z3r (big blind) folded before Flop
Seat 4: antonull folded before Flop (didn't bet)
Seat 5: Krawicz folded on the Turn
Seat 6: HubertusB folded before Flop (didn't bet)



PokerStars Zoom Hand #186648030737:  Hold'em No Limit ($0.02/$0.05) - 2018/05/20 22:36:40 CCT [2018/05/20 10:36:40 ET]
Table 'Donati' 6-max Seat #1 is the button
Seat 1: rino803 ($5.19 in chips) 
Seat 2: Hilton5 ($2.15 in chips) 
Seat 3: HubertusB ($5.21 in chips) 
Seat 4: galina817 ($6.35 in chips) 
Seat 5: CallMeBunny ($3.74 in chips) 
Seat 6: VoneRT ($5 in chips) 
Hilton5: posts small blind $0.02
HubertusB: posts big blind $0.05
*** HOLE CARDS ***
Dealt to HubertusB [2c 3c]
galina817: folds 
CallMeBunny: raises $0.10 to $0.15
VoneRT: folds 
rino803: calls $0.15
Hilton5: folds 
HubertusB: folds 
*** FLOP *** [6c Kh 2h]
CallMeBunny: bets $0.14
rino803: folds 
Uncalled bet ($0.14) returned to CallMeBunny
CallMeBunny collected $0.35 from pot
CallMeBunny: doesn't show hand 
*** SUMMARY ***
Total pot $0.37 | Rake $0.02 
Board [6c Kh 2h]
Seat 1: rino803 (button) folded on the Flop
Seat 2: Hilton5 (small blind) folded before Flop
Seat 3: HubertusB (big blind) folded before Flop
Seat 4: galina817 folded before Flop (didn't bet)
Seat 5: CallMeBunny collected ($0.35)
Seat 6: VoneRT folded before Flop (didn't bet)



PokerStars Zoom Hand #186648054124:  Hold'em No Limit ($0.02/$0.05) - 2018/05/20 22:37:17 CCT [2018/05/20 10:37:17 ET]
Table 'Donati' 6-max Seat #1 is the button
Seat 1: putya-putya ($4.35 in chips) 
Seat 2: youri1961 ($5.78 in chips) 
Seat 3: UNO.228 ($5.15 in chips) 
Seat 4: LEGAL3D ($4.95 in chips) 
Seat 5: HubertusB ($5.09 in chips) 
Seat 6: cesarmike1 ($7.57 in chips) 
youri1961: posts small blind $0.02
UNO.228: posts big blind $0.05
*** HOLE CARDS ***
Dealt to HubertusB [Ks Js]
LEGAL3D: folds 
HubertusB: raises $0.10 to $0.15
cesarmike1: folds 
putya-putya: folds 
youri1961: folds 
UNO.228: folds 
Uncalled bet ($0.10) returned to HubertusB
HubertusB collected $0.12 from pot
HubertusB: doesn't show hand 
*** SUMMARY ***
Total pot $0.12 | Rake $0 
Seat 1: putya-putya (button) folded before Flop (didn't bet)
Seat 2: youri1961 (small blind) folded before Flop
Seat 3: UNO.228 (big blind) folded before Flop
Seat 4: LEGAL3D folded before Flop (didn't bet)
Seat 5: HubertusB collected ($0.12)
Seat 6: cesarmike1 folded before Flop (didn't bet)



PokerStars Zoom Hand #186648044020:  Hold'em No Limit ($0.02/$0.05) - 2018/05/20 22:37:01 CCT [2018/05/20 10:37:01 ET]
Table 'Donati' 6-max Seat #1 is the button
Seat 1: zwetok ($8.30 in chips) 
Seat 2: HubertusB ($5.16 in chips) 
Seat 3: I.Mimeev ($5 in chips) 
Seat 4: porter551 ($3.88 in chips) 
Seat 5: lzoflamingo ($6.35 in chips) 
Seat 6: urahayanagi ($12.36 in chips) 
HubertusB: posts small blind $0.02
I.Mimeev: posts big blind $0.05
*** HOLE CARDS ***
Dealt to HubertusB [9d Ah]
porter551: folds 
lzoflamingo: raises $0.10 to $0.15
urahayanagi: folds 
zwetok: folds 
HubertusB: folds 
I.Mimeev: calls $0.10
*** FLOP *** [Jc Kd Js]
I.Mimeev: bets $0.10
lzoflamingo: folds 
Uncalled bet ($0.10) returned to I.Mimeev
I.Mimeev collected $0.31 from pot
I.Mimeev: doesn't show hand 
*** SUMMARY ***
Total pot $0.32 | Rake $0.01 
Board [Jc Kd Js]
Seat 1: zwetok (button) folded before Flop (didn't bet)
Seat 2: HubertusB (small blind) folded before Flop
Seat 3: I.Mimeev (big blind) collected ($0.31)
Seat 4: porter551 folded before Flop (didn't bet)
Seat 5: lzoflamingo folded on the Flop
Seat 6: urahayanagi folded before Flop (didn't bet)



PokerStars Zoom Hand #186648049069:  Hold'em No Limit ($0.02/$0.05) - 2018/05/20 22:37:09 CCT [2018/05/20 10:37:09 ET]
Table 'Donati' 6-max Seat #1 is the button
Seat 1: BigCat16Max ($2.12 in chips) 
Seat 2: Manolo19765 ($4.53 in chips) 
Seat 3: HubertusB ($5.14 in chips) 
Seat 4: <Bogolal> ($7.28 in chips) 
Seat 5: SAVA231 ($9.71 in chips) 
Seat 6: Brofessor123 ($12.87 in chips) 
Manolo19765: posts small blind $0.02
HubertusB: posts big blind $0.05
*** HOLE CARDS ***
Dealt to HubertusB [2c Kh]
<Bogolal>: raises $0.10 to $0.15
SAVA231: folds 
Brofessor123: folds 
BigCat16Max: folds 
Manolo19765: calls $0.13
HubertusB: folds 
*** FLOP *** [5s 7s Ac]
Manolo19765: checks 
<Bogolal>: bets $0.20
Manolo19765: calls $0.20
*** TURN *** [5s 7s Ac] [Qc]
Manolo19765: checks 
<Bogolal>: checks 
*** RIVER *** [5s 7s Ac Qc] [8s]
Manolo19765: bets $0.36
<Bogolal>: folds 
Uncalled bet ($0.36) returned to Manolo19765
Manolo19765 collected $0.72 from pot
Manolo19765: doesn't show hand 
*** SUMMARY ***
Total pot $0.75 | Rake $0.03 
Board [5s 7s Ac Qc 8s]
Seat 1: BigCat16Max (button) folded before Flop (didn't bet)
Seat 2: Manolo19765 (small blind) collected ($0.72)
Seat 3: HubertusB (big blind) folded before Flop
Seat 4: <Bogolal> folded on the River
Seat 5: SAVA231 folded before Flop (didn't bet)
Seat 6: Brofessor123 folded before Flop (didn't bet)



PokerStars Zoom Hand #186648066925:  Hold'em No Limit ($0.02/$0.05) - 2018/05/20 22:37:37 CCT [2018/05/20 10:37:37 ET]
Table 'Donati' 6-max Seat #1 is the button
Seat 1: HubertusB ($5.16 in chips) 
Seat 2: RRrush37 ($5.02 in chips) 
Seat 3: PSqsd ($5.03 in chips) 
Seat 4: diman2341577 ($3.85 in chips) 
Seat 5: BigEd2006 ($7.37 in chips) 
Seat 6: eltorinio ($5 in chips) 
RRrush37: posts small blind $0.02
PSqsd: posts big blind $0.05
*** HOLE CARDS ***
Dealt to HubertusB [3h 3s]
diman2341577: calls $0.05
BigEd2006: folds 
eltorinio: folds 
HubertusB: calls $0.05
RRrush37: calls $0.03
PSqsd: checks 
*** FLOP *** [5c 5d 9c]
RRrush37: checks 
PSqsd: checks 
diman2341577: bets $0.05
HubertusB: folds 
RRrush37: folds 
PSqsd: folds 
Uncalled bet ($0.05) returned to diman2341577
diman2341577 collected $0.19 from pot
diman2341577: doesn't show hand 
*** SUMMARY ***
Total pot $0.20 | Rake $0.01 
Board [5c 5d 9c]
Seat 1: HubertusB (button) folded on the Flop
Seat 2: RRrush37 (small blind) folded on the Flop
Seat 3: PSqsd (big blind) folded on the Flop
Seat 4: diman2341577 collected ($0.19)
Seat 5: BigEd2006 folded before Flop (didn't bet)
Seat 6: eltorinio folded before Flop (didn't bet)



PokerStars Zoom Hand #186648035760:  Hold'em No Limit ($0.02/$0.05) - 2018/05/20 22:36:48 CCT [2018/05/20 10:36:48 ET]
Table 'Donati' 6-max Seat #1 is the button
Seat 1: meibutsu ($5.71 in chips) 
Seat 2: stevy112 ($3.34 in chips) 
Seat 3: Siorassc ($7.26 in chips) 
Seat 4: ccwolf7 ($4.71 in chips) 
Seat 5: NomercY85 ($4.96 in chips) 
Seat 6: HubertusB ($5.16 in chips) 
stevy112: posts small blind $0.02
Siorassc: posts big blind $0.05
*** HOLE CARDS ***
Dealt to HubertusB [Ts Jc]
ccwolf7: calls $0.05
NomercY85: folds 
HubertusB: folds 
meibutsu: calls $0.05
stevy112: folds 
Siorassc: checks 
*** FLOP *** [4s As 9c]
Siorassc: checks 
ccwolf7: checks 
meibutsu: checks 
*** TURN *** [4s As 9c] [9s]
Siorassc: checks 
ccwolf7: checks 
meibutsu: checks 
*** RIVER *** [4s As 9c 9s] [3s]
Siorassc: checks 
ccwolf7: checks 
meibutsu: checks 
*** SHOW DOWN ***
Siorassc: shows [6s Kc] (a flush, Ace high)
ccwolf7: mucks hand 
meibutsu: shows [8s 8c] (a flush, Ace high - Eight higher)
meibutsu collected $0.16 from pot
*** SUMMARY ***
Total pot $0.17 | Rake $0.01 
Board [4s As 9c 9s 3s]
Seat 1: meibutsu (button) showed [8s 8c] and won ($0.16) with a flush, Ace high
Seat 2: stevy112 (small blind) folded before Flop
Seat 3: Siorassc (big blind) showed [6s Kc] and lost with a flush, Ace high
Seat 4: ccwolf7 mucked [Qd Th]
Seat 5: NomercY85 folded before Flop (didn't bet)
Seat 6: HubertusB folded before Flop (didn't bet)



PokerStars Zoom Hand #186648080126:  Hold'em No Limit ($0.02/$0.05) - 2018/05/20 22:37:58 CCT [2018/05/20 10:37:58 ET]
Table 'Donati' 6-max Seat #1 is the button
Seat 1: NomercY85 ($4.82 in chips) 
Seat 2: ThiagooPaiva ($5.48 in chips) 
Seat 3: bober2702 ($6.44 in chips) 
Seat 4: Golodayushii ($27.08 in chips) 
Seat 5: orangedeuce ($5.14 in chips) 
Seat 6: HubertusB ($5.11 in chips) 
ThiagooPaiva: posts small blind $0.02
bober2702: posts big blind $0.05
*** HOLE CARDS ***
Dealt to HubertusB [Ac Qs]
Golodayushii: folds 
orangedeuce: folds 
HubertusB: raises $0.10 to $0.15
NomercY85: folds 
ThiagooPaiva: folds 
bober2702: folds 
Uncalled bet ($0.10) returned to HubertusB
HubertusB collected $0.12 from pot
HubertusB: doesn't show hand 
*** SUMMARY ***
Total pot $0.12 | Rake $0 
Seat 1: NomercY85 (button) folded before Flop (didn't bet)
Seat 2: ThiagooPaiva (small blind) folded before Flop
Seat 3: bober2702 (big blind) folded before Flop
Seat 4: Golodayushii folded before Flop (didn't bet)
Seat 5: orangedeuce folded before Flop (didn't bet)
Seat 6: HubertusB collected ($0.12)



PokerStars Zoom Hand #186648039606:  Hold'em No Limit ($0.02/$0.05) - 2018/05/20 22:36:54 CCT [2018/05/20 10:36:54 ET]
Table 'Donati' 6-max Seat #1 is the button
Seat 1: HubertusB ($5.16 in chips) 
Seat 2: Clubberer80 ($6.01 in chips) 
Seat 3: Grigoriy40$ ($18.01 in chips) 
Seat 4: PM17Lev ($5.70 in chips) 
Seat 5: SpaceOrca ($3.22 in chips) 
Seat 6: Karlyvzla27 ($5.41 in chips) 
Clubberer80: posts small blind $0.02
Grigoriy40$: posts big blind $0.05
*** HOLE CARDS ***
Dealt to HubertusB [2s Ac]
PM17Lev: folds 
SpaceOrca: raises $0.10 to $0.15
Karlyvzla27: folds 
HubertusB: folds 
Clubberer80: folds 
Grigoriy40$ has timed out
Grigoriy40$: folds 
Uncalled bet ($0.10) returned to SpaceOrca
SpaceOrca collected $0.12 from pot
SpaceOrca: doesn't show hand 
*** SUMMARY ***
Total pot $0.12 | Rake $0 
Seat 1: HubertusB (button) folded before Flop (didn't bet)
Seat 2: Clubberer80 (small blind) folded before Flop
Seat 3: Grigoriy40$ (big blind) folded before Flop
Seat 4: PM17Lev folded before Flop (didn't bet)
Seat 5: SpaceOrca collected ($0.12)
Seat 6: Karlyvzla27 folded before Flop (didn't bet)



PokerStars Zoom Hand #186648098127:  Hold'em No Limit ($0.02/$0.05) - 2018/05/20 22:38:26 CCT [2018/05/20 10:38:26 ET]
Table 'Donati' 6-max Seat #1 is the button
Seat 1: TheFibonachi ($10.94 in chips) 
Seat 2: diman2341577 ($3.89 in chips) 
Seat 3: CANYA_V ($7.08 in chips) 
Seat 4: BigEd2006 ($7.07 in chips) 
Seat 5: HubertusB ($5.16 in chips) 
Seat 6: RuDe1234 ($5 in chips) 
diman2341577: posts small blind $0.02
CANYA_V: posts big blind $0.05
*** HOLE CARDS ***
Dealt to HubertusB [Ad 7s]
BigEd2006: folds 
HubertusB: folds 
RuDe1234: folds 
TheFibonachi: folds 
diman2341577: folds 
Uncalled bet ($0.03) returned to CANYA_V
CANYA_V collected $0.04 from pot
CANYA_V: doesn't show hand 
*** SUMMARY ***
Total pot $0.04 | Rake $0 
Seat 1: TheFibonachi (button) folded before Flop (didn't bet)
Seat 2: diman2341577 (small blind) folded before Flop
Seat 3: CANYA_V (big blind) collected ($0.04)
Seat 4: BigEd2006 folded before Flop (didn't bet)
Seat 5: HubertusB folded before Flop (didn't bet)
Seat 6: RuDe1234 folded before Flop (didn't bet)



PokerStars Zoom Hand #186648094854:  Hold'em No Limit ($0.02/$0.05) - 2018/05/20 22:38:21 CCT [2018/05/20 10:38:21 ET]
Table 'Donati' 6-max Seat #1 is the button
Seat 1: axilleas33 ($5.26 in chips) 
Seat 2: HubertusB ($5.18 in chips) 
Seat 3: jacco2004 ($1.05 in chips) 
Seat 4: TalksAlot86 ($1.94 in chips) 
Seat 5: vodila310 ($2.73 in chips) 
Seat 6: luka1981good ($6.72 in chips) 
HubertusB: posts small blind $0.02
jacco2004: posts big blind $0.05
*** HOLE CARDS ***
Dealt to HubertusB [7h Jc]
TalksAlot86: folds 
vodila310: folds 
luka1981good: folds 
axilleas33: raises $0.05 to $0.10
HubertusB: folds 
jacco2004: calls $0.05
*** FLOP *** [4d Jh Js]
jacco2004: checks 
axilleas33: bets $0.13
jacco2004: folds 
Uncalled bet ($0.13) returned to axilleas33
axilleas33 collected $0.21 from pot
axilleas33: doesn't show hand 
*** SUMMARY ***
Total pot $0.22 | Rake $0.01 
Board [4d Jh Js]
Seat 1: axilleas33 (button) collected ($0.21)
Seat 2: HubertusB (small blind) folded before Flop
Seat 3: jacco2004 (big blind) folded on the Flop
Seat 4: TalksAlot86 folded before Flop (didn't bet)
Seat 5: vodila310 folded before Flop (didn't bet)
Seat 6: luka1981good folded before Flop (didn't bet)



PokerStars Zoom Hand #186648101940:  Hold'em No Limit ($0.02/$0.05) - 2018/05/20 22:38:32 CCT [2018/05/20 10:38:32 ET]
Table 'Donati' 6-max Seat #1 is the button
Seat 1: hitomi111 ($5.40 in chips) 
Seat 2: matdzr ($4.22 in chips) 
Seat 3: C-class man ($5 in chips) 
Seat 4: rtyh2003 ($3.38 in chips) 
Seat 5: HubertusB ($5.16 in chips) 
Seat 6: BardJeka ($5.07 in chips) 
matdzr: posts small blind $0.02
C-class man: posts big blind $0.05
*** HOLE CARDS ***
Dealt to HubertusB [5c 6c]
rtyh2003: folds 
HubertusB: raises $0.10 to $0.15
BardJeka: folds 
hitomi111: folds 
matdzr: folds 
C-class man: folds 
Uncalled bet ($0.10) returned to HubertusB
HubertusB collected $0.12 from pot
HubertusB: doesn't show hand 
*** SUMMARY ***
Total pot $0.12 | Rake $0 
Seat 1: hitomi111 (button) folded before Flop (didn't bet)
Seat 2: matdzr (small blind) folded before Flop
Seat 3: C-class man (big blind) folded before Flop
Seat 4: rtyh2003 folded before Flop (didn't bet)
Seat 5: HubertusB collected ($0.12)
Seat 6: BardJeka folded before Flop (didn't bet)



PokerStars Zoom Hand #186648109530:  Hold'em No Limit ($0.02/$0.05) - 2018/05/20 22:38:44 CCT [2018/05/20 10:38:44 ET]
Table 'Donati' 6-max Seat #1 is the button
Seat 1: Hunter152327 ($5 in chips) 
Seat 2: Sergei44427 ($8.83 in chips) 
Seat 3: HubertusB ($5.23 in chips) 
Seat 4: LzeDmitriy21 ($2.69 in chips) 
Seat 5: Croo633 ($6.53 in chips) 
Seat 6: U_RULIA ($5.50 in chips) 
Sergei44427: posts small blind $0.02
HubertusB: posts big blind $0.05
*** HOLE CARDS ***
Dealt to HubertusB [8d 8h]
LzeDmitriy21: folds 
Croo633: folds 
U_RULIA: folds 
Hunter152327: folds 
Sergei44427: folds 
Uncalled bet ($0.03) returned to HubertusB
HubertusB collected $0.04 from pot
HubertusB: doesn't show hand 
*** SUMMARY ***
Total pot $0.04 | Rake $0 
Seat 1: Hunter152327 (button) folded before Flop (didn't bet)
Seat 2: Sergei44427 (small blind) folded before Flop
Seat 3: HubertusB (big blind) collected ($0.04)
Seat 4: LzeDmitriy21 folded before Flop (didn't bet)
Seat 5: Croo633 folded before Flop (didn't bet)
Seat 6: U_RULIA folded before Flop (didn't bet)



PokerStars Zoom Hand #186648115774:  Hold'em No Limit ($0.02/$0.05) - 2018/05/20 22:38:54 CCT [2018/05/20 10:38:54 ET]
Table 'Donati' 6-max Seat #1 is the button
Seat 1: HubertusB ($5.25 in chips) 
Seat 2: kingreigns ($10.74 in chips) 
Seat 3: incorrect88 ($5 in chips) 
Seat 4: KurpatovX ($7.03 in chips) 
Seat 5: falcao991 ($5.02 in chips) 
Seat 6: Daemon'sKiss ($5.18 in chips) 
kingreigns: posts small blind $0.02
incorrect88: posts big blind $0.05
*** HOLE CARDS ***
Dealt to HubertusB [7s Jd]
KurpatovX: folds 
falcao991: raises $0.10 to $0.15
Daemon'sKiss: folds 
HubertusB: folds 
kingreigns: folds 
incorrect88: folds 
Uncalled bet ($0.10) returned to falcao991
falcao991 collected $0.12 from pot
falcao991: doesn't show hand 
*** SUMMARY ***
Total pot $0.12 | Rake $0 
Seat 1: HubertusB (button) folded before Flop (didn't bet)
Seat 2: kingreigns (small blind) folded before Flop
Seat 3: incorrect88 (big blind) folded before Flop
Seat 4: KurpatovX folded before Flop (didn't bet)
Seat 5: falcao991 collected ($0.12)
Seat 6: Daemon'sKiss folded before Flop (didn't bet)



PokerStars Zoom Hand #186648118301:  Hold'em No Limit ($0.02/$0.05) - 2018/05/20 22:38:58 CCT [2018/05/20 10:38:58 ET]
Table 'Donati' 6-max Seat #1 is the button
Seat 1: Naosky ($7.14 in chips) 
Seat 2: fedyl78 ($4.93 in chips) 
Seat 3: urahayanagi ($12.48 in chips) 
Seat 4: Clubberer80 ($5.71 in chips) 
Seat 5: AbraRoy ($11.10 in chips) 
Seat 6: HubertusB ($5.25 in chips) 
fedyl78: posts small blind $0.02
urahayanagi: posts big blind $0.05
*** HOLE CARDS ***
Dealt to HubertusB [Js 6d]
Clubberer80: raises $0.07 to $0.12
AbraRoy: folds 
HubertusB: folds 
Naosky: folds 
fedyl78: folds 
urahayanagi: folds 
Uncalled bet ($0.07) returned to Clubberer80
Clubberer80 collected $0.12 from pot
Clubberer80: doesn't show hand 
*** SUMMARY ***
Total pot $0.12 | Rake $0 
Seat 1: Naosky (button) folded before Flop (didn't bet)
Seat 2: fedyl78 (small blind) folded before Flop
Seat 3: urahayanagi (big blind) folded before Flop
Seat 4: Clubberer80 collected ($0.12)
Seat 5: AbraRoy folded before Flop (didn't bet)
Seat 6: HubertusB folded before Flop (didn't bet)



PokerStars Zoom Hand #186648122860:  Hold'em No Limit ($0.02/$0.05) - 2018/05/20 22:39:05 CCT [2018/05/20 10:39:05 ET]
Table 'Donati' 6-max Seat #1 is the button
Seat 1: dato5557 ($4.21 in chips) 
Seat 2: HubertusB ($5.25 in chips) 
Seat 3: galina817 ($5.29 in chips) 
Seat 4: Wolveredo ($5 in chips) 
Seat 5: TheFibonachi ($11.03 in chips) 
Seat 6: Blackantz ($5.05 in chips) 
HubertusB: posts small blind $0.02
galina817: posts big blind $0.05
*** HOLE CARDS ***
Dealt to HubertusB [Kc Ts]
Wolveredo: folds 
TheFibonachi: folds 
Blackantz: folds 
dato5557: folds 
HubertusB: folds 
Uncalled bet ($0.03) returned to galina817
galina817 collected $0.04 from pot
galina817: doesn't show hand 
*** SUMMARY ***
Total pot $0.04 | Rake $0 
Seat 1: dato5557 (button) folded before Flop (didn't bet)
Seat 2: HubertusB (small blind) folded before Flop
Seat 3: galina817 (big blind) collected ($0.04)
Seat 4: Wolveredo folded before Flop (didn't bet)
Seat 5: TheFibonachi folded before Flop (didn't bet)
Seat 6: Blackantz folded before Flop (didn't bet)



PokerStars Zoom Hand #186648131018:  Hold'em No Limit ($0.02/$0.05) - 2018/05/20 22:39:18 CCT [2018/05/20 10:39:18 ET]
Table 'Donati' 6-max Seat #1 is the button
Seat 1: InnusikM ($2.81 in chips) 
Seat 2: wowAAlolKK ($2.41 in chips) 
Seat 3: HubertusB ($5.23 in chips) 
Seat 4: Brofessor123 ($13.08 in chips) 
Seat 5: Clubberer80 ($5.73 in chips) 
Seat 6: lasyboy999 ($5 in chips) 
wowAAlolKK: posts small blind $0.02
HubertusB: posts big blind $0.05
*** HOLE CARDS ***
Dealt to HubertusB [5c 5d]
Brofessor123: folds 
Clubberer80: folds 
lasyboy999: folds 
InnusikM: folds 
wowAAlolKK: folds 
Uncalled bet ($0.03) returned to HubertusB
HubertusB collected $0.04 from pot
HubertusB: doesn't show hand 
*** SUMMARY ***
Total pot $0.04 | Rake $0 
Seat 1: InnusikM (button) folded before Flop (didn't bet)
Seat 2: wowAAlolKK (small blind) folded before Flop
Seat 3: HubertusB (big blind) collected ($0.04)
Seat 4: Brofessor123 folded before Flop (didn't bet)
Seat 5: Clubberer80 folded before Flop (didn't bet)
Seat 6: lasyboy999 folded before Flop (didn't bet)



PokerStars Zoom Hand #186648127886:  Hold'em No Limit ($0.02/$0.05) - 2018/05/20 22:39:13 CCT [2018/05/20 10:39:13 ET]
Table 'Donati' 6-max Seat #1 is the button
Seat 1: aForrester ($5 in chips) 
Seat 2: alexblakjak ($1.67 in chips) 
Seat 3: WhiteWolf459 ($5 in chips) 
Seat 4: HubertusB ($5.23 in chips) 
Seat 5: ghost1que ($6.02 in chips) 
Seat 6: rino803 ($5.05 in chips) 
alexblakjak: posts small blind $0.02
WhiteWolf459: posts big blind $0.05
*** HOLE CARDS ***
Dealt to HubertusB [3s Jh]
HubertusB: folds 
ghost1que: folds 
rino803: folds 
aForrester: folds 
alexblakjak: calls $0.03
WhiteWolf459: checks 
*** FLOP *** [7s Ks 9s]
alexblakjak: checks 
WhiteWolf459: checks 
*** TURN *** [7s Ks 9s] [Qh]
alexblakjak: bets $0.05
WhiteWolf459: folds 
Uncalled bet ($0.05) returned to alexblakjak
alexblakjak collected $0.10 from pot
alexblakjak: doesn't show hand 
*** SUMMARY ***
Total pot $0.10 | Rake $0 
Board [7s Ks 9s Qh]
Seat 1: aForrester (button) folded before Flop (didn't bet)
Seat 2: alexblakjak (small blind) collected ($0.10)
Seat 3: WhiteWolf459 (big blind) folded on the Turn
Seat 4: HubertusB folded before Flop (didn't bet)
Seat 5: ghost1que folded before Flop (didn't bet)
Seat 6: rino803 folded before Flop (didn't bet)



PokerStars Zoom Hand #186648138184:  Hold'em No Limit ($0.02/$0.05) - 2018/05/20 22:39:29 CCT [2018/05/20 10:39:29 ET]
Table 'Donati' 6-max Seat #1 is the button
Seat 1: axilleas33 ($5.19 in chips) 
Seat 2: DylanMoran ($14.75 in chips) 
Seat 3: Tustik ($3.85 in chips) 
Seat 4: jacco2004 ($1 in chips) 
Seat 5: Shalev7 ($6.04 in chips) 
Seat 6: HubertusB ($5.25 in chips) 
DylanMoran: posts small blind $0.02
Tustik: posts big blind $0.05
*** HOLE CARDS ***
Dealt to HubertusB [6s 4h]
jacco2004: folds 
Shalev7: raises $0.08 to $0.13
HubertusB: folds 
axilleas33: folds 
DylanMoran: folds 
Tustik: folds 
Uncalled bet ($0.08) returned to Shalev7
Shalev7 collected $0.12 from pot
Shalev7: doesn't show hand 
*** SUMMARY ***
Total pot $0.12 | Rake $0 
Seat 1: axilleas33 (button) folded before Flop (didn't bet)
Seat 2: DylanMoran (small blind) folded before Flop
Seat 3: Tustik (big blind) folded before Flop
Seat 4: jacco2004 folded before Flop (didn't bet)
Seat 5: Shalev7 collected ($0.12)
Seat 6: HubertusB folded before Flop (didn't bet)



PokerStars Zoom Hand #186648141978:  Hold'em No Limit ($0.02/$0.05) - 2018/05/20 22:39:35 CCT [2018/05/20 10:39:35 ET]
Table 'Donati' 6-max Seat #1 is the button
Seat 1: HubertusB ($5.25 in chips) 
Seat 2: chips010 ($20.55 in chips) 
Seat 3: Savavlad97 ($13.61 in chips) 
Seat 4: sixequjfive ($27.14 in chips) 
Seat 5: BEPA4KAps ($6.71 in chips) 
Seat 6: Blackantz ($5.78 in chips) 
chips010: posts small blind $0.02
Savavlad97: posts big blind $0.05
*** HOLE CARDS ***
Dealt to HubertusB [As 5h]
sixequjfive: raises $0.08 to $0.13
BEPA4KAps: folds 
Blackantz: folds 
HubertusB: folds 
chips010: folds 
Savavlad97: folds 
Uncalled bet ($0.08) returned to sixequjfive
sixequjfive collected $0.12 from pot
sixequjfive: doesn't show hand 
*** SUMMARY ***
Total pot $0.12 | Rake $0 
Seat 1: HubertusB (button) folded before Flop (didn't bet)
Seat 2: chips010 (small blind) folded before Flop
Seat 3: Savavlad97 (big blind) folded before Flop
Seat 4: sixequjfive collected ($0.12)
Seat 5: BEPA4KAps folded before Flop (didn't bet)
Seat 6: Blackantz folded before Flop (didn't bet)



PokerStars Zoom Hand #186648146499:  Hold'em No Limit ($0.02/$0.05) - 2018/05/20 22:39:42 CCT [2018/05/20 10:39:42 ET]
Table 'Donati' 6-max Seat #1 is the button
Seat 1: Hanart ($5.27 in chips) 
Seat 2: HubertusB ($5.25 in chips) 
Seat 3: Vajdalf92 ($5.14 in chips) 
Seat 4: fahundes ($2.92 in chips) 
Seat 5: WhiteWolf459 ($5 in chips) 
Seat 6: funfun55 ($5.64 in chips) 
HubertusB: posts small blind $0.02
Vajdalf92: posts big blind $0.05
*** HOLE CARDS ***
Dealt to HubertusB [Ts Tc]
fahundes: folds 
WhiteWolf459: folds 
funfun55: folds 
Hanart has timed out
Hanart: folds 
HubertusB: raises $0.10 to $0.15
Vajdalf92: calls $0.10
*** FLOP *** [Ks 9h Qc]
HubertusB: bets $0.15
Vajdalf92: calls $0.15
*** TURN *** [Ks 9h Qc] [8c]
HubertusB: checks 
Vajdalf92: checks 
*** RIVER *** [Ks 9h Qc 8c] [3s]
HubertusB: checks 
Vajdalf92: checks 
*** SHOW DOWN ***
HubertusB: shows [Ts Tc] (a pair of Tens)
Vajdalf92: shows [Qs Ad] (a pair of Queens)
Vajdalf92 collected $0.58 from pot
*** SUMMARY ***
Total pot $0.60 | Rake $0.02 
Board [Ks 9h Qc 8c 3s]
Seat 1: Hanart (button) folded before Flop (didn't bet)
Seat 2: HubertusB (small blind) showed [Ts Tc] and lost with a pair of Tens
Seat 3: Vajdalf92 (big blind) showed [Qs Ad] and won ($0.58) with a pair of Queens
Seat 4: fahundes folded before Flop (didn't bet)
Seat 5: WhiteWolf459 folded before Flop (didn't bet)
Seat 6: funfun55 folded before Flop (didn't bet)



PokerStars Zoom Hand #186648181652:  Hold'em No Limit ($0.02/$0.05) - 2018/05/20 22:40:37 CCT [2018/05/20 10:40:37 ET]
Table 'Donati' 6-max Seat #1 is the button
Seat 1: rino803 ($5.07 in chips) 
Seat 2: Golodayushii ($5.63 in chips) 
Seat 3: AbraRoy ($16.34 in chips) 
Seat 4: probil777a ($4.93 in chips) 
Seat 5: HubertusB ($4.95 in chips) 
Seat 6: Demyosaur ($9.77 in chips) 
Golodayushii: posts small blind $0.02
AbraRoy: posts big blind $0.05
*** HOLE CARDS ***
Dealt to HubertusB [Jd Jh]
probil777a: folds 
HubertusB: raises $0.10 to $0.15
Demyosaur: folds 
rino803: folds 
Golodayushii: folds 
AbraRoy: raises $0.30 to $0.45
HubertusB: calls $0.30
*** FLOP *** [5s 7s Ts]
AbraRoy: checks 
HubertusB: checks 
*** TURN *** [5s 7s Ts] [4d]
AbraRoy: bets $0.57
HubertusB: calls $0.57
*** RIVER *** [5s 7s Ts 4d] [5d]
AbraRoy: bets $1.10
HubertusB: calls $1.10
*** SHOW DOWN ***
AbraRoy: shows [Kd Ks] (two pair, Kings and Fives)
HubertusB: mucks hand 
AbraRoy collected $4.08 from pot
*** SUMMARY ***
Total pot $4.26 | Rake $0.18 
Board [5s 7s Ts 4d 5d]
Seat 1: rino803 (button) folded before Flop (didn't bet)
Seat 2: Golodayushii (small blind) folded before Flop
Seat 3: AbraRoy (big blind) showed [Kd Ks] and won ($4.08) with two pair, Kings and Fives
Seat 4: probil777a folded before Flop (didn't bet)
Seat 5: HubertusB mucked [Jd Jh]
Seat 6: Demyosaur folded before Flop (didn't bet)



PokerStars Zoom Hand #186648212414:  Hold'em No Limit ($0.02/$0.05) - 2018/05/20 22:41:25 CCT [2018/05/20 10:41:25 ET]
Table 'Donati' 6-max Seat #1 is the button
Seat 1: kaimaj ($5 in chips) 
Seat 2: Roman197430 ($5.50 in chips) 
Seat 3: HubertusB ($2.83 in chips) 
Seat 4: aaw990619 ($3.72 in chips) 
Seat 5: BeatLimits ($5.93 in chips) 
Seat 6: sityu8411 ($3.71 in chips) 
Roman197430: posts small blind $0.02
HubertusB: posts big blind $0.05
*** HOLE CARDS ***
Dealt to HubertusB [Jh 5c]
aaw990619: folds 
BeatLimits: folds 
sityu8411: folds 
kaimaj: folds 
Roman197430: folds 
Uncalled bet ($0.03) returned to HubertusB
HubertusB collected $0.04 from pot
HubertusB: doesn't show hand 
*** SUMMARY ***
Total pot $0.04 | Rake $0 
Seat 1: kaimaj (button) folded before Flop (didn't bet)
Seat 2: Roman197430 (small blind) folded before Flop
Seat 3: HubertusB (big blind) collected ($0.04)
Seat 4: aaw990619 folded before Flop (didn't bet)
Seat 5: BeatLimits folded before Flop (didn't bet)
Seat 6: sityu8411 folded before Flop (didn't bet)



PokerStars Zoom Hand #186648207870:  Hold'em No Limit ($0.02/$0.05) - 2018/05/20 22:41:18 CCT [2018/05/20 10:41:18 ET]
Table 'Donati' 6-max Seat #1 is the button
Seat 1: Silencer91 ($7.91 in chips) 
Seat 2: incorrect88 ($7.29 in chips) 
Seat 3: BEPA4KAps ($6.43 in chips) 
Seat 4: HubertusB ($2.83 in chips) 
Seat 5: rdleitao ($5 in chips) 
Seat 6: BoSs00 ($8.24 in chips) 
incorrect88: posts small blind $0.02
BEPA4KAps: posts big blind $0.05
*** HOLE CARDS ***
Dealt to HubertusB [6s 2s]
HubertusB: folds 
rdleitao: folds 
BoSs00: raises $0.05 to $0.10
Silencer91: folds 
incorrect88: raises $0.35 to $0.45
BEPA4KAps: folds 
BoSs00: calls $0.35
*** FLOP *** [4s 5c 9h]
incorrect88: bets $0.61
BoSs00: calls $0.61
*** TURN *** [4s 5c 9h] [Qh]
incorrect88: bets $1.39
BoSs00: folds 
Uncalled bet ($1.39) returned to incorrect88
incorrect88 collected $2.08 from pot
incorrect88: doesn't show hand 
*** SUMMARY ***
Total pot $2.17 | Rake $0.09 
Board [4s 5c 9h Qh]
Seat 1: Silencer91 (button) folded before Flop (didn't bet)
Seat 2: incorrect88 (small blind) collected ($2.08)
Seat 3: BEPA4KAps (big blind) folded before Flop
Seat 4: HubertusB folded before Flop (didn't bet)
Seat 5: rdleitao folded before Flop (didn't bet)
Seat 6: BoSs00 folded on the Turn



PokerStars Zoom Hand #186648223837:  Hold'em No Limit ($0.02/$0.05) - 2018/05/20 22:41:43 CCT [2018/05/20 10:41:43 ET]
Table 'Donati' 6-max Seat #1 is the button
Seat 1: Voron9 ($11.35 in chips) 
Seat 2: newf5959 ($2.93 in chips) 
Seat 3: SCAMMER12345 ($5.33 in chips) 
Seat 4: olega2006 ($13.35 in chips) 
Seat 5: kaimaj ($5.47 in chips) 
Seat 6: HubertusB ($2.85 in chips) 
newf5959: posts small blind $0.02
SCAMMER12345: posts big blind $0.05
*** HOLE CARDS ***
Dealt to HubertusB [Ah Jd]
olega2006: folds 
kaimaj: folds 
HubertusB: raises $0.10 to $0.15
Voron9: folds 
newf5959: folds 
SCAMMER12345: folds 
Uncalled bet ($0.10) returned to HubertusB
HubertusB collected $0.12 from pot
HubertusB: doesn't show hand 
*** SUMMARY ***
Total pot $0.12 | Rake $0 
Seat 1: Voron9 (button) folded before Flop (didn't bet)
Seat 2: newf5959 (small blind) folded before Flop
Seat 3: SCAMMER12345 (big blind) folded before Flop
Seat 4: olega2006 folded before Flop (didn't bet)
Seat 5: kaimaj folded before Flop (didn't bet)
Seat 6: HubertusB collected ($0.12)



PokerStars Zoom Hand #186648249864:  Hold'em No Limit ($0.02/$0.05) - 2018/05/20 22:42:20 CCT [2018/05/20 10:42:20 ET]
Table 'Donati' 6-max Seat #1 is the button
Seat 1: sunao1983 ($3.84 in chips) 
Seat 2: Goosich ($7.77 in chips) 
Seat 3: cazzzwell ($6.28 in chips) 
Seat 4: Silencer91 ($6.76 in chips) 
Seat 5: C-class man ($7.04 in chips) 
Seat 6: HubertusB ($2.92 in chips) 
Goosich: posts small blind $0.02
cazzzwell: posts big blind $0.05
*** HOLE CARDS ***
Dealt to HubertusB [Jc Qd]
Silencer91: folds 
C-class man: folds 
HubertusB: raises $0.10 to $0.15
sunao1983: folds 
Goosich: folds 
cazzzwell: folds 
Uncalled bet ($0.10) returned to HubertusB
HubertusB collected $0.12 from pot
HubertusB: doesn't show hand 
*** SUMMARY ***
Total pot $0.12 | Rake $0 
Seat 1: sunao1983 (button) folded before Flop (didn't bet)
Seat 2: Goosich (small blind) folded before Flop
Seat 3: cazzzwell (big blind) folded before Flop
Seat 4: Silencer91 folded before Flop (didn't bet)
Seat 5: C-class man folded before Flop (didn't bet)
Seat 6: HubertusB collected ($0.12)



PokerStars Zoom Hand #186648243333:  Hold'em No Limit ($0.02/$0.05) - 2018/05/20 22:42:10 CCT [2018/05/20 10:42:10 ET]
Table 'Donati' 6-max Seat #1 is the button
Seat 1: HubertusB ($2.92 in chips) 
Seat 2: Kozak Sila ($1.47 in chips) 
Seat 3: PM17Lev ($5.05 in chips) 
Seat 4: eliasfleitas ($5 in chips) 
Seat 5: incorrect88 ($18.21 in chips) 
Seat 6: hitomi111 ($5.32 in chips) 
Kozak Sila: posts small blind $0.02
PM17Lev: posts big blind $0.05
*** HOLE CARDS ***
Dealt to HubertusB [8h 9d]
eliasfleitas: folds 
incorrect88: folds 
hitomi111: raises $0.10 to $0.15
HubertusB: folds 
Kozak Sila: calls $0.13
PM17Lev: folds 
*** FLOP *** [8s As Ks]
Kozak Sila: checks 
hitomi111: bets $0.35
Kozak Sila: raises $0.97 to $1.32 and is all-in
hitomi111: calls $0.97
*** TURN *** [8s As Ks] [4h]
*** RIVER *** [8s As Ks 4h] [Ts]
*** SHOW DOWN ***
Kozak Sila: shows [Ac Kh] (two pair, Aces and Kings)
hitomi111: shows [Kc Kd] (three of a kind, Kings)
hitomi111 collected $2.87 from pot
*** SUMMARY ***
Total pot $2.99 | Rake $0.12 
Board [8s As Ks 4h Ts]
Seat 1: HubertusB (button) folded before Flop (didn't bet)
Seat 2: Kozak Sila (small blind) showed [Ac Kh] and lost with two pair, Aces and Kings
Seat 3: PM17Lev (big blind) folded before Flop
Seat 4: eliasfleitas folded before Flop (didn't bet)
Seat 5: incorrect88 folded before Flop (didn't bet)
Seat 6: hitomi111 showed [Kc Kd] and won ($2.87) with three of a kind, Kings



PokerStars Zoom Hand #186648263359:  Hold'em No Limit ($0.02/$0.05) - 2018/05/20 22:42:41 CCT [2018/05/20 10:42:41 ET]
Table 'Donati' 6-max Seat #1 is the button
Seat 1: probil777a ($4.86 in chips) 
Seat 2: HubertusB ($2.99 in chips) 
Seat 3: ThiagooPaiva ($5.44 in chips) 
Seat 4: Brofessor123 ($13.51 in chips) 
Seat 5: kingreigns ($5.07 in chips) 
Seat 6: joop119 ($6.73 in chips) 
HubertusB: posts small blind $0.02
ThiagooPaiva: posts big blind $0.05
*** HOLE CARDS ***
Dealt to HubertusB [Kh 2c]
Brofessor123: folds 
kingreigns: folds 
joop119: folds 
probil777a: folds 
HubertusB: folds 
Uncalled bet ($0.03) returned to ThiagooPaiva
ThiagooPaiva collected $0.04 from pot
ThiagooPaiva: doesn't show hand 
*** SUMMARY ***
Total pot $0.04 | Rake $0 
Seat 1: probil777a (button) folded before Flop (didn't bet)
Seat 2: HubertusB (small blind) folded before Flop
Seat 3: ThiagooPaiva (big blind) collected ($0.04)
Seat 4: Brofessor123 folded before Flop (didn't bet)
Seat 5: kingreigns folded before Flop (didn't bet)
Seat 6: joop119 folded before Flop (didn't bet)



PokerStars Zoom Hand #186648266561:  Hold'em No Limit ($0.02/$0.05) - 2018/05/20 22:42:46 CCT [2018/05/20 10:42:46 ET]
Table 'Donati' 6-max Seat #1 is the button
Seat 1: boom248 ($4.11 in chips) 
Seat 2: Sergei44427 ($5.55 in chips) 
Seat 3: ritasexy ($5.49 in chips) 
Seat 4: HubertusB ($2.97 in chips) 
Seat 5: nakashi11 ($2.46 in chips) 
Seat 6: -Z3RO_DAY- ($10.81 in chips) 
Sergei44427: posts small blind $0.02
ritasexy: posts big blind $0.05
*** HOLE CARDS ***
Dealt to HubertusB [2c Qd]
HubertusB: folds 
nakashi11: folds 
-Z3RO_DAY-: folds 
boom248: folds 
Sergei44427: raises $0.10 to $0.15
ritasexy: folds 
Uncalled bet ($0.10) returned to Sergei44427
Sergei44427 collected $0.10 from pot
Sergei44427: doesn't show hand 
*** SUMMARY ***
Total pot $0.10 | Rake $0 
Seat 1: boom248 (button) folded before Flop (didn't bet)
Seat 2: Sergei44427 (small blind) collected ($0.10)
Seat 3: ritasexy (big blind) folded before Flop
Seat 4: HubertusB folded before Flop (didn't bet)
Seat 5: nakashi11 folded before Flop (didn't bet)
Seat 6: -Z3RO_DAY- folded before Flop (didn't bet)



PokerStars Zoom Hand #186648270510:  Hold'em No Limit ($0.02/$0.05) - 2018/05/20 22:42:52 CCT [2018/05/20 10:42:52 ET]
Table 'Donati' 6-max Seat #1 is the button
Seat 1: Egozocker ($6.19 in chips) 
Seat 2: boom248 ($4.11 in chips) 
Seat 3: HubertusB ($2.97 in chips) 
Seat 4: AndreyK11 ($6.04 in chips) 
Seat 5: Silencer91 ($7.51 in chips) 
Seat 6: Siorassc ($6.05 in chips) 
boom248: posts small blind $0.02
HubertusB: posts big blind $0.05
*** HOLE CARDS ***
Dealt to HubertusB [5s 8d]
AndreyK11: folds 
Silencer91: folds 
Siorassc: folds 
Egozocker: raises $0.07 to $0.12
boom248: folds 
HubertusB: folds 
Uncalled bet ($0.07) returned to Egozocker
Egozocker collected $0.12 from pot
Egozocker: doesn't show hand 
*** SUMMARY ***
Total pot $0.12 | Rake $0 
Seat 1: Egozocker (button) collected ($0.12)
Seat 2: boom248 (small blind) folded before Flop
Seat 3: HubertusB (big blind) folded before Flop
Seat 4: AndreyK11 folded before Flop (didn't bet)
Seat 5: Silencer91 folded before Flop (didn't bet)
Seat 6: Siorassc folded before Flop (didn't bet)



PokerStars Zoom Hand #186648276395:  Hold'em No Limit ($0.02/$0.05) - 2018/05/20 22:43:01 CCT [2018/05/20 10:43:01 ET]
Table 'Donati' 6-max Seat #1 is the button
Seat 1: Vahenta ($5.45 in chips) 
Seat 2: youri1961 ($4.85 in chips) 
Seat 3: falcao991 ($18.06 in chips) 
Seat 4: Molesterx ($5 in chips) 
Seat 5: HubertusB ($2.92 in chips) 
Seat 6: damienftw ($6.34 in chips) 
youri1961: posts small blind $0.02
falcao991: posts big blind $0.05
*** HOLE CARDS ***
Dealt to HubertusB [8h Kd]
Molesterx: folds 
HubertusB: folds 
damienftw: folds 
Vahenta: folds 
youri1961: folds 
Uncalled bet ($0.03) returned to falcao991
falcao991 collected $0.04 from pot
falcao991: doesn't show hand 
*** SUMMARY ***
Total pot $0.04 | Rake $0 
Seat 1: Vahenta (button) folded before Flop (didn't bet)
Seat 2: youri1961 (small blind) folded before Flop
Seat 3: falcao991 (big blind) collected ($0.04)
Seat 4: Molesterx folded before Flop (didn't bet)
Seat 5: HubertusB folded before Flop (didn't bet)
Seat 6: damienftw folded before Flop (didn't bet)



PokerStars Zoom Hand #186648282865:  Hold'em No Limit ($0.02/$0.05) - 2018/05/20 22:43:11 CCT [2018/05/20 10:43:11 ET]
Table 'Donati' 6-max Seat #1 is the button
Seat 1: HubertusB ($2.90 in chips) 
Seat 2: Molesterx ($5 in chips) 
Seat 3: superRODRI ($5 in chips) 
Seat 4: Vahenta ($5.45 in chips) 
Seat 5: OsloVest ($9.52 in chips) 
Seat 6: Blackantz ($5 in chips) 
Molesterx: posts small blind $0.02
superRODRI: posts big blind $0.05
*** HOLE CARDS ***
Dealt to HubertusB [Kd 4d]
Vahenta: folds 
OsloVest: folds 
Blackantz: folds 
HubertusB: folds 
Molesterx: folds 
Uncalled bet ($0.03) returned to superRODRI
superRODRI collected $0.04 from pot
superRODRI: doesn't show hand 
*** SUMMARY ***
Total pot $0.04 | Rake $0 
Seat 1: HubertusB (button) folded before Flop (didn't bet)
Seat 2: Molesterx (small blind) folded before Flop
Seat 3: superRODRI (big blind) collected ($0.04)
Seat 4: Vahenta folded before Flop (didn't bet)
Seat 5: OsloVest folded before Flop (didn't bet)
Seat 6: Blackantz folded before Flop (didn't bet)



PokerStars Zoom Hand #186648246587:  Hold'em No Limit ($0.02/$0.05) - 2018/05/20 22:42:15 CCT [2018/05/20 10:42:15 ET]
Table 'Donati' 6-max Seat #1 is the button
Seat 1: I.Mimeev ($4.15 in chips) 
Seat 2: Ente1512 ($5.68 in chips) 
Seat 3: Lingaringa ($5 in chips) 
Seat 4: HubertusB ($2.92 in chips) 
Seat 5: STARteamPR0 ($5.53 in chips) 
Seat 6: niko1078 ($5.56 in chips) 
Ente1512: posts small blind $0.02
Lingaringa: posts big blind $0.05
*** HOLE CARDS ***
Dealt to HubertusB [Ad 8s]
HubertusB: folds 
STARteamPR0: raises $0.10 to $0.15
niko1078: calls $0.15
I.Mimeev: calls $0.15
Ente1512: folds 
Lingaringa: folds 
*** FLOP *** [Qd 4c 7d]
STARteamPR0: checks 
niko1078: checks 
I.Mimeev: bets $0.25
STARteamPR0: calls $0.25
niko1078: folds 
*** TURN *** [Qd 4c 7d] [7c]
STARteamPR0: checks 
I.Mimeev: bets $1
STARteamPR0: calls $1
*** RIVER *** [Qd 4c 7d 7c] [3c]
STARteamPR0: checks 
I.Mimeev: checks 
*** SHOW DOWN ***
STARteamPR0: shows [7h Ah] (three of a kind, Sevens)
I.Mimeev: mucks hand 
STARteamPR0 collected $2.89 from pot
*** SUMMARY ***
Total pot $3.02 | Rake $0.13 
Board [Qd 4c 7d 7c 3c]
Seat 1: I.Mimeev (button) mucked [9s Jh]
Seat 2: Ente1512 (small blind) folded before Flop
Seat 3: Lingaringa (big blind) folded before Flop
Seat 4: HubertusB folded before Flop (didn't bet)
Seat 5: STARteamPR0 showed [7h Ah] and won ($2.89) with three of a kind, Sevens
Seat 6: niko1078 folded on the Flop



PokerStars Zoom Hand #186648286706:  Hold'em No Limit ($0.02/$0.05) - 2018/05/20 22:43:17 CCT [2018/05/20 10:43:17 ET]
Table 'Donati' 6-max Seat #1 is the button
Seat 1: Blackantz ($5 in chips) 
Seat 2: Silencer91 ($6.73 in chips) 
Seat 3: LortabsOnMe ($5 in chips) 
Seat 4: derak488 ($5 in chips) 
Seat 5: HubertusB ($2.90 in chips) 
Seat 6: XXXiao ($6.13 in chips) 
Silencer91: posts small blind $0.02
LortabsOnMe: posts big blind $0.05
*** HOLE CARDS ***
Dealt to HubertusB [3d 7s]
derak488: folds 
HubertusB: folds 
XXXiao: raises $0.12 to $0.17
Blackantz: folds 
Silencer91: folds 
LortabsOnMe: folds 
Uncalled bet ($0.12) returned to XXXiao
XXXiao collected $0.12 from pot
XXXiao: doesn't show hand 
*** SUMMARY ***
Total pot $0.12 | Rake $0 
Seat 1: Blackantz (button) folded before Flop (didn't bet)
Seat 2: Silencer91 (small blind) folded before Flop
Seat 3: LortabsOnMe (big blind) folded before Flop
Seat 4: derak488 folded before Flop (didn't bet)
Seat 5: HubertusB folded before Flop (didn't bet)
Seat 6: XXXiao collected ($0.12)



PokerStars Zoom Hand #186648279611:  Hold'em No Limit ($0.02/$0.05) - 2018/05/20 22:43:06 CCT [2018/05/20 10:43:06 ET]
Table 'Donati' 6-max Seat #1 is the button
Seat 1: flyingwoodz ($4.81 in chips) 
Seat 2: HubertusB ($2.92 in chips) 
Seat 3: LeetSkilz ($5.22 in chips) 
Seat 4: BoSs00 ($6.03 in chips) 
Seat 5: Izaak247 ($5.13 in chips) 
Seat 6: ripe berry ($13.34 in chips) 
HubertusB: posts small blind $0.02
LeetSkilz: posts big blind $0.05
*** HOLE CARDS ***
Dealt to HubertusB [3d Kc]
BoSs00: folds 
Izaak247: folds 
ripe berry: calls $0.05
flyingwoodz: calls $0.05
HubertusB: folds 
LeetSkilz: checks 
*** FLOP *** [Kd 6c Jd]
LeetSkilz: checks 
ripe berry: checks 
flyingwoodz: checks 
*** TURN *** [Kd 6c Jd] [Tc]
LeetSkilz: checks 
ripe berry: checks 
flyingwoodz: checks 
*** RIVER *** [Kd 6c Jd Tc] [2c]
LeetSkilz: checks 
ripe berry: checks 
flyingwoodz: checks 
*** SHOW DOWN ***
LeetSkilz: shows [Ad 7h] (high card Ace)
ripe berry: shows [9h Th] (a pair of Tens)
flyingwoodz: mucks hand 
ripe berry collected $0.16 from pot
*** SUMMARY ***
Total pot $0.17 | Rake $0.01 
Board [Kd 6c Jd Tc 2c]
Seat 1: flyingwoodz (button) mucked [8h 7c]
Seat 2: HubertusB (small blind) folded before Flop
Seat 3: LeetSkilz (big blind) showed [Ad 7h] and lost with high card Ace
Seat 4: BoSs00 folded before Flop (didn't bet)
Seat 5: Izaak247 folded before Flop (didn't bet)
Seat 6: ripe berry showed [9h Th] and won ($0.16) with a pair of Tens



PokerStars Zoom Hand #186648302841:  Hold'em No Limit ($0.02/$0.05) - 2018/05/20 22:43:42 CCT [2018/05/20 10:43:42 ET]
Table 'Donati' 6-max Seat #1 is the button
Seat 1: BeatLimits ($5.25 in chips) 
Seat 2: falcao991 ($9.24 in chips) 
Seat 3: kickupduster ($5.07 in chips) 
Seat 4: -Z3RO_DAY- ($5.28 in chips) 
Seat 5: HubertusB ($2.85 in chips) 
Seat 6: natashaluz ($1.89 in chips) 
falcao991: posts small blind $0.02
kickupduster: posts big blind $0.05
*** HOLE CARDS ***
Dealt to HubertusB [5d 8s]
-Z3RO_DAY-: folds 
HubertusB: folds 
natashaluz: folds 
BeatLimits: folds 
falcao991: folds 
Uncalled bet ($0.03) returned to kickupduster
kickupduster collected $0.04 from pot
kickupduster: doesn't show hand 
*** SUMMARY ***
Total pot $0.04 | Rake $0 
Seat 1: BeatLimits (button) folded before Flop (didn't bet)
Seat 2: falcao991 (small blind) folded before Flop
Seat 3: kickupduster (big blind) collected ($0.04)
Seat 4: -Z3RO_DAY- folded before Flop (didn't bet)
Seat 5: HubertusB folded before Flop (didn't bet)
Seat 6: natashaluz folded before Flop (didn't bet)



PokerStars Zoom Hand #186648291198:  Hold'em No Limit ($0.02/$0.05) - 2018/05/20 22:43:24 CCT [2018/05/20 10:43:24 ET]
Table 'Donati' 6-max Seat #1 is the button
Seat 1: QUAD_D4M4GE ($10.27 in chips) 
Seat 2: ILLi.oLL ($4.60 in chips) 
Seat 3: Lingaringa ($5.13 in chips) 
Seat 4: HubertusB ($2.90 in chips) 
Seat 5: Sergei44427 ($5.50 in chips) 
Seat 6: rtyh2003 ($4.96 in chips) 
ILLi.oLL: posts small blind $0.02
Lingaringa: posts big blind $0.05
*** HOLE CARDS ***
Dealt to HubertusB [2c 6s]
HubertusB: folds 
Sergei44427: folds 
rtyh2003: folds 
QUAD_D4M4GE: raises $0.10 to $0.15
ILLi.oLL: calls $0.13
Lingaringa: calls $0.10
*** FLOP *** [7c Td 2s]
ILLi.oLL: checks 
Lingaringa: bets $0.18
QUAD_D4M4GE: folds 
ILLi.oLL: folds 
Uncalled bet ($0.18) returned to Lingaringa
Lingaringa collected $0.43 from pot
Lingaringa: doesn't show hand 
*** SUMMARY ***
Total pot $0.45 | Rake $0.02 
Board [7c Td 2s]
Seat 1: QUAD_D4M4GE (button) folded on the Flop
Seat 2: ILLi.oLL (small blind) folded on the Flop
Seat 3: Lingaringa (big blind) collected ($0.43)
Seat 4: HubertusB folded before Flop (didn't bet)
Seat 5: Sergei44427 folded before Flop (didn't bet)
Seat 6: rtyh2003 folded before Flop (didn't bet)



PokerStars Zoom Hand #186648294434:  Hold'em No Limit ($0.02/$0.05) - 2018/05/20 22:43:29 CCT [2018/05/20 10:43:29 ET]
Table 'Donati' 6-max Seat #1 is the button
Seat 1: Silencer91 ($6.71 in chips) 
Seat 2: Make6666 ($5.18 in chips) 
Seat 3: HubertusB ($2.90 in chips) 
Seat 4: XXXiao ($5 in chips) 
Seat 5: Yptom ($3.54 in chips) 
Seat 6: IVAN071RU ($2.61 in chips) 
Make6666: posts small blind $0.02
HubertusB: posts big blind $0.05
*** HOLE CARDS ***
Dealt to HubertusB [Ah 4s]
XXXiao: folds 
Yptom: raises $0.06 to $0.11
IVAN071RU: raises $0.09 to $0.20
Silencer91: folds 
Make6666: folds 
HubertusB: folds 
Yptom: calls $0.09
*** FLOP *** [Jh Qc 3c]
Yptom: checks 
IVAN071RU: checks 
*** TURN *** [Jh Qc 3c] [Kc]
Yptom: bets $0.15
IVAN071RU: calls $0.15
*** RIVER *** [Jh Qc 3c Kc] [7h]
Yptom: checks 
IVAN071RU: bets $0.37
Yptom: calls $0.37
*** SHOW DOWN ***
IVAN071RU: shows [9s Js] (a pair of Jacks)
Yptom: shows [Qh Ac] (a pair of Queens)
Yptom collected $1.45 from pot
*** SUMMARY ***
Total pot $1.51 | Rake $0.06 
Board [Jh Qc 3c Kc 7h]
Seat 1: Silencer91 (button) folded before Flop (didn't bet)
Seat 2: Make6666 (small blind) folded before Flop
Seat 3: HubertusB (big blind) folded before Flop
Seat 4: XXXiao folded before Flop (didn't bet)
Seat 5: Yptom showed [Qh Ac] and won ($1.45) with a pair of Queens
Seat 6: IVAN071RU showed [9s Js] and lost with a pair of Jacks



PokerStars Zoom Hand #186648300236:  Hold'em No Limit ($0.02/$0.05) - 2018/05/20 22:43:38 CCT [2018/05/20 10:43:38 ET]
Table 'Donati' 6-max Seat #1 is the button
Seat 1: Goosich ($10.75 in chips) 
Seat 2: erhan001111 ($5.29 in chips) 
Seat 3: Oleksii Voronin ($6.05 in chips) 
Seat 4: superfluxo ($1.52 in chips) 
Seat 5: kolmikov ($3.74 in chips) 
Seat 6: HubertusB ($2.85 in chips) 
erhan001111: posts small blind $0.02
Oleksii Voronin: posts big blind $0.05
*** HOLE CARDS ***
Dealt to HubertusB [Qd 7d]
superfluxo: calls $0.05
kolmikov: calls $0.05
HubertusB: folds 
Goosich: folds 
erhan001111: folds 
Oleksii Voronin: checks 
*** FLOP *** [8s 6s 6c]
Oleksii Voronin: checks 
superfluxo: checks 
kolmikov: bets $0.10
Oleksii Voronin: folds 
superfluxo: folds 
Uncalled bet ($0.10) returned to kolmikov
kolmikov collected $0.16 from pot
kolmikov: doesn't show hand 
*** SUMMARY ***
Total pot $0.17 | Rake $0.01 
Board [8s 6s 6c]
Seat 1: Goosich (button) folded before Flop (didn't bet)
Seat 2: erhan001111 (small blind) folded before Flop
Seat 3: Oleksii Voronin (big blind) folded on the Flop
Seat 4: superfluxo folded on the Flop
Seat 5: kolmikov collected ($0.16)
Seat 6: HubertusB folded before Flop (didn't bet)



PokerStars Zoom Hand #186648309959:  Hold'em No Limit ($0.02/$0.05) - 2018/05/20 22:43:53 CCT [2018/05/20 10:43:53 ET]
Table 'Donati' 6-max Seat #1 is the button
Seat 1: HubertusB ($2.83 in chips) 
Seat 2: Tustik ($8.20 in chips) 
Seat 3: Bane91 ($1.96 in chips) 
Seat 4: -Z3RO_DAY- ($5 in chips) 
Seat 5: 111si@v@111 ($4.17 in chips) 
Seat 6: volodymyr546 ($8.73 in chips) 
Tustik: posts small blind $0.02
Bane91: posts big blind $0.05
*** HOLE CARDS ***
Dealt to HubertusB [9h As]
-Z3RO_DAY-: folds 
111si@v@111: folds 
volodymyr546: folds 
HubertusB: raises $0.10 to $0.15
Tustik: folds 
Bane91 has timed out while disconnected
Bane91: folds 
Uncalled bet ($0.10) returned to HubertusB
HubertusB collected $0.12 from pot
HubertusB: doesn't show hand 
*** SUMMARY ***
Total pot $0.12 | Rake $0 
Seat 1: HubertusB (button) collected ($0.12)
Seat 2: Tustik (small blind) folded before Flop
Seat 3: Bane91 (big blind) folded before Flop
Seat 4: -Z3RO_DAY- folded before Flop (didn't bet)
Seat 5: 111si@v@111 folded before Flop (didn't bet)
Seat 6: volodymyr546 folded before Flop (didn't bet)



PokerStars Zoom Hand #186648306737:  Hold'em No Limit ($0.02/$0.05) - 2018/05/20 22:43:48 CCT [2018/05/20 10:43:48 ET]
Table 'Donati' 6-max Seat #1 is the button
Seat 1: KR4TT ($5.99 in chips) 
Seat 2: HubertusB ($2.85 in chips) 
Seat 3: Karlyvzla27 ($2.51 in chips) 
Seat 4: Elch14 ($5 in chips) 
Seat 5: Batsman.RI ($3.13 in chips) 
Seat 6: JohnnyZero3 ($5.54 in chips) 
HubertusB: posts small blind $0.02
Karlyvzla27: posts big blind $0.05
*** HOLE CARDS ***
Dealt to HubertusB [8d Tc]
Elch14: folds 
Batsman.RI: raises $0.10 to $0.15
JohnnyZero3: folds 
KR4TT: folds 
HubertusB: folds 
Karlyvzla27: calls $0.10
*** FLOP *** [Jh 6d 6h]
Karlyvzla27: checks 
Batsman.RI: bets $0.10
Karlyvzla27: calls $0.10
*** TURN *** [Jh 6d 6h] [Td]
Karlyvzla27: checks 
Batsman.RI: bets $0.10
Karlyvzla27: raises $0.40 to $0.50
Batsman.RI: folds 
Uncalled bet ($0.40) returned to Karlyvzla27
Karlyvzla27 collected $0.69 from pot
Karlyvzla27: doesn't show hand 
*** SUMMARY ***
Total pot $0.72 | Rake $0.03 
Board [Jh 6d 6h Td]
Seat 1: KR4TT (button) folded before Flop (didn't bet)
Seat 2: HubertusB (small blind) folded before Flop
Seat 3: Karlyvzla27 (big blind) collected ($0.69)
Seat 4: Elch14 folded before Flop (didn't bet)
Seat 5: Batsman.RI folded on the Turn
Seat 6: JohnnyZero3 folded before Flop (didn't bet)



PokerStars Zoom Hand #186648327996:  Hold'em No Limit ($0.02/$0.05) - 2018/05/20 22:44:21 CCT [2018/05/20 10:44:21 ET]
Table 'Donati' 6-max Seat #1 is the button
Seat 1: porter551 ($5.12 in chips) 
Seat 2: luka1981good ($5.40 in chips) 
Seat 3: HubertusB ($2.90 in chips) 
Seat 4: AndreyK11 ($5 in chips) 
Seat 5: maks00743 ($2.05 in chips) 
Seat 6: TalksAlot86 ($2.24 in chips) 
luka1981good: posts small blind $0.02
HubertusB: posts big blind $0.05
*** HOLE CARDS ***
Dealt to HubertusB [8h 6s]
AndreyK11: folds 
maks00743: folds 
TalksAlot86: folds 
porter551: folds 
luka1981good: folds 
Uncalled bet ($0.03) returned to HubertusB
HubertusB collected $0.04 from pot
HubertusB: doesn't show hand 
*** SUMMARY ***
Total pot $0.04 | Rake $0 
Seat 1: porter551 (button) folded before Flop (didn't bet)
Seat 2: luka1981good (small blind) folded before Flop
Seat 3: HubertusB (big blind) collected ($0.04)
Seat 4: AndreyK11 folded before Flop (didn't bet)
Seat 5: maks00743 folded before Flop (didn't bet)
Seat 6: TalksAlot86 folded before Flop (didn't bet)



PokerStars Zoom Hand #186648333038:  Hold'em No Limit ($0.02/$0.05) - 2018/05/20 22:44:29 CCT [2018/05/20 10:44:29 ET]
Table 'Donati' 6-max Seat #1 is the button
Seat 1: Only_Vizard ($5 in chips) 
Seat 2: AbraRoy ($17.72 in chips) 
Seat 3: PVKMSSSSR ($5.43 in chips) 
Seat 4: MetaTrader4 ($5 in chips) 
Seat 5: Chunichi ($9.72 in chips) 
Seat 6: HubertusB ($2.92 in chips) 
AbraRoy: posts small blind $0.02
PVKMSSSSR: posts big blind $0.05
*** HOLE CARDS ***
Dealt to HubertusB [2d Ad]
MetaTrader4: folds 
Chunichi: folds 
HubertusB: raises $0.05 to $0.10
Only_Vizard: raises $0.25 to $0.35
AbraRoy: folds 
PVKMSSSSR: folds 
HubertusB: folds 
Uncalled bet ($0.25) returned to Only_Vizard
Only_Vizard collected $0.27 from pot
Only_Vizard: doesn't show hand 
*** SUMMARY ***
Total pot $0.27 | Rake $0 
Seat 1: Only_Vizard (button) collected ($0.27)
Seat 2: AbraRoy (small blind) folded before Flop
Seat 3: PVKMSSSSR (big blind) folded before Flop
Seat 4: MetaTrader4 folded before Flop (didn't bet)
Seat 5: Chunichi folded before Flop (didn't bet)
Seat 6: HubertusB folded before Flop



PokerStars Zoom Hand #186648342013:  Hold'em No Limit ($0.02/$0.05) - 2018/05/20 22:44:43 CCT [2018/05/20 10:44:43 ET]
Table 'Donati' 6-max Seat #1 is the button
Seat 1: ellvis82 ($5 in chips) 
Seat 2: HubertusB ($2.82 in chips) 
Seat 3: ivan 1987465 ($6.56 in chips) 
Seat 4: VoneRT ($5 in chips) 
Seat 5: kingreigns ($9.85 in chips) 
Seat 6: Chinga4kuk ($5.07 in chips) 
HubertusB: posts small blind $0.02
ivan 1987465: posts big blind $0.05
*** HOLE CARDS ***
Dealt to HubertusB [4s 9h]
VoneRT: folds 
kingreigns: raises $0.10 to $0.15
Chinga4kuk: folds 
ellvis82: folds 
HubertusB: folds 
ivan 1987465: folds 
Uncalled bet ($0.10) returned to kingreigns
kingreigns collected $0.12 from pot
kingreigns: doesn't show hand 
*** SUMMARY ***
Total pot $0.12 | Rake $0 
Seat 1: ellvis82 (button) folded before Flop (didn't bet)
Seat 2: HubertusB (small blind) folded before Flop
Seat 3: ivan 1987465 (big blind) folded before Flop
Seat 4: VoneRT folded before Flop (didn't bet)
Seat 5: kingreigns collected ($0.12)
Seat 6: Chinga4kuk folded before Flop (didn't bet)



PokerStars Zoom Hand #186648350292:  Hold'em No Limit ($0.02/$0.05) - 2018/05/20 22:44:56 CCT [2018/05/20 10:44:56 ET]
Table 'Donati' 6-max Seat #1 is the button
Seat 1: kranovoy22 ($5 in chips) 
Seat 2: BeatLimits ($5.15 in chips) 
Seat 3: qwer9019 ($17.34 in chips) 
Seat 4: XXXiao ($7.56 in chips) 
Seat 5: Andranik23ru ($2.98 in chips) 
Seat 6: HubertusB ($2.80 in chips) 
BeatLimits: posts small blind $0.02
qwer9019: posts big blind $0.05
*** HOLE CARDS ***
Dealt to HubertusB [3s 8d]
XXXiao: folds 
Andranik23ru: folds 
HubertusB: folds 
kranovoy22: folds 
BeatLimits: folds 
Uncalled bet ($0.03) returned to qwer9019
qwer9019 collected $0.04 from pot
qwer9019: doesn't show hand 
*** SUMMARY ***
Total pot $0.04 | Rake $0 
Seat 1: kranovoy22 (button) folded before Flop (didn't bet)
Seat 2: BeatLimits (small blind) folded before Flop
Seat 3: qwer9019 (big blind) collected ($0.04)
Seat 4: XXXiao folded before Flop (didn't bet)
Seat 5: Andranik23ru folded before Flop (didn't bet)
Seat 6: HubertusB folded before Flop (didn't bet)



PokerStars Zoom Hand #186648345168:  Hold'em No Limit ($0.02/$0.05) - 2018/05/20 22:44:48 CCT [2018/05/20 10:44:48 ET]
Table 'Donati' 6-max Seat #1 is the button
Seat 1: HubertusB ($2.80 in chips) 
Seat 2: derak488 ($5.03 in chips) 
Seat 3: MetaTrader4 ($5 in chips) 
Seat 4: Alekskey777 ($4.15 in chips) 
Seat 5: 720gramm ($8.59 in chips) 
Seat 6: AbraRoy ($9.86 in chips) 
derak488: posts small blind $0.02
MetaTrader4: posts big blind $0.05
*** HOLE CARDS ***
Dealt to HubertusB [4d Ac]
Alekskey777: folds 
720gramm: folds 
AbraRoy: raises $0.07 to $0.12
HubertusB: folds 
derak488: folds 
MetaTrader4: raises $0.28 to $0.40
AbraRoy: calls $0.28
*** FLOP *** [6c Td 7h]
MetaTrader4: checks 
AbraRoy: bets $0.28
MetaTrader4: calls $0.28
*** TURN *** [6c Td 7h] [5d]
MetaTrader4: checks 
AbraRoy: bets $0.50
MetaTrader4: folds 
Uncalled bet ($0.50) returned to AbraRoy
AbraRoy collected $1.32 from pot
AbraRoy: doesn't show hand 
*** SUMMARY ***
Total pot $1.38 | Rake $0.06 
Board [6c Td 7h 5d]
Seat 1: HubertusB (button) folded before Flop (didn't bet)
Seat 2: derak488 (small blind) folded before Flop
Seat 3: MetaTrader4 (big blind) folded on the Turn
Seat 4: Alekskey777 folded before Flop (didn't bet)
Seat 5: 720gramm folded before Flop (didn't bet)
Seat 6: AbraRoy collected ($1.32)



PokerStars Zoom Hand #186648354280:  Hold'em No Limit ($0.02/$0.05) - 2018/05/20 22:45:02 CCT [2018/05/20 10:45:02 ET]
Table 'Donati' 6-max Seat #1 is the button
Seat 1: Siorassc ($6.08 in chips) 
Seat 2: cesarmike1 ($6.30 in chips) 
Seat 3: Krawicz ($5 in chips) 
Seat 4: zwetok ($5 in chips) 
Seat 5: HubertusB ($2.80 in chips) 
Seat 6: dImon0688 ($4.07 in chips) 
cesarmike1: posts small blind $0.02
Krawicz: posts big blind $0.05
*** HOLE CARDS ***
Dealt to HubertusB [9s 9h]
zwetok: raises $0.06 to $0.11
HubertusB: calls $0.11
dImon0688: calls $0.11
Siorassc: folds 
cesarmike1: folds 
Krawicz: folds 
*** FLOP *** [7c Kd 3c]
zwetok: checks 
HubertusB: bets $0.20
dImon0688: calls $0.20
zwetok: calls $0.20
*** TURN *** [7c Kd 3c] [Td]
zwetok: checks 
HubertusB: checks 
dImon0688: checks 
*** RIVER *** [7c Kd 3c Td] [Ts]
zwetok: checks 
HubertusB: checks 
dImon0688: bets $0.25
zwetok: calls $0.25
HubertusB: folds 
*** SHOW DOWN ***
dImon0688: shows [6c 8c] (a pair of Tens)
zwetok: shows [8d 7d] (two pair, Tens and Sevens)
zwetok collected $1.44 from pot
*** SUMMARY ***
Total pot $1.50 | Rake $0.06 
Board [7c Kd 3c Td Ts]
Seat 1: Siorassc (button) folded before Flop (didn't bet)
Seat 2: cesarmike1 (small blind) folded before Flop
Seat 3: Krawicz (big blind) folded before Flop
Seat 4: zwetok showed [8d 7d] and won ($1.44) with two pair, Tens and Sevens
Seat 5: HubertusB folded on the River
Seat 6: dImon0688 showed [6c 8c] and lost with a pair of Tens



PokerStars Zoom Hand #186648386876:  Hold'em No Limit ($0.02/$0.05) - 2018/05/20 22:45:53 CCT [2018/05/20 10:45:53 ET]
Table 'Donati' 6-max Seat #1 is the button
Seat 1: rtyh2003 ($5.23 in chips) 
Seat 2: zazaz1977 ($2.10 in chips) 
Seat 3: Rainmy ($5 in chips) 
Seat 4: HubertusB ($2.49 in chips) 
Seat 5: KALEEL.NZ ($13.88 in chips) 
Seat 6: sshan ($5.07 in chips) 
zazaz1977: posts small blind $0.02
Rainmy: posts big blind $0.05
*** HOLE CARDS ***
Dealt to HubertusB [2s Kc]
HubertusB: folds 
KALEEL.NZ: folds 
sshan: folds 
rtyh2003: folds 
zazaz1977: folds 
Uncalled bet ($0.03) returned to Rainmy
Rainmy collected $0.04 from pot
Rainmy: doesn't show hand 
*** SUMMARY ***
Total pot $0.04 | Rake $0 
Seat 1: rtyh2003 (button) folded before Flop (didn't bet)
Seat 2: zazaz1977 (small blind) folded before Flop
Seat 3: Rainmy (big blind) collected ($0.04)
Seat 4: HubertusB folded before Flop (didn't bet)
Seat 5: KALEEL.NZ folded before Flop (didn't bet)
Seat 6: sshan folded before Flop (didn't bet)



PokerStars Zoom Hand #186648390101:  Hold'em No Limit ($0.02/$0.05) - 2018/05/20 22:45:58 CCT [2018/05/20 10:45:58 ET]
Table 'Donati' 6-max Seat #1 is the button
Seat 1: p0kerbob ($5.51 in chips) 
Seat 2: Fish @ China ($6.04 in chips) 
Seat 3: HubertusB ($2.49 in chips) 
Seat 4: Andrew_Enix ($4.54 in chips) 
Seat 5: JohnnyZero3 ($5.18 in chips) 
Seat 6: NomercY85 ($8.03 in chips) 
Fish @ China: posts small blind $0.02
HubertusB: posts big blind $0.05
*** HOLE CARDS ***
Dealt to HubertusB [Js 6c]
Andrew_Enix: folds 
JohnnyZero3: folds 
NomercY85: folds 
p0kerbob: folds 
Fish @ China: folds 
Uncalled bet ($0.03) returned to HubertusB
HubertusB collected $0.04 from pot
HubertusB: doesn't show hand 
*** SUMMARY ***
Total pot $0.04 | Rake $0 
Seat 1: p0kerbob (button) folded before Flop (didn't bet)
Seat 2: Fish @ China (small blind) folded before Flop
Seat 3: HubertusB (big blind) collected ($0.04)
Seat 4: Andrew_Enix folded before Flop (didn't bet)
Seat 5: JohnnyZero3 folded before Flop (didn't bet)
Seat 6: NomercY85 folded before Flop (didn't bet)



PokerStars Zoom Hand #186648408035:  Hold'em No Limit ($0.02/$0.05) - 2018/05/20 22:46:26 CCT [2018/05/20 10:46:26 ET]
Table 'Donati' 6-max Seat #1 is the button
Seat 1: HubertusB ($2.51 in chips) 
Seat 2: ivan 1987465 ($6.95 in chips) 
Seat 3: FWRWest ($4.16 in chips) 
Seat 4: chips010 ($5.10 in chips) 
Seat 5: Naosky ($6.46 in chips) 
Seat 6: Kaizenja ($3.93 in chips) 
ivan 1987465: posts small blind $0.02
FWRWest: posts big blind $0.05
*** HOLE CARDS ***
Dealt to HubertusB [Th 4d]
chips010: folds 
Naosky: folds 
Kaizenja: folds 
HubertusB: folds 
ivan 1987465: folds 
Uncalled bet ($0.03) returned to FWRWest
FWRWest collected $0.04 from pot
FWRWest: doesn't show hand 
*** SUMMARY ***
Total pot $0.04 | Rake $0 
Seat 1: HubertusB (button) folded before Flop (didn't bet)
Seat 2: ivan 1987465 (small blind) folded before Flop
Seat 3: FWRWest (big blind) collected ($0.04)
Seat 4: chips010 folded before Flop (didn't bet)
Seat 5: Naosky folded before Flop (didn't bet)
Seat 6: Kaizenja folded before Flop (didn't bet)



PokerStars Zoom Hand #186648404741:  Hold'em No Limit ($0.02/$0.05) - 2018/05/20 22:46:21 CCT [2018/05/20 10:46:21 ET]
Table 'Donati' 6-max Seat #1 is the button
Seat 1: joop119 ($5.75 in chips) 
Seat 2: LeetSkilz ($5.25 in chips) 
Seat 3: sollgewinnen ($3.17 in chips) 
Seat 4: HubertusB ($2.51 in chips) 
Seat 5: hitomi111 ($7.98 in chips) 
Seat 6: falcao991 ($17.72 in chips) 
LeetSkilz: posts small blind $0.02
sollgewinnen: posts big blind $0.05
*** HOLE CARDS ***
Dealt to HubertusB [Jh 7s]
HubertusB: folds 
hitomi111: raises $0.10 to $0.15
falcao991: folds 
joop119: raises $0.30 to $0.45
LeetSkilz: folds 
sollgewinnen: calls $0.40
hitomi111: folds 
*** FLOP *** [Ks Ts 6s]
sollgewinnen: bets $0.05
joop119: folds 
Uncalled bet ($0.05) returned to sollgewinnen
sollgewinnen collected $1.03 from pot
sollgewinnen: doesn't show hand 
*** SUMMARY ***
Total pot $1.07 | Rake $0.04 
Board [Ks Ts 6s]
Seat 1: joop119 (button) folded on the Flop
Seat 2: LeetSkilz (small blind) folded before Flop
Seat 3: sollgewinnen (big blind) collected ($1.03)
Seat 4: HubertusB folded before Flop (didn't bet)
Seat 5: hitomi111 folded before Flop
Seat 6: falcao991 folded before Flop (didn't bet)



PokerStars Zoom Hand #186648411947:  Hold'em No Limit ($0.02/$0.05) - 2018/05/20 22:46:32 CCT [2018/05/20 10:46:32 ET]
Table 'Donati' 6-max Seat #1 is the button
Seat 1: class29 ($5.59 in chips) 
Seat 2: pokerwayne6 ($4.65 in chips) 
Seat 3: NomercY85 ($9.74 in chips) 
Seat 4: an2004 ($16.26 in chips) 
Seat 5: HubertusB ($2.51 in chips) 
Seat 6: Urisdep ($7.89 in chips) 
pokerwayne6: posts small blind $0.02
NomercY85: posts big blind $0.05
*** HOLE CARDS ***
Dealt to HubertusB [4c 2h]
an2004: folds 
HubertusB: folds 
Urisdep: folds 
class29: raises $0.07 to $0.12
pokerwayne6: calls $0.10
NomercY85: folds 
*** FLOP *** [Kd Qh Qd]
pokerwayne6: checks 
class29: checks 
*** TURN *** [Kd Qh Qd] [6d]
pokerwayne6: bets $0.30
class29: folds 
Uncalled bet ($0.30) returned to pokerwayne6
pokerwayne6 collected $0.28 from pot
pokerwayne6: doesn't show hand 
*** SUMMARY ***
Total pot $0.29 | Rake $0.01 
Board [Kd Qh Qd 6d]
Seat 1: class29 (button) folded on the Turn
Seat 2: pokerwayne6 (small blind) collected ($0.28)
Seat 3: NomercY85 (big blind) folded before Flop
Seat 4: an2004 folded before Flop (didn't bet)
Seat 5: HubertusB folded before Flop (didn't bet)
Seat 6: Urisdep folded before Flop (didn't bet)



PokerStars Zoom Hand #186648415172:  Hold'em No Limit ($0.02/$0.05) - 2018/05/20 22:46:37 CCT [2018/05/20 10:46:37 ET]
Table 'Donati' 6-max Seat #1 is the button
Seat 1: stakoms82 ($15.03 in chips) 
Seat 2: HubertusB ($2.51 in chips) 
Seat 3: NomercY85 ($6.62 in chips) 
Seat 4: an2004 ($16.26 in chips) 
Seat 5: Egozocker ($6.37 in chips) 
Seat 6: zazaz1977 ($5.57 in chips) 
HubertusB: posts small blind $0.02
NomercY85: posts big blind $0.05
*** HOLE CARDS ***
Dealt to HubertusB [Kc 2h]
an2004: folds 
Egozocker: folds 
zazaz1977: folds 
stakoms82: raises $0.05 to $0.10
HubertusB: folds 
NomercY85: calls $0.05
*** FLOP *** [Ah Jh 4h]
NomercY85: checks 
stakoms82: bets $0.15
NomercY85: folds 
Uncalled bet ($0.15) returned to stakoms82
stakoms82 collected $0.21 from pot
stakoms82: doesn't show hand 
*** SUMMARY ***
Total pot $0.22 | Rake $0.01 
Board [Ah Jh 4h]
Seat 1: stakoms82 (button) collected ($0.21)
Seat 2: HubertusB (small blind) folded before Flop
Seat 3: NomercY85 (big blind) folded on the Flop
Seat 4: an2004 folded before Flop (didn't bet)
Seat 5: Egozocker folded before Flop (didn't bet)
Seat 6: zazaz1977 folded before Flop (didn't bet)



PokerStars Zoom Hand #186648422269:  Hold'em No Limit ($0.02/$0.05) - 2018/05/20 22:46:48 CCT [2018/05/20 10:46:48 ET]
Table 'Donati' 6-max Seat #1 is the button
Seat 1: an2004 ($4.03 in chips) 
Seat 2: Tustik ($7.54 in chips) 
Seat 3: geass0621 ($5.56 in chips) 
Seat 4: Blackantz ($5.80 in chips) 
Seat 5: whoisdurrrrr ($5.07 in chips) 
Seat 6: HubertusB ($2.49 in chips) 
Tustik: posts small blind $0.02
geass0621: posts big blind $0.05
*** HOLE CARDS ***
Dealt to HubertusB [4s 2c]
Blackantz: folds 
whoisdurrrrr: folds 
HubertusB: folds 
an2004: folds 
Tustik: folds 
Uncalled bet ($0.03) returned to geass0621
geass0621 collected $0.04 from pot
geass0621: doesn't show hand 
*** SUMMARY ***
Total pot $0.04 | Rake $0 
Seat 1: an2004 (button) folded before Flop (didn't bet)
Seat 2: Tustik (small blind) folded before Flop
Seat 3: geass0621 (big blind) collected ($0.04)
Seat 4: Blackantz folded before Flop (didn't bet)
Seat 5: whoisdurrrrr folded before Flop (didn't bet)
Seat 6: HubertusB folded before Flop (didn't bet)



PokerStars Zoom Hand #186648418348:  Hold'em No Limit ($0.02/$0.05) - 2018/05/20 22:46:42 CCT [2018/05/20 10:46:42 ET]
Table 'Donati' 6-max Seat #1 is the button
Seat 1: dato5557 ($3.61 in chips) 
Seat 2: SpurenIeger ($0.88 in chips) 
Seat 3: grzywekkk ($5.63 in chips) 
Seat 4: HubertusB ($2.49 in chips) 
Seat 5: kickupduster ($5.46 in chips) 
Seat 6: Guitarzan00 ($5 in chips) 
SpurenIeger: posts small blind $0.02
grzywekkk: posts big blind $0.05
*** HOLE CARDS ***
Dealt to HubertusB [6s 9c]
HubertusB: folds 
kickupduster: folds 
Guitarzan00: raises $0.07 to $0.12
dato5557: folds 
SpurenIeger: folds 
grzywekkk: calls $0.07
*** FLOP *** [9s 4d Tc]
grzywekkk: checks 
Guitarzan00: checks 
*** TURN *** [9s 4d Tc] [Js]
grzywekkk: bets $0.19
Guitarzan00: calls $0.19
*** RIVER *** [9s 4d Tc Js] [Jd]
grzywekkk: bets $0.40
Guitarzan00: folds 
Uncalled bet ($0.40) returned to grzywekkk
grzywekkk collected $0.61 from pot
grzywekkk: doesn't show hand 
*** SUMMARY ***
Total pot $0.64 | Rake $0.03 
Board [9s 4d Tc Js Jd]
Seat 1: dato5557 (button) folded before Flop (didn't bet)
Seat 2: SpurenIeger (small blind) folded before Flop
Seat 3: grzywekkk (big blind) collected ($0.61)
Seat 4: HubertusB folded before Flop (didn't bet)
Seat 5: kickupduster folded before Flop (didn't bet)
Seat 6: Guitarzan00 folded on the River



PokerStars Zoom Hand #186648428089:  Hold'em No Limit ($0.02/$0.05) - 2018/05/20 22:46:57 CCT [2018/05/20 10:46:57 ET]
Table 'Donati' 6-max Seat #1 is the button
Seat 1: lasyboy999 ($5.02 in chips) 
Seat 2: JohnnyZero3 ($5.13 in chips) 
Seat 3: HubertusB ($2.49 in chips) 
Seat 4: Molesterx ($5.27 in chips) 
Seat 5: Shalev7 ($5.18 in chips) 
Seat 6: aleks kyh ($7.68 in chips) 
JohnnyZero3: posts small blind $0.02
HubertusB: posts big blind $0.05
*** HOLE CARDS ***
Dealt to HubertusB [7h 6h]
Molesterx: folds 
Shalev7: raises $0.10 to $0.15
aleks kyh: folds 
lasyboy999: folds 
JohnnyZero3: folds 
HubertusB: raises $0.40 to $0.55
Shalev7: calls $0.40
*** FLOP *** [8h Qs As]
HubertusB: bets $0.60
Shalev7: calls $0.60
*** TURN *** [8h Qs As] [7d]
HubertusB: checks 
Shalev7: checks 
*** RIVER *** [8h Qs As 7d] [2c]
HubertusB: checks 
Shalev7: bets $4.03 and is all-in
HubertusB: folds 
Uncalled bet ($4.03) returned to Shalev7
Shalev7 collected $2.22 from pot
Shalev7: doesn't show hand 
*** SUMMARY ***
Total pot $2.32 | Rake $0.10 
Board [8h Qs As 7d 2c]
Seat 1: lasyboy999 (button) folded before Flop (didn't bet)
Seat 2: JohnnyZero3 (small blind) folded before Flop
Seat 3: HubertusB (big blind) folded on the River
Seat 4: Molesterx folded before Flop (didn't bet)
Seat 5: Shalev7 collected ($2.22)
Seat 6: aleks kyh folded before Flop (didn't bet)



PokerStars Zoom Hand #186648455650:  Hold'em No Limit ($0.02/$0.05) - 2018/05/20 22:47:40 CCT [2018/05/20 10:47:40 ET]
Table 'Donati' 6-max Seat #1 is the button
Seat 1: t123t684 ($5 in chips) 
Seat 2: xxx1114 ($2.86 in chips) 
Seat 3: stakoms82 ($15.07 in chips) 
Seat 4: Kenichi Liu ($5.15 in chips) 
Seat 5: HubertusB ($1.34 in chips) 
Seat 6: OsloVest ($9.08 in chips) 
xxx1114: posts small blind $0.02
stakoms82: posts big blind $0.05
*** HOLE CARDS ***
Dealt to HubertusB [4c 2d]
Kenichi Liu: folds 
HubertusB: folds 
OsloVest: folds 
t123t684: folds 
xxx1114: raises $2.81 to $2.86 and is all-in
stakoms82: folds 
Uncalled bet ($2.81) returned to xxx1114
xxx1114 collected $0.10 from pot
xxx1114: doesn't show hand 
*** SUMMARY ***
Total pot $0.10 | Rake $0 
Seat 1: t123t684 (button) folded before Flop (didn't bet)
Seat 2: xxx1114 (small blind) collected ($0.10)
Seat 3: stakoms82 (big blind) folded before Flop
Seat 4: Kenichi Liu folded before Flop (didn't bet)
Seat 5: HubertusB folded before Flop (didn't bet)
Seat 6: OsloVest folded before Flop (didn't bet)



PokerStars Zoom Hand #186648462617:  Hold'em No Limit ($0.02/$0.05) - 2018/05/20 22:47:51 CCT [2018/05/20 10:47:51 ET]
Table 'Donati' 6-max Seat #1 is the button
Seat 1: HubertusB ($1.32 in chips) 
Seat 2: Pityu9966 ($2.25 in chips) 
Seat 3: lzoflamingo ($8.79 in chips) 
Seat 4: UltraRunnerr ($5.92 in chips) 
Seat 5: djon023rus ($6.29 in chips) 
Seat 6: slob43.ru ($4.83 in chips) 
Pityu9966: posts small blind $0.02
lzoflamingo: posts big blind $0.05
*** HOLE CARDS ***
Dealt to HubertusB [Ah Qd]
UltraRunnerr: folds 
djon023rus: folds 
slob43.ru: folds 
HubertusB: raises $0.10 to $0.15
Pityu9966: folds 
lzoflamingo: folds 
Uncalled bet ($0.10) returned to HubertusB
HubertusB collected $0.12 from pot
HubertusB: doesn't show hand 
*** SUMMARY ***
Total pot $0.12 | Rake $0 
Seat 1: HubertusB (button) collected ($0.12)
Seat 2: Pityu9966 (small blind) folded before Flop
Seat 3: lzoflamingo (big blind) folded before Flop
Seat 4: UltraRunnerr folded before Flop (didn't bet)
Seat 5: djon023rus folded before Flop (didn't bet)
Seat 6: slob43.ru folded before Flop (didn't bet)



PokerStars Zoom Hand #186648469731:  Hold'em No Limit ($0.02/$0.05) - 2018/05/20 22:48:02 CCT [2018/05/20 10:48:02 ET]
Table 'Donati' 6-max Seat #1 is the button
Seat 1: incorrect88 ($19.24 in chips) 
Seat 2: dimasps12 ($7.77 in chips) 
Seat 3: JohnnyZero3 ($5.55 in chips) 
Seat 4: HubertusB ($1.39 in chips) 
Seat 5: falcao991 ($10.19 in chips) 
Seat 6: tanutarou ($5.60 in chips) 
dimasps12: posts small blind $0.02
JohnnyZero3: posts big blind $0.05
*** HOLE CARDS ***
Dealt to HubertusB [Jd 8d]
HubertusB: raises $0.10 to $0.15
falcao991: folds 
tanutarou: folds 
incorrect88: folds 
dimasps12: folds 
JohnnyZero3: folds 
Uncalled bet ($0.10) returned to HubertusB
HubertusB collected $0.12 from pot
HubertusB: doesn't show hand 
*** SUMMARY ***
Total pot $0.12 | Rake $0 
Seat 1: incorrect88 (button) folded before Flop (didn't bet)
Seat 2: dimasps12 (small blind) folded before Flop
Seat 3: JohnnyZero3 (big blind) folded before Flop
Seat 4: HubertusB collected ($0.12)
Seat 5: falcao991 folded before Flop (didn't bet)
Seat 6: tanutarou folded before Flop (didn't bet)



PokerStars Zoom Hand #186648459424:  Hold'em No Limit ($0.02/$0.05) - 2018/05/20 22:47:46 CCT [2018/05/20 10:47:46 ET]
Table 'Donati' 6-max Seat #1 is the button
Seat 1: ghost1que ($7.26 in chips) 
Seat 2: HubertusB ($1.34 in chips) 
Seat 3: Kenichi Liu ($5.15 in chips) 
Seat 4: 30NIKI30 ($6.28 in chips) 
Seat 5: slob43.ru ($4.83 in chips) 
Seat 6: Mr. Roquim ($5.93 in chips) 
HubertusB: posts small blind $0.02
Kenichi Liu: posts big blind $0.05
*** HOLE CARDS ***
Dealt to HubertusB [Qd 3d]
30NIKI30: folds 
slob43.ru: folds 
Mr. Roquim: raises $0.10 to $0.15
ghost1que: folds 
HubertusB: folds 
Kenichi Liu: calls $0.10
*** FLOP *** [3s 8c 3h]
Kenichi Liu: checks 
Mr. Roquim: bets $0.10
Kenichi Liu: folds 
Uncalled bet ($0.10) returned to Mr. Roquim
Mr. Roquim collected $0.31 from pot
Mr. Roquim: doesn't show hand 
*** SUMMARY ***
Total pot $0.32 | Rake $0.01 
Board [3s 8c 3h]
Seat 1: ghost1que (button) folded before Flop (didn't bet)
Seat 2: HubertusB (small blind) folded before Flop
Seat 3: Kenichi Liu (big blind) folded on the Flop
Seat 4: 30NIKI30 folded before Flop (didn't bet)
Seat 5: slob43.ru folded before Flop (didn't bet)
Seat 6: Mr. Roquim collected ($0.31)



PokerStars Zoom Hand #186648477336:  Hold'em No Limit ($0.02/$0.05) - 2018/05/20 22:48:14 CCT [2018/05/20 10:48:14 ET]
Table 'Donati' 6-max Seat #1 is the button
Seat 1: schnubbiAA ($8.53 in chips) 
Seat 2: UNO.228 ($5.37 in chips) 
Seat 3: HubertusB ($1.46 in chips) 
Seat 4: falcao991 ($10.19 in chips) 
Seat 5: OsloVest ($5.62 in chips) 
Seat 6: metalblack ($8.48 in chips) 
UNO.228: posts small blind $0.02
HubertusB: posts big blind $0.05
*** HOLE CARDS ***
Dealt to HubertusB [4d 5c]
falcao991: folds 
OsloVest: folds 
metalblack: folds 
schnubbiAA: folds 
UNO.228: folds 
Uncalled bet ($0.03) returned to HubertusB
HubertusB collected $0.04 from pot
HubertusB: doesn't show hand 
*** SUMMARY ***
Total pot $0.04 | Rake $0 
Seat 1: schnubbiAA (button) folded before Flop (didn't bet)
Seat 2: UNO.228 (small blind) folded before Flop
Seat 3: HubertusB (big blind) collected ($0.04)
Seat 4: falcao991 folded before Flop (didn't bet)
Seat 5: OsloVest folded before Flop (didn't bet)
Seat 6: metalblack folded before Flop (didn't bet)



PokerStars Zoom Hand #186648483073:  Hold'em No Limit ($0.02/$0.05) - 2018/05/20 22:48:23 CCT [2018/05/20 10:48:23 ET]
Table 'Donati' 6-max Seat #1 is the button
Seat 1: HubertusB ($1.48 in chips) 
Seat 2: hellhippo ($5.02 in chips) 
Seat 3: Daemon'sKiss ($6.08 in chips) 
Seat 4: aberrational ($5 in chips) 
Seat 5: fahundes ($1.37 in chips) 
Seat 6: Savavlad97 ($5.83 in chips) 
hellhippo: posts small blind $0.02
Daemon'sKiss: posts big blind $0.05
*** HOLE CARDS ***
Dealt to HubertusB [As Ac]
aberrational: raises $0.10 to $0.15
fahundes: folds 
Savavlad97: calls $0.15
HubertusB: raises $1.33 to $1.48 and is all-in
hellhippo: folds 
Daemon'sKiss: folds 
aberrational: calls $1.33
Savavlad97: folds 
*** FLOP *** [3h Jd 4d]
*** TURN *** [3h Jd 4d] [Ts]
*** RIVER *** [3h Jd 4d Ts] [Ah]
*** SHOW DOWN ***
aberrational: shows [Td Th] (three of a kind, Tens)
HubertusB: shows [As Ac] (three of a kind, Aces)
HubertusB collected $3.05 from pot
*** SUMMARY ***
Total pot $3.18 | Rake $0.13 
Board [3h Jd 4d Ts Ah]
Seat 1: HubertusB (button) showed [As Ac] and won ($3.05) with three of a kind, Aces
Seat 2: hellhippo (small blind) folded before Flop
Seat 3: Daemon'sKiss (big blind) folded before Flop
Seat 4: aberrational showed [Td Th] and lost with three of a kind, Tens
Seat 5: fahundes folded before Flop (didn't bet)
Seat 6: Savavlad97 folded before Flop



PokerStars Zoom Hand #186648502759:  Hold'em No Limit ($0.02/$0.05) - 2018/05/20 22:48:54 CCT [2018/05/20 10:48:54 ET]
Table 'Donati' 6-max Seat #1 is the button
Seat 1: sityu8411 ($6.56 in chips) 
Seat 2: lasyboy999 ($5.22 in chips) 
Seat 3: MetaTrader4 ($6.17 in chips) 
Seat 4: CallMeBunny ($2.35 in chips) 
Seat 5: zazaz1977 ($5.74 in chips) 
Seat 6: HubertusB ($3.05 in chips) 
lasyboy999: posts small blind $0.02
MetaTrader4: posts big blind $0.05
*** HOLE CARDS ***
Dealt to HubertusB [Kh 5d]
CallMeBunny: folds 
zazaz1977: raises $0.10 to $0.15
HubertusB: folds 
sityu8411: folds 
lasyboy999: folds 
MetaTrader4: folds 
Uncalled bet ($0.10) returned to zazaz1977
zazaz1977 collected $0.12 from pot
zazaz1977: doesn't show hand 
*** SUMMARY ***
Total pot $0.12 | Rake $0 
Seat 1: sityu8411 (button) folded before Flop (didn't bet)
Seat 2: lasyboy999 (small blind) folded before Flop
Seat 3: MetaTrader4 (big blind) folded before Flop
Seat 4: CallMeBunny folded before Flop (didn't bet)
Seat 5: zazaz1977 collected ($0.12)
Seat 6: HubertusB folded before Flop (didn't bet)



PokerStars Zoom Hand #186648506034:  Hold'em No Limit ($0.02/$0.05) - 2018/05/20 22:48:59 CCT [2018/05/20 10:48:59 ET]
Table 'Donati' 6-max Seat #1 is the button
Seat 1: Mr. Roquim ($5.48 in chips) 
Seat 2: HubertusB ($3.05 in chips) 
Seat 3: ivan 1987465 ($6.53 in chips) 
Seat 4: whoisdurrrrr ($5.02 in chips) 
Seat 5: indy179 ($5 in chips) 
Seat 6: geass0621 ($6.06 in chips) 
HubertusB: posts small blind $0.02
ivan 1987465: posts big blind $0.05
*** HOLE CARDS ***
Dealt to HubertusB [9h 7c]
whoisdurrrrr: folds 
indy179: folds 
geass0621: folds 
Mr. Roquim: raises $0.07 to $0.12
HubertusB: folds 
ivan 1987465: folds 
Uncalled bet ($0.07) returned to Mr. Roquim
Mr. Roquim collected $0.12 from pot
Mr. Roquim: doesn't show hand 
*** SUMMARY ***
Total pot $0.12 | Rake $0 
Seat 1: Mr. Roquim (button) collected ($0.12)
Seat 2: HubertusB (small blind) folded before Flop
Seat 3: ivan 1987465 (big blind) folded before Flop
Seat 4: whoisdurrrrr folded before Flop (didn't bet)
Seat 5: indy179 folded before Flop (didn't bet)
Seat 6: geass0621 folded before Flop (didn't bet)



PokerStars Zoom Hand #186648509840:  Hold'em No Limit ($0.02/$0.05) - 2018/05/20 22:49:05 CCT [2018/05/20 10:49:05 ET]
Table 'Donati' 6-max Seat #1 is the button
Seat 1: SRD03 ($6.25 in chips) 
Seat 2: olegkrasnoda ($2 in chips) 
Seat 3: Chunichi ($7.19 in chips) 
Seat 4: sityu8411 ($6.54 in chips) 
Seat 5: HubertusB ($3.03 in chips) 
Seat 6: rdleitao ($5 in chips) 
olegkrasnoda: posts small blind $0.02
Chunichi: posts big blind $0.05
*** HOLE CARDS ***
Dealt to HubertusB [Ts 6s]
sityu8411: folds 
HubertusB: folds 
rdleitao: folds 
SRD03: folds 
olegkrasnoda: raises $0.05 to $0.10
Chunichi: folds 
Uncalled bet ($0.05) returned to olegkrasnoda
olegkrasnoda collected $0.10 from pot
olegkrasnoda: doesn't show hand 
*** SUMMARY ***
Total pot $0.10 | Rake $0 
Seat 1: SRD03 (button) folded before Flop (didn't bet)
Seat 2: olegkrasnoda (small blind) collected ($0.10)
Seat 3: Chunichi (big blind) folded before Flop
Seat 4: sityu8411 folded before Flop (didn't bet)
Seat 5: HubertusB folded before Flop (didn't bet)
Seat 6: rdleitao folded before Flop (didn't bet)



PokerStars Zoom Hand #186648518851:  Hold'em No Limit ($0.02/$0.05) - 2018/05/20 22:49:19 CCT [2018/05/20 10:49:19 ET]
Table 'Donati' 6-max Seat #1 is the button
Seat 1: sajonara666 ($4.83 in chips) 
Seat 2: Fr3dST ($6.43 in chips) 
Seat 3: HubertusB ($3.03 in chips) 
Seat 4: kickupduster ($5 in chips) 
Seat 5: R@Y_01RUS ($5.39 in chips) 
Seat 6: lzoflamingo ($8.78 in chips) 
Fr3dST: posts small blind $0.02
HubertusB: posts big blind $0.05
*** HOLE CARDS ***
Dealt to HubertusB [5d Ad]
kickupduster: folds 
R@Y_01RUS: folds 
lzoflamingo: folds 
sajonara666: folds 
Fr3dST: folds 
Uncalled bet ($0.03) returned to HubertusB
HubertusB collected $0.04 from pot
HubertusB: doesn't show hand 
*** SUMMARY ***
Total pot $0.04 | Rake $0 
Seat 1: sajonara666 (button) folded before Flop (didn't bet)
Seat 2: Fr3dST (small blind) folded before Flop
Seat 3: HubertusB (big blind) collected ($0.04)
Seat 4: kickupduster folded before Flop (didn't bet)
Seat 5: R@Y_01RUS folded before Flop (didn't bet)
Seat 6: lzoflamingo folded before Flop (didn't bet)



