PokerStars Zoom Hand #193803314562:  Hold'em No Limit ($0.01/$0.02) - 2018/11/27 23:55:51 CUST [2018/11/27 10:55:51 ET]
Table 'Halley' 6-max Seat #1 is the button
Seat 1: MarsKarpfen ($2.08 in chips) 
Seat 2: demure2607 ($2.63 in chips) 
Seat 3: hc agorist ($2 in chips) 
Seat 4: mr.taverner ($2.81 in chips) 
Seat 5: ravemaster-z ($2 in chips) 
Seat 6: Lirik0808 ($2.56 in chips) 
demure2607: posts small blind $0.01
hc agorist: posts big blind $0.02
*** HOLE CARDS ***
Dealt to hc agorist [4s As]
mr.taverner: raises $0.03 to $0.05
ravemaster-z: folds 
Lirik0808: folds 
MarsKarpfen: folds 
demure2607: folds 
hc agorist: folds 
Uncalled bet ($0.03) returned to mr.taverner
mr.taverner collected $0.05 from pot
mr.taverner: doesn't show hand 
*** SUMMARY ***
Total pot $0.05 | Rake $0 
Seat 1: MarsKarpfen (button) folded before Flop (didn't bet)
Seat 2: demure2607 (small blind) folded before Flop
Seat 3: hc agorist (big blind) folded before Flop
Seat 4: mr.taverner collected ($0.05)
Seat 5: ravemaster-z folded before Flop (didn't bet)
Seat 6: Lirik0808 folded before Flop (didn't bet)



PokerStars Zoom Hand #193803322838:  Hold'em No Limit ($0.01/$0.02) - 2018/11/27 23:56:10 CUST [2018/11/27 10:56:10 ET]
Table 'Halley' 6-max Seat #1 is the button
Seat 1: hc agorist ($1.98 in chips) 
Seat 2: booktable ($2 in chips) 
Seat 3: ma-tsu-1014 ($10.78 in chips) 
Seat 4: Vanana Roja ($2.19 in chips) 
Seat 5: medicina1992 ($4.28 in chips) 
Seat 6: RIMMM867 ($0.87 in chips) 
booktable: posts small blind $0.01
ma-tsu-1014: posts big blind $0.02
*** HOLE CARDS ***
Dealt to hc agorist [3h 3s]
Vanana Roja: folds 
medicina1992: raises $0.02 to $0.04
RIMMM867: folds 
hc agorist: calls $0.04
booktable: folds 
ma-tsu-1014: folds 
*** FLOP *** [9h 6d 6c]
medicina1992: checks 
hc agorist: bets $0.04
medicina1992: calls $0.04
*** TURN *** [9h 6d 6c] [3d]
medicina1992: checks 
hc agorist: bets $0.36
medicina1992: folds 
Uncalled bet ($0.36) returned to hc agorist
hc agorist collected $0.18 from pot
hc agorist: doesn't show hand 
*** SUMMARY ***
Total pot $0.19 | Rake $0.01 
Board [9h 6d 6c 3d]
Seat 1: hc agorist (button) collected ($0.18)
Seat 2: booktable (small blind) folded before Flop
Seat 3: ma-tsu-1014 (big blind) folded before Flop
Seat 4: Vanana Roja folded before Flop (didn't bet)
Seat 5: medicina1992 folded on the Turn
Seat 6: RIMMM867 folded before Flop (didn't bet)



PokerStars Zoom Hand #193803342473:  Hold'em No Limit ($0.01/$0.02) - 2018/11/27 23:56:55 CUST [2018/11/27 10:56:55 ET]
Table 'Halley' 6-max Seat #1 is the button
Seat 1: simon32.ru ($2.15 in chips) 
Seat 2: hc agorist ($2.08 in chips) 
Seat 3: AAQQQ ($2.03 in chips) 
Seat 4: Exclusive394 ($3.06 in chips) 
Seat 5: zeus11983 ($2.86 in chips) 
Seat 6: tucloze ($0.71 in chips) 
hc agorist: posts small blind $0.01
AAQQQ: posts big blind $0.02
*** HOLE CARDS ***
Dealt to hc agorist [7s 2d]
Exclusive394: folds 
zeus11983: folds 
tucloze: folds 
simon32.ru: folds 
hc agorist: folds 
Uncalled bet ($0.01) returned to AAQQQ
AAQQQ collected $0.02 from pot
AAQQQ: doesn't show hand 
*** SUMMARY ***
Total pot $0.02 | Rake $0 
Seat 1: simon32.ru (button) folded before Flop (didn't bet)
Seat 2: hc agorist (small blind) folded before Flop
Seat 3: AAQQQ (big blind) collected ($0.02)
Seat 4: Exclusive394 folded before Flop (didn't bet)
Seat 5: zeus11983 folded before Flop (didn't bet)
Seat 6: tucloze folded before Flop (didn't bet)



PokerStars Zoom Hand #193803347675:  Hold'em No Limit ($0.01/$0.02) - 2018/11/27 23:57:07 CUST [2018/11/27 10:57:07 ET]
Table 'Halley' 6-max Seat #1 is the button
Seat 1: manmld ($1.88 in chips) 
Seat 2: aquilex2799 ($2.62 in chips) 
Seat 3: Olga Berezina ($2.62 in chips) 
Seat 4: Siyah Horoz ($2 in chips) 
Seat 5: Dialektik330 ($1.64 in chips) 
Seat 6: hc agorist ($2.07 in chips) 
aquilex2799: posts small blind $0.01
Olga Berezina: posts big blind $0.02
*** HOLE CARDS ***
Dealt to hc agorist [4s 4h]
Siyah Horoz: folds 
Dialektik330: raises $0.02 to $0.04
hc agorist: calls $0.04
manmld: folds 
aquilex2799: folds 
Olga Berezina: folds 
*** FLOP *** [3d 6h 8c]
Dialektik330: bets $0.02
hc agorist: calls $0.02
*** TURN *** [3d 6h 8c] [6d]
Dialektik330: bets $0.02
hc agorist: calls $0.02
*** RIVER *** [3d 6h 8c 6d] [Js]
Dialektik330: bets $0.04
hc agorist: calls $0.04
*** SHOW DOWN ***
Dialektik330: shows [Jh Ac] (two pair, Jacks and Sixes)
hc agorist: mucks hand 
Dialektik330 collected $0.26 from pot
*** SUMMARY ***
Total pot $0.27 | Rake $0.01 
Board [3d 6h 8c 6d Js]
Seat 1: manmld (button) folded before Flop (didn't bet)
Seat 2: aquilex2799 (small blind) folded before Flop
Seat 3: Olga Berezina (big blind) folded before Flop
Seat 4: Siyah Horoz folded before Flop (didn't bet)
Seat 5: Dialektik330 showed [Jh Ac] and won ($0.26) with two pair, Jacks and Sixes
Seat 6: hc agorist mucked [4s 4h]



PokerStars Zoom Hand #193803364320:  Hold'em No Limit ($0.01/$0.02) - 2018/11/27 23:57:45 CUST [2018/11/27 10:57:45 ET]
Table 'Halley' 6-max Seat #1 is the button
Seat 1: Makkydae ($2.14 in chips) 
Seat 2: AndreSill ($2.01 in chips) 
Seat 3: AlexGalimov ($2 in chips) 
Seat 4: nikolai55556 ($1.76 in chips) 
Seat 5: hc agorist ($1.95 in chips) 
Seat 6: Fika time! ($2.01 in chips) 
AndreSill: posts small blind $0.01
AlexGalimov: posts big blind $0.02
*** HOLE CARDS ***
Dealt to hc agorist [Td Js]
nikolai55556: raises $0.02 to $0.04
hc agorist: raises $0.11 to $0.15
Fika time!: folds 
Makkydae: folds 
AndreSill: folds 
AlexGalimov: folds 
nikolai55556: folds 
Uncalled bet ($0.11) returned to hc agorist
hc agorist collected $0.11 from pot
hc agorist: doesn't show hand 
*** SUMMARY ***
Total pot $0.11 | Rake $0 
Seat 1: Makkydae (button) folded before Flop (didn't bet)
Seat 2: AndreSill (small blind) folded before Flop
Seat 3: AlexGalimov (big blind) folded before Flop
Seat 4: nikolai55556 folded before Flop
Seat 5: hc agorist collected ($0.11)
Seat 6: Fika time! folded before Flop (didn't bet)



PokerStars Zoom Hand #193803371760:  Hold'em No Limit ($0.01/$0.02) - 2018/11/27 23:58:02 CUST [2018/11/27 10:58:02 ET]
Table 'Halley' 6-max Seat #1 is the button
Seat 1: billy the x ($4.39 in chips) 
Seat 2: Maverick_JPR ($2.84 in chips) 
Seat 3: hc agorist ($2.02 in chips) 
Seat 4: AlphaYoga ($2.12 in chips) 
Seat 5: Fixmenem ($2.06 in chips) 
Seat 6: andrqi ($5.91 in chips) 
Maverick_JPR: posts small blind $0.01
hc agorist: posts big blind $0.02
*** HOLE CARDS ***
Dealt to hc agorist [Ts 9d]
AlphaYoga: folds 
Fixmenem: folds 
andrqi: folds 
billy the x: folds 
Maverick_JPR: raises $0.04 to $0.06
hc agorist: raises $0.12 to $0.18
Maverick_JPR: folds 
Uncalled bet ($0.12) returned to hc agorist
hc agorist collected $0.12 from pot
hc agorist: doesn't show hand 
*** SUMMARY ***
Total pot $0.12 | Rake $0 
Seat 1: billy the x (button) folded before Flop (didn't bet)
Seat 2: Maverick_JPR (small blind) folded before Flop
Seat 3: hc agorist (big blind) collected ($0.12)
Seat 4: AlphaYoga folded before Flop (didn't bet)
Seat 5: Fixmenem folded before Flop (didn't bet)
Seat 6: andrqi folded before Flop (didn't bet)



PokerStars Zoom Hand #193803381763:  Hold'em No Limit ($0.01/$0.02) - 2018/11/27 23:58:25 CUST [2018/11/27 10:58:25 ET]
Table 'Halley' 6-max Seat #1 is the button
Seat 1: dominkaS ($4.12 in chips) 
Seat 2: Piparkoks ($1.63 in chips) 
Seat 3: RIMMM867 ($1.50 in chips) 
Seat 4: not tóday ($2.28 in chips) 
Seat 5: Maximus122 ($2.32 in chips) 
Seat 6: hc agorist ($2.08 in chips) 
Piparkoks: posts small blind $0.01
RIMMM867: posts big blind $0.02
*** HOLE CARDS ***
Dealt to hc agorist [Ad Qs]
not tóday: folds 
Maximus122: folds 
hc agorist: raises $0.04 to $0.06
dominkaS: folds 
Piparkoks: calls $0.05
RIMMM867: folds 
*** FLOP *** [6c Kh 8d]
Piparkoks: checks 
hc agorist: checks 
*** TURN *** [6c Kh 8d] [Jd]
Piparkoks: bets $0.22
hc agorist: folds 
Uncalled bet ($0.22) returned to Piparkoks
Piparkoks collected $0.14 from pot
Piparkoks: doesn't show hand 
*** SUMMARY ***
Total pot $0.14 | Rake $0 
Board [6c Kh 8d Jd]
Seat 1: dominkaS (button) folded before Flop (didn't bet)
Seat 2: Piparkoks (small blind) collected ($0.14)
Seat 3: RIMMM867 (big blind) folded before Flop
Seat 4: not tóday folded before Flop (didn't bet)
Seat 5: Maximus122 folded before Flop (didn't bet)
Seat 6: hc agorist folded on the Turn



PokerStars Zoom Hand #193803397246:  Hold'em No Limit ($0.01/$0.02) - 2018/11/27 23:59:00 CUST [2018/11/27 10:59:00 ET]
Table 'Halley' 6-max Seat #1 is the button
Seat 1: bl@cksnowman ($2.32 in chips) 
Seat 2: hc agorist ($2.02 in chips) 
Seat 3: umka186 ($2 in chips) 
Seat 4: NaumiPar ($2.22 in chips) 
Seat 5: 10jka282 ($0.87 in chips) 
Seat 6: savvas1821 ($1.87 in chips) 
hc agorist: posts small blind $0.01
umka186: posts big blind $0.02
*** HOLE CARDS ***
Dealt to hc agorist [6c As]
NaumiPar: folds 
10jka282: raises $0.02 to $0.04
savvas1821: calls $0.04
bl@cksnowman: folds 
hc agorist: raises $0.14 to $0.18
umka186: folds 
10jka282: folds 
savvas1821: folds 
Uncalled bet ($0.14) returned to hc agorist
hc agorist collected $0.14 from pot
hc agorist: doesn't show hand 
*** SUMMARY ***
Total pot $0.14 | Rake $0 
Seat 1: bl@cksnowman (button) folded before Flop (didn't bet)
Seat 2: hc agorist (small blind) collected ($0.14)
Seat 3: umka186 (big blind) folded before Flop
Seat 4: NaumiPar folded before Flop (didn't bet)
Seat 5: 10jka282 folded before Flop
Seat 6: savvas1821 folded before Flop



PokerStars Zoom Hand #193803406098:  Hold'em No Limit ($0.01/$0.02) - 2018/11/27 23:59:20 CUST [2018/11/27 10:59:20 ET]
Table 'Halley' 6-max Seat #1 is the button
Seat 1: hc agorist ($2.12 in chips) 
Seat 2: Pilatius Pok ($5.92 in chips) 
Seat 3: vvk22 ($2.27 in chips) 
Seat 4: doktor1771 ($3.61 in chips) 
Seat 5: Kala77 ($3.51 in chips) 
Seat 6: goldplay ($10.02 in chips) 
Pilatius Pok: posts small blind $0.01
vvk22: posts big blind $0.02
*** HOLE CARDS ***
Dealt to hc agorist [9c 8d]
doktor1771: raises $0.04 to $0.06
Kala77: folds 
goldplay: folds 
hc agorist: folds 
Pilatius Pok: folds 
vvk22: folds 
Uncalled bet ($0.04) returned to doktor1771
doktor1771 collected $0.05 from pot
doktor1771: doesn't show hand 
*** SUMMARY ***
Total pot $0.05 | Rake $0 
Seat 1: hc agorist (button) folded before Flop (didn't bet)
Seat 2: Pilatius Pok (small blind) folded before Flop
Seat 3: vvk22 (big blind) folded before Flop
Seat 4: doktor1771 collected ($0.05)
Seat 5: Kala77 folded before Flop (didn't bet)
Seat 6: goldplay folded before Flop (didn't bet)



PokerStars Zoom Hand #193803412343:  Hold'em No Limit ($0.01/$0.02) - 2018/11/27 23:59:34 CUST [2018/11/27 10:59:34 ET]
Table 'Halley' 6-max Seat #1 is the button
Seat 1: MarioAlan ($2.25 in chips) 
Seat 2: taurusvit ($2 in chips) 
Seat 3: feijão84 ($2.15 in chips) 
Seat 4: Valdis_ok!!! ($2.22 in chips) 
Seat 5: hc agorist ($2.12 in chips) 
Seat 6: V-SCORPIO-C ($3.55 in chips) 
taurusvit: posts small blind $0.01
feijão84: posts big blind $0.02
*** HOLE CARDS ***
Dealt to hc agorist [3s Qd]
Valdis_ok!!! has timed out
Valdis_ok!!!: folds 
hc agorist: folds 
V-SCORPIO-C: folds 
MarioAlan: raises $0.04 to $0.06
taurusvit: folds 
feijão84: folds 
Uncalled bet ($0.04) returned to MarioAlan
MarioAlan collected $0.05 from pot
MarioAlan: doesn't show hand 
*** SUMMARY ***
Total pot $0.05 | Rake $0 
Seat 1: MarioAlan (button) collected ($0.05)
Seat 2: taurusvit (small blind) folded before Flop
Seat 3: feijão84 (big blind) folded before Flop
Seat 4: Valdis_ok!!! folded before Flop (didn't bet)
Seat 5: hc agorist folded before Flop (didn't bet)
Seat 6: V-SCORPIO-C folded before Flop (didn't bet)



PokerStars Zoom Hand #193803414544:  Hold'em No Limit ($0.01/$0.02) - 2018/11/27 23:59:39 CUST [2018/11/27 10:59:39 ET]
Table 'Halley' 6-max Seat #1 is the button
Seat 1: pokerfan3999 ($2.13 in chips) 
Seat 2: ivan show276 ($2.14 in chips) 
Seat 3: olega2006 ($2.10 in chips) 
Seat 4: hc agorist ($2.12 in chips) 
Seat 5: tantsor88 ($2.03 in chips) 
Seat 6: Dannebobbe ($2.96 in chips) 
ivan show276: posts small blind $0.01
olega2006: posts big blind $0.02
*** HOLE CARDS ***
Dealt to hc agorist [Kd Qd]
hc agorist: raises $0.04 to $0.06
tantsor88: folds 
Dannebobbe: folds 
pokerfan3999: calls $0.06
ivan show276: raises $0.20 to $0.26
olega2006: folds 
hc agorist: calls $0.20
pokerfan3999: folds 
*** FLOP *** [Ah Jc 3c]
ivan show276: checks 
hc agorist: checks 
*** TURN *** [Ah Jc 3c] [4c]
ivan show276: bets $0.39
hc agorist: folds 
Uncalled bet ($0.39) returned to ivan show276
ivan show276 collected $0.58 from pot
ivan show276: doesn't show hand 
*** SUMMARY ***
Total pot $0.60 | Rake $0.02 
Board [Ah Jc 3c 4c]
Seat 1: pokerfan3999 (button) folded before Flop
Seat 2: ivan show276 (small blind) collected ($0.58)
Seat 3: olega2006 (big blind) folded before Flop
Seat 4: hc agorist folded on the Turn
Seat 5: tantsor88 folded before Flop (didn't bet)
Seat 6: Dannebobbe folded before Flop (didn't bet)



PokerStars Zoom Hand #193803436568:  Hold'em No Limit ($0.01/$0.02) - 2018/11/28 0:00:28 CUST [2018/11/27 11:00:28 ET]
Table 'Halley' 6-max Seat #1 is the button
Seat 1: aEROplan-JR ($4.74 in chips) 
Seat 2: An.Lib79 ($1.95 in chips) 
Seat 3: Rooos21 ($1.89 in chips) 
Seat 4: hc agorist ($1.86 in chips) 
Seat 5: GreyKeeperRu ($1.51 in chips) 
Seat 6: skendroshen ($2.07 in chips) 
An.Lib79: posts small blind $0.01
Rooos21: posts big blind $0.02
*** HOLE CARDS ***
Dealt to hc agorist [9s 2d]
hc agorist: folds 
GreyKeeperRu: raises $0.04 to $0.06
skendroshen: folds 
aEROplan-JR: folds 
An.Lib79: folds 
Rooos21: folds 
Uncalled bet ($0.04) returned to GreyKeeperRu
GreyKeeperRu collected $0.05 from pot
GreyKeeperRu: doesn't show hand 
*** SUMMARY ***
Total pot $0.05 | Rake $0 
Seat 1: aEROplan-JR (button) folded before Flop (didn't bet)
Seat 2: An.Lib79 (small blind) folded before Flop
Seat 3: Rooos21 (big blind) folded before Flop
Seat 4: hc agorist folded before Flop (didn't bet)
Seat 5: GreyKeeperRu collected ($0.05)
Seat 6: skendroshen folded before Flop (didn't bet)



PokerStars Zoom Hand #193803438344:  Hold'em No Limit ($0.01/$0.02) - 2018/11/28 0:00:32 CUST [2018/11/27 11:00:32 ET]
Table 'Halley' 6-max Seat #1 is the button
Seat 1: Farid_Sakhbiev ($2.60 in chips) 
Seat 2: TehLuny ($1.80 in chips) 
Seat 3: hc agorist ($1.86 in chips) 
Seat 4: chesspeed ($2.97 in chips) 
Seat 5: Maverick_JPR ($2 in chips) 
Seat 6: modefokerr ($2.10 in chips) 
TehLuny: posts small blind $0.01
hc agorist: posts big blind $0.02
*** HOLE CARDS ***
Dealt to hc agorist [Jc Qc]
chesspeed: folds 
Maverick_JPR: folds 
modefokerr: folds 
Farid_Sakhbiev: folds 
TehLuny: raises $0.03 to $0.05
hc agorist: calls $0.03
*** FLOP *** [7h Jd 9d]
TehLuny: bets $0.06
hc agorist: calls $0.06
*** TURN *** [7h Jd 9d] [2h]
TehLuny: bets $0.12
hc agorist: calls $0.12
*** RIVER *** [7h Jd 9d 2h] [Tc]
TehLuny: bets $0.31
hc agorist: folds 
Uncalled bet ($0.31) returned to TehLuny
TehLuny collected $0.44 from pot
TehLuny: doesn't show hand 
*** SUMMARY ***
Total pot $0.46 | Rake $0.02 
Board [7h Jd 9d 2h Tc]
Seat 1: Farid_Sakhbiev (button) folded before Flop (didn't bet)
Seat 2: TehLuny (small blind) collected ($0.44)
Seat 3: hc agorist (big blind) folded on the River
Seat 4: chesspeed folded before Flop (didn't bet)
Seat 5: Maverick_JPR folded before Flop (didn't bet)
Seat 6: modefokerr folded before Flop (didn't bet)



PokerStars Zoom Hand #193803465923:  Hold'em No Limit ($0.01/$0.02) - 2018/11/28 0:01:30 CUST [2018/11/27 11:01:30 ET]
Table 'Halley' 6-max Seat #1 is the button
Seat 1: femmew ($0.95 in chips) 
Seat 2: hc agorist ($1.63 in chips) 
Seat 3: ivan show276 ($2 in chips) 
Seat 4: Kakadu 38 ($2.08 in chips) 
Seat 5: papacoda ($1.65 in chips) 
Seat 6: olegan.o94 ($1.20 in chips) 
hc agorist: posts small blind $0.01
ivan show276: posts big blind $0.02
*** HOLE CARDS ***
Dealt to hc agorist [Ts 8h]
Kakadu 38: folds 
papacoda: folds 
olegan.o94: raises $0.04 to $0.06
femmew: folds 
hc agorist: folds 
ivan show276: folds 
Uncalled bet ($0.04) returned to olegan.o94
olegan.o94 collected $0.05 from pot
olegan.o94: doesn't show hand 
*** SUMMARY ***
Total pot $0.05 | Rake $0 
Seat 1: femmew (button) folded before Flop (didn't bet)
Seat 2: hc agorist (small blind) folded before Flop
Seat 3: ivan show276 (big blind) folded before Flop
Seat 4: Kakadu 38 folded before Flop (didn't bet)
Seat 5: papacoda folded before Flop (didn't bet)
Seat 6: olegan.o94 collected ($0.05)



PokerStars Zoom Hand #193803461598:  Hold'em No Limit ($0.01/$0.02) - 2018/11/28 0:01:21 CUST [2018/11/27 11:01:21 ET]
Table 'Halley' 6-max Seat #1 is the button
Seat 1: azcar129 ($3.90 in chips) 
Seat 2: chameleon365 ($1.73 in chips) 
Seat 3: AGT1960 ($7.20 in chips) 
Seat 4: LdnOnDTrack ($2 in chips) 
Seat 5: uzzy85nelutu ($3.64 in chips) 
Seat 6: hc agorist ($1.63 in chips) 
chameleon365: posts small blind $0.01
AGT1960: posts big blind $0.02
*** HOLE CARDS ***
Dealt to hc agorist [Jc 8h]
LdnOnDTrack: raises $0.03 to $0.05
uzzy85nelutu: folds 
hc agorist: folds 
azcar129: folds 
chameleon365: calls $0.04
AGT1960: folds 
*** FLOP *** [7h 3h 2h]
chameleon365: checks 
LdnOnDTrack: bets $0.06
chameleon365: folds 
Uncalled bet ($0.06) returned to LdnOnDTrack
LdnOnDTrack collected $0.12 from pot
LdnOnDTrack: doesn't show hand 
*** SUMMARY ***
Total pot $0.12 | Rake $0 
Board [7h 3h 2h]
Seat 1: azcar129 (button) folded before Flop (didn't bet)
Seat 2: chameleon365 (small blind) folded on the Flop
Seat 3: AGT1960 (big blind) folded before Flop
Seat 4: LdnOnDTrack collected ($0.12)
Seat 5: uzzy85nelutu folded before Flop (didn't bet)
Seat 6: hc agorist folded before Flop (didn't bet)



PokerStars Zoom Hand #193803468329:  Hold'em No Limit ($0.01/$0.02) - 2018/11/28 0:01:35 CUST [2018/11/27 11:01:35 ET]
Table 'Halley' 6-max Seat #1 is the button
Seat 1: hc agorist ($1.62 in chips) 
Seat 2: MusashiiDen ($2.59 in chips) 
Seat 3: Giggio3301 ($2 in chips) 
Seat 4: veksy ($2.70 in chips) 
Seat 5: Dimas54ru ($0.82 in chips) 
Seat 6: easywtf ($4.88 in chips) 
MusashiiDen: posts small blind $0.01
Giggio3301: posts big blind $0.02
*** HOLE CARDS ***
Dealt to hc agorist [4s 4h]
veksy: folds 
Dimas54ru: folds 
easywtf: folds 
hc agorist: raises $0.02 to $0.04
MusashiiDen: folds 
Giggio3301: raises $0.08 to $0.12
hc agorist: calls $0.08
*** FLOP *** [8h 6c Ad]
Giggio3301: bets $0.13
hc agorist: folds 
Uncalled bet ($0.13) returned to Giggio3301
Giggio3301 collected $0.24 from pot
Giggio3301: doesn't show hand 
*** SUMMARY ***
Total pot $0.25 | Rake $0.01 
Board [8h 6c Ad]
Seat 1: hc agorist (button) folded on the Flop
Seat 2: MusashiiDen (small blind) folded before Flop
Seat 3: Giggio3301 (big blind) collected ($0.24)
Seat 4: veksy folded before Flop (didn't bet)
Seat 5: Dimas54ru folded before Flop (didn't bet)
Seat 6: easywtf folded before Flop (didn't bet)



PokerStars Zoom Hand #193803488671:  Hold'em No Limit ($0.01/$0.02) - 2018/11/28 0:02:15 CUST [2018/11/27 11:02:15 ET]
Table 'Halley' 6-max Seat #1 is the button
Seat 1: fumina.k ($2.46 in chips) 
Seat 2: Speletajss ($2.21 in chips) 
Seat 3: Texnolog1992 ($1.74 in chips) 
Seat 4: aquilex2799 ($2.04 in chips) 
Seat 5: hc agorist ($1.50 in chips) 
Seat 6: michael yen ($1.42 in chips) 
Speletajss: posts small blind $0.01
Texnolog1992: posts big blind $0.02
*** HOLE CARDS ***
Dealt to hc agorist [Kc 2h]
aquilex2799: folds 
hc agorist: folds 
michael yen: raises $0.05 to $0.07
fumina.k: folds 
Speletajss: folds 
Texnolog1992: folds 
Uncalled bet ($0.05) returned to michael yen
michael yen collected $0.05 from pot
michael yen: doesn't show hand 
*** SUMMARY ***
Total pot $0.05 | Rake $0 
Seat 1: fumina.k (button) folded before Flop (didn't bet)
Seat 2: Speletajss (small blind) folded before Flop
Seat 3: Texnolog1992 (big blind) folded before Flop
Seat 4: aquilex2799 folded before Flop (didn't bet)
Seat 5: hc agorist folded before Flop (didn't bet)
Seat 6: michael yen collected ($0.05)



PokerStars Zoom Hand #193803491320:  Hold'em No Limit ($0.01/$0.02) - 2018/11/28 0:02:20 CUST [2018/11/27 11:02:20 ET]
Table 'Halley' 6-max Seat #1 is the button
Seat 1: alexps922 ($5.57 in chips) 
Seat 2: simple s0o ($3.35 in chips) 
Seat 3: batek_1 ($2.23 in chips) 
Seat 4: hc agorist ($1.50 in chips) 
Seat 5: mjolk_sena ($2.19 in chips) 
Seat 6: LikMnFeta ($4.21 in chips) 
simple s0o: posts small blind $0.01
batek_1: posts big blind $0.02
*** HOLE CARDS ***
Dealt to hc agorist [7h Ac]
hc agorist: folds 
mjolk_sena: folds 
LikMnFeta: folds 
alexps922: raises $0.02 to $0.04
simple s0o: folds 
batek_1: folds 
Uncalled bet ($0.02) returned to alexps922
alexps922 collected $0.05 from pot
alexps922: doesn't show hand 
*** SUMMARY ***
Total pot $0.05 | Rake $0 
Seat 1: alexps922 (button) collected ($0.05)
Seat 2: simple s0o (small blind) folded before Flop
Seat 3: batek_1 (big blind) folded before Flop
Seat 4: hc agorist folded before Flop (didn't bet)
Seat 5: mjolk_sena folded before Flop (didn't bet)
Seat 6: LikMnFeta folded before Flop (didn't bet)



PokerStars Zoom Hand #193803494265:  Hold'em No Limit ($0.01/$0.02) - 2018/11/28 0:02:26 CUST [2018/11/27 11:02:26 ET]
Table 'Halley' 6-max Seat #1 is the button
Seat 1: manmld ($2.32 in chips) 
Seat 2: tucloze ($3.61 in chips) 
Seat 3: Vanana Roja ($3.64 in chips) 
Seat 4: JBD101 ($3.97 in chips) 
Seat 5: Akutagawa ($2.14 in chips) 
Seat 6: hc agorist ($1.50 in chips) 
tucloze: posts small blind $0.01
Vanana Roja: posts big blind $0.02
*** HOLE CARDS ***
Dealt to hc agorist [6d 8h]
JBD101: folds 
Akutagawa: folds 
hc agorist: folds 
manmld: raises $0.04 to $0.06
tucloze: folds 
Vanana Roja: raises $0.14 to $0.20
manmld: folds 
Uncalled bet ($0.14) returned to Vanana Roja
Vanana Roja collected $0.13 from pot
Vanana Roja: doesn't show hand 
*** SUMMARY ***
Total pot $0.13 | Rake $0 
Seat 1: manmld (button) folded before Flop
Seat 2: tucloze (small blind) folded before Flop
Seat 3: Vanana Roja (big blind) collected ($0.13)
Seat 4: JBD101 folded before Flop (didn't bet)
Seat 5: Akutagawa folded before Flop (didn't bet)
Seat 6: hc agorist folded before Flop (didn't bet)



PokerStars Zoom Hand #193803497218:  Hold'em No Limit ($0.01/$0.02) - 2018/11/28 0:02:32 CUST [2018/11/27 11:02:32 ET]
Table 'Halley' 6-max Seat #1 is the button
Seat 1: Geopgiy ($1.03 in chips) 
Seat 2: TEAMPRO10000 ($2.99 in chips) 
Seat 3: hc agorist ($1.50 in chips) 
Seat 4: GreyKeeperRu ($3.67 in chips) 
Seat 5: pokerfan3999 ($2.10 in chips) 
Seat 6: BetaDelirium ($4.59 in chips) 
TEAMPRO10000: posts small blind $0.01
hc agorist: posts big blind $0.02
*** HOLE CARDS ***
Dealt to hc agorist [Qc Qh]
GreyKeeperRu: raises $0.04 to $0.06
pokerfan3999: folds 
BetaDelirium: folds 
Geopgiy: calls $0.06
TEAMPRO10000: folds 
hc agorist: raises $0.24 to $0.30
GreyKeeperRu: folds 
Geopgiy: folds 
Uncalled bet ($0.24) returned to hc agorist
hc agorist collected $0.19 from pot
hc agorist: doesn't show hand 
*** SUMMARY ***
Total pot $0.19 | Rake $0 
Seat 1: Geopgiy (button) folded before Flop
Seat 2: TEAMPRO10000 (small blind) folded before Flop
Seat 3: hc agorist (big blind) collected ($0.19)
Seat 4: GreyKeeperRu folded before Flop
Seat 5: pokerfan3999 folded before Flop (didn't bet)
Seat 6: BetaDelirium folded before Flop (didn't bet)



PokerStars Zoom Hand #193803512823:  Hold'em No Limit ($0.01/$0.02) - 2018/11/28 0:03:03 CUST [2018/11/27 11:03:03 ET]
Table 'Halley' 6-max Seat #1 is the button
Seat 1: croc65 ($1.36 in chips) 
Seat 2: hc agorist ($1.63 in chips) 
Seat 3: Glokk1 ($3.96 in chips) 
Seat 4: makis146 ($1.69 in chips) 
Seat 5: cuwmek ($2.08 in chips) 
Seat 6: laggi^tl0 ($1 in chips) 
hc agorist: posts small blind $0.01
Glokk1: posts big blind $0.02
*** HOLE CARDS ***
Dealt to hc agorist [8c Ad]
makis146: folds 
cuwmek: folds 
laggi^tl0: raises $0.04 to $0.06
croc65: folds 
hc agorist: folds 
Glokk1: folds 
Uncalled bet ($0.04) returned to laggi^tl0
laggi^tl0 collected $0.05 from pot
laggi^tl0: doesn't show hand 
*** SUMMARY ***
Total pot $0.05 | Rake $0 
Seat 1: croc65 (button) folded before Flop (didn't bet)
Seat 2: hc agorist (small blind) folded before Flop
Seat 3: Glokk1 (big blind) folded before Flop
Seat 4: makis146 folded before Flop (didn't bet)
Seat 5: cuwmek folded before Flop (didn't bet)
Seat 6: laggi^tl0 collected ($0.05)



PokerStars Zoom Hand #193803515421:  Hold'em No Limit ($0.01/$0.02) - 2018/11/28 0:03:08 CUST [2018/11/27 11:03:08 ET]
Table 'Halley' 6-max Seat #1 is the button
Seat 1: hc agorist ($1.62 in chips) 
Seat 2: batek_1 ($2.16 in chips) 
Seat 3: I.valued09 ($2.30 in chips) 
Seat 4: firebrigadenor ($2.35 in chips) 
Seat 5: booktable ($2.27 in chips) 
Seat 6: andrqi ($2.71 in chips) 
batek_1: posts small blind $0.01
I.valued09: posts big blind $0.02
*** HOLE CARDS ***
Dealt to hc agorist [3c 7d]
firebrigadenor: folds 
booktable: folds 
andrqi: raises $0.04 to $0.06
hc agorist: folds 
batek_1: folds 
I.valued09: folds 
Uncalled bet ($0.04) returned to andrqi
andrqi collected $0.05 from pot
andrqi: doesn't show hand 
*** SUMMARY ***
Total pot $0.05 | Rake $0 
Seat 1: hc agorist (button) folded before Flop (didn't bet)
Seat 2: batek_1 (small blind) folded before Flop
Seat 3: I.valued09 (big blind) folded before Flop
Seat 4: firebrigadenor folded before Flop (didn't bet)
Seat 5: booktable folded before Flop (didn't bet)
Seat 6: andrqi collected ($0.05)



PokerStars Zoom Hand #193803519518:  Hold'em No Limit ($0.01/$0.02) - 2018/11/28 0:03:16 CUST [2018/11/27 11:03:16 ET]
Table 'Halley' 6-max Seat #1 is the button
Seat 1: Eveyor ($11.13 in chips) 
Seat 2: MusashiiDen ($3.61 in chips) 
Seat 3: beeblover ($2 in chips) 
Seat 4: hc agorist ($1.62 in chips) 
Seat 5: hsienko ($2.02 in chips) 
Seat 6: nicemitya ($3.21 in chips) 
MusashiiDen: posts small blind $0.01
beeblover: posts big blind $0.02
*** HOLE CARDS ***
Dealt to hc agorist [Qh Kc]
hc agorist: raises $0.04 to $0.06
hsienko: folds 
nicemitya: folds 
Eveyor: folds 
MusashiiDen: folds 
beeblover: folds 
Uncalled bet ($0.04) returned to hc agorist
hc agorist collected $0.05 from pot
hc agorist: doesn't show hand 
*** SUMMARY ***
Total pot $0.05 | Rake $0 
Seat 1: Eveyor (button) folded before Flop (didn't bet)
Seat 2: MusashiiDen (small blind) folded before Flop
Seat 3: beeblover (big blind) folded before Flop
Seat 4: hc agorist collected ($0.05)
Seat 5: hsienko folded before Flop (didn't bet)
Seat 6: nicemitya folded before Flop (didn't bet)



PokerStars Zoom Hand #193803527692:  Hold'em No Limit ($0.01/$0.02) - 2018/11/28 0:03:32 CUST [2018/11/27 11:03:32 ET]
Table 'Halley' 6-max Seat #1 is the button
Seat 1: KOSMELY79 ($1.86 in chips) 
Seat 2: LikMnFeta ($3.21 in chips) 
Seat 3: fumina.k ($2.43 in chips) 
Seat 4: hc agorist ($1.65 in chips) 
Seat 5: alexps922 ($2.82 in chips) 
Seat 6: Rooos21 ($2.21 in chips) 
LikMnFeta: posts small blind $0.01
fumina.k: posts big blind $0.02
*** HOLE CARDS ***
Dealt to hc agorist [7h Ac]
hc agorist: folds 
alexps922: raises $0.03 to $0.05
Rooos21: folds 
KOSMELY79: folds 
LikMnFeta: folds 
fumina.k: folds 
Uncalled bet ($0.03) returned to alexps922
alexps922 collected $0.05 from pot
alexps922: doesn't show hand 
*** SUMMARY ***
Total pot $0.05 | Rake $0 
Seat 1: KOSMELY79 (button) folded before Flop (didn't bet)
Seat 2: LikMnFeta (small blind) folded before Flop
Seat 3: fumina.k (big blind) folded before Flop
Seat 4: hc agorist folded before Flop (didn't bet)
Seat 5: alexps922 collected ($0.05)
Seat 6: Rooos21 folded before Flop (didn't bet)



PokerStars Zoom Hand #193803536502:  Hold'em No Limit ($0.01/$0.02) - 2018/11/28 0:03:49 CUST [2018/11/27 11:03:49 ET]
Table 'Halley' 6-max Seat #1 is the button
Seat 1: heinz51 ($3.60 in chips) 
Seat 2: chesspeed ($3.01 in chips) 
Seat 3: Sakhalin65reg ($3.75 in chips) 
Seat 4: PE8512 ($1.51 in chips) 
Seat 5: ForHistory ($7.33 in chips) 
Seat 6: hc agorist ($1.63 in chips) 
chesspeed: posts small blind $0.01
Sakhalin65reg: posts big blind $0.02
*** HOLE CARDS ***
Dealt to hc agorist [Ts 9d]
PE8512: folds 
ForHistory: raises $0.03 to $0.05
hc agorist: raises $0.13 to $0.18
heinz51: folds 
chesspeed: folds 
Sakhalin65reg: folds 
ForHistory: folds 
Uncalled bet ($0.13) returned to hc agorist
hc agorist collected $0.13 from pot
hc agorist: doesn't show hand 
*** SUMMARY ***
Total pot $0.13 | Rake $0 
Seat 1: heinz51 (button) folded before Flop (didn't bet)
Seat 2: chesspeed (small blind) folded before Flop
Seat 3: Sakhalin65reg (big blind) folded before Flop
Seat 4: PE8512 folded before Flop (didn't bet)
Seat 5: ForHistory folded before Flop
Seat 6: hc agorist collected ($0.13)



PokerStars Zoom Hand #193803510299:  Hold'em No Limit ($0.01/$0.02) - 2018/11/28 0:02:58 CUST [2018/11/27 11:02:58 ET]
Table 'Halley' 6-max Seat #1 is the button
Seat 1: ivan show276 ($2 in chips) 
Seat 2: dagostinop ($4.49 in chips) 
Seat 3: Kraya1986 ($1.92 in chips) 
Seat 4: 13044031 ($6.69 in chips) 
Seat 5: hc agorist ($1.63 in chips) 
Seat 6: sorokinpv36 ($1.86 in chips) 
dagostinop: posts small blind $0.01
Kraya1986: posts big blind $0.02
*** HOLE CARDS ***
Dealt to hc agorist [2d 9c]
13044031: folds 
hc agorist: folds 
sorokinpv36: folds 
ivan show276: raises $0.02 to $0.04
dagostinop: calls $0.03
Kraya1986: calls $0.02
*** FLOP *** [7h 5h 8d]
dagostinop: bets $0.07
Kraya1986: calls $0.07
ivan show276: calls $0.07
*** TURN *** [7h 5h 8d] [4c]
dagostinop: checks 
Kraya1986: bets $0.12
ivan show276: calls $0.12
dagostinop: folds 
*** RIVER *** [7h 5h 8d 4c] [5d]
Kraya1986: bets $0.10
ivan show276: folds 
Uncalled bet ($0.10) returned to Kraya1986
Kraya1986 collected $0.55 from pot
Kraya1986: doesn't show hand 
*** SUMMARY ***
Total pot $0.57 | Rake $0.02 
Board [7h 5h 8d 4c 5d]
Seat 1: ivan show276 (button) folded on the River
Seat 2: dagostinop (small blind) folded on the Turn
Seat 3: Kraya1986 (big blind) collected ($0.55)
Seat 4: 13044031 folded before Flop (didn't bet)
Seat 5: hc agorist folded before Flop (didn't bet)
Seat 6: sorokinpv36 folded before Flop (didn't bet)



PokerStars Zoom Hand #193803547313:  Hold'em No Limit ($0.01/$0.02) - 2018/11/28 0:04:10 CUST [2018/11/27 11:04:10 ET]
Table 'Halley' 6-max Seat #1 is the button
Seat 1: firebrigadenor ($2.09 in chips) 
Seat 2: lucky7wlsrud ($2.65 in chips) 
Seat 3: robotlolz ($2.14 in chips) 
Seat 4: helolele ($2.25 in chips) 
Seat 5: hc agorist ($1.71 in chips) 
Seat 6: alex7241183 ($2.79 in chips) 
lucky7wlsrud: posts small blind $0.01
robotlolz: posts big blind $0.02
*** HOLE CARDS ***
Dealt to hc agorist [Kd 6s]
helolele: folds 
hc agorist: folds 
alex7241183: folds 
firebrigadenor: raises $0.05 to $0.07
lucky7wlsrud: folds 
robotlolz: folds 
Uncalled bet ($0.05) returned to firebrigadenor
firebrigadenor collected $0.05 from pot
firebrigadenor: doesn't show hand 
*** SUMMARY ***
Total pot $0.05 | Rake $0 
Seat 1: firebrigadenor (button) collected ($0.05)
Seat 2: lucky7wlsrud (small blind) folded before Flop
Seat 3: robotlolz (big blind) folded before Flop
Seat 4: helolele folded before Flop (didn't bet)
Seat 5: hc agorist folded before Flop (didn't bet)
Seat 6: alex7241183 folded before Flop (didn't bet)



PokerStars Zoom Hand #193803552930:  Hold'em No Limit ($0.01/$0.02) - 2018/11/28 0:04:21 CUST [2018/11/27 11:04:21 ET]
Table 'Halley' 6-max Seat #1 is the button
Seat 1: hc agorist ($1.70 in chips) 
Seat 2: vetrov.s ($2.10 in chips) 
Seat 3: PugoGrasse ($2.98 in chips) 
Seat 4: aquilex2799 ($1.73 in chips) 
Seat 5: robotlolz ($2.12 in chips) 
Seat 6: rimtis ($1.05 in chips) 
vetrov.s: posts small blind $0.01
PugoGrasse: posts big blind $0.02
*** HOLE CARDS ***
Dealt to hc agorist [8h Ac]
aquilex2799: folds 
robotlolz: folds 
rimtis: folds 
hc agorist: raises $0.02 to $0.04
vetrov.s: folds 
PugoGrasse: folds 
Uncalled bet ($0.02) returned to hc agorist
hc agorist collected $0.05 from pot
hc agorist: doesn't show hand 
*** SUMMARY ***
Total pot $0.05 | Rake $0 
Seat 1: hc agorist (button) collected ($0.05)
Seat 2: vetrov.s (small blind) folded before Flop
Seat 3: PugoGrasse (big blind) folded before Flop
Seat 4: aquilex2799 folded before Flop (didn't bet)
Seat 5: robotlolz folded before Flop (didn't bet)
Seat 6: rimtis folded before Flop (didn't bet)



PokerStars Zoom Hand #193803530215:  Hold'em No Limit ($0.01/$0.02) - 2018/11/28 0:03:37 CUST [2018/11/27 11:03:37 ET]
Table 'Halley' 6-max Seat #1 is the button
Seat 1: Knu2002 ($2.57 in chips) 
Seat 2: GektorRUS ($2.05 in chips) 
Seat 3: hc agorist ($1.65 in chips) 
Seat 4: Ringde ($5.20 in chips) 
Seat 5: naimscorp ($1.28 in chips) 
Seat 6: StMaxPit ($1.24 in chips) 
GektorRUS: posts small blind $0.01
hc agorist: posts big blind $0.02
*** HOLE CARDS ***
Dealt to hc agorist [9c 7h]
Ringde: folds 
naimscorp: folds 
StMaxPit: raises $0.04 to $0.06
Knu2002: calls $0.06
GektorRUS: folds 
hc agorist: folds 
*** FLOP *** [6c Qs 7s]
StMaxPit: bets $0.07
Knu2002: calls $0.07
*** TURN *** [6c Qs 7s] [3s]
StMaxPit: bets $0.08
Knu2002: raises $0.14 to $0.22
StMaxPit: folds 
Uncalled bet ($0.14) returned to Knu2002
Knu2002 collected $0.43 from pot
Knu2002: doesn't show hand 
*** SUMMARY ***
Total pot $0.45 | Rake $0.02 
Board [6c Qs 7s 3s]
Seat 1: Knu2002 (button) collected ($0.43)
Seat 2: GektorRUS (small blind) folded before Flop
Seat 3: hc agorist (big blind) folded before Flop
Seat 4: Ringde folded before Flop (didn't bet)
Seat 5: naimscorp folded before Flop (didn't bet)
Seat 6: StMaxPit folded on the Turn



PokerStars Zoom Hand #193803550377:  Hold'em No Limit ($0.01/$0.02) - 2018/11/28 0:04:16 CUST [2018/11/27 11:04:16 ET]
Table 'Halley' 6-max Seat #1 is the button
Seat 1: anzzud ($2.01 in chips) 
Seat 2: hc agorist ($1.71 in chips) 
Seat 3: THE SHADOW78 ($2.08 in chips) 
Seat 4: Makkydae ($2.28 in chips) 
Seat 5: aEROplan-JR ($4.96 in chips) 
Seat 6: goldplay ($8.90 in chips) 
hc agorist: posts small blind $0.01
THE SHADOW78: posts big blind $0.02
*** HOLE CARDS ***
Dealt to hc agorist [Th 4s]
Makkydae: folds 
aEROplan-JR: folds 
goldplay: calls $0.02
anzzud: folds 
hc agorist: folds 
THE SHADOW78: checks 
*** FLOP *** [Qh 3c 7s]
THE SHADOW78: checks 
goldplay: bets $0.02
THE SHADOW78: folds 
Uncalled bet ($0.02) returned to goldplay
goldplay collected $0.05 from pot
goldplay: doesn't show hand 
*** SUMMARY ***
Total pot $0.05 | Rake $0 
Board [Qh 3c 7s]
Seat 1: anzzud (button) folded before Flop (didn't bet)
Seat 2: hc agorist (small blind) folded before Flop
Seat 3: THE SHADOW78 (big blind) folded on the Flop
Seat 4: Makkydae folded before Flop (didn't bet)
Seat 5: aEROplan-JR folded before Flop (didn't bet)
Seat 6: goldplay collected ($0.05)



PokerStars Zoom Hand #193803559072:  Hold'em No Limit ($0.01/$0.02) - 2018/11/28 0:04:33 CUST [2018/11/27 11:04:33 ET]
Table 'Halley' 6-max Seat #1 is the button
Seat 1: Vlaams ($2.03 in chips) 
Seat 2: qrzking ($4.82 in chips) 
Seat 3: simple s0o ($3.14 in chips) 
Seat 4: hc agorist ($1.73 in chips) 
Seat 5: MarioAlan ($2.33 in chips) 
Seat 6: AlexGalimov ($2.07 in chips) 
qrzking: posts small blind $0.01
simple s0o: posts big blind $0.02
*** HOLE CARDS ***
Dealt to hc agorist [As 4d]
hc agorist: folds 
MarioAlan: folds 
AlexGalimov: folds 
Vlaams: folds 
qrzking: folds 
Uncalled bet ($0.01) returned to simple s0o
simple s0o collected $0.02 from pot
simple s0o: doesn't show hand 
*** SUMMARY ***
Total pot $0.02 | Rake $0 
Seat 1: Vlaams (button) folded before Flop (didn't bet)
Seat 2: qrzking (small blind) folded before Flop
Seat 3: simple s0o (big blind) collected ($0.02)
Seat 4: hc agorist folded before Flop (didn't bet)
Seat 5: MarioAlan folded before Flop (didn't bet)
Seat 6: AlexGalimov folded before Flop (didn't bet)



PokerStars Zoom Hand #193803561628:  Hold'em No Limit ($0.01/$0.02) - 2018/11/28 0:04:38 CUST [2018/11/27 11:04:38 ET]
Table 'Halley' 6-max Seat #1 is the button
Seat 1: Pascho ($4.21 in chips) 
Seat 2: maxbreak147 ($2.10 in chips) 
Seat 3: medicina1992 ($2.58 in chips) 
Seat 4: BetaDelirium ($3.99 in chips) 
Seat 5: averzia ($1.99 in chips) 
Seat 6: hc agorist ($1.73 in chips) 
maxbreak147: posts small blind $0.01
medicina1992: posts big blind $0.02
*** HOLE CARDS ***
Dealt to hc agorist [8c 8s]
BetaDelirium: folds 
averzia: folds 
hc agorist: raises $0.04 to $0.06
Pascho: folds 
maxbreak147: folds 
medicina1992: raises $0.13 to $0.19
hc agorist: calls $0.13
*** FLOP *** [8h Jc Td]
medicina1992: bets $0.22
hc agorist: raises $0.44 to $0.66
medicina1992: raises $1.73 to $2.39 and is all-in
hc agorist: calls $0.88 and is all-in
Uncalled bet ($0.85) returned to medicina1992
*** TURN *** [8h Jc Td] [Qc]
*** RIVER *** [8h Jc Td Qc] [Ts]
*** SHOW DOWN ***
medicina1992: shows [Qs Qh] (a full house, Queens full of Tens)
hc agorist: shows [8c 8s] (a full house, Eights full of Tens)
medicina1992 collected $3.35 from pot
*** SUMMARY ***
Total pot $3.47 | Rake $0.12 
Board [8h Jc Td Qc Ts]
Seat 1: Pascho (button) folded before Flop (didn't bet)
Seat 2: maxbreak147 (small blind) folded before Flop
Seat 3: medicina1992 (big blind) showed [Qs Qh] and won ($3.35) with a full house, Queens full of Tens
Seat 4: BetaDelirium folded before Flop (didn't bet)
Seat 5: averzia folded before Flop (didn't bet)
Seat 6: hc agorist showed [8c 8s] and lost with a full house, Eights full of Tens



PokerStars Zoom Hand #193803608389:  Hold'em No Limit ($0.01/$0.02) - 2018/11/28 0:06:05 CUST [2018/11/27 11:06:05 ET]
Table 'Halley' 6-max Seat #1 is the button
Seat 1: Nundeeh ($2 in chips) 
Seat 2: nikolai55556 ($1.67 in chips) 
Seat 3: bbaty123 ($2 in chips) 
Seat 4: LikMnFeta ($3.26 in chips) 
Seat 5: hc agorist ($1.97 in chips) 
Seat 6: zhuyi2111 ($1.91 in chips) 
nikolai55556: posts small blind $0.01
bbaty123: posts big blind $0.02
*** HOLE CARDS ***
Dealt to hc agorist [5c Ah]
LikMnFeta: folds 
hc agorist: folds 
zhuyi2111: folds 
Nundeeh: folds 
nikolai55556: folds 
Uncalled bet ($0.01) returned to bbaty123
bbaty123 collected $0.02 from pot
bbaty123: doesn't show hand 
*** SUMMARY ***
Total pot $0.02 | Rake $0 
Seat 1: Nundeeh (button) folded before Flop (didn't bet)
Seat 2: nikolai55556 (small blind) folded before Flop
Seat 3: bbaty123 (big blind) collected ($0.02)
Seat 4: LikMnFeta folded before Flop (didn't bet)
Seat 5: hc agorist folded before Flop (didn't bet)
Seat 6: zhuyi2111 folded before Flop (didn't bet)



PokerStars Zoom Hand #193803595349:  Hold'em No Limit ($0.01/$0.02) - 2018/11/28 0:05:41 CUST [2018/11/27 11:05:41 ET]
Table 'Halley' 6-max Seat #1 is the button
Seat 1: Resut ($2.10 in chips) 
Seat 2: RLB.3891 ($2 in chips) 
Seat 3: hc agorist ($2 in chips) 
Seat 4: Fikcyjny ($1.45 in chips) 
Seat 5: chesspeed ($5.12 in chips) 
Seat 6: nicemitya ($7.99 in chips) 
RLB.3891: posts small blind $0.01
hc agorist: posts big blind $0.02
*** HOLE CARDS ***
Dealt to hc agorist [8d 4h]
Fikcyjny: folds 
chesspeed: folds 
nicemitya: raises $0.04 to $0.06
Resut: calls $0.06
RLB.3891: folds 
hc agorist: folds 
*** FLOP *** [Jc 7s 6d]
nicemitya: checks 
Resut: checks 
*** TURN *** [Jc 7s 6d] [Qd]
nicemitya: checks 
Resut: checks 
*** RIVER *** [Jc 7s 6d Qd] [9d]
nicemitya: checks 
Resut: bets $0.14
nicemitya: folds 
Uncalled bet ($0.14) returned to Resut
Resut collected $0.14 from pot
Resut: doesn't show hand 
*** SUMMARY ***
Total pot $0.15 | Rake $0.01 
Board [Jc 7s 6d Qd 9d]
Seat 1: Resut (button) collected ($0.14)
Seat 2: RLB.3891 (small blind) folded before Flop
Seat 3: hc agorist (big blind) folded before Flop
Seat 4: Fikcyjny folded before Flop (didn't bet)
Seat 5: chesspeed folded before Flop (didn't bet)
Seat 6: nicemitya folded on the River



PokerStars Zoom Hand #193803611132:  Hold'em No Limit ($0.01/$0.02) - 2018/11/28 0:06:10 CUST [2018/11/27 11:06:10 ET]
Table 'Halley' 6-max Seat #1 is the button
Seat 1: hc agorist ($1.97 in chips) 
Seat 2: nicemitya ($3.25 in chips) 
Seat 3: Merlois ($2 in chips) 
Seat 4: tihatan ($2.82 in chips) 
Seat 5: TMZ VVV ($1.16 in chips) 
Seat 6: Cyb3r47 ($1.99 in chips) 
nicemitya: posts small blind $0.01
Merlois: posts big blind $0.02
*** HOLE CARDS ***
Dealt to hc agorist [7d Th]
tihatan: raises $0.03 to $0.05
TMZ VVV: folds 
Cyb3r47: folds 
hc agorist: folds 
nicemitya: folds 
Merlois: folds 
Uncalled bet ($0.03) returned to tihatan
tihatan collected $0.05 from pot
tihatan: doesn't show hand 
*** SUMMARY ***
Total pot $0.05 | Rake $0 
Seat 1: hc agorist (button) folded before Flop (didn't bet)
Seat 2: nicemitya (small blind) folded before Flop
Seat 3: Merlois (big blind) folded before Flop
Seat 4: tihatan collected ($0.05)
Seat 5: TMZ VVV folded before Flop (didn't bet)
Seat 6: Cyb3r47 folded before Flop (didn't bet)



PokerStars Zoom Hand #193803601292:  Hold'em No Limit ($0.01/$0.02) - 2018/11/28 0:05:52 CUST [2018/11/27 11:05:52 ET]
Table 'Halley' 6-max Seat #1 is the button
Seat 1: charlie35000 ($3.20 in chips) 
Seat 2: hc agorist ($1.98 in chips) 
Seat 3: Ilya "rc" T ($2.43 in chips) 
Seat 4: jdawgz93 ($1.34 in chips) 
Seat 5: Mendes0607 ($2.90 in chips) 
Seat 6: simple s0o ($6 in chips) 
hc agorist: posts small blind $0.01
Ilya "rc" T: posts big blind $0.02
*** HOLE CARDS ***
Dealt to hc agorist [5c 7d]
jdawgz93: calls $0.02
Mendes0607: raises $0.02 to $0.04
simple s0o: folds 
charlie35000: folds 
hc agorist: folds 
Ilya "rc" T: calls $0.02
jdawgz93: calls $0.02
*** FLOP *** [2c Tc 6d]
Ilya "rc" T: checks 
jdawgz93: checks 
Mendes0607: bets $0.12
Ilya "rc" T: folds 
jdawgz93: folds 
Uncalled bet ($0.12) returned to Mendes0607
Mendes0607 collected $0.13 from pot
Mendes0607: doesn't show hand 
*** SUMMARY ***
Total pot $0.13 | Rake $0 
Board [2c Tc 6d]
Seat 1: charlie35000 (button) folded before Flop (didn't bet)
Seat 2: hc agorist (small blind) folded before Flop
Seat 3: Ilya "rc" T (big blind) folded on the Flop
Seat 4: jdawgz93 folded on the Flop
Seat 5: Mendes0607 collected ($0.13)
Seat 6: simple s0o folded before Flop (didn't bet)



PokerStars Zoom Hand #193803615983:  Hold'em No Limit ($0.01/$0.02) - 2018/11/28 0:06:19 CUST [2018/11/27 11:06:19 ET]
Table 'Halley' 6-max Seat #1 is the button
Seat 1: Oberon63 ($2 in chips) 
Seat 2: jaaz241 ($2 in chips) 
Seat 3: hc agorist ($1.97 in chips) 
Seat 4: nicemitya ($7.91 in chips) 
Seat 5: MellivoraSto ($2.03 in chips) 
Seat 6: bbaty123 ($2.01 in chips) 
jaaz241: posts small blind $0.01
hc agorist: posts big blind $0.02
*** HOLE CARDS ***
Dealt to hc agorist [As 6d]
nicemitya: folds 
MellivoraSto: folds 
bbaty123: folds 
Oberon63: folds 
jaaz241: folds 
Uncalled bet ($0.01) returned to hc agorist
hc agorist collected $0.02 from pot
hc agorist: doesn't show hand 
*** SUMMARY ***
Total pot $0.02 | Rake $0 
Seat 1: Oberon63 (button) folded before Flop (didn't bet)
Seat 2: jaaz241 (small blind) folded before Flop
Seat 3: hc agorist (big blind) collected ($0.02)
Seat 4: nicemitya folded before Flop (didn't bet)
Seat 5: MellivoraSto folded before Flop (didn't bet)
Seat 6: bbaty123 folded before Flop (didn't bet)



PokerStars Zoom Hand #193803613293:  Hold'em No Limit ($0.01/$0.02) - 2018/11/28 0:06:14 CUST [2018/11/27 11:06:14 ET]
Table 'Halley' 6-max Seat #1 is the button
Seat 1: jaaz241 ($2 in chips) 
Seat 2: fazanis4e ($2 in chips) 
Seat 3: gertrude1904 ($1 in chips) 
Seat 4: Giggio3301 ($2.15 in chips) 
Seat 5: hc agorist ($1.97 in chips) 
Seat 6: Spinno ($2.03 in chips) 
fazanis4e: posts small blind $0.01
gertrude1904: posts big blind $0.02
*** HOLE CARDS ***
Dealt to hc agorist [7d Ac]
Giggio3301: folds 
hc agorist: folds 
Spinno: folds 
jaaz241: folds 
fazanis4e: folds 
Uncalled bet ($0.01) returned to gertrude1904
gertrude1904 collected $0.02 from pot
gertrude1904: doesn't show hand 
*** SUMMARY ***
Total pot $0.02 | Rake $0 
Seat 1: jaaz241 (button) folded before Flop (didn't bet)
Seat 2: fazanis4e (small blind) folded before Flop
Seat 3: gertrude1904 (big blind) collected ($0.02)
Seat 4: Giggio3301 folded before Flop (didn't bet)
Seat 5: hc agorist folded before Flop (didn't bet)
Seat 6: Spinno folded before Flop (didn't bet)



PokerStars Zoom Hand #193803620880:  Hold'em No Limit ($0.01/$0.02) - 2018/11/28 0:06:28 CUST [2018/11/27 11:06:28 ET]
Table 'Halley' 6-max Seat #1 is the button
Seat 1: PritkovO ($3.52 in chips) 
Seat 2: insaneken ($2.01 in chips) 
Seat 3: gibbon479 ($1.96 in chips) 
Seat 4: vintage1122 ($2.13 in chips) 
Seat 5: felipe_anps ($1.97 in chips) 
Seat 6: hc agorist ($1.98 in chips) 
insaneken: posts small blind $0.01
gibbon479: posts big blind $0.02
*** HOLE CARDS ***
Dealt to hc agorist [9s 4s]
vintage1122: folds 
felipe_anps: folds 
hc agorist: raises $0.02 to $0.04
PritkovO: folds 
insaneken: folds 
gibbon479: folds 
Uncalled bet ($0.02) returned to hc agorist
hc agorist collected $0.05 from pot
hc agorist: doesn't show hand 
*** SUMMARY ***
Total pot $0.05 | Rake $0 
Seat 1: PritkovO (button) folded before Flop (didn't bet)
Seat 2: insaneken (small blind) folded before Flop
Seat 3: gibbon479 (big blind) folded before Flop
Seat 4: vintage1122 folded before Flop (didn't bet)
Seat 5: felipe_anps folded before Flop (didn't bet)
Seat 6: hc agorist collected ($0.05)



PokerStars Zoom Hand #193803630601:  Hold'em No Limit ($0.01/$0.02) - 2018/11/28 0:06:46 CUST [2018/11/27 11:06:46 ET]
Table 'Halley' 6-max Seat #1 is the button
Seat 1: MellivoraSto ($2.01 in chips) 
Seat 2: chokoboy12 ($2.59 in chips) 
Seat 3: mecantplay ($2.54 in chips) 
Seat 4: demure2607 ($2.88 in chips) 
Seat 5: RLB.3891 ($2.18 in chips) 
Seat 6: hc agorist ($2.01 in chips) 
chokoboy12: posts small blind $0.01
mecantplay: posts big blind $0.02
*** HOLE CARDS ***
Dealt to hc agorist [Tc Th]
demure2607: folds 
RLB.3891: folds 
hc agorist: raises $0.04 to $0.06
MellivoraSto: folds 
chokoboy12: calls $0.05
mecantplay: folds 
*** FLOP *** [7s 7c Qs]
chokoboy12: checks 
hc agorist: checks 
*** TURN *** [7s 7c Qs] [9h]
chokoboy12: bets $0.07
hc agorist: calls $0.07
*** RIVER *** [7s 7c Qs 9h] [8h]
chokoboy12: bets $0.18
hc agorist: calls $0.18
*** SHOW DOWN ***
chokoboy12: shows [Jd Jc] (two pair, Jacks and Sevens)
hc agorist: mucks hand 
chokoboy12 collected $0.62 from pot
*** SUMMARY ***
Total pot $0.64 | Rake $0.02 
Board [7s 7c Qs 9h 8h]
Seat 1: MellivoraSto (button) folded before Flop (didn't bet)
Seat 2: chokoboy12 (small blind) showed [Jd Jc] and won ($0.62) with two pair, Jacks and Sevens
Seat 3: mecantplay (big blind) folded before Flop
Seat 4: demure2607 folded before Flop (didn't bet)
Seat 5: RLB.3891 folded before Flop (didn't bet)
Seat 6: hc agorist mucked [Tc Th]



PokerStars Zoom Hand #193803647290:  Hold'em No Limit ($0.01/$0.02) - 2018/11/28 0:07:17 CUST [2018/11/27 11:07:17 ET]
Table 'Halley' 6-max Seat #1 is the button
Seat 1: uratr ($2.79 in chips) 
Seat 2: hc agorist ($1.70 in chips) 
Seat 3: UEF b ($1.94 in chips) 
Seat 4: amaposh ($2 in chips) 
Seat 5: kutyalab2 ($2.71 in chips) 
Seat 6: olegan.o94 ($1.76 in chips) 
hc agorist: posts small blind $0.01
UEF b: posts big blind $0.02
*** HOLE CARDS ***
Dealt to hc agorist [7s 3h]
amaposh: folds 
kutyalab2: folds 
olegan.o94: folds 
uratr: folds 
hc agorist: folds 
Uncalled bet ($0.01) returned to UEF b
UEF b collected $0.02 from pot
UEF b: doesn't show hand 
*** SUMMARY ***
Total pot $0.02 | Rake $0 
Seat 1: uratr (button) folded before Flop (didn't bet)
Seat 2: hc agorist (small blind) folded before Flop
Seat 3: UEF b (big blind) collected ($0.02)
Seat 4: amaposh folded before Flop (didn't bet)
Seat 5: kutyalab2 folded before Flop (didn't bet)
Seat 6: olegan.o94 folded before Flop (didn't bet)



PokerStars Zoom Hand #193803650535:  Hold'em No Limit ($0.01/$0.02) - 2018/11/28 0:07:23 CUST [2018/11/27 11:07:23 ET]
Table 'Halley' 6-max Seat #1 is the button
Seat 1: MarsKarpfen ($1.95 in chips) 
Seat 2: anzzud ($2 in chips) 
Seat 3: BetaDelirium ($3.85 in chips) 
Seat 4: hc agorist ($1.69 in chips) 
Seat 5: Traxai ($4.45 in chips) 
Seat 6: firebrigadenor ($2.14 in chips) 
anzzud: posts small blind $0.01
BetaDelirium: posts big blind $0.02
*** HOLE CARDS ***
Dealt to hc agorist [Ks 9c]
hc agorist: raises $0.02 to $0.04
Traxai: folds 
firebrigadenor: folds 
MarsKarpfen: folds 
anzzud: folds 
BetaDelirium: folds 
Uncalled bet ($0.02) returned to hc agorist
hc agorist collected $0.05 from pot
hc agorist: doesn't show hand 
*** SUMMARY ***
Total pot $0.05 | Rake $0 
Seat 1: MarsKarpfen (button) folded before Flop (didn't bet)
Seat 2: anzzud (small blind) folded before Flop
Seat 3: BetaDelirium (big blind) folded before Flop
Seat 4: hc agorist collected ($0.05)
Seat 5: Traxai folded before Flop (didn't bet)
Seat 6: firebrigadenor folded before Flop (didn't bet)



PokerStars Zoom Hand #193803656554:  Hold'em No Limit ($0.01/$0.02) - 2018/11/28 0:07:34 CUST [2018/11/27 11:07:34 ET]
Table 'Halley' 6-max Seat #1 is the button
Seat 1: jdawgz93 ($1.14 in chips) 
Seat 2: eVoKid920 ($2.70 in chips) 
Seat 3: hc agorist ($1.72 in chips) 
Seat 4: Maverick_JPR ($3.35 in chips) 
Seat 5: THE SHADOW78 ($2.31 in chips) 
Seat 6: umka186 ($2 in chips) 
eVoKid920: posts small blind $0.01
hc agorist: posts big blind $0.02
*** HOLE CARDS ***
Dealt to hc agorist [Kh Th]
Maverick_JPR: folds 
THE SHADOW78: raises $0.04 to $0.06
umka186: folds 
jdawgz93: calls $0.06
eVoKid920: folds 
hc agorist: raises $0.19 to $0.25
THE SHADOW78: calls $0.19
jdawgz93: folds 
*** FLOP *** [7c Qd 7s]
hc agorist: bets $0.19
THE SHADOW78: folds 
Uncalled bet ($0.19) returned to hc agorist
hc agorist collected $0.55 from pot
hc agorist: doesn't show hand 
*** SUMMARY ***
Total pot $0.57 | Rake $0.02 
Board [7c Qd 7s]
Seat 1: jdawgz93 (button) folded before Flop
Seat 2: eVoKid920 (small blind) folded before Flop
Seat 3: hc agorist (big blind) collected ($0.55)
Seat 4: Maverick_JPR folded before Flop (didn't bet)
Seat 5: THE SHADOW78 folded on the Flop
Seat 6: umka186 folded before Flop (didn't bet)



PokerStars Zoom Hand #193803676062:  Hold'em No Limit ($0.01/$0.02) - 2018/11/28 0:08:10 CUST [2018/11/27 11:08:10 ET]
Table 'Halley' 6-max Seat #1 is the button
Seat 1: hc agorist ($2.02 in chips) 
Seat 2: aimerubpp ($2.06 in chips) 
Seat 3: SkyElephant ($2.03 in chips) 
Seat 4: rikc7 ($9.17 in chips) 
Seat 5: walderlee ($3.31 in chips) 
Seat 6: sangohan2288 ($2 in chips) 
aimerubpp: posts small blind $0.01
SkyElephant: posts big blind $0.02
*** HOLE CARDS ***
Dealt to hc agorist [Kc 5d]
rikc7: raises $0.04 to $0.06
walderlee: folds 
sangohan2288: folds 
hc agorist: folds 
aimerubpp: calls $0.05
SkyElephant: folds 
*** FLOP *** [3h 9s Js]
aimerubpp: checks 
rikc7: bets $0.08
aimerubpp: folds 
Uncalled bet ($0.08) returned to rikc7
rikc7 collected $0.14 from pot
rikc7: doesn't show hand 
*** SUMMARY ***
Total pot $0.14 | Rake $0 
Board [3h 9s Js]
Seat 1: hc agorist (button) folded before Flop (didn't bet)
Seat 2: aimerubpp (small blind) folded on the Flop
Seat 3: SkyElephant (big blind) folded before Flop
Seat 4: rikc7 collected ($0.14)
Seat 5: walderlee folded before Flop (didn't bet)
Seat 6: sangohan2288 folded before Flop (didn't bet)



PokerStars Zoom Hand #193803683630:  Hold'em No Limit ($0.01/$0.02) - 2018/11/28 0:08:24 CUST [2018/11/27 11:08:24 ET]
Table 'Halley' 6-max Seat #1 is the button
Seat 1: DenyLi ($2.29 in chips) 
Seat 2: iizi21 ($2.83 in chips) 
Seat 3: VIP ASH 777 ($2 in chips) 
Seat 4: Mr Drust ($3.21 in chips) 
Seat 5: hc agorist ($2.01 in chips) 
Seat 6: rychu1906 ($3.46 in chips) 
iizi21: posts small blind $0.01
VIP ASH 777: posts big blind $0.02
*** HOLE CARDS ***
Dealt to hc agorist [5s 9h]
Mr Drust: folds 
hc agorist: folds 
rychu1906: folds 
DenyLi: folds 
iizi21: raises $0.04 to $0.06
VIP ASH 777: folds 
Uncalled bet ($0.04) returned to iizi21
iizi21 collected $0.04 from pot
iizi21: doesn't show hand 
*** SUMMARY ***
Total pot $0.04 | Rake $0 
Seat 1: DenyLi (button) folded before Flop (didn't bet)
Seat 2: iizi21 (small blind) collected ($0.04)
Seat 3: VIP ASH 777 (big blind) folded before Flop
Seat 4: Mr Drust folded before Flop (didn't bet)
Seat 5: hc agorist folded before Flop (didn't bet)
Seat 6: rychu1906 folded before Flop (didn't bet)



PokerStars Zoom Hand #193803688436:  Hold'em No Limit ($0.01/$0.02) - 2018/11/28 0:08:33 CUST [2018/11/27 11:08:33 ET]
Table 'Halley' 6-max Seat #1 is the button
Seat 1: StraightPR0 ($3.57 in chips) 
Seat 2: chesspeed ($2.73 in chips) 
Seat 3: THE SHADOW78 ($2.14 in chips) 
Seat 4: Ruslan13581 ($2.29 in chips) 
Seat 5: lucianocamil ($2.10 in chips) 
Seat 6: hc agorist ($2.01 in chips) 
chesspeed: posts small blind $0.01
THE SHADOW78: posts big blind $0.02
*** HOLE CARDS ***
Dealt to hc agorist [Th 7c]
Ruslan13581: folds 
lucianocamil: raises $0.05 to $0.07
hc agorist: folds 
StraightPR0: folds 
chesspeed: folds 
THE SHADOW78: folds 
Uncalled bet ($0.05) returned to lucianocamil
lucianocamil collected $0.05 from pot
lucianocamil: doesn't show hand 
*** SUMMARY ***
Total pot $0.05 | Rake $0 
Seat 1: StraightPR0 (button) folded before Flop (didn't bet)
Seat 2: chesspeed (small blind) folded before Flop
Seat 3: THE SHADOW78 (big blind) folded before Flop
Seat 4: Ruslan13581 folded before Flop (didn't bet)
Seat 5: lucianocamil collected ($0.05)
Seat 6: hc agorist folded before Flop (didn't bet)



PokerStars Zoom Hand #193803678229:  Hold'em No Limit ($0.01/$0.02) - 2018/11/28 0:08:14 CUST [2018/11/27 11:08:14 ET]
Table 'Halley' 6-max Seat #1 is the button
Seat 1: momrocks ($1.46 in chips) 
Seat 2: kingkongkk19 ($2.16 in chips) 
Seat 3: eduardo17377 ($2.60 in chips) 
Seat 4: hc agorist ($2.02 in chips) 
Seat 5: V-SCORPIO-C ($4.47 in chips) 
Seat 6: Random case ($2.06 in chips) 
kingkongkk19: posts small blind $0.01
eduardo17377: posts big blind $0.02
*** HOLE CARDS ***
Dealt to hc agorist [Jc 5c]
hc agorist: folds 
V-SCORPIO-C: folds 
Random case: folds 
momrocks: folds 
kingkongkk19: raises $0.04 to $0.06
eduardo17377: calls $0.04
*** FLOP *** [Kd 9s Td]
kingkongkk19: checks 
eduardo17377: checks 
*** TURN *** [Kd 9s Td] [4s]
kingkongkk19: bets $0.21
eduardo17377: folds 
Uncalled bet ($0.21) returned to kingkongkk19
kingkongkk19 collected $0.12 from pot
kingkongkk19: doesn't show hand 
*** SUMMARY ***
Total pot $0.12 | Rake $0 
Board [Kd 9s Td 4s]
Seat 1: momrocks (button) folded before Flop (didn't bet)
Seat 2: kingkongkk19 (small blind) collected ($0.12)
Seat 3: eduardo17377 (big blind) folded on the Turn
Seat 4: hc agorist folded before Flop (didn't bet)
Seat 5: V-SCORPIO-C folded before Flop (didn't bet)
Seat 6: Random case folded before Flop (didn't bet)



PokerStars Zoom Hand #193803680917:  Hold'em No Limit ($0.01/$0.02) - 2018/11/28 0:08:19 CUST [2018/11/27 11:08:19 ET]
Table 'Halley' 6-max Seat #1 is the button
Seat 1: belomor245 ($2.22 in chips) 
Seat 2: hc agorist ($2.02 in chips) 
Seat 3: Comandos025 ($4.32 in chips) 
Seat 4: k4b4llfod4 ($2.46 in chips) 
Seat 5: zura-dzhm ($1.68 in chips) 
Seat 6: babayan1301 ($3.24 in chips) 
hc agorist: posts small blind $0.01
Comandos025: posts big blind $0.02
*** HOLE CARDS ***
Dealt to hc agorist [6s 3c]
k4b4llfod4: folds 
zura-dzhm: folds 
babayan1301: folds 
belomor245: raises $0.02 to $0.04
hc agorist: folds 
Comandos025: calls $0.02
*** FLOP *** [2c 9s 5s]
Comandos025: checks 
belomor245: checks 
*** TURN *** [2c 9s 5s] [3s]
Comandos025: bets $0.07
belomor245: folds 
Uncalled bet ($0.07) returned to Comandos025
Comandos025 collected $0.09 from pot
Comandos025: doesn't show hand 
*** SUMMARY ***
Total pot $0.09 | Rake $0 
Board [2c 9s 5s 3s]
Seat 1: belomor245 (button) folded on the Turn
Seat 2: hc agorist (small blind) folded before Flop
Seat 3: Comandos025 (big blind) collected ($0.09)
Seat 4: k4b4llfod4 folded before Flop (didn't bet)
Seat 5: zura-dzhm folded before Flop (didn't bet)
Seat 6: babayan1301 folded before Flop (didn't bet)



PokerStars Zoom Hand #193803694919:  Hold'em No Limit ($0.01/$0.02) - 2018/11/28 0:08:45 CUST [2018/11/27 11:08:45 ET]
Table 'Halley' 6-max Seat #1 is the button
Seat 1: fazanis4e ($2.37 in chips) 
Seat 2: Qwkl ($2 in chips) 
Seat 3: hc agorist ($2.01 in chips) 
Seat 4: slavkinsas ($0.99 in chips) 
Seat 5: dancayamanda ($2 in chips) 
Seat 6: edik111666 ($2.64 in chips) 
Qwkl: posts small blind $0.01
hc agorist: posts big blind $0.02
*** HOLE CARDS ***
Dealt to hc agorist [Ad 4s]
slavkinsas: folds 
dancayamanda: folds 
edik111666: raises $0.03 to $0.05
fazanis4e: folds 
Qwkl: folds 
hc agorist: folds 
Uncalled bet ($0.03) returned to edik111666
edik111666 collected $0.05 from pot
edik111666: doesn't show hand 
*** SUMMARY ***
Total pot $0.05 | Rake $0 
Seat 1: fazanis4e (button) folded before Flop (didn't bet)
Seat 2: Qwkl (small blind) folded before Flop
Seat 3: hc agorist (big blind) folded before Flop
Seat 4: slavkinsas folded before Flop (didn't bet)
Seat 5: dancayamanda folded before Flop (didn't bet)
Seat 6: edik111666 collected ($0.05)



PokerStars Zoom Hand #193803685724:  Hold'em No Limit ($0.01/$0.02) - 2018/11/28 0:08:28 CUST [2018/11/27 11:08:28 ET]
Table 'Halley' 6-max Seat #1 is the button
Seat 1: hc agorist ($2.01 in chips) 
Seat 2: Rrripl ($1.17 in chips) 
Seat 3: andrey122232 ($1.68 in chips) 
Seat 4: GI G0!² ($2.72 in chips) 
Seat 5: olega2006 ($2.53 in chips) 
Seat 6: artpoker77 ($1.24 in chips) 
Rrripl: posts small blind $0.01
andrey122232: posts big blind $0.02
*** HOLE CARDS ***
Dealt to hc agorist [Ks 6h]
GI G0!²: folds 
olega2006: folds 
artpoker77: raises $0.04 to $0.06
hc agorist: folds 
Rrripl: folds 
andrey122232: calls $0.04
*** FLOP *** [7h 8h 8s]
andrey122232: checks 
artpoker77: bets $0.05
andrey122232: calls $0.05
*** TURN *** [7h 8h 8s] [2d]
andrey122232: checks 
artpoker77: checks 
*** RIVER *** [7h 8h 8s 2d] [Jh]
andrey122232: bets $0.04
artpoker77: folds 
Uncalled bet ($0.04) returned to andrey122232
andrey122232 collected $0.22 from pot
andrey122232: doesn't show hand 
*** SUMMARY ***
Total pot $0.23 | Rake $0.01 
Board [7h 8h 8s 2d Jh]
Seat 1: hc agorist (button) folded before Flop (didn't bet)
Seat 2: Rrripl (small blind) folded before Flop
Seat 3: andrey122232 (big blind) collected ($0.22)
Seat 4: GI G0!² folded before Flop (didn't bet)
Seat 5: olega2006 folded before Flop (didn't bet)
Seat 6: artpoker77 folded on the River



PokerStars Zoom Hand #193803705744:  Hold'em No Limit ($0.01/$0.02) - 2018/11/28 0:09:05 CUST [2018/11/27 11:09:05 ET]
Table 'Halley' 6-max Seat #1 is the button
Seat 1: nikolai55556 ($1.58 in chips) 
Seat 2: hc agorist ($1.99 in chips) 
Seat 3: kingkongkk19 ($2.78 in chips) 
Seat 4: AlexGalimov ($2.28 in chips) 
Seat 5: reyesreyes16 ($5.77 in chips) 
Seat 6: lcstrambi ($9.25 in chips) 
hc agorist: posts small blind $0.01
kingkongkk19: posts big blind $0.02
*** HOLE CARDS ***
Dealt to hc agorist [Jc 6d]
AlexGalimov: folds 
reyesreyes16: raises $0.04 to $0.06
lcstrambi: folds 
nikolai55556: raises $0.04 to $0.10
hc agorist: folds 
kingkongkk19: folds 
reyesreyes16: calls $0.04
*** FLOP *** [Jh 3d Ts]
reyesreyes16: checks 
nikolai55556: bets $0.22
reyesreyes16: folds 
Uncalled bet ($0.22) returned to nikolai55556
nikolai55556 collected $0.22 from pot
nikolai55556: doesn't show hand 
*** SUMMARY ***
Total pot $0.23 | Rake $0.01 
Board [Jh 3d Ts]
Seat 1: nikolai55556 (button) collected ($0.22)
Seat 2: hc agorist (small blind) folded before Flop
Seat 3: kingkongkk19 (big blind) folded before Flop
Seat 4: AlexGalimov folded before Flop (didn't bet)
Seat 5: reyesreyes16 folded on the Flop
Seat 6: lcstrambi folded before Flop (didn't bet)



PokerStars Zoom Hand #193803711270:  Hold'em No Limit ($0.01/$0.02) - 2018/11/28 0:09:15 CUST [2018/11/27 11:09:15 ET]
Table 'Halley' 6-max Seat #1 is the button
Seat 1: hc agorist ($1.98 in chips) 
Seat 2: meniasjo ($4.72 in chips) 
Seat 3: Roadis ($2 in chips) 
Seat 4: charlie35000 ($3.42 in chips) 
Seat 5: Mammarella56 ($2 in chips) 
Seat 6: sakuraakina ($2.58 in chips) 
meniasjo: posts small blind $0.01
Roadis: posts big blind $0.02
*** HOLE CARDS ***
Dealt to hc agorist [Jc Ts]
charlie35000: folds 
Mammarella56: folds 
sakuraakina: folds 
hc agorist: raises $0.02 to $0.04
meniasjo: folds 
Roadis: raises $0.12 to $0.16
hc agorist: folds 
Uncalled bet ($0.12) returned to Roadis
Roadis collected $0.09 from pot
Roadis: doesn't show hand 
*** SUMMARY ***
Total pot $0.09 | Rake $0 
Seat 1: hc agorist (button) folded before Flop
Seat 2: meniasjo (small blind) folded before Flop
Seat 3: Roadis (big blind) collected ($0.09)
Seat 4: charlie35000 folded before Flop (didn't bet)
Seat 5: Mammarella56 folded before Flop (didn't bet)
Seat 6: sakuraakina folded before Flop (didn't bet)



PokerStars Zoom Hand #193803702391:  Hold'em No Limit ($0.01/$0.02) - 2018/11/28 0:08:59 CUST [2018/11/27 11:08:59 ET]
Table 'Halley' 6-max Seat #1 is the button
Seat 1: k4b4llfod4 ($3.18 in chips) 
Seat 2: Conan0024 ($3.83 in chips) 
Seat 3: TEAMPRO10000 ($2.35 in chips) 
Seat 4: DovRuslan ($1.80 in chips) 
Seat 5: hc agorist ($1.99 in chips) 
Seat 6: olega2006 ($2.16 in chips) 
Conan0024: posts small blind $0.01
TEAMPRO10000: posts big blind $0.02
*** HOLE CARDS ***
Dealt to hc agorist [4d Qd]
DovRuslan: folds 
hc agorist: folds 
olega2006: folds 
k4b4llfod4: folds 
Conan0024: raises $0.04 to $0.06
TEAMPRO10000: calls $0.04
*** FLOP *** [Jc Qc 7h]
Conan0024: checks 
TEAMPRO10000: checks 
*** TURN *** [Jc Qc 7h] [2d]
Conan0024: checks 
TEAMPRO10000: bets $0.06
Conan0024: calls $0.06
*** RIVER *** [Jc Qc 7h 2d] [3s]
Conan0024: checks 
TEAMPRO10000: checks 
*** SHOW DOWN ***
Conan0024: shows [Js 9s] (a pair of Jacks)
TEAMPRO10000: mucks hand 
Conan0024 collected $0.23 from pot
*** SUMMARY ***
Total pot $0.24 | Rake $0.01 
Board [Jc Qc 7h 2d 3s]
Seat 1: k4b4llfod4 (button) folded before Flop (didn't bet)
Seat 2: Conan0024 (small blind) showed [Js 9s] and won ($0.23) with a pair of Jacks
Seat 3: TEAMPRO10000 (big blind) mucked [As 3h]
Seat 4: DovRuslan folded before Flop (didn't bet)
Seat 5: hc agorist folded before Flop (didn't bet)
Seat 6: olega2006 folded before Flop (didn't bet)



PokerStars Zoom Hand #193803707974:  Hold'em No Limit ($0.01/$0.02) - 2018/11/28 0:09:09 CUST [2018/11/27 11:09:09 ET]
Table 'Halley' 6-max Seat #1 is the button
Seat 1: StrikeG312 ($2.06 in chips) 
Seat 2: derscheuer ($7.25 in chips) 
Seat 3: Rusherito87 ($2.18 in chips) 
Seat 4: RaiseF0rWin ($2.35 in chips) 
Seat 5: SRERAF ($2.46 in chips) 
Seat 6: hc agorist ($1.98 in chips) 
derscheuer: posts small blind $0.01
Rusherito87: posts big blind $0.02
*** HOLE CARDS ***
Dealt to hc agorist [6s Qh]
RaiseF0rWin: folds 
SRERAF: folds 
hc agorist: folds 
StrikeG312: raises $0.03 to $0.05
derscheuer: calls $0.04
Rusherito87: folds 
*** FLOP *** [6h 2d Tc]
derscheuer: bets $0.06
StrikeG312: folds 
Uncalled bet ($0.06) returned to derscheuer
derscheuer collected $0.12 from pot
derscheuer: doesn't show hand 
*** SUMMARY ***
Total pot $0.12 | Rake $0 
Board [6h 2d Tc]
Seat 1: StrikeG312 (button) folded on the Flop
Seat 2: derscheuer (small blind) collected ($0.12)
Seat 3: Rusherito87 (big blind) folded before Flop
Seat 4: RaiseF0rWin folded before Flop (didn't bet)
Seat 5: SRERAF folded before Flop (didn't bet)
Seat 6: hc agorist folded before Flop (didn't bet)



PokerStars Zoom Hand #193803726360:  Hold'em No Limit ($0.01/$0.02) - 2018/11/28 0:09:43 CUST [2018/11/27 11:09:43 ET]
Table 'Halley' 6-max Seat #1 is the button
Seat 1: RIMMM867 ($1.02 in chips) 
Seat 2: averzia ($2.66 in chips) 
Seat 3: olesia010 ($2.48 in chips) 
Seat 4: hc agorist ($1.94 in chips) 
Seat 5: vasilek263 ($1.07 in chips) 
Seat 6: Ruslan13581 ($3.60 in chips) 
averzia: posts small blind $0.01
olesia010: posts big blind $0.02
*** HOLE CARDS ***
Dealt to hc agorist [Ah Ts]
hc agorist: raises $0.02 to $0.04
vasilek263: folds 
Ruslan13581: folds 
RIMMM867: folds 
averzia: folds 
olesia010: folds 
Uncalled bet ($0.02) returned to hc agorist
hc agorist collected $0.05 from pot
hc agorist: doesn't show hand 
*** SUMMARY ***
Total pot $0.05 | Rake $0 
Seat 1: RIMMM867 (button) folded before Flop (didn't bet)
Seat 2: averzia (small blind) folded before Flop
Seat 3: olesia010 (big blind) folded before Flop
Seat 4: hc agorist collected ($0.05)
Seat 5: vasilek263 folded before Flop (didn't bet)
Seat 6: Ruslan13581 folded before Flop (didn't bet)



PokerStars Zoom Hand #193803723180:  Hold'em No Limit ($0.01/$0.02) - 2018/11/28 0:09:37 CUST [2018/11/27 11:09:37 ET]
Table 'Halley' 6-max Seat #1 is the button
Seat 1: C.Tom92 ($3.97 in chips) 
Seat 2: Spiridon1980 ($3.02 in chips) 
Seat 3: hsienko ($3.36 in chips) 
Seat 4: Berserker922 ($3.56 in chips) 
Seat 5: hc agorist ($1.94 in chips) 
Seat 6: AVyiO ($2.38 in chips) 
Spiridon1980: posts small blind $0.01
hsienko: posts big blind $0.02
*** HOLE CARDS ***
Dealt to hc agorist [2d Ts]
Berserker922: folds 
hc agorist: folds 
AVyiO: folds 
C.Tom92: folds 
Spiridon1980: raises $0.03 to $0.05
hsienko: calls $0.03
*** FLOP *** [7s Ks Js]
Spiridon1980: bets $0.06
hsienko: folds 
Uncalled bet ($0.06) returned to Spiridon1980
Spiridon1980 collected $0.10 from pot
Spiridon1980: doesn't show hand 
*** SUMMARY ***
Total pot $0.10 | Rake $0 
Board [7s Ks Js]
Seat 1: C.Tom92 (button) folded before Flop (didn't bet)
Seat 2: Spiridon1980 (small blind) collected ($0.10)
Seat 3: hsienko (big blind) folded on the Flop
Seat 4: Berserker922 folded before Flop (didn't bet)
Seat 5: hc agorist folded before Flop (didn't bet)
Seat 6: AVyiO folded before Flop (didn't bet)



PokerStars Zoom Hand #193803734005:  Hold'em No Limit ($0.01/$0.02) - 2018/11/28 0:09:57 CUST [2018/11/27 11:09:57 ET]
Table 'Halley' 6-max Seat #1 is the button
Seat 1: PsychoticBR ($3.78 in chips) 
Seat 2: Maverick_JPR ($2.22 in chips) 
Seat 3: hc agorist ($1.97 in chips) 
Seat 4: Jendonio ($0.51 in chips) 
Seat 5: 4365870921 ($2.13 in chips) 
Seat 6: helolele ($3.39 in chips) 
Maverick_JPR: posts small blind $0.01
hc agorist: posts big blind $0.02
*** HOLE CARDS ***
Dealt to hc agorist [4h 7d]
Jendonio: folds 
4365870921: folds 
helolele: folds 
PsychoticBR: folds 
Maverick_JPR: folds 
Uncalled bet ($0.01) returned to hc agorist
hc agorist collected $0.02 from pot
hc agorist: doesn't show hand 
*** SUMMARY ***
Total pot $0.02 | Rake $0 
Seat 1: PsychoticBR (button) folded before Flop (didn't bet)
Seat 2: Maverick_JPR (small blind) folded before Flop
Seat 3: hc agorist (big blind) collected ($0.02)
Seat 4: Jendonio folded before Flop (didn't bet)
Seat 5: 4365870921 folded before Flop (didn't bet)
Seat 6: helolele folded before Flop (didn't bet)



PokerStars Zoom Hand #193803740537:  Hold'em No Limit ($0.01/$0.02) - 2018/11/28 0:10:09 CUST [2018/11/27 11:10:09 ET]
Table 'Halley' 6-max Seat #1 is the button
Seat 1: sorokinpv36 ($3.63 in chips) 
Seat 2: hc agorist ($1.98 in chips) 
Seat 3: Honochin ($1.57 in chips) 
Seat 4: firebrigadenor ($2.06 in chips) 
Seat 5: MellivoraSto ($2.51 in chips) 
Seat 6: BoJi0313 ($2.52 in chips) 
hc agorist: posts small blind $0.01
Honochin: posts big blind $0.02
*** HOLE CARDS ***
Dealt to hc agorist [Ts 4c]
firebrigadenor: folds 
MellivoraSto: folds 
BoJi0313: folds 
sorokinpv36: folds 
hc agorist: folds 
Uncalled bet ($0.01) returned to Honochin
Honochin collected $0.02 from pot
Honochin: doesn't show hand 
*** SUMMARY ***
Total pot $0.02 | Rake $0 
Seat 1: sorokinpv36 (button) folded before Flop (didn't bet)
Seat 2: hc agorist (small blind) folded before Flop
Seat 3: Honochin (big blind) collected ($0.02)
Seat 4: firebrigadenor folded before Flop (didn't bet)
Seat 5: MellivoraSto folded before Flop (didn't bet)
Seat 6: BoJi0313 folded before Flop (didn't bet)



PokerStars Zoom Hand #193803743180:  Hold'em No Limit ($0.01/$0.02) - 2018/11/28 0:10:14 CUST [2018/11/27 11:10:14 ET]
Table 'Halley' 6-max Seat #1 is the button
Seat 1: vetrov.s ($2.06 in chips) 
Seat 2: tenak1 ($1.86 in chips) 
Seat 3: markiz655 ($2 in chips) 
Seat 4: hc agorist ($1.97 in chips) 
Seat 5: batek_1 ($2.68 in chips) 
Seat 6: Kakadu 38 ($2.96 in chips) 
tenak1: posts small blind $0.01
markiz655: posts big blind $0.02
*** HOLE CARDS ***
Dealt to hc agorist [3h Ad]
hc agorist: folds 
batek_1: raises $0.04 to $0.06
Kakadu 38: folds 
vetrov.s: folds 
tenak1: folds 
markiz655: folds 
Uncalled bet ($0.04) returned to batek_1
batek_1 collected $0.05 from pot
batek_1: doesn't show hand 
*** SUMMARY ***
Total pot $0.05 | Rake $0 
Seat 1: vetrov.s (button) folded before Flop (didn't bet)
Seat 2: tenak1 (small blind) folded before Flop
Seat 3: markiz655 (big blind) folded before Flop
Seat 4: hc agorist folded before Flop (didn't bet)
Seat 5: batek_1 collected ($0.05)
Seat 6: Kakadu 38 folded before Flop (didn't bet)



PokerStars Zoom Hand #193803746399:  Hold'em No Limit ($0.01/$0.02) - 2018/11/28 0:10:20 CUST [2018/11/27 11:10:20 ET]
Table 'Halley' 6-max Seat #1 is the button
Seat 1: hc agorist ($1.97 in chips) 
Seat 2: Rooos21 ($1.74 in chips) 
Seat 3: firebrigadenor ($2.05 in chips) 
Seat 4: Agno$tic ($2.05 in chips) 
Seat 5: dancayamanda ($2.91 in chips) 
Seat 6: ThePatrick90 ($0.47 in chips) 
Rooos21: posts small blind $0.01
firebrigadenor: posts big blind $0.02
*** HOLE CARDS ***
Dealt to hc agorist [Kh 5c]
Agno$tic: folds 
dancayamanda: raises $0.04 to $0.06
ThePatrick90: raises $0.10 to $0.16
hc agorist: folds 
Rooos21: folds 
firebrigadenor: folds 
dancayamanda: calls $0.10
*** FLOP *** [6s Qh Qd]
dancayamanda: checks 
ThePatrick90: bets $0.16
dancayamanda: folds 
Uncalled bet ($0.16) returned to ThePatrick90
ThePatrick90 collected $0.34 from pot
ThePatrick90: doesn't show hand 
*** SUMMARY ***
Total pot $0.35 | Rake $0.01 
Board [6s Qh Qd]
Seat 1: hc agorist (button) folded before Flop (didn't bet)
Seat 2: Rooos21 (small blind) folded before Flop
Seat 3: firebrigadenor (big blind) folded before Flop
Seat 4: Agno$tic folded before Flop (didn't bet)
Seat 5: dancayamanda folded on the Flop
Seat 6: ThePatrick90 collected ($0.34)



PokerStars Zoom Hand #193803749177:  Hold'em No Limit ($0.01/$0.02) - 2018/11/28 0:10:25 CUST [2018/11/27 11:10:25 ET]
Table 'Halley' 6-max Seat #1 is the button
Seat 1: AllenChang22 ($2.98 in chips) 
Seat 2: vasilek263 ($1.07 in chips) 
Seat 3: locuks ($2 in chips) 
Seat 4: iizi21 ($2.89 in chips) 
Seat 5: hc agorist ($1.97 in chips) 
Seat 6: amaposh ($3.08 in chips) 
vasilek263: posts small blind $0.01
locuks: posts big blind $0.02
*** HOLE CARDS ***
Dealt to hc agorist [9s Tc]
iizi21: folds 
hc agorist: raises $0.02 to $0.04
amaposh: folds 
AllenChang22: calls $0.04
vasilek263: calls $0.03
locuks: calls $0.02
*** FLOP *** [3h 5d 9d]
vasilek263: checks 
locuks has timed out
locuks: checks 
hc agorist: bets $0.08
AllenChang22: calls $0.08
vasilek263: folds 
locuks has timed out
locuks: folds 
*** TURN *** [3h 5d 9d] [Qs]
hc agorist: checks 
AllenChang22: bets $0.16
hc agorist: folds 
Uncalled bet ($0.16) returned to AllenChang22
AllenChang22 collected $0.31 from pot
AllenChang22: doesn't show hand 
*** SUMMARY ***
Total pot $0.32 | Rake $0.01 
Board [3h 5d 9d Qs]
Seat 1: AllenChang22 (button) collected ($0.31)
Seat 2: vasilek263 (small blind) folded on the Flop
Seat 3: locuks (big blind) folded on the Flop
Seat 4: iizi21 folded before Flop (didn't bet)
Seat 5: hc agorist folded on the Turn
Seat 6: amaposh folded before Flop (didn't bet)



PokerStars Zoom Hand #193803803427:  Hold'em No Limit ($0.01/$0.02) - 2018/11/28 0:12:05 CUST [2018/11/27 11:12:05 ET]
Table 'Halley' 6-max Seat #1 is the button
Seat 1: Mizepa ($2.88 in chips) 
Seat 2: hc agorist ($1.85 in chips) 
Seat 3: firebrigadenor ($2.02 in chips) 
Seat 4: simon32.ru ($2.02 in chips) 
Seat 5: rewq333 ($2.32 in chips) 
Seat 6: mitarasi1231 ($2.84 in chips) 
hc agorist: posts small blind $0.01
firebrigadenor: posts big blind $0.02
*** HOLE CARDS ***
Dealt to hc agorist [6s Ad]
simon32.ru: folds 
rewq333: raises $0.04 to $0.06
mitarasi1231: folds 
Mizepa: folds 
hc agorist: folds 
firebrigadenor: folds 
Uncalled bet ($0.04) returned to rewq333
rewq333 collected $0.05 from pot
rewq333: doesn't show hand 
*** SUMMARY ***
Total pot $0.05 | Rake $0 
Seat 1: Mizepa (button) folded before Flop (didn't bet)
Seat 2: hc agorist (small blind) folded before Flop
Seat 3: firebrigadenor (big blind) folded before Flop
Seat 4: simon32.ru folded before Flop (didn't bet)
Seat 5: rewq333 collected ($0.05)
Seat 6: mitarasi1231 folded before Flop (didn't bet)



PokerStars Zoom Hand #193803809965:  Hold'em No Limit ($0.01/$0.02) - 2018/11/28 0:12:17 CUST [2018/11/27 11:12:17 ET]
Table 'Halley' 6-max Seat #1 is the button
Seat 1: Mr.Folddddd ($0.50 in chips) 
Seat 2: Lehavorkuta ($2.05 in chips) 
Seat 3: hc agorist ($1.84 in chips) 
Seat 4: Egor142NVKZ ($0.99 in chips) 
Seat 5: AVyiO ($3.42 in chips) 
Seat 6: Rooos21 ($1.73 in chips) 
Lehavorkuta: posts small blind $0.01
hc agorist: posts big blind $0.02
*** HOLE CARDS ***
Dealt to hc agorist [7d Qc]
Egor142NVKZ: folds 
AVyiO: folds 
Rooos21: folds 
Mr.Folddddd: folds 
Lehavorkuta: folds 
Uncalled bet ($0.01) returned to hc agorist
hc agorist collected $0.02 from pot
hc agorist: doesn't show hand 
*** SUMMARY ***
Total pot $0.02 | Rake $0 
Seat 1: Mr.Folddddd (button) folded before Flop (didn't bet)
Seat 2: Lehavorkuta (small blind) folded before Flop
Seat 3: hc agorist (big blind) collected ($0.02)
Seat 4: Egor142NVKZ folded before Flop (didn't bet)
Seat 5: AVyiO folded before Flop (didn't bet)
Seat 6: Rooos21 folded before Flop (didn't bet)



PokerStars Zoom Hand #193803807268:  Hold'em No Limit ($0.01/$0.02) - 2018/11/28 0:12:12 CUST [2018/11/27 11:12:12 ET]
Table 'Halley' 6-max Seat #1 is the button
Seat 1: AAQQQ ($2 in chips) 
Seat 2: kutyalab2 ($2.63 in chips) 
Seat 3: Her2827 ($2 in chips) 
Seat 4: Juliks91 ($1.98 in chips) 
Seat 5: Nossna ($2.39 in chips) 
Seat 6: hc agorist ($1.84 in chips) 
kutyalab2: posts small blind $0.01
Her2827: posts big blind $0.02
*** HOLE CARDS ***
Dealt to hc agorist [6s 9h]
Juliks91: raises $0.02 to $0.04
Nossna: folds 
hc agorist: folds 
AAQQQ: folds 
kutyalab2: folds 
Her2827: folds 
Uncalled bet ($0.02) returned to Juliks91
Juliks91 collected $0.05 from pot
Juliks91: doesn't show hand 
*** SUMMARY ***
Total pot $0.05 | Rake $0 
Seat 1: AAQQQ (button) folded before Flop (didn't bet)
Seat 2: kutyalab2 (small blind) folded before Flop
Seat 3: Her2827 (big blind) folded before Flop
Seat 4: Juliks91 collected ($0.05)
Seat 5: Nossna folded before Flop (didn't bet)
Seat 6: hc agorist folded before Flop (didn't bet)



PokerStars Zoom Hand #193803815495:  Hold'em No Limit ($0.01/$0.02) - 2018/11/28 0:12:27 CUST [2018/11/27 11:12:27 ET]
Table 'Halley' 6-max Seat #1 is the button
Seat 1: dancayamanda ($2.78 in chips) 
Seat 2: belomor245 ($4.99 in chips) 
Seat 3: 13Axel44 ($2.87 in chips) 
Seat 4: gibbon479 ($1.82 in chips) 
Seat 5: hc agorist ($1.85 in chips) 
Seat 6: Tucos ($2.33 in chips) 
belomor245: posts small blind $0.01
13Axel44: posts big blind $0.02
*** HOLE CARDS ***
Dealt to hc agorist [6s 5s]
gibbon479: folds 
hc agorist: raises $0.02 to $0.04
Tucos: folds 
dancayamanda: folds 
belomor245: folds 
13Axel44: folds 
Uncalled bet ($0.02) returned to hc agorist
hc agorist collected $0.05 from pot
hc agorist: doesn't show hand 
*** SUMMARY ***
Total pot $0.05 | Rake $0 
Seat 1: dancayamanda (button) folded before Flop (didn't bet)
Seat 2: belomor245 (small blind) folded before Flop
Seat 3: 13Axel44 (big blind) folded before Flop
Seat 4: gibbon479 folded before Flop (didn't bet)
Seat 5: hc agorist collected ($0.05)
Seat 6: Tucos folded before Flop (didn't bet)



PokerStars Zoom Hand #193803822446:  Hold'em No Limit ($0.01/$0.02) - 2018/11/28 0:12:40 CUST [2018/11/27 11:12:40 ET]
Table 'Halley' 6-max Seat #1 is the button
Seat 1: hc agorist ($1.88 in chips) 
Seat 2: Lakchenko ($2.01 in chips) 
Seat 3: azcar129 ($2.80 in chips) 
Seat 4: zeus11983 ($2.29 in chips) 
Seat 5: Pilich1234 ($2 in chips) 
Seat 6: mitsinis ($2.53 in chips) 
Lakchenko: posts small blind $0.01
azcar129: posts big blind $0.02
*** HOLE CARDS ***
Dealt to hc agorist [8s 7d]
zeus11983: folds 
Pilich1234: folds 
mitsinis: folds 
hc agorist: folds 
Lakchenko: folds 
Uncalled bet ($0.01) returned to azcar129
azcar129 collected $0.02 from pot
azcar129: doesn't show hand 
*** SUMMARY ***
Total pot $0.02 | Rake $0 
Seat 1: hc agorist (button) folded before Flop (didn't bet)
Seat 2: Lakchenko (small blind) folded before Flop
Seat 3: azcar129 (big blind) collected ($0.02)
Seat 4: zeus11983 folded before Flop (didn't bet)
Seat 5: Pilich1234 folded before Flop (didn't bet)
Seat 6: mitsinis folded before Flop (didn't bet)



PokerStars Zoom Hand #193803825705:  Hold'em No Limit ($0.01/$0.02) - 2018/11/28 0:12:46 CUST [2018/11/27 11:12:46 ET]
Table 'Halley' 6-max Seat #1 is the button
Seat 1: Fun 1956 ($0.24 in chips) 
Seat 2: Vlaams ($1.99 in chips) 
Seat 3: lcstrambi ($7.49 in chips) 
Seat 4: attendant3 ($2 in chips) 
Seat 5: alex7241183 ($1.59 in chips) 
Seat 6: hc agorist ($1.88 in chips) 
Vlaams: posts small blind $0.01
lcstrambi: posts big blind $0.02
*** HOLE CARDS ***
Dealt to hc agorist [4c 4h]
attendant3: folds 
alex7241183: folds 
hc agorist: raises $0.02 to $0.04
Fun 1956: raises $0.20 to $0.24 and is all-in
Vlaams: folds 
lcstrambi: raises $0.20 to $0.44
hc agorist: folds 
Uncalled bet ($0.20) returned to lcstrambi
*** FLOP *** [8h 7s Jc]
*** TURN *** [8h 7s Jc] [2h]
*** RIVER *** [8h 7s Jc 2h] [Tc]
*** SHOW DOWN ***
lcstrambi: shows [Ks Jd] (a pair of Jacks)
Fun 1956: shows [8c Qd] (a pair of Eights)
lcstrambi collected $0.51 from pot
*** SUMMARY ***
Total pot $0.53 | Rake $0.02 
Board [8h 7s Jc 2h Tc]
Seat 1: Fun 1956 (button) showed [8c Qd] and lost with a pair of Eights
Seat 2: Vlaams (small blind) folded before Flop
Seat 3: lcstrambi (big blind) showed [Ks Jd] and won ($0.51) with a pair of Jacks
Seat 4: attendant3 folded before Flop (didn't bet)
Seat 5: alex7241183 folded before Flop (didn't bet)
Seat 6: hc agorist folded before Flop



PokerStars Zoom Hand #193803842387:  Hold'em No Limit ($0.01/$0.02) - 2018/11/28 0:13:17 CUST [2018/11/27 11:13:17 ET]
Table 'Halley' 6-max Seat #1 is the button
Seat 1: melse_youth ($2.05 in chips) 
Seat 2: BaSkeD174 ($1.22 in chips) 
Seat 3: hc agorist ($1.84 in chips) 
Seat 4: nikonova88 ($4.16 in chips) 
Seat 5: hencego ($1.06 in chips) 
Seat 6: Yokirill ($1.99 in chips) 
BaSkeD174: posts small blind $0.01
hc agorist: posts big blind $0.02
*** HOLE CARDS ***
Dealt to hc agorist [7h 5h]
nikonova88: folds 
hencego: folds 
Yokirill has timed out
Yokirill: folds 
melse_youth: folds 
BaSkeD174: calls $0.01
hc agorist: raises $0.04 to $0.06
BaSkeD174: calls $0.04
*** FLOP *** [3d 3s Qs]
BaSkeD174: checks 
hc agorist: bets $0.04
BaSkeD174: folds 
Uncalled bet ($0.04) returned to hc agorist
hc agorist collected $0.12 from pot
hc agorist: doesn't show hand 
*** SUMMARY ***
Total pot $0.12 | Rake $0 
Board [3d 3s Qs]
Seat 1: melse_youth (button) folded before Flop (didn't bet)
Seat 2: BaSkeD174 (small blind) folded on the Flop
Seat 3: hc agorist (big blind) collected ($0.12)
Seat 4: nikonova88 folded before Flop (didn't bet)
Seat 5: hencego folded before Flop (didn't bet)
Seat 6: Yokirill folded before Flop (didn't bet)



PokerStars Zoom Hand #193803868473:  Hold'em No Limit ($0.01/$0.02) - 2018/11/28 0:14:05 CUST [2018/11/27 11:14:05 ET]
Table 'Halley' 6-max Seat #1 is the button
Seat 1: hc agorist ($1.89 in chips) 
Seat 2: kutyalab2 ($2.60 in chips) 
Seat 3: rigel_poker ($2.03 in chips) 
Seat 4: Silock ($2.04 in chips) 
Seat 5: Ringde ($8.11 in chips) 
Seat 6: sangohan2288 ($1.90 in chips) 
kutyalab2: posts small blind $0.01
rigel_poker: posts big blind $0.02
*** HOLE CARDS ***
Dealt to hc agorist [Ad 5c]
Silock: folds 
Ringde: folds 
sangohan2288: folds 
hc agorist: raises $0.04 to $0.06
kutyalab2: folds 
rigel_poker: folds 
Uncalled bet ($0.04) returned to hc agorist
hc agorist collected $0.05 from pot
hc agorist: doesn't show hand 
*** SUMMARY ***
Total pot $0.05 | Rake $0 
Seat 1: hc agorist (button) collected ($0.05)
Seat 2: kutyalab2 (small blind) folded before Flop
Seat 3: rigel_poker (big blind) folded before Flop
Seat 4: Silock folded before Flop (didn't bet)
Seat 5: Ringde folded before Flop (didn't bet)
Seat 6: sangohan2288 folded before Flop (didn't bet)



PokerStars Zoom Hand #193803877742:  Hold'em No Limit ($0.01/$0.02) - 2018/11/28 0:14:22 CUST [2018/11/27 11:14:22 ET]
Table 'Halley' 6-max Seat #1 is the button
Seat 1: firebrigadenor ($2.11 in chips) 
Seat 2: StraightPR0 ($2.76 in chips) 
Seat 3: edik111666 ($2.17 in chips) 
Seat 4: cepeja8 ($1.04 in chips) 
Seat 5: hc agorist ($1.92 in chips) 
Seat 6: Ringde ($5.36 in chips) 
StraightPR0: posts small blind $0.01
edik111666: posts big blind $0.02
*** HOLE CARDS ***
Dealt to hc agorist [9s Ad]
cepeja8: folds 
hc agorist: raises $0.02 to $0.04
Ringde: folds 
firebrigadenor: folds 
StraightPR0: folds 
edik111666: folds 
Uncalled bet ($0.02) returned to hc agorist
hc agorist collected $0.05 from pot
hc agorist: doesn't show hand 
*** SUMMARY ***
Total pot $0.05 | Rake $0 
Seat 1: firebrigadenor (button) folded before Flop (didn't bet)
Seat 2: StraightPR0 (small blind) folded before Flop
Seat 3: edik111666 (big blind) folded before Flop
Seat 4: cepeja8 folded before Flop (didn't bet)
Seat 5: hc agorist collected ($0.05)
Seat 6: Ringde folded before Flop (didn't bet)



PokerStars Zoom Hand #193803885274:  Hold'em No Limit ($0.01/$0.02) - 2018/11/28 0:14:36 CUST [2018/11/27 11:14:36 ET]
Table 'Halley' 6-max Seat #1 is the button
Seat 1: joelox25 ($2.01 in chips) 
Seat 2: umka186 ($2 in chips) 
Seat 3: sangohan2288 ($1.90 in chips) 
Seat 4: hc agorist ($1.95 in chips) 
Seat 5: K.Belozerov ($2.25 in chips) 
Seat 6: CALL-09 ($1.87 in chips) 
umka186: posts small blind $0.01
sangohan2288: posts big blind $0.02
*** HOLE CARDS ***
Dealt to hc agorist [Th Kc]
hc agorist: raises $0.02 to $0.04
K.Belozerov: folds 
CALL-09: folds 
joelox25: folds 
umka186: folds 
sangohan2288: folds 
Uncalled bet ($0.02) returned to hc agorist
hc agorist collected $0.05 from pot
hc agorist: doesn't show hand 
*** SUMMARY ***
Total pot $0.05 | Rake $0 
Seat 1: joelox25 (button) folded before Flop (didn't bet)
Seat 2: umka186 (small blind) folded before Flop
Seat 3: sangohan2288 (big blind) folded before Flop
Seat 4: hc agorist collected ($0.05)
Seat 5: K.Belozerov folded before Flop (didn't bet)
Seat 6: CALL-09 folded before Flop (didn't bet)



PokerStars Zoom Hand #193803864668:  Hold'em No Limit ($0.01/$0.02) - 2018/11/28 0:13:58 CUST [2018/11/27 11:13:58 ET]
Table 'Halley' 6-max Seat #1 is the button
Seat 1: Epzer ($2.77 in chips) 
Seat 2: hc agorist ($1.90 in chips) 
Seat 3: Royal#0405 ($1 in chips) 
Seat 4: maferna ($2.21 in chips) 
Seat 5: helolele ($2.36 in chips) 
Seat 6: dancayamanda ($4.06 in chips) 
hc agorist: posts small blind $0.01
Royal#0405: posts big blind $0.02
*** HOLE CARDS ***
Dealt to hc agorist [2s Ks]
maferna: folds 
helolele: raises $0.03 to $0.05
dancayamanda: folds 
Epzer: calls $0.05
hc agorist: folds 
Royal#0405: calls $0.03
*** FLOP *** [4s 6h 5c]
Royal#0405: bets $0.08
helolele: folds 
Epzer: raises $0.08 to $0.16
Royal#0405: calls $0.08
*** TURN *** [4s 6h 5c] [Th]
Royal#0405: bets $0.02
Epzer: raises $0.16 to $0.18
Royal#0405: calls $0.16
*** RIVER *** [4s 6h 5c Th] [Jc]
Royal#0405: bets $0.02
Epzer: calls $0.02
*** SHOW DOWN ***
Royal#0405: shows [Ad 7c] (high card Ace)
Epzer: shows [5s Ah] (a pair of Fives)
Epzer collected $0.85 from pot
*** SUMMARY ***
Total pot $0.88 | Rake $0.03 
Board [4s 6h 5c Th Jc]
Seat 1: Epzer (button) showed [5s Ah] and won ($0.85) with a pair of Fives
Seat 2: hc agorist (small blind) folded before Flop
Seat 3: Royal#0405 (big blind) showed [Ad 7c] and lost with high card Ace
Seat 4: maferna folded before Flop (didn't bet)
Seat 5: helolele folded on the Flop
Seat 6: dancayamanda folded before Flop (didn't bet)



PokerStars Zoom Hand #193803895190:  Hold'em No Limit ($0.01/$0.02) - 2018/11/28 0:14:54 CUST [2018/11/27 11:14:54 ET]
Table 'Halley' 6-max Seat #1 is the button
Seat 1: GreyKeeperRu ($2.11 in chips) 
Seat 2: Igarrokk ($3.60 in chips) 
Seat 3: firebrigadenor ($2.94 in chips) 
Seat 4: hc agorist ($1.98 in chips) 
Seat 5: IMVV310 ($2.06 in chips) 
Seat 6: Roadis ($3.16 in chips) 
Igarrokk: posts small blind $0.01
firebrigadenor: posts big blind $0.02
*** HOLE CARDS ***
Dealt to hc agorist [Jc 8s]
hc agorist: folds 
IMVV310: folds 
Roadis: folds 
GreyKeeperRu: folds 
Igarrokk: raises $0.04 to $0.06
firebrigadenor: raises $0.12 to $0.18
Igarrokk: calls $0.12
*** FLOP *** [2c 7c Kc]
Igarrokk: checks 
firebrigadenor: bets $0.26
Igarrokk: folds 
Uncalled bet ($0.26) returned to firebrigadenor
firebrigadenor collected $0.35 from pot
firebrigadenor: doesn't show hand 
*** SUMMARY ***
Total pot $0.36 | Rake $0.01 
Board [2c 7c Kc]
Seat 1: GreyKeeperRu (button) folded before Flop (didn't bet)
Seat 2: Igarrokk (small blind) folded on the Flop
Seat 3: firebrigadenor (big blind) collected ($0.35)
Seat 4: hc agorist folded before Flop (didn't bet)
Seat 5: IMVV310 folded before Flop (didn't bet)
Seat 6: Roadis folded before Flop (didn't bet)



PokerStars Zoom Hand #193803898436:  Hold'em No Limit ($0.01/$0.02) - 2018/11/28 0:15:00 CUST [2018/11/27 11:15:00 ET]
Table 'Halley' 6-max Seat #1 is the button
Seat 1: MrGroov91 ($0.86 in chips) 
Seat 2: high0008 ($2.55 in chips) 
Seat 3: StrikeG312 ($3.03 in chips) 
Seat 4: cobrettti ($1.88 in chips) 
Seat 5: goldenshirt ($1.97 in chips) 
Seat 6: hc agorist ($1.98 in chips) 
high0008: posts small blind $0.01
StrikeG312: posts big blind $0.02
*** HOLE CARDS ***
Dealt to hc agorist [Ad 2h]
cobrettti: folds 
goldenshirt: folds 
hc agorist: raises $0.02 to $0.04
MrGroov91: calls $0.04
high0008: folds 
StrikeG312: calls $0.02
*** FLOP *** [Js 5d Qs]
StrikeG312: checks 
hc agorist: checks 
MrGroov91: bets $0.06
StrikeG312: folds 
hc agorist: folds 
Uncalled bet ($0.06) returned to MrGroov91
MrGroov91 collected $0.13 from pot
MrGroov91: doesn't show hand 
*** SUMMARY ***
Total pot $0.13 | Rake $0 
Board [Js 5d Qs]
Seat 1: MrGroov91 (button) collected ($0.13)
Seat 2: high0008 (small blind) folded before Flop
Seat 3: StrikeG312 (big blind) folded on the Flop
Seat 4: cobrettti folded before Flop (didn't bet)
Seat 5: goldenshirt folded before Flop (didn't bet)
Seat 6: hc agorist folded on the Flop



PokerStars Zoom Hand #193803912722:  Hold'em No Limit ($0.01/$0.02) - 2018/11/28 0:15:26 CUST [2018/11/27 11:15:26 ET]
Table 'Halley' 6-max Seat #1 is the button
Seat 1: IMVV310 ($2.03 in chips) 
Seat 2: xXMCLXx ($3.17 in chips) 
Seat 3: hc agorist ($1.94 in chips) 
Seat 4: modefokerr ($2.74 in chips) 
Seat 5: dagostinop ($1.51 in chips) 
Seat 6: Danil548 ($2.40 in chips) 
xXMCLXx: posts small blind $0.01
hc agorist: posts big blind $0.02
*** HOLE CARDS ***
Dealt to hc agorist [9c Ks]
modefokerr: folds 
dagostinop: folds 
Danil548: folds 
IMVV310: folds 
xXMCLXx: folds 
Uncalled bet ($0.01) returned to hc agorist
hc agorist collected $0.02 from pot
hc agorist: doesn't show hand 
*** SUMMARY ***
Total pot $0.02 | Rake $0 
Seat 1: IMVV310 (button) folded before Flop (didn't bet)
Seat 2: xXMCLXx (small blind) folded before Flop
Seat 3: hc agorist (big blind) collected ($0.02)
Seat 4: modefokerr folded before Flop (didn't bet)
Seat 5: dagostinop folded before Flop (didn't bet)
Seat 6: Danil548 folded before Flop (didn't bet)



PokerStars Zoom Hand #193803921013:  Hold'em No Limit ($0.01/$0.02) - 2018/11/28 0:15:41 CUST [2018/11/27 11:15:41 ET]
Table 'Halley' 6-max Seat #1 is the button
Seat 1: UEF b ($2.14 in chips) 
Seat 2: feijão84 ($2.41 in chips) 
Seat 3: 13Lanky ($2.51 in chips) 
Seat 4: Conan0024 ($3.36 in chips) 
Seat 5: karstenkloss ($2.02 in chips) 
Seat 6: hc agorist ($1.95 in chips) 
feijão84: posts small blind $0.01
13Lanky: posts big blind $0.02
*** HOLE CARDS ***
Dealt to hc agorist [Jh 9h]
Conan0024: folds 
karstenkloss: raises $0.04 to $0.06
hc agorist: calls $0.06
UEF b: calls $0.06
feijão84: folds 
13Lanky: calls $0.04
*** FLOP *** [Jc 4s Jd]
13Lanky: checks 
karstenkloss: checks 
hc agorist: checks 
UEF b: bets $0.10
13Lanky: folds 
karstenkloss: folds 
hc agorist: calls $0.10
*** TURN *** [Jc 4s Jd] [3s]
hc agorist: checks 
UEF b: bets $0.30
hc agorist: calls $0.30
*** RIVER *** [Jc 4s Jd 3s] [3c]
hc agorist: checks 
UEF b: bets $0.71
hc agorist: calls $0.71
*** SHOW DOWN ***
UEF b: shows [Qs Js] (a full house, Jacks full of Threes)
hc agorist: shows [Jh 9h] (a full house, Jacks full of Threes)
hc agorist collected $1.19 from pot
UEF b collected $1.19 from pot
*** SUMMARY ***
Total pot $2.47 | Rake $0.09 
Board [Jc 4s Jd 3s 3c]
Seat 1: UEF b (button) showed [Qs Js] and won ($1.19) with a full house, Jacks full of Threes
Seat 2: feijão84 (small blind) folded before Flop
Seat 3: 13Lanky (big blind) folded on the Flop
Seat 4: Conan0024 folded before Flop (didn't bet)
Seat 5: karstenkloss folded on the Flop
Seat 6: hc agorist showed [Jh 9h] and won ($1.19) with a full house, Jacks full of Threes



PokerStars Zoom Hand #193803976508:  Hold'em No Limit ($0.01/$0.02) - 2018/11/28 0:17:22 CUST [2018/11/27 11:17:22 ET]
Table 'Halley' 6-max Seat #1 is the button
Seat 1: Mattos_Tiago ($1.13 in chips) 
Seat 2: hc agorist ($1.97 in chips) 
Seat 3: olega2006 ($2.14 in chips) 
Seat 4: Egor142NVKZ ($1.66 in chips) 
Seat 5: simple s0o ($4.90 in chips) 
Seat 6: Conan0024 ($3.53 in chips) 
hc agorist: posts small blind $0.01
olega2006: posts big blind $0.02
*** HOLE CARDS ***
Dealt to hc agorist [2s 8h]
Egor142NVKZ: folds 
simple s0o: folds 
Conan0024: folds 
Mattos_Tiago: folds 
hc agorist: folds 
Uncalled bet ($0.01) returned to olega2006
olega2006 collected $0.02 from pot
olega2006: doesn't show hand 
*** SUMMARY ***
Total pot $0.02 | Rake $0 
Seat 1: Mattos_Tiago (button) folded before Flop (didn't bet)
Seat 2: hc agorist (small blind) folded before Flop
Seat 3: olega2006 (big blind) collected ($0.02)
Seat 4: Egor142NVKZ folded before Flop (didn't bet)
Seat 5: simple s0o folded before Flop (didn't bet)
Seat 6: Conan0024 folded before Flop (didn't bet)



PokerStars Zoom Hand #193803982609:  Hold'em No Limit ($0.01/$0.02) - 2018/11/28 0:17:33 CUST [2018/11/27 11:17:33 ET]
Table 'Halley' 6-max Seat #1 is the button
Seat 1: zsmoler ($4.75 in chips) 
Seat 2: helolele ($3.23 in chips) 
Seat 3: Mammarella56 ($2.52 in chips) 
Seat 4: edduarth ($3.62 in chips) 
Seat 5: hc agorist ($1.96 in chips) 
Seat 6: dagostinop ($1.39 in chips) 
helolele: posts small blind $0.01
Mammarella56: posts big blind $0.02
*** HOLE CARDS ***
Dealt to hc agorist [5d Jh]
edduarth: raises $0.04 to $0.06
hc agorist: folds 
dagostinop: folds 
zsmoler: folds 
helolele: folds 
Mammarella56: folds 
Uncalled bet ($0.04) returned to edduarth
edduarth collected $0.05 from pot
edduarth: doesn't show hand 
*** SUMMARY ***
Total pot $0.05 | Rake $0 
Seat 1: zsmoler (button) folded before Flop (didn't bet)
Seat 2: helolele (small blind) folded before Flop
Seat 3: Mammarella56 (big blind) folded before Flop
Seat 4: edduarth collected ($0.05)
Seat 5: hc agorist folded before Flop (didn't bet)
Seat 6: dagostinop folded before Flop (didn't bet)



PokerStars Zoom Hand #193803985407:  Hold'em No Limit ($0.01/$0.02) - 2018/11/28 0:17:38 CUST [2018/11/27 11:17:38 ET]
Table 'Halley' 6-max Seat #1 is the button
Seat 1: Glokk1 ($1.58 in chips) 
Seat 2: armanner2677 ($2.60 in chips) 
Seat 3: hc agorist ($1.96 in chips) 
Seat 4: Siyah Horoz ($1.94 in chips) 
Seat 5: titan148 ($2.64 in chips) 
Seat 6: ifuseekamy66 ($5.11 in chips) 
armanner2677: posts small blind $0.01
hc agorist: posts big blind $0.02
*** HOLE CARDS ***
Dealt to hc agorist [3c 5c]
Siyah Horoz: folds 
titan148: folds 
ifuseekamy66: folds 
Glokk1: folds 
armanner2677: folds 
Uncalled bet ($0.01) returned to hc agorist
hc agorist collected $0.02 from pot
hc agorist: doesn't show hand 
*** SUMMARY ***
Total pot $0.02 | Rake $0 
Seat 1: Glokk1 (button) folded before Flop (didn't bet)
Seat 2: armanner2677 (small blind) folded before Flop
Seat 3: hc agorist (big blind) collected ($0.02)
Seat 4: Siyah Horoz folded before Flop (didn't bet)
Seat 5: titan148 folded before Flop (didn't bet)
Seat 6: ifuseekamy66 folded before Flop (didn't bet)



PokerStars Zoom Hand #193803979271:  Hold'em No Limit ($0.01/$0.02) - 2018/11/28 0:17:27 CUST [2018/11/27 11:17:27 ET]
Table 'Halley' 6-max Seat #1 is the button
Seat 1: hc agorist ($1.96 in chips) 
Seat 2: Hopladi ($1.36 in chips) 
Seat 3: Silock ($2.03 in chips) 
Seat 4: exel11 ($2.06 in chips) 
Seat 5: shalombro1 ($2.10 in chips) 
Seat 6: GektorRUS ($2.10 in chips) 
Hopladi: posts small blind $0.01
Silock: posts big blind $0.02
*** HOLE CARDS ***
Dealt to hc agorist [9s 2d]
exel11: calls $0.02
shalombro1: folds 
GektorRUS: raises $0.07 to $0.09
hc agorist: folds 
Hopladi: folds 
Silock: folds 
exel11: calls $0.07
*** FLOP *** [Kd 7s 4s]
exel11: checks 
GektorRUS: bets $0.13
exel11: folds 
Uncalled bet ($0.13) returned to GektorRUS
GektorRUS collected $0.20 from pot
GektorRUS: doesn't show hand 
*** SUMMARY ***
Total pot $0.21 | Rake $0.01 
Board [Kd 7s 4s]
Seat 1: hc agorist (button) folded before Flop (didn't bet)
Seat 2: Hopladi (small blind) folded before Flop
Seat 3: Silock (big blind) folded before Flop
Seat 4: exel11 folded on the Flop
Seat 5: shalombro1 folded before Flop (didn't bet)
Seat 6: GektorRUS collected ($0.20)



PokerStars Zoom Hand #193803995735:  Hold'em No Limit ($0.01/$0.02) - 2018/11/28 0:17:57 CUST [2018/11/27 11:17:57 ET]
Table 'Halley' 6-max Seat #1 is the button
Seat 1: Lovefish.com ($2.02 in chips) 
Seat 2: hc agorist ($1.97 in chips) 
Seat 3: Foxxe100 ($2 in chips) 
Seat 4: sangohan2288 ($4.46 in chips) 
Seat 5: GRizlik14 ($3.22 in chips) 
Seat 6: olamoon ($2.70 in chips) 
hc agorist: posts small blind $0.01
Foxxe100: posts big blind $0.02
*** HOLE CARDS ***
Dealt to hc agorist [5c Kh]
sangohan2288: folds 
GRizlik14: folds 
olamoon: folds 
Lovefish.com: folds 
hc agorist: folds 
Uncalled bet ($0.01) returned to Foxxe100
Foxxe100 collected $0.02 from pot
Foxxe100: doesn't show hand 
*** SUMMARY ***
Total pot $0.02 | Rake $0 
Seat 1: Lovefish.com (button) folded before Flop (didn't bet)
Seat 2: hc agorist (small blind) folded before Flop
Seat 3: Foxxe100 (big blind) collected ($0.02)
Seat 4: sangohan2288 folded before Flop (didn't bet)
Seat 5: GRizlik14 folded before Flop (didn't bet)
Seat 6: olamoon folded before Flop (didn't bet)



PokerStars Zoom Hand #193803998527:  Hold'em No Limit ($0.01/$0.02) - 2018/11/28 0:18:02 CUST [2018/11/27 11:18:02 ET]
Table 'Halley' 6-max Seat #1 is the button
Seat 1: hc agorist ($1.96 in chips) 
Seat 2: naimscorp ($1.65 in chips) 
Seat 3: inhonestus ($2.12 in chips) 
Seat 4: fakas2803 ($0.92 in chips) 
Seat 5: C.Tom92 ($5.17 in chips) 
Seat 6: laxan1988 ($2.09 in chips) 
naimscorp: posts small blind $0.01
inhonestus: posts big blind $0.02
*** HOLE CARDS ***
Dealt to hc agorist [Qd 3s]
fakas2803: folds 
C.Tom92: folds 
laxan1988: folds 
hc agorist: folds 
naimscorp: folds 
Uncalled bet ($0.01) returned to inhonestus
inhonestus collected $0.02 from pot
inhonestus: doesn't show hand 
*** SUMMARY ***
Total pot $0.02 | Rake $0 
Seat 1: hc agorist (button) folded before Flop (didn't bet)
Seat 2: naimscorp (small blind) folded before Flop
Seat 3: inhonestus (big blind) collected ($0.02)
Seat 4: fakas2803 folded before Flop (didn't bet)
Seat 5: C.Tom92 folded before Flop (didn't bet)
Seat 6: laxan1988 folded before Flop (didn't bet)



PokerStars Zoom Hand #193804001775:  Hold'em No Limit ($0.01/$0.02) - 2018/11/28 0:18:08 CUST [2018/11/27 11:18:08 ET]
Table 'Halley' 6-max Seat #1 is the button
Seat 1: rewq333 ($8.03 in chips) 
Seat 2: léitau ($2.06 in chips) 
Seat 3: walderlee ($0.92 in chips) 
Seat 4: hc agorist ($1.96 in chips) 
Seat 5: booktable ($2.36 in chips) 
Seat 6: biron108 ($1.41 in chips) 
léitau: posts small blind $0.01
walderlee: posts big blind $0.02
*** HOLE CARDS ***
Dealt to hc agorist [9s 4s]
hc agorist: folds 
booktable: folds 
biron108: folds 
rewq333: folds 
léitau: raises $0.03 to $0.05
walderlee: calls $0.03
*** FLOP *** [3h 9c Jc]
léitau: bets $0.06
walderlee: folds 
Uncalled bet ($0.06) returned to léitau
léitau collected $0.10 from pot
léitau: doesn't show hand 
*** SUMMARY ***
Total pot $0.10 | Rake $0 
Board [3h 9c Jc]
Seat 1: rewq333 (button) folded before Flop (didn't bet)
Seat 2: léitau (small blind) collected ($0.10)
Seat 3: walderlee (big blind) folded on the Flop
Seat 4: hc agorist folded before Flop (didn't bet)
Seat 5: booktable folded before Flop (didn't bet)
Seat 6: biron108 folded before Flop (didn't bet)



PokerStars Zoom Hand #193804005022:  Hold'em No Limit ($0.01/$0.02) - 2018/11/28 0:18:14 CUST [2018/11/27 11:18:14 ET]
Table 'Halley' 6-max Seat #1 is the button
Seat 1: supa4444 ($1.91 in chips) 
Seat 2: high0008 ($2 in chips) 
Seat 3: torrflugan77 ($2.29 in chips) 
Seat 4: rewq333 ($5.53 in chips) 
Seat 5: hc agorist ($1.96 in chips) 
Seat 6: serge87100 ($2 in chips) 
high0008: posts small blind $0.01
torrflugan77: posts big blind $0.02
*** HOLE CARDS ***
Dealt to hc agorist [Qs 9h]
rewq333: folds 
hc agorist: raises $0.02 to $0.04
serge87100: folds 
supa4444: folds 
high0008: raises $0.12 to $0.16
torrflugan77: folds 
hc agorist: folds 
Uncalled bet ($0.12) returned to high0008
high0008 collected $0.10 from pot
high0008: doesn't show hand 
*** SUMMARY ***
Total pot $0.10 | Rake $0 
Seat 1: supa4444 (button) folded before Flop (didn't bet)
Seat 2: high0008 (small blind) collected ($0.10)
Seat 3: torrflugan77 (big blind) folded before Flop
Seat 4: rewq333 folded before Flop (didn't bet)
Seat 5: hc agorist folded before Flop
Seat 6: serge87100 folded before Flop (didn't bet)



PokerStars Zoom Hand #193803991437:  Hold'em No Limit ($0.01/$0.02) - 2018/11/28 0:17:49 CUST [2018/11/27 11:17:49 ET]
Table 'Halley' 6-max Seat #1 is the button
Seat 1: Mr Drust ($1.71 in chips) 
Seat 2: Nanitto10 ($1.98 in chips) 
Seat 3: malluk ($6.08 in chips) 
Seat 4: hc agorist ($1.97 in chips) 
Seat 5: lucaspp051 ($2.02 in chips) 
Seat 6: PPYPP ($2 in chips) 
Nanitto10: posts small blind $0.01
malluk: posts big blind $0.02
*** HOLE CARDS ***
Dealt to hc agorist [6c 8d]
hc agorist: folds 
lucaspp051: folds 
PPYPP: folds 
Mr Drust: folds 
Nanitto10: folds 
Uncalled bet ($0.01) returned to malluk
malluk collected $0.02 from pot
malluk: doesn't show hand 
*** SUMMARY ***
Total pot $0.02 | Rake $0 
Seat 1: Mr Drust (button) folded before Flop (didn't bet)
Seat 2: Nanitto10 (small blind) folded before Flop
Seat 3: malluk (big blind) collected ($0.02)
Seat 4: hc agorist folded before Flop (didn't bet)
Seat 5: lucaspp051 folded before Flop (didn't bet)
Seat 6: PPYPP folded before Flop (didn't bet)



PokerStars Zoom Hand #193804013396:  Hold'em No Limit ($0.01/$0.02) - 2018/11/28 0:18:29 CUST [2018/11/27 11:18:29 ET]
Table 'Halley' 6-max Seat #1 is the button
Seat 1: MsSuffolk ($0.84 in chips) 
Seat 2: nicemitya ($5.52 in chips) 
Seat 3: olesia010 ($2 in chips) 
Seat 4: hc agorist ($1.92 in chips) 
Seat 5: TMZ VVV ($0.46 in chips) 
Seat 6: ChingHsuanT ($2.06 in chips) 
nicemitya: posts small blind $0.01
olesia010: posts big blind $0.02
*** HOLE CARDS ***
Dealt to hc agorist [Tc Kd]
hc agorist: raises $0.04 to $0.06
TMZ VVV: folds 
ChingHsuanT: folds 
MsSuffolk: folds 
nicemitya: folds 
olesia010: folds 
Uncalled bet ($0.04) returned to hc agorist
hc agorist collected $0.05 from pot
hc agorist: doesn't show hand 
*** SUMMARY ***
Total pot $0.05 | Rake $0 
Seat 1: MsSuffolk (button) folded before Flop (didn't bet)
Seat 2: nicemitya (small blind) folded before Flop
Seat 3: olesia010 (big blind) folded before Flop
Seat 4: hc agorist collected ($0.05)
Seat 5: TMZ VVV folded before Flop (didn't bet)
Seat 6: ChingHsuanT folded before Flop (didn't bet)



PokerStars Zoom Hand #193804018904:  Hold'em No Limit ($0.01/$0.02) - 2018/11/28 0:18:39 CUST [2018/11/27 11:18:39 ET]
Table 'Halley' 6-max Seat #1 is the button
Seat 1: XGzeroGX ($2.47 in chips) 
Seat 2: Foxxe100 ($2.10 in chips) 
Seat 3: LikMnFeta ($5.42 in chips) 
Seat 4: bbaty123 ($2.03 in chips) 
Seat 5: Conan0024 ($3.47 in chips) 
Seat 6: hc agorist ($1.95 in chips) 
Foxxe100: posts small blind $0.01
LikMnFeta: posts big blind $0.02
*** HOLE CARDS ***
Dealt to hc agorist [9c 9h]
bbaty123: folds 
Conan0024: folds 
hc agorist: raises $0.04 to $0.06
XGzeroGX: folds 
Foxxe100: folds 
LikMnFeta: calls $0.04
*** FLOP *** [7c 9s Kc]
LikMnFeta: checks 
hc agorist: bets $0.10
LikMnFeta: folds 
Uncalled bet ($0.10) returned to hc agorist
hc agorist collected $0.13 from pot
hc agorist: doesn't show hand 
*** SUMMARY ***
Total pot $0.13 | Rake $0 
Board [7c 9s Kc]
Seat 1: XGzeroGX (button) folded before Flop (didn't bet)
Seat 2: Foxxe100 (small blind) folded before Flop
Seat 3: LikMnFeta (big blind) folded on the Flop
Seat 4: bbaty123 folded before Flop (didn't bet)
Seat 5: Conan0024 folded before Flop (didn't bet)
Seat 6: hc agorist collected ($0.13)



PokerStars Zoom Hand #193804032143:  Hold'em No Limit ($0.01/$0.02) - 2018/11/28 0:19:03 CUST [2018/11/27 11:19:03 ET]
Table 'Halley' 6-max Seat #1 is the button
Seat 1: AlexGalimov ($2.13 in chips) 
Seat 2: firebrigadenor ($2.04 in chips) 
Seat 3: hc agorist ($2.02 in chips) 
Seat 4: CuttingCobra ($2.17 in chips) 
Seat 5: inhonestus ($2.14 in chips) 
Seat 6: Merlois ($2.36 in chips) 
firebrigadenor: posts small blind $0.01
hc agorist: posts big blind $0.02
*** HOLE CARDS ***
Dealt to hc agorist [9d Ts]
CuttingCobra: folds 
inhonestus: folds 
Merlois: folds 
AlexGalimov: raises $0.04 to $0.06
firebrigadenor: folds 
hc agorist: calls $0.04
*** FLOP *** [Th 9c Qd]
hc agorist: checks 
AlexGalimov: bets $0.06
hc agorist: raises $0.19 to $0.25
AlexGalimov: calls $0.19
*** TURN *** [Th 9c Qd] [2c]
hc agorist: bets $0.46
AlexGalimov: calls $0.46
*** RIVER *** [Th 9c Qd 2c] [2d]
hc agorist: checks 
AlexGalimov: bets $1.36 and is all-in
hc agorist: folds 
Uncalled bet ($1.36) returned to AlexGalimov
AlexGalimov collected $1.50 from pot
AlexGalimov: doesn't show hand 
*** SUMMARY ***
Total pot $1.55 | Rake $0.05 
Board [Th 9c Qd 2c 2d]
Seat 1: AlexGalimov (button) collected ($1.50)
Seat 2: firebrigadenor (small blind) folded before Flop
Seat 3: hc agorist (big blind) folded on the River
Seat 4: CuttingCobra folded before Flop (didn't bet)
Seat 5: inhonestus folded before Flop (didn't bet)
Seat 6: Merlois folded before Flop (didn't bet)



PokerStars Zoom Hand #193804070877:  Hold'em No Limit ($0.01/$0.02) - 2018/11/28 0:20:13 CUST [2018/11/27 11:20:13 ET]
Table 'Halley' 6-max Seat #1 is the button
Seat 1: Akutagawa ($2 in chips) 
Seat 2: hc agorist ($1.25 in chips) 
Seat 3: edik111666 ($2.49 in chips) 
Seat 4: Snoro72 ($2.58 in chips) 
Seat 5: RIMMM867 ($0.91 in chips) 
Seat 6: qipidhas ($2.12 in chips) 
hc agorist: posts small blind $0.01
edik111666: posts big blind $0.02
*** HOLE CARDS ***
Dealt to hc agorist [6d 4h]
Snoro72: folds 
RIMMM867: raises $0.02 to $0.04
qipidhas: raises $0.14 to $0.18
Akutagawa: folds 
hc agorist: folds 
edik111666: folds 
RIMMM867: raises $0.73 to $0.91 and is all-in
qipidhas: calls $0.73
*** FLOP *** [Ks 8s Jc]
*** TURN *** [Ks 8s Jc] [2c]
*** RIVER *** [Ks 8s Jc 2c] [3d]
*** SHOW DOWN ***
RIMMM867: shows [Kd Kc] (three of a kind, Kings)
qipidhas: shows [Qs Jh] (a pair of Jacks)
RIMMM867 collected $1.79 from pot
*** SUMMARY ***
Total pot $1.85 | Rake $0.06 
Board [Ks 8s Jc 2c 3d]
Seat 1: Akutagawa (button) folded before Flop (didn't bet)
Seat 2: hc agorist (small blind) folded before Flop
Seat 3: edik111666 (big blind) folded before Flop
Seat 4: Snoro72 folded before Flop (didn't bet)
Seat 5: RIMMM867 showed [Kd Kc] and won ($1.79) with three of a kind, Kings
Seat 6: qipidhas showed [Qs Jh] and lost with a pair of Jacks



PokerStars Zoom Hand #193804075317:  Hold'em No Limit ($0.01/$0.02) - 2018/11/28 0:20:21 CUST [2018/11/27 11:20:21 ET]
Table 'Halley' 6-max Seat #1 is the button
Seat 1: luther96 ($2.05 in chips) 
Seat 2: Pilich1234 ($2.38 in chips) 
Seat 3: mitsinis ($2.05 in chips) 
Seat 4: alea1707 ($2 in chips) 
Seat 5: Fixmenem ($2.16 in chips) 
Seat 6: hc agorist ($1.24 in chips) 
Pilich1234: posts small blind $0.01
mitsinis: posts big blind $0.02
*** HOLE CARDS ***
Dealt to hc agorist [As Qd]
alea1707: folds 
Fixmenem: folds 
hc agorist: raises $0.04 to $0.06
luther96: folds 
Pilich1234: raises $0.12 to $0.18
mitsinis: folds 
hc agorist: raises $1.06 to $1.24 and is all-in
Pilich1234: calls $1.06
*** FIRST FLOP *** [3c Jh 3h]
*** FIRST TURN *** [3c Jh 3h] [6s]
*** FIRST RIVER *** [3c Jh 3h 6s] [5d]
*** SECOND FLOP *** [Js 4c Jc]
*** SECOND TURN *** [Js 4c Jc] [Qh]
*** SECOND RIVER *** [Js 4c Jc Qh] [8c]
*** FIRST SHOW DOWN ***
Pilich1234: shows [Ad Ks] (a pair of Threes)
hc agorist: shows [As Qd] (a pair of Threes - lower kicker)
Pilich1234 collected $1.21 from pot
*** SECOND SHOW DOWN ***
Pilich1234: shows [Ad Ks] (a pair of Jacks)
hc agorist: shows [As Qd] (two pair, Queens and Jacks)
hc agorist collected $1.20 from pot
*** SUMMARY ***
Total pot $2.50 | Rake $0.09 
Hand was run twice
FIRST Board [3c Jh 3h 6s 5d]
SECOND Board [Js 4c Jc Qh 8c]
Seat 1: luther96 (button) folded before Flop (didn't bet)
Seat 2: Pilich1234 (small blind) showed [Ad Ks] and won ($1.21) with a pair of Threes, and lost with a pair of Jacks
Seat 3: mitsinis (big blind) folded before Flop
Seat 4: alea1707 folded before Flop (didn't bet)
Seat 5: Fixmenem folded before Flop (didn't bet)
Seat 6: hc agorist showed [As Qd] and lost with a pair of Threes, and won ($1.20) with two pair, Queens and Jacks



PokerStars Zoom Hand #193804094800:  Hold'em No Limit ($0.01/$0.02) - 2018/11/28 0:20:56 CUST [2018/11/27 11:20:56 ET]
Table 'Halley' 6-max Seat #1 is the button
Seat 1: hc agorist ($1.20 in chips) 
Seat 2: Silock ($2 in chips) 
Seat 3: HeyItsM3 ($2 in chips) 
Seat 4: kjonesgg ($3.85 in chips) 
Seat 5: river3623 ($4.31 in chips) 
Seat 6: insaneken ($2.38 in chips) 
Silock: posts small blind $0.01
HeyItsM3: posts big blind $0.02
*** HOLE CARDS ***
Dealt to hc agorist [Ks 4c]
kjonesgg: folds 
river3623: folds 
insaneken: folds 
hc agorist: folds 
Silock: folds 
Uncalled bet ($0.01) returned to HeyItsM3
HeyItsM3 collected $0.02 from pot
HeyItsM3: doesn't show hand 
*** SUMMARY ***
Total pot $0.02 | Rake $0 
Seat 1: hc agorist (button) folded before Flop (didn't bet)
Seat 2: Silock (small blind) folded before Flop
Seat 3: HeyItsM3 (big blind) collected ($0.02)
Seat 4: kjonesgg folded before Flop (didn't bet)
Seat 5: river3623 folded before Flop (didn't bet)
Seat 6: insaneken folded before Flop (didn't bet)



PokerStars Zoom Hand #193804098131:  Hold'em No Limit ($0.01/$0.02) - 2018/11/28 0:21:02 CUST [2018/11/27 11:21:02 ET]
Table 'Halley' 6-max Seat #1 is the button
Seat 1: Holand153 ($2 in chips) 
Seat 2: Alexey407 ($2 in chips) 
Seat 3: VVPcmpn ($0.87 in chips) 
Seat 4: hc agorist ($1.20 in chips) 
Seat 5: ForHistory ($3.42 in chips) 
Seat 6: makis146 ($3.95 in chips) 
Alexey407: posts small blind $0.01
VVPcmpn: posts big blind $0.02
*** HOLE CARDS ***
Dealt to hc agorist [Qh 8d]
hc agorist: folds 
ForHistory: folds 
makis146: folds 
Holand153: folds 
Alexey407: raises $0.04 to $0.06
VVPcmpn: calls $0.04
*** FLOP *** [2c 6s Qd]
Alexey407: bets $0.08
VVPcmpn: folds 
Uncalled bet ($0.08) returned to Alexey407
Alexey407 collected $0.12 from pot
Alexey407: doesn't show hand 
*** SUMMARY ***
Total pot $0.12 | Rake $0 
Board [2c 6s Qd]
Seat 1: Holand153 (button) folded before Flop (didn't bet)
Seat 2: Alexey407 (small blind) collected ($0.12)
Seat 3: VVPcmpn (big blind) folded on the Flop
Seat 4: hc agorist folded before Flop (didn't bet)
Seat 5: ForHistory folded before Flop (didn't bet)
Seat 6: makis146 folded before Flop (didn't bet)



PokerStars Zoom Hand #193804100794:  Hold'em No Limit ($0.01/$0.02) - 2018/11/28 0:21:07 CUST [2018/11/27 11:21:07 ET]
Table 'Halley' 6-max Seat #1 is the button
Seat 1: Simkooo ($2 in chips) 
Seat 2: TheRedPillx ($2 in chips) 
Seat 3: hc agorist ($1.20 in chips) 
Seat 4: lokli ($0.67 in chips) 
Seat 5: hilquiass ($2.02 in chips) 
Seat 6: Geopgiy ($1.23 in chips) 
TheRedPillx: posts small blind $0.01
hc agorist: posts big blind $0.02
*** HOLE CARDS ***
Dealt to hc agorist [8h 9h]
lokli: raises $0.02 to $0.04
hilquiass: folds 
Geopgiy: folds 
Simkooo: folds 
TheRedPillx: folds 
hc agorist: calls $0.02
*** FLOP *** [5d 6h Jc]
hc agorist: checks 
lokli: bets $0.04
hc agorist: calls $0.04
*** TURN *** [5d 6h Jc] [Ks]
hc agorist: checks 
lokli: bets $0.04
hc agorist: folds 
Uncalled bet ($0.04) returned to lokli
lokli collected $0.16 from pot
lokli: doesn't show hand 
*** SUMMARY ***
Total pot $0.17 | Rake $0.01 
Board [5d 6h Jc Ks]
Seat 1: Simkooo (button) folded before Flop (didn't bet)
Seat 2: TheRedPillx (small blind) folded before Flop
Seat 3: hc agorist (big blind) folded on the Turn
Seat 4: lokli collected ($0.16)
Seat 5: hilquiass folded before Flop (didn't bet)
Seat 6: Geopgiy folded before Flop (didn't bet)



PokerStars Zoom Hand #193804128477:  Hold'em No Limit ($0.01/$0.02) - 2018/11/28 0:21:57 CUST [2018/11/27 11:21:57 ET]
Table 'Halley' 6-max Seat #1 is the button
Seat 1: hc agorist ($1.12 in chips) 
Seat 2: Lovefish.com ($2.24 in chips) 
Seat 3: markiz655 ($2 in chips) 
Seat 4: melse_youth ($2 in chips) 
Seat 5: almanik ($1.99 in chips) 
Seat 6: Snegul ($0.81 in chips) 
Lovefish.com: posts small blind $0.01
markiz655: posts big blind $0.02
*** HOLE CARDS ***
Dealt to hc agorist [6c 8d]
melse_youth: folds 
almanik: folds 
Snegul: folds 
hc agorist: folds 
Lovefish.com: folds 
Uncalled bet ($0.01) returned to markiz655
markiz655 collected $0.02 from pot
markiz655: doesn't show hand 
*** SUMMARY ***
Total pot $0.02 | Rake $0 
Seat 1: hc agorist (button) folded before Flop (didn't bet)
Seat 2: Lovefish.com (small blind) folded before Flop
Seat 3: markiz655 (big blind) collected ($0.02)
Seat 4: melse_youth folded before Flop (didn't bet)
Seat 5: almanik folded before Flop (didn't bet)
Seat 6: Snegul folded before Flop (didn't bet)



PokerStars Zoom Hand #193804136734:  Hold'em No Limit ($0.01/$0.02) - 2018/11/28 0:22:12 CUST [2018/11/27 11:22:12 ET]
Table 'Halley' 6-max Seat #1 is the button
Seat 1: Lifecards7 ($1.71 in chips) 
Seat 2: hc agorist ($1.12 in chips) 
Seat 3: ivan show276 ($2 in chips) 
Seat 4: Qwkl ($2.03 in chips) 
Seat 5: laugodaw ($2.48 in chips) 
Seat 6: ravemaster-z ($1.86 in chips) 
hc agorist: posts small blind $0.01
ivan show276: posts big blind $0.02
*** HOLE CARDS ***
Dealt to hc agorist [Ah 6c]
Qwkl: folds 
laugodaw: folds 
ravemaster-z: folds 
Lifecards7: folds 
hc agorist: folds 
Uncalled bet ($0.01) returned to ivan show276
ivan show276 collected $0.02 from pot
ivan show276: doesn't show hand 
*** SUMMARY ***
Total pot $0.02 | Rake $0 
Seat 1: Lifecards7 (button) folded before Flop (didn't bet)
Seat 2: hc agorist (small blind) folded before Flop
Seat 3: ivan show276 (big blind) collected ($0.02)
Seat 4: Qwkl folded before Flop (didn't bet)
Seat 5: laugodaw folded before Flop (didn't bet)
Seat 6: ravemaster-z folded before Flop (didn't bet)



PokerStars Zoom Hand #193804142931:  Hold'em No Limit ($0.01/$0.02) - 2018/11/28 0:22:23 CUST [2018/11/27 11:22:23 ET]
Table 'Halley' 6-max Seat #1 is the button
Seat 1: Pilich1234 ($2.27 in chips) 
Seat 2: VVPcmpn ($0.81 in chips) 
Seat 3: makis146 ($4.08 in chips) 
Seat 4: yuratan ($4.35 in chips) 
Seat 5: hc agorist ($1.11 in chips) 
Seat 6: A.A.P.1977 ($1.92 in chips) 
VVPcmpn: posts small blind $0.01
makis146: posts big blind $0.02
*** HOLE CARDS ***
Dealt to hc agorist [Js 7h]
yuratan: folds 
hc agorist: folds 
A.A.P.1977: folds 
Pilich1234: folds 
VVPcmpn: raises $0.02 to $0.04
makis146: calls $0.02
*** FLOP *** [Qh 8s Qd]
VVPcmpn: checks 
makis146: checks 
*** TURN *** [Qh 8s Qd] [6c]
VVPcmpn: bets $0.04
makis146: calls $0.04
*** RIVER *** [Qh 8s Qd 6c] [8h]
VVPcmpn: checks 
makis146: checks 
*** SHOW DOWN ***
VVPcmpn: shows [3c Ac] (two pair, Queens and Eights)
makis146: mucks hand 
VVPcmpn collected $0.15 from pot
*** SUMMARY ***
Total pot $0.16 | Rake $0.01 
Board [Qh 8s Qd 6c 8h]
Seat 1: Pilich1234 (button) folded before Flop (didn't bet)
Seat 2: VVPcmpn (small blind) showed [3c Ac] and won ($0.15) with two pair, Queens and Eights
Seat 3: makis146 (big blind) mucked [Jd 9d]
Seat 4: yuratan folded before Flop (didn't bet)
Seat 5: hc agorist folded before Flop (didn't bet)
Seat 6: A.A.P.1977 folded before Flop (didn't bet)



PokerStars Zoom Hand #193804133425:  Hold'em No Limit ($0.01/$0.02) - 2018/11/28 0:22:06 CUST [2018/11/27 11:22:06 ET]
Table 'Halley' 6-max Seat #1 is the button
Seat 1: TheRedPillx ($2.01 in chips) 
Seat 2: mg-deniz ($3.91 in chips) 
Seat 3: derscheuer ($7.12 in chips) 
Seat 4: psicopokerr ($0.97 in chips) 
Seat 5: simple s0o ($3.34 in chips) 
Seat 6: hc agorist ($1.12 in chips) 
mg-deniz: posts small blind $0.01
derscheuer: posts big blind $0.02
*** HOLE CARDS ***
Dealt to hc agorist [4h 5c]
psicopokerr: folds 
simple s0o: folds 
hc agorist: folds 
TheRedPillx: raises $0.02 to $0.04
mg-deniz: folds 
derscheuer: raises $0.06 to $0.10
TheRedPillx: folds 
Uncalled bet ($0.06) returned to derscheuer
derscheuer collected $0.09 from pot
derscheuer: doesn't show hand 
*** SUMMARY ***
Total pot $0.09 | Rake $0 
Seat 1: TheRedPillx (button) folded before Flop
Seat 2: mg-deniz (small blind) folded before Flop
Seat 3: derscheuer (big blind) collected ($0.09)
Seat 4: psicopokerr folded before Flop (didn't bet)
Seat 5: simple s0o folded before Flop (didn't bet)
Seat 6: hc agorist folded before Flop (didn't bet)



PokerStars Zoom Hand #193804153323:  Hold'em No Limit ($0.01/$0.02) - 2018/11/28 0:22:42 CUST [2018/11/27 11:22:42 ET]
Table 'Halley' 6-max Seat #1 is the button
Seat 1: Roadis ($2.27 in chips) 
Seat 2: bulugo333 ($3.47 in chips) 
Seat 3: hc agorist ($1.11 in chips) 
Seat 4: nicemitya ($9.02 in chips) 
Seat 5: XMrMojoRisinX ($2.13 in chips) 
Seat 6: kailass ($4.87 in chips) 
bulugo333: posts small blind $0.01
hc agorist: posts big blind $0.02
*** HOLE CARDS ***
Dealt to hc agorist [Kd Ac]
nicemitya: folds 
XMrMojoRisinX: folds 
kailass: folds 
Roadis: folds 
bulugo333: folds 
Uncalled bet ($0.01) returned to hc agorist
hc agorist collected $0.02 from pot
hc agorist: doesn't show hand 
*** SUMMARY ***
Total pot $0.02 | Rake $0 
Seat 1: Roadis (button) folded before Flop (didn't bet)
Seat 2: bulugo333 (small blind) folded before Flop
Seat 3: hc agorist (big blind) collected ($0.02)
Seat 4: nicemitya folded before Flop (didn't bet)
Seat 5: XMrMojoRisinX folded before Flop (didn't bet)
Seat 6: kailass folded before Flop (didn't bet)



PokerStars Zoom Hand #193804146178:  Hold'em No Limit ($0.01/$0.02) - 2018/11/28 0:22:29 CUST [2018/11/27 11:22:29 ET]
Table 'Halley' 6-max Seat #1 is the button
Seat 1: savvas1821 ($0.22 in chips) 
Seat 2: GektorRUS ($2.12 in chips) 
Seat 3: GRizlik14 ($3.31 in chips) 
Seat 4: BigRosco1992 ($3.69 in chips) 
Seat 5: hc agorist ($1.11 in chips) 
Seat 6: mg-deniz ($2.81 in chips) 
GektorRUS: posts small blind $0.01
GRizlik14: posts big blind $0.02
*** HOLE CARDS ***
Dealt to hc agorist [6s Tc]
BigRosco1992: raises $0.02 to $0.04
hc agorist: folds 
mg-deniz: raises $0.13 to $0.17
savvas1821: folds 
GektorRUS: folds 
GRizlik14: folds 
BigRosco1992: calls $0.13
*** FLOP *** [3d Jc 5d]
BigRosco1992: checks 
mg-deniz: bets $0.27
BigRosco1992: folds 
Uncalled bet ($0.27) returned to mg-deniz
mg-deniz collected $0.36 from pot
mg-deniz: doesn't show hand 
*** SUMMARY ***
Total pot $0.37 | Rake $0.01 
Board [3d Jc 5d]
Seat 1: savvas1821 (button) folded before Flop (didn't bet)
Seat 2: GektorRUS (small blind) folded before Flop
Seat 3: GRizlik14 (big blind) folded before Flop
Seat 4: BigRosco1992 folded on the Flop
Seat 5: hc agorist folded before Flop (didn't bet)
Seat 6: mg-deniz collected ($0.36)



PokerStars Zoom Hand #193804150089:  Hold'em No Limit ($0.01/$0.02) - 2018/11/28 0:22:36 CUST [2018/11/27 11:22:36 ET]
Table 'Halley' 6-max Seat #1 is the button
Seat 1: StraightPR0 ($3.48 in chips) 
Seat 2: TayyPokerSTARS ($2 in chips) 
Seat 3: V-SCORPIO-C ($5.06 in chips) 
Seat 4: hc agorist ($1.11 in chips) 
Seat 5: GI G0!² ($2.02 in chips) 
Seat 6: Lovefish.com ($2.40 in chips) 
TayyPokerSTARS: posts small blind $0.01
V-SCORPIO-C: posts big blind $0.02
*** HOLE CARDS ***
Dealt to hc agorist [7h Qs]
hc agorist: folds 
GI G0!²: raises $0.04 to $0.06
Lovefish.com: folds 
StraightPR0: folds 
TayyPokerSTARS: calls $0.05
V-SCORPIO-C: folds 
*** FLOP *** [Qc 5h 2c]
TayyPokerSTARS: checks 
GI G0!²: bets $0.08
TayyPokerSTARS: calls $0.08
*** TURN *** [Qc 5h 2c] [7s]
TayyPokerSTARS: checks 
GI G0!²: checks 
*** RIVER *** [Qc 5h 2c 7s] [Ts]
TayyPokerSTARS: checks 
GI G0!²: bets $0.19
TayyPokerSTARS: calls $0.19
*** SHOW DOWN ***
GI G0!²: shows [Th Tc] (three of a kind, Tens)
TayyPokerSTARS: mucks hand 
GI G0!² collected $0.66 from pot
*** SUMMARY ***
Total pot $0.68 | Rake $0.02 
Board [Qc 5h 2c 7s Ts]
Seat 1: StraightPR0 (button) folded before Flop (didn't bet)
Seat 2: TayyPokerSTARS (small blind) mucked [Ac Qd]
Seat 3: V-SCORPIO-C (big blind) folded before Flop
Seat 4: hc agorist folded before Flop (didn't bet)
Seat 5: GI G0!² showed [Th Tc] and won ($0.66) with three of a kind, Tens
Seat 6: Lovefish.com folded before Flop (didn't bet)



PokerStars Zoom Hand #193804170474:  Hold'em No Limit ($0.01/$0.02) - 2018/11/28 0:23:13 CUST [2018/11/27 11:23:13 ET]
Table 'Halley' 6-max Seat #1 is the button
Seat 1: ChrisCreys ($2.74 in chips) 
Seat 2: meniasjo ($3.88 in chips) 
Seat 3: tokyopop0330 ($1.99 in chips) 
Seat 4: hc agorist ($1.12 in chips) 
Seat 5: Thomas Wi13 ($2.27 in chips) 
Seat 6: V-SCORPIO-C ($5.06 in chips) 
meniasjo: posts small blind $0.01
tokyopop0330: posts big blind $0.02
*** HOLE CARDS ***
Dealt to hc agorist [Tc 6c]
hc agorist: folds 
Thomas Wi13: folds 
V-SCORPIO-C: folds 
ChrisCreys: folds 
meniasjo: raises $0.04 to $0.06
tokyopop0330: folds 
Uncalled bet ($0.04) returned to meniasjo
meniasjo collected $0.04 from pot
meniasjo: doesn't show hand 
*** SUMMARY ***
Total pot $0.04 | Rake $0 
Seat 1: ChrisCreys (button) folded before Flop (didn't bet)
Seat 2: meniasjo (small blind) collected ($0.04)
Seat 3: tokyopop0330 (big blind) folded before Flop
Seat 4: hc agorist folded before Flop (didn't bet)
Seat 5: Thomas Wi13 folded before Flop (didn't bet)
Seat 6: V-SCORPIO-C folded before Flop (didn't bet)



PokerStars Zoom Hand #193804173741:  Hold'em No Limit ($0.01/$0.02) - 2018/11/28 0:23:19 CUST [2018/11/27 11:23:19 ET]
Table 'Halley' 6-max Seat #1 is the button
Seat 1: jaaz241 ($2.21 in chips) 
Seat 2: hc agorist ($1.12 in chips) 
Seat 3: kingkongkk19 ($2 in chips) 
Seat 4: zhx9001 ($12.09 in chips) 
Seat 5: bubapich ($2.08 in chips) 
Seat 6: XGzeroGX ($2.01 in chips) 
hc agorist: posts small blind $0.01
kingkongkk19: posts big blind $0.02
*** HOLE CARDS ***
Dealt to hc agorist [Kd 6c]
zhx9001: folds 
bubapich: raises $2.06 to $2.08 and is all-in
XGzeroGX: folds 
jaaz241: folds 
hc agorist: folds 
kingkongkk19: folds 
Uncalled bet ($2.06) returned to bubapich
bubapich collected $0.05 from pot
bubapich: doesn't show hand 
*** SUMMARY ***
Total pot $0.05 | Rake $0 
Seat 1: jaaz241 (button) folded before Flop (didn't bet)
Seat 2: hc agorist (small blind) folded before Flop
Seat 3: kingkongkk19 (big blind) folded before Flop
Seat 4: zhx9001 folded before Flop (didn't bet)
Seat 5: bubapich collected ($0.05)
Seat 6: XGzeroGX folded before Flop (didn't bet)



PokerStars Zoom Hand #193804177040:  Hold'em No Limit ($0.01/$0.02) - 2018/11/28 0:23:25 CUST [2018/11/27 11:23:25 ET]
Table 'Halley' 6-max Seat #1 is the button
Seat 1: hc agorist ($1.11 in chips) 
Seat 2: helolele ($2.71 in chips) 
Seat 3: booktable ($2.12 in chips) 
Seat 4: kuLtur3 ($2.01 in chips) 
Seat 5: ninix17 ($3.46 in chips) 
Seat 6: Marcus mrrv ($2.01 in chips) 
helolele: posts small blind $0.01
booktable: posts big blind $0.02
*** HOLE CARDS ***
Dealt to hc agorist [2h 7c]
kuLtur3: folds 
ninix17: raises $0.04 to $0.06
Marcus mrrv: folds 
hc agorist: folds 
helolele: folds 
booktable: folds 
Uncalled bet ($0.04) returned to ninix17
ninix17 collected $0.05 from pot
ninix17: doesn't show hand 
*** SUMMARY ***
Total pot $0.05 | Rake $0 
Seat 1: hc agorist (button) folded before Flop (didn't bet)
Seat 2: helolele (small blind) folded before Flop
Seat 3: booktable (big blind) folded before Flop
Seat 4: kuLtur3 folded before Flop (didn't bet)
Seat 5: ninix17 collected ($0.05)
Seat 6: Marcus mrrv folded before Flop (didn't bet)



PokerStars Zoom Hand #193804183109:  Hold'em No Limit ($0.01/$0.02) - 2018/11/28 0:23:36 CUST [2018/11/27 11:23:36 ET]
Table 'Halley' 6-max Seat #1 is the button
Seat 1: pv2903 ($2.38 in chips) 
Seat 2: liy731 ($3.23 in chips) 
Seat 3: StrikeG312 ($3.13 in chips) 
Seat 4: hc agorist ($1.11 in chips) 
Seat 5: lucaspp051 ($2.05 in chips) 
Seat 6: ecsite1985 ($0.20 in chips) 
liy731: posts small blind $0.01
StrikeG312: posts big blind $0.02
*** HOLE CARDS ***
Dealt to hc agorist [3h 4h]
hc agorist: raises $0.02 to $0.04
lucaspp051: folds 
ecsite1985: folds 
pv2903: folds 
liy731: folds 
StrikeG312: calls $0.02
*** FLOP *** [Th Jd Qs]
StrikeG312: checks 
hc agorist: bets $0.08
StrikeG312: calls $0.08
*** TURN *** [Th Jd Qs] [6d]
StrikeG312: checks 
hc agorist: checks 
*** RIVER *** [Th Jd Qs 6d] [Qc]
StrikeG312: bets $0.14
hc agorist: folds 
Uncalled bet ($0.14) returned to StrikeG312
StrikeG312 collected $0.24 from pot
StrikeG312: doesn't show hand 
*** SUMMARY ***
Total pot $0.25 | Rake $0.01 
Board [Th Jd Qs 6d Qc]
Seat 1: pv2903 (button) folded before Flop (didn't bet)
Seat 2: liy731 (small blind) folded before Flop
Seat 3: StrikeG312 (big blind) collected ($0.24)
Seat 4: hc agorist folded on the River
Seat 5: lucaspp051 folded before Flop (didn't bet)
Seat 6: ecsite1985 folded before Flop (didn't bet)



PokerStars Zoom Hand #193804202119:  Hold'em No Limit ($0.01/$0.02) - 2018/11/28 0:24:10 CUST [2018/11/27 11:24:10 ET]
Table 'Halley' 6-max Seat #1 is the button
Seat 1: Yokirill ($2.17 in chips) 
Seat 2: hc agorist ($0.99 in chips) 
Seat 3: Dannebobbe ($4.18 in chips) 
Seat 4: grajekTeo ($2.24 in chips) 
Seat 5: Ruslan13581 ($5.45 in chips) 
Seat 6: ifuseekamy66 ($2.16 in chips) 
hc agorist: posts small blind $0.01
Dannebobbe: posts big blind $0.02
*** HOLE CARDS ***
Dealt to hc agorist [Jc 6c]
grajekTeo: folds 
Ruslan13581: raises $0.02 to $0.04
ifuseekamy66: folds 
Yokirill: folds 
hc agorist: folds 
Dannebobbe: folds 
Uncalled bet ($0.02) returned to Ruslan13581
Ruslan13581 collected $0.05 from pot
Ruslan13581: doesn't show hand 
*** SUMMARY ***
Total pot $0.05 | Rake $0 
Seat 1: Yokirill (button) folded before Flop (didn't bet)
Seat 2: hc agorist (small blind) folded before Flop
Seat 3: Dannebobbe (big blind) folded before Flop
Seat 4: grajekTeo folded before Flop (didn't bet)
Seat 5: Ruslan13581 collected ($0.05)
Seat 6: ifuseekamy66 folded before Flop (didn't bet)



PokerStars Zoom Hand #193804204884:  Hold'em No Limit ($0.01/$0.02) - 2018/11/28 0:24:15 CUST [2018/11/27 11:24:15 ET]
Table 'Halley' 6-max Seat #1 is the button
Seat 1: walderlee ($1.21 in chips) 
Seat 2: darkoldmaker ($6.81 in chips) 
Seat 3: hc agorist ($0.98 in chips) 
Seat 4: fazanis4e ($3.85 in chips) 
Seat 5: silvabeach ($1.97 in chips) 
Seat 6: K.Belozerov ($1.99 in chips) 
darkoldmaker: posts small blind $0.01
hc agorist: posts big blind $0.02
*** HOLE CARDS ***
Dealt to hc agorist [7h 7d]
fazanis4e: folds 
silvabeach: folds 
K.Belozerov: folds 
walderlee: folds 
darkoldmaker: raises $0.03 to $0.05
hc agorist: raises $0.10 to $0.15
darkoldmaker: calls $0.10
*** FLOP *** [3d 2s As]
darkoldmaker: checks 
hc agorist: checks 
*** TURN *** [3d 2s As] [2c]
darkoldmaker: checks 
hc agorist: bets $0.10
darkoldmaker: calls $0.10
*** RIVER *** [3d 2s As 2c] [4h]
darkoldmaker: checks 
hc agorist: checks 
*** SHOW DOWN ***
darkoldmaker: shows [5c 5s] (a straight, Ace to Five)
hc agorist: mucks hand 
darkoldmaker collected $0.48 from pot
*** SUMMARY ***
Total pot $0.50 | Rake $0.02 
Board [3d 2s As 2c 4h]
Seat 1: walderlee (button) folded before Flop (didn't bet)
Seat 2: darkoldmaker (small blind) showed [5c 5s] and won ($0.48) with a straight, Ace to Five
Seat 3: hc agorist (big blind) mucked [7h 7d]
Seat 4: fazanis4e folded before Flop (didn't bet)
Seat 5: silvabeach folded before Flop (didn't bet)
Seat 6: K.Belozerov folded before Flop (didn't bet)



PokerStars Zoom Hand #193804227242:  Hold'em No Limit ($0.01/$0.02) - 2018/11/28 0:24:55 CUST [2018/11/27 11:24:55 ET]
Table 'Halley' 6-max Seat #1 is the button
Seat 1: PPYPP ($2.51 in chips) 
Seat 2: A.A.P.1977 ($1.91 in chips) 
Seat 3: PsychoticBR ($2.93 in chips) 
Seat 4: RaiseF0rWin ($2 in chips) 
Seat 5: MatiFz11 ($1.88 in chips) 
Seat 6: hc agorist ($0.73 in chips) 
A.A.P.1977: posts small blind $0.01
PsychoticBR: posts big blind $0.02
*** HOLE CARDS ***
Dealt to hc agorist [2h Js]
RaiseF0rWin: folds 
MatiFz11: folds 
hc agorist: folds 
PPYPP: folds 
A.A.P.1977: folds 
Uncalled bet ($0.01) returned to PsychoticBR
PsychoticBR collected $0.02 from pot
PsychoticBR: doesn't show hand 
*** SUMMARY ***
Total pot $0.02 | Rake $0 
Seat 1: PPYPP (button) folded before Flop (didn't bet)
Seat 2: A.A.P.1977 (small blind) folded before Flop
Seat 3: PsychoticBR (big blind) collected ($0.02)
Seat 4: RaiseF0rWin folded before Flop (didn't bet)
Seat 5: MatiFz11 folded before Flop (didn't bet)
Seat 6: hc agorist folded before Flop (didn't bet)



PokerStars Zoom Hand #193804230527:  Hold'em No Limit ($0.01/$0.02) - 2018/11/28 0:25:01 CUST [2018/11/27 11:25:01 ET]
Table 'Halley' 6-max Seat #1 is the button
Seat 1: amaposh ($2 in chips) 
Seat 2: MiuFuringi ($5.31 in chips) 
Seat 3: Ruslan13581 ($2.16 in chips) 
Seat 4: grajekTeo ($3.30 in chips) 
Seat 5: hc agorist ($0.73 in chips) 
Seat 6: Mizzek ($2.62 in chips) 
MiuFuringi: posts small blind $0.01
Ruslan13581: posts big blind $0.02
*** HOLE CARDS ***
Dealt to hc agorist [5s Td]
grajekTeo: raises $0.04 to $0.06
hc agorist: folds 
Mizzek: calls $0.06
amaposh: folds 
MiuFuringi: folds 
Ruslan13581: folds 
*** FLOP *** [3d 2c As]
grajekTeo: bets $0.05
Mizzek: calls $0.05
*** TURN *** [3d 2c As] [Jh]
grajekTeo: checks 
Mizzek: bets $0.09
grajekTeo: calls $0.09
*** RIVER *** [3d 2c As Jh] [2h]
grajekTeo: checks 
Mizzek: checks 
*** SHOW DOWN ***
grajekTeo: shows [Qc Tc] (a pair of Deuces)
Mizzek: shows [8h Ah] (two pair, Aces and Deuces)
Mizzek collected $0.41 from pot
*** SUMMARY ***
Total pot $0.43 | Rake $0.02 
Board [3d 2c As Jh 2h]
Seat 1: amaposh (button) folded before Flop (didn't bet)
Seat 2: MiuFuringi (small blind) folded before Flop
Seat 3: Ruslan13581 (big blind) folded before Flop
Seat 4: grajekTeo showed [Qc Tc] and lost with a pair of Deuces
Seat 5: hc agorist folded before Flop (didn't bet)
Seat 6: Mizzek showed [8h Ah] and won ($0.41) with two pair, Aces and Deuces



PokerStars Zoom Hand #193804237128:  Hold'em No Limit ($0.01/$0.02) - 2018/11/28 0:25:13 CUST [2018/11/27 11:25:13 ET]
Table 'Halley' 6-max Seat #1 is the button
Seat 1: Berserker922 ($3.06 in chips) 
Seat 2: hencego ($1.01 in chips) 
Seat 3: nicemitya ($5.27 in chips) 
Seat 4: MiuFuringi ($5.30 in chips) 
Seat 5: HeyItsM3 ($2.21 in chips) 
Seat 6: hc agorist ($0.73 in chips) 
hencego: posts small blind $0.01
nicemitya: posts big blind $0.02
*** HOLE CARDS ***
Dealt to hc agorist [9d 7h]
MiuFuringi: folds 
HeyItsM3: folds 
hc agorist: folds 
Berserker922: raises $0.03 to $0.05
hencego: folds 
nicemitya: raises $0.13 to $0.18
Berserker922: folds 
Uncalled bet ($0.13) returned to nicemitya
nicemitya collected $0.11 from pot
nicemitya: doesn't show hand 
*** SUMMARY ***
Total pot $0.11 | Rake $0 
Seat 1: Berserker922 (button) folded before Flop
Seat 2: hencego (small blind) folded before Flop
Seat 3: nicemitya (big blind) collected ($0.11)
Seat 4: MiuFuringi folded before Flop (didn't bet)
Seat 5: HeyItsM3 folded before Flop (didn't bet)
Seat 6: hc agorist folded before Flop (didn't bet)



PokerStars Zoom Hand #193804233245:  Hold'em No Limit ($0.01/$0.02) - 2018/11/28 0:25:06 CUST [2018/11/27 11:25:06 ET]
Table 'Halley' 6-max Seat #1 is the button
Seat 1: hc agorist ($0.73 in chips) 
Seat 2: StraightPR0 ($6.59 in chips) 
Seat 3: ninix17 ($2.71 in chips) 
Seat 4: BoJlaHgeMopT ($2.10 in chips) 
Seat 5: Olzhas8905 ($1.30 in chips) 
Seat 6: zsolo480 ($0.93 in chips) 
StraightPR0: posts small blind $0.01
ninix17: posts big blind $0.02
*** HOLE CARDS ***
Dealt to hc agorist [3h Ac]
BoJlaHgeMopT: raises $0.04 to $0.06
Olzhas8905: calls $0.06
zsolo480: folds 
hc agorist: folds 
StraightPR0: folds 
ninix17: folds 
*** FLOP *** [Qd Ah Tc]
BoJlaHgeMopT: checks 
Olzhas8905: checks 
*** TURN *** [Qd Ah Tc] [8s]
BoJlaHgeMopT: checks 
Olzhas8905: checks 
*** RIVER *** [Qd Ah Tc 8s] [Ts]
BoJlaHgeMopT: checks 
Olzhas8905: checks 
*** SHOW DOWN ***
BoJlaHgeMopT: shows [4s 4d] (two pair, Tens and Fours)
Olzhas8905: mucks hand 
BoJlaHgeMopT collected $0.14 from pot
*** SUMMARY ***
Total pot $0.15 | Rake $0.01 
Board [Qd Ah Tc 8s Ts]
Seat 1: hc agorist (button) folded before Flop (didn't bet)
Seat 2: StraightPR0 (small blind) folded before Flop
Seat 3: ninix17 (big blind) folded before Flop
Seat 4: BoJlaHgeMopT showed [4s 4d] and won ($0.14) with two pair, Tens and Fours
Seat 5: Olzhas8905 mucked [Kh 9h]
Seat 6: zsolo480 folded before Flop (didn't bet)



PokerStars Zoom Hand #193804248441:  Hold'em No Limit ($0.01/$0.02) - 2018/11/28 0:25:33 CUST [2018/11/27 11:25:33 ET]
Table 'Halley' 6-max Seat #1 is the button
Seat 1: JBD101 ($2.12 in chips) 
Seat 2: hc agorist ($0.71 in chips) 
Seat 3: hawkzinbr ($1.97 in chips) 
Seat 4: insaneken ($2.40 in chips) 
Seat 5: CuttingCobra ($2 in chips) 
Seat 6: kailass ($2.65 in chips) 
hc agorist: posts small blind $0.01
hawkzinbr: posts big blind $0.02
*** HOLE CARDS ***
Dealt to hc agorist [9h As]
insaneken: folds 
CuttingCobra: raises $0.04 to $0.06
kailass: folds 
JBD101: folds 
hc agorist: folds 
hawkzinbr: folds 
Uncalled bet ($0.04) returned to CuttingCobra
CuttingCobra collected $0.05 from pot
CuttingCobra: doesn't show hand 
*** SUMMARY ***
Total pot $0.05 | Rake $0 
Seat 1: JBD101 (button) folded before Flop (didn't bet)
Seat 2: hc agorist (small blind) folded before Flop
Seat 3: hawkzinbr (big blind) folded before Flop
Seat 4: insaneken folded before Flop (didn't bet)
Seat 5: CuttingCobra collected ($0.05)
Seat 6: kailass folded before Flop (didn't bet)



PokerStars Zoom Hand #193804240599:  Hold'em No Limit ($0.01/$0.02) - 2018/11/28 0:25:19 CUST [2018/11/27 11:25:19 ET]
Table 'Halley' 6-max Seat #1 is the button
Seat 1: anasanto ($2.94 in chips) 
Seat 2: 13044031 ($8.87 in chips) 
Seat 3: hc agorist ($0.73 in chips) 
Seat 4: Neokeynesian ($2 in chips) 
Seat 5: Ruslan13581 ($2.60 in chips) 
Seat 6: LikMnFeta ($2.89 in chips) 
13044031: posts small blind $0.01
hc agorist: posts big blind $0.02
*** HOLE CARDS ***
Dealt to hc agorist [5s 6c]
Neokeynesian: folds 
Ruslan13581: folds 
LikMnFeta: folds 
anasanto: raises $0.03 to $0.05
13044031: calls $0.04
hc agorist: folds 
*** FLOP *** [9s 4s Jh]
13044031: checks 
anasanto: bets $0.09
13044031: folds 
Uncalled bet ($0.09) returned to anasanto
anasanto collected $0.12 from pot
anasanto: doesn't show hand 
*** SUMMARY ***
Total pot $0.12 | Rake $0 
Board [9s 4s Jh]
Seat 1: anasanto (button) collected ($0.12)
Seat 2: 13044031 (small blind) folded on the Flop
Seat 3: hc agorist (big blind) folded before Flop
Seat 4: Neokeynesian folded before Flop (didn't bet)
Seat 5: Ruslan13581 folded before Flop (didn't bet)
Seat 6: LikMnFeta folded before Flop (didn't bet)



PokerStars Zoom Hand #193804258442:  Hold'em No Limit ($0.01/$0.02) - 2018/11/28 0:25:51 CUST [2018/11/27 11:25:51 ET]
Table 'Halley' 6-max Seat #1 is the button
Seat 1: hc agorist ($0.70 in chips) 
Seat 2: dntp ($2 in chips) 
Seat 3: shogi17 ($3.19 in chips) 
Seat 4: SILK207 ($2.19 in chips) 
Seat 5: insaneken ($2.38 in chips) 
Seat 6: Juliks91 ($1.94 in chips) 
dntp: posts small blind $0.01
shogi17: posts big blind $0.02
*** HOLE CARDS ***
Dealt to hc agorist [2c 6c]
SILK207: folds 
insaneken: folds 
Juliks91: raises $0.02 to $0.04
hc agorist: folds 
dntp: folds 
shogi17: folds 
Uncalled bet ($0.02) returned to Juliks91
Juliks91 collected $0.05 from pot
Juliks91: doesn't show hand 
*** SUMMARY ***
Total pot $0.05 | Rake $0 
Seat 1: hc agorist (button) folded before Flop (didn't bet)
Seat 2: dntp (small blind) folded before Flop
Seat 3: shogi17 (big blind) folded before Flop
Seat 4: SILK207 folded before Flop (didn't bet)
Seat 5: insaneken folded before Flop (didn't bet)
Seat 6: Juliks91 collected ($0.05)



PokerStars Zoom Hand #193804255160:  Hold'em No Limit ($0.01/$0.02) - 2018/11/28 0:25:45 CUST [2018/11/27 11:25:45 ET]
Table 'Halley' 6-max Seat #1 is the button
Seat 1: hencego ($1.01 in chips) 
Seat 2: ivan show276 ($2.01 in chips) 
Seat 3: naimscorp ($1.88 in chips) 
Seat 4: hc agorist ($0.70 in chips) 
Seat 5: Foxxe100 ($2.04 in chips) 
Seat 6: VVPcmpn ($1.14 in chips) 
ivan show276: posts small blind $0.01
naimscorp: posts big blind $0.02
*** HOLE CARDS ***
Dealt to hc agorist [6d Jc]
hc agorist: folds 
Foxxe100: folds 
VVPcmpn: raises $0.02 to $0.04
hencego: folds 
ivan show276: folds 
naimscorp: folds 
Uncalled bet ($0.02) returned to VVPcmpn
VVPcmpn collected $0.05 from pot
VVPcmpn: doesn't show hand 
*** SUMMARY ***
Total pot $0.05 | Rake $0 
Seat 1: hencego (button) folded before Flop (didn't bet)
Seat 2: ivan show276 (small blind) folded before Flop
Seat 3: naimscorp (big blind) folded before Flop
Seat 4: hc agorist folded before Flop (didn't bet)
Seat 5: Foxxe100 folded before Flop (didn't bet)
Seat 6: VVPcmpn collected ($0.05)



PokerStars Zoom Hand #193804263988:  Hold'em No Limit ($0.01/$0.02) - 2018/11/28 0:26:01 CUST [2018/11/27 11:26:01 ET]
Table 'Halley' 6-max Seat #1 is the button
Seat 1: modefokerr ($3 in chips) 
Seat 2: high0008 ($2.27 in chips) 
Seat 3: kers474 ($6.66 in chips) 
Seat 4: markiz655 ($2.16 in chips) 
Seat 5: hc agorist ($0.70 in chips) 
Seat 6: 72odonkey ($2.20 in chips) 
high0008: posts small blind $0.01
kers474: posts big blind $0.02
*** HOLE CARDS ***
Dealt to hc agorist [Ac 3h]
markiz655: folds 
hc agorist: folds 
72odonkey: raises $0.04 to $0.06
modefokerr: folds 
high0008: folds 
kers474: folds 
Uncalled bet ($0.04) returned to 72odonkey
72odonkey collected $0.05 from pot
72odonkey: doesn't show hand 
*** SUMMARY ***
Total pot $0.05 | Rake $0 
Seat 1: modefokerr (button) folded before Flop (didn't bet)
Seat 2: high0008 (small blind) folded before Flop
Seat 3: kers474 (big blind) folded before Flop
Seat 4: markiz655 folded before Flop (didn't bet)
Seat 5: hc agorist folded before Flop (didn't bet)
Seat 6: 72odonkey collected ($0.05)



PokerStars Zoom Hand #193804266851:  Hold'em No Limit ($0.01/$0.02) - 2018/11/28 0:26:06 CUST [2018/11/27 11:26:06 ET]
Table 'Halley' 6-max Seat #1 is the button
Seat 1: BoJlaHgeMopT ($2.23 in chips) 
Seat 2: Ericcan007 ($2 in chips) 
Seat 3: iizi21 ($2.37 in chips) 
Seat 4: melse_youth ($2.08 in chips) 
Seat 5: VAKONDA666 ($2.02 in chips) 
Seat 6: hc agorist ($0.70 in chips) 
Ericcan007: posts small blind $0.01
iizi21: posts big blind $0.02
*** HOLE CARDS ***
Dealt to hc agorist [3d 9s]
melse_youth: folds 
VAKONDA666: folds 
hc agorist: folds 
BoJlaHgeMopT: folds 
Ericcan007: raises $0.04 to $0.06
iizi21: folds 
Uncalled bet ($0.04) returned to Ericcan007
Ericcan007 collected $0.04 from pot
Ericcan007: doesn't show hand 
*** SUMMARY ***
Total pot $0.04 | Rake $0 
Seat 1: BoJlaHgeMopT (button) folded before Flop (didn't bet)
Seat 2: Ericcan007 (small blind) collected ($0.04)
Seat 3: iizi21 (big blind) folded before Flop
Seat 4: melse_youth folded before Flop (didn't bet)
Seat 5: VAKONDA666 folded before Flop (didn't bet)
Seat 6: hc agorist folded before Flop (didn't bet)



PokerStars Zoom Hand #193804271314:  Hold'em No Limit ($0.01/$0.02) - 2018/11/28 0:26:14 CUST [2018/11/27 11:26:14 ET]
Table 'Halley' 6-max Seat #1 is the button
Seat 1: juliPMK ($2 in chips) 
Seat 2: StrikeG312 ($2.68 in chips) 
Seat 3: 1FIC ($2.82 in chips) 
Seat 4: hc agorist ($0.70 in chips) 
Seat 5: CuttingCobra ($2.21 in chips) 
Seat 6: laggi^tl0 ($0.83 in chips) 
StrikeG312: posts small blind $0.01
1FIC: posts big blind $0.02
*** HOLE CARDS ***
Dealt to hc agorist [8d Qh]
hc agorist: folds 
CuttingCobra: folds 
laggi^tl0: folds 
juliPMK: folds 
StrikeG312: raises $0.04 to $0.06
1FIC: folds 
Uncalled bet ($0.04) returned to StrikeG312
StrikeG312 collected $0.04 from pot
StrikeG312: doesn't show hand 
*** SUMMARY ***
Total pot $0.04 | Rake $0 
Seat 1: juliPMK (button) folded before Flop (didn't bet)
Seat 2: StrikeG312 (small blind) collected ($0.04)
Seat 3: 1FIC (big blind) folded before Flop
Seat 4: hc agorist folded before Flop (didn't bet)
Seat 5: CuttingCobra folded before Flop (didn't bet)
Seat 6: laggi^tl0 folded before Flop (didn't bet)



PokerStars Zoom Hand #193804277510:  Hold'em No Limit ($0.01/$0.02) - 2018/11/28 0:26:25 CUST [2018/11/27 11:26:25 ET]
Table 'Halley' 6-max Seat #1 is the button
Seat 1: fcj12 ($4.09 in chips) 
Seat 2: Karel33555 ($0.91 in chips) 
Seat 3: hc agorist ($0.70 in chips) 
Seat 4: skendroshen ($2.13 in chips) 
Seat 5: Foxxe100 ($2.16 in chips) 
Seat 6: Juliks91 ($1.98 in chips) 
Karel33555: posts small blind $0.01
hc agorist: posts big blind $0.02
*** HOLE CARDS ***
Dealt to hc agorist [Th Qs]
skendroshen: folds 
Foxxe100: folds 
Juliks91: folds 
fcj12: folds 
Karel33555: folds 
Uncalled bet ($0.01) returned to hc agorist
hc agorist collected $0.02 from pot
hc agorist: doesn't show hand 
*** SUMMARY ***
Total pot $0.02 | Rake $0 
Seat 1: fcj12 (button) folded before Flop (didn't bet)
Seat 2: Karel33555 (small blind) folded before Flop
Seat 3: hc agorist (big blind) collected ($0.02)
Seat 4: skendroshen folded before Flop (didn't bet)
Seat 5: Foxxe100 folded before Flop (didn't bet)
Seat 6: Juliks91 folded before Flop (didn't bet)



PokerStars Zoom Hand #193804287168:  Hold'em No Limit ($0.01/$0.02) - 2018/11/28 0:26:42 CUST [2018/11/27 11:26:42 ET]
Table 'Halley' 6-max Seat #1 is the button
Seat 1: ZeusCMR ($1.92 in chips) 
Seat 2: hc agorist ($0.71 in chips) 
Seat 3: Fixmenem ($2.17 in chips) 
Seat 4: gimod66 ($2.17 in chips) 
Seat 5: bubapich ($2.17 in chips) 
Seat 6: swraider ($2.93 in chips) 
hc agorist: posts small blind $0.01
Fixmenem: posts big blind $0.02
*** HOLE CARDS ***
Dealt to hc agorist [Kh Qc]
gimod66: folds 
bubapich: folds 
swraider: folds 
ZeusCMR: folds 
hc agorist: raises $0.04 to $0.06
Fixmenem: folds 
Uncalled bet ($0.04) returned to hc agorist
hc agorist collected $0.04 from pot
hc agorist: doesn't show hand 
*** SUMMARY ***
Total pot $0.04 | Rake $0 
Seat 1: ZeusCMR (button) folded before Flop (didn't bet)
Seat 2: hc agorist (small blind) collected ($0.04)
Seat 3: Fixmenem (big blind) folded before Flop
Seat 4: gimod66 folded before Flop (didn't bet)
Seat 5: bubapich folded before Flop (didn't bet)
Seat 6: swraider folded before Flop (didn't bet)



PokerStars Zoom Hand #193804283758:  Hold'em No Limit ($0.01/$0.02) - 2018/11/28 0:26:36 CUST [2018/11/27 11:26:36 ET]
Table 'Halley' 6-max Seat #1 is the button
Seat 1: Lakchenko ($1.26 in chips) 
Seat 2: DudMeister ($2 in chips) 
Seat 3: joelox25 ($2.08 in chips) 
Seat 4: Fillippe M. ($2.02 in chips) 
Seat 5: hc agorist ($0.71 in chips) 
Seat 6: Foxxe100 ($2.10 in chips) 
DudMeister: posts small blind $0.01
joelox25: posts big blind $0.02
*** HOLE CARDS ***
Dealt to hc agorist [9d 3s]
Fillippe M.: folds 
hc agorist: folds 
Foxxe100: folds 
Lakchenko: raises $0.03 to $0.05
DudMeister: raises $0.12 to $0.17
joelox25: folds 
Lakchenko: folds 
Uncalled bet ($0.12) returned to DudMeister
DudMeister collected $0.12 from pot
DudMeister: doesn't show hand 
*** SUMMARY ***
Total pot $0.12 | Rake $0 
Seat 1: Lakchenko (button) folded before Flop
Seat 2: DudMeister (small blind) collected ($0.12)
Seat 3: joelox25 (big blind) folded before Flop
Seat 4: Fillippe M. folded before Flop (didn't bet)
Seat 5: hc agorist folded before Flop (didn't bet)
Seat 6: Foxxe100 folded before Flop (didn't bet)



PokerStars Zoom Hand #193804274114:  Hold'em No Limit ($0.01/$0.02) - 2018/11/28 0:26:19 CUST [2018/11/27 11:26:19 ET]
Table 'Halley' 6-max Seat #1 is the button
Seat 1: Fillippe M. ($2 in chips) 
Seat 2: ivan show276 ($2.77 in chips) 
Seat 3: Aegeides ($2.73 in chips) 
Seat 4: hc agorist ($0.70 in chips) 
Seat 5: uty123381 ($0.27 in chips) 
Seat 6: insaneken ($1.73 in chips) 
ivan show276: posts small blind $0.01
Aegeides: posts big blind $0.02
*** HOLE CARDS ***
Dealt to hc agorist [Qd 9h]
hc agorist: folds 
uty123381: calls $0.02
insaneken: folds 
Fillippe M.: raises $0.08 to $0.10
ivan show276: folds 
Aegeides: folds 
uty123381: calls $0.08
*** FLOP *** [4d 9c 4c]
uty123381: checks 
Fillippe M.: checks 
*** TURN *** [4d 9c 4c] [5h]
uty123381: checks 
Fillippe M.: checks 
*** RIVER *** [4d 9c 4c 5h] [3h]
uty123381: checks 
Fillippe M.: checks 
*** SHOW DOWN ***
uty123381: shows [3s Ah] (two pair, Fours and Threes)
Fillippe M.: mucks hand 
uty123381 collected $0.22 from pot
*** SUMMARY ***
Total pot $0.23 | Rake $0.01 
Board [4d 9c 4c 5h 3h]
Seat 1: Fillippe M. (button) mucked [As Qs]
Seat 2: ivan show276 (small blind) folded before Flop
Seat 3: Aegeides (big blind) folded before Flop
Seat 4: hc agorist folded before Flop (didn't bet)
Seat 5: uty123381 showed [3s Ah] and won ($0.22) with two pair, Fours and Threes
Seat 6: insaneken folded before Flop (didn't bet)



PokerStars Zoom Hand #193804296669:  Hold'em No Limit ($0.01/$0.02) - 2018/11/28 0:26:59 CUST [2018/11/27 11:26:59 ET]
Table 'Halley' 6-max Seat #1 is the button
Seat 1: hc agorist ($0.73 in chips) 
Seat 2: BaSkeD174 ($1.01 in chips) 
Seat 3: Romannlk ($5.79 in chips) 
Seat 4: Pilich1234 ($2.01 in chips) 
Seat 5: Venn7 ($4.64 in chips) 
Seat 6: Bloodclub94 ($2 in chips) 
BaSkeD174: posts small blind $0.01
Romannlk: posts big blind $0.02
*** HOLE CARDS ***
Dealt to hc agorist [9c 7c]
Pilich1234: folds 
Venn7: folds 
Bloodclub94: folds 
hc agorist: raises $0.02 to $0.04
BaSkeD174: calls $0.03
Romannlk: calls $0.02
*** FLOP *** [Jd Tc Kc]
BaSkeD174: checks 
Romannlk: bets $0.04
hc agorist: calls $0.04
BaSkeD174: calls $0.04
*** TURN *** [Jd Tc Kc] [Jc]
BaSkeD174: checks 
Romannlk: checks 
hc agorist: bets $0.18
BaSkeD174: folds 
Romannlk: folds 
Uncalled bet ($0.18) returned to hc agorist
hc agorist collected $0.23 from pot
hc agorist: doesn't show hand 
*** SUMMARY ***
Total pot $0.24 | Rake $0.01 
Board [Jd Tc Kc Jc]
Seat 1: hc agorist (button) collected ($0.23)
Seat 2: BaSkeD174 (small blind) folded on the Turn
Seat 3: Romannlk (big blind) folded on the Turn
Seat 4: Pilich1234 folded before Flop (didn't bet)
Seat 5: Venn7 folded before Flop (didn't bet)
Seat 6: Bloodclub94 folded before Flop (didn't bet)



PokerStars Zoom Hand #193804335542:  Hold'em No Limit ($0.01/$0.02) - 2018/11/28 0:28:08 CUST [2018/11/27 11:28:08 ET]
Table 'Halley' 6-max Seat #1 is the button
Seat 1: Fixmenem ($2 in chips) 
Seat 2: onkel198431 ($2.93 in chips) 
Seat 3: AGT1960 ($2.18 in chips) 
Seat 4: darkoldmaker ($6.14 in chips) 
Seat 5: hc agorist ($0.84 in chips) 
Seat 6: glaci153 ($0.78 in chips) 
onkel198431: posts small blind $0.01
AGT1960: posts big blind $0.02
*** HOLE CARDS ***
Dealt to hc agorist [8h 8d]
darkoldmaker: folds 
hc agorist: raises $0.04 to $0.06
glaci153: folds 
Fixmenem: folds 
onkel198431: folds 
AGT1960: folds 
Uncalled bet ($0.04) returned to hc agorist
hc agorist collected $0.05 from pot
hc agorist: doesn't show hand 
*** SUMMARY ***
Total pot $0.05 | Rake $0 
Seat 1: Fixmenem (button) folded before Flop (didn't bet)
Seat 2: onkel198431 (small blind) folded before Flop
Seat 3: AGT1960 (big blind) folded before Flop
Seat 4: darkoldmaker folded before Flop (didn't bet)
Seat 5: hc agorist collected ($0.05)
Seat 6: glaci153 folded before Flop (didn't bet)



PokerStars Zoom Hand #193804316422:  Hold'em No Limit ($0.01/$0.02) - 2018/11/28 0:27:34 CUST [2018/11/27 11:27:34 ET]
Table 'Halley' 6-max Seat #1 is the button
Seat 1: JBD101 ($3.81 in chips) 
Seat 2: serge87100 ($2.36 in chips) 
Seat 3: hc agorist ($0.88 in chips) 
Seat 4: xtwocardsx ($4.09 in chips) 
Seat 5: valdes755 ($1 in chips) 
Seat 6: Nossna ($2.58 in chips) 
serge87100: posts small blind $0.01
hc agorist: posts big blind $0.02
*** HOLE CARDS ***
Dealt to hc agorist [Td 8s]
xtwocardsx: raises $0.02 to $0.04
valdes755: calls $0.04
Nossna: folds 
JBD101: folds 
serge87100: folds 
hc agorist: calls $0.02
*** FLOP *** [As Jd Jh]
hc agorist: checks 
xtwocardsx: checks 
valdes755: checks 
*** TURN *** [As Jd Jh] [Jc]
hc agorist: checks 
xtwocardsx: checks 
valdes755: bets $0.06
hc agorist: folds 
xtwocardsx: calls $0.06
*** RIVER *** [As Jd Jh Jc] [6d]
xtwocardsx: checks 
valdes755: bets $0.24
xtwocardsx: calls $0.24
*** SHOW DOWN ***
valdes755: shows [Ts Js] (four of a kind, Jacks)
xtwocardsx: mucks hand 
valdes755 collected $0.70 from pot
*** SUMMARY ***
Total pot $0.73 | Rake $0.03 
Board [As Jd Jh Jc 6d]
Seat 1: JBD101 (button) folded before Flop (didn't bet)
Seat 2: serge87100 (small blind) folded before Flop
Seat 3: hc agorist (big blind) folded on the Turn
Seat 4: xtwocardsx mucked [Kd Th]
Seat 5: valdes755 showed [Ts Js] and won ($0.70) with four of a kind, Jacks
Seat 6: Nossna folded before Flop (didn't bet)



PokerStars Zoom Hand #193804351231:  Hold'em No Limit ($0.01/$0.02) - 2018/11/28 0:28:36 CUST [2018/11/27 11:28:36 ET]
Table 'Halley' 6-max Seat #1 is the button
Seat 1: nikolai55556 ($1.06 in chips) 
Seat 2: ale3810 ($1.63 in chips) 
Seat 3: P.Cogito ($2 in chips) 
Seat 4: hc agorist ($0.86 in chips) 
Seat 5: mitsinis ($2.20 in chips) 
Seat 6: Petra-Fox ($1.89 in chips) 
ale3810: posts small blind $0.01
P.Cogito: posts big blind $0.02
*** HOLE CARDS ***
Dealt to hc agorist [9d Jc]
hc agorist: folds 
mitsinis: folds 
Petra-Fox: folds 
nikolai55556: folds 
ale3810: folds 
Uncalled bet ($0.01) returned to P.Cogito
P.Cogito collected $0.02 from pot
P.Cogito: doesn't show hand 
*** SUMMARY ***
Total pot $0.02 | Rake $0 
Seat 1: nikolai55556 (button) folded before Flop (didn't bet)
Seat 2: ale3810 (small blind) folded before Flop
Seat 3: P.Cogito (big blind) collected ($0.02)
Seat 4: hc agorist folded before Flop (didn't bet)
Seat 5: mitsinis folded before Flop (didn't bet)
Seat 6: Petra-Fox folded before Flop (didn't bet)



PokerStars Zoom Hand #193804347823:  Hold'em No Limit ($0.01/$0.02) - 2018/11/28 0:28:30 CUST [2018/11/27 11:28:30 ET]
Table 'Halley' 6-max Seat #1 is the button
Seat 1: demon7521 ($3.87 in chips) 
Seat 2: hc agorist ($0.87 in chips) 
Seat 3: Ruslan13581 ($5.21 in chips) 
Seat 4: easywtf ($1.91 in chips) 
Seat 5: Maximus122 ($3.78 in chips) 
Seat 6: Dannebobbe ($10.65 in chips) 
hc agorist: posts small blind $0.01
Ruslan13581: posts big blind $0.02
*** HOLE CARDS ***
Dealt to hc agorist [2s Td]
easywtf: folds 
Maximus122: folds 
Dannebobbe: folds 
demon7521: raises $0.04 to $0.06
hc agorist: folds 
Ruslan13581: folds 
Uncalled bet ($0.04) returned to demon7521
demon7521 collected $0.05 from pot
demon7521: doesn't show hand 
*** SUMMARY ***
Total pot $0.05 | Rake $0 
Seat 1: demon7521 (button) collected ($0.05)
Seat 2: hc agorist (small blind) folded before Flop
Seat 3: Ruslan13581 (big blind) folded before Flop
Seat 4: easywtf folded before Flop (didn't bet)
Seat 5: Maximus122 folded before Flop (didn't bet)
Seat 6: Dannebobbe folded before Flop (didn't bet)



PokerStars Zoom Hand #193804342721:  Hold'em No Limit ($0.01/$0.02) - 2018/11/28 0:28:21 CUST [2018/11/27 11:28:21 ET]
Table 'Halley' 6-max Seat #1 is the button
Seat 1: AdamFlorin25 ($1.48 in chips) 
Seat 2: papydom0727 ($1.63 in chips) 
Seat 3: oleg25552 ($0.94 in chips) 
Seat 4: Lehavorkuta ($2.54 in chips) 
Seat 5: PugoGrasse ($2.99 in chips) 
Seat 6: hc agorist ($0.87 in chips) 
papydom0727: posts small blind $0.01
oleg25552: posts big blind $0.02
*** HOLE CARDS ***
Dealt to hc agorist [3s Kd]
Lehavorkuta: folds 
PugoGrasse: folds 
hc agorist: folds 
AdamFlorin25: folds 
papydom0727: calls $0.01
oleg25552: checks 
*** FLOP *** [Qs 7s Qc]
papydom0727: bets $0.04
oleg25552: folds 
Uncalled bet ($0.04) returned to papydom0727
papydom0727 collected $0.04 from pot
papydom0727: doesn't show hand 
*** SUMMARY ***
Total pot $0.04 | Rake $0 
Board [Qs 7s Qc]
Seat 1: AdamFlorin25 (button) folded before Flop (didn't bet)
Seat 2: papydom0727 (small blind) collected ($0.04)
Seat 3: oleg25552 (big blind) folded on the Flop
Seat 4: Lehavorkuta folded before Flop (didn't bet)
Seat 5: PugoGrasse folded before Flop (didn't bet)
Seat 6: hc agorist folded before Flop (didn't bet)



PokerStars Zoom Hand #193804344978:  Hold'em No Limit ($0.01/$0.02) - 2018/11/28 0:28:25 CUST [2018/11/27 11:28:25 ET]
Table 'Halley' 6-max Seat #1 is the button
Seat 1: hc agorist ($0.87 in chips) 
Seat 2: Alexarulit ($2.06 in chips) 
Seat 3: olegan.o94 ($0.75 in chips) 
Seat 4: valdes755 ($1.36 in chips) 
Seat 5: Lawrence$lim ($2 in chips) 
Seat 6: Qwkl ($2.51 in chips) 
Alexarulit: posts small blind $0.01
olegan.o94: posts big blind $0.02
*** HOLE CARDS ***
Dealt to hc agorist [9d 5d]
valdes755: folds 
Lawrence$lim: folds 
Qwkl: folds 
hc agorist: folds 
Alexarulit: raises $0.03 to $0.05
olegan.o94: raises $0.10 to $0.15
Alexarulit: calls $0.10
*** FLOP *** [9s Ks 3d]
Alexarulit: checks 
olegan.o94: bets $0.15
Alexarulit: calls $0.15
*** TURN *** [9s Ks 3d] [Kd]
Alexarulit: checks 
olegan.o94: bets $0.45 and is all-in
Alexarulit: folds 
Uncalled bet ($0.45) returned to olegan.o94
olegan.o94 collected $0.58 from pot
olegan.o94: doesn't show hand 
*** SUMMARY ***
Total pot $0.60 | Rake $0.02 
Board [9s Ks 3d Kd]
Seat 1: hc agorist (button) folded before Flop (didn't bet)
Seat 2: Alexarulit (small blind) folded on the Turn
Seat 3: olegan.o94 (big blind) collected ($0.58)
Seat 4: valdes755 folded before Flop (didn't bet)
Seat 5: Lawrence$lim folded before Flop (didn't bet)
Seat 6: Qwkl folded before Flop (didn't bet)



PokerStars Zoom Hand #193804357519:  Hold'em No Limit ($0.01/$0.02) - 2018/11/28 0:28:47 CUST [2018/11/27 11:28:47 ET]
Table 'Halley' 6-max Seat #1 is the button
Seat 1: fazanis4e ($2 in chips) 
Seat 2: dyingSun ($2.29 in chips) 
Seat 3: hc agorist ($0.86 in chips) 
Seat 4: Petra-Fox ($1.89 in chips) 
Seat 5: the_n3w3r_guy ($2 in chips) 
Seat 6: maplenuts ($2.92 in chips) 
dyingSun: posts small blind $0.01
hc agorist: posts big blind $0.02
*** HOLE CARDS ***
Dealt to hc agorist [9d Ks]
Petra-Fox: folds 
the_n3w3r_guy: folds 
maplenuts: raises $0.02 to $0.04
fazanis4e: folds 
dyingSun: folds 
hc agorist: calls $0.02
*** FLOP *** [Td 5c 4c]
hc agorist: checks 
maplenuts: bets $0.09
hc agorist: folds 
Uncalled bet ($0.09) returned to maplenuts
maplenuts collected $0.09 from pot
maplenuts: doesn't show hand 
*** SUMMARY ***
Total pot $0.09 | Rake $0 
Board [Td 5c 4c]
Seat 1: fazanis4e (button) folded before Flop (didn't bet)
Seat 2: dyingSun (small blind) folded before Flop
Seat 3: hc agorist (big blind) folded on the Flop
Seat 4: Petra-Fox folded before Flop (didn't bet)
Seat 5: the_n3w3r_guy folded before Flop (didn't bet)
Seat 6: maplenuts collected ($0.09)



PokerStars Zoom Hand #193804379230:  Hold'em No Limit ($0.01/$0.02) - 2018/11/28 0:29:26 CUST [2018/11/27 11:29:26 ET]
Table 'Halley' 6-max Seat #1 is the button
Seat 1: tihatan ($2.04 in chips) 
Seat 2: hc agorist ($0.82 in chips) 
Seat 3: Johneik ($2 in chips) 
Seat 4: Belgatoy ($1.97 in chips) 
Seat 5: hsienko ($2.07 in chips) 
Seat 6: CEP}I{bIK ($1.97 in chips) 
hc agorist: posts small blind $0.01
Johneik: posts big blind $0.02
*** HOLE CARDS ***
Dealt to hc agorist [Js Ac]
Belgatoy: folds 
hsienko: folds 
CEP}I{bIK: folds 
tihatan: raises $0.03 to $0.05
hc agorist: raises $0.15 to $0.20
Johneik: folds 
tihatan: calls $0.15
*** FLOP *** [5s Tc 4c]
hc agorist: bets $0.62 and is all-in
tihatan: folds 
Uncalled bet ($0.62) returned to hc agorist
hc agorist collected $0.41 from pot
hc agorist: doesn't show hand 
*** SUMMARY ***
Total pot $0.42 | Rake $0.01 
Board [5s Tc 4c]
Seat 1: tihatan (button) folded on the Flop
Seat 2: hc agorist (small blind) collected ($0.41)
Seat 3: Johneik (big blind) folded before Flop
Seat 4: Belgatoy folded before Flop (didn't bet)
Seat 5: hsienko folded before Flop (didn't bet)
Seat 6: CEP}I{bIK folded before Flop (didn't bet)



PokerStars Zoom Hand #193804354659:  Hold'em No Limit ($0.01/$0.02) - 2018/11/28 0:28:42 CUST [2018/11/27 11:28:42 ET]
Table 'Halley' 6-max Seat #1 is the button
Seat 1: jaaz241 ($4.70 in chips) 
Seat 2: demon7521 ($2.13 in chips) 
Seat 3: Maximus122 ($3.77 in chips) 
Seat 4: heisenbucket ($2.01 in chips) 
Seat 5: hc agorist ($0.86 in chips) 
Seat 6: Hopladi ($1.70 in chips) 
demon7521: posts small blind $0.01
Maximus122: posts big blind $0.02
*** HOLE CARDS ***
Dealt to hc agorist [2d 3h]
heisenbucket: raises $0.04 to $0.06
hc agorist: folds 
Hopladi: calls $0.06
jaaz241: folds 
demon7521: calls $0.05
Maximus122: calls $0.04
*** FLOP *** [5h Ac 5s]
demon7521: checks 
Maximus122: checks 
heisenbucket: checks 
Hopladi: bets $0.08
demon7521: folds 
Maximus122: folds 
heisenbucket: calls $0.08
*** TURN *** [5h Ac 5s] [Jd]
heisenbucket: checks 
Hopladi: checks 
*** RIVER *** [5h Ac 5s Jd] [3c]
heisenbucket: bets $0.34
Hopladi: calls $0.34
*** SHOW DOWN ***
heisenbucket: shows [Jc As] (two pair, Aces and Jacks)
Hopladi: mucks hand 
heisenbucket collected $1.04 from pot
*** SUMMARY ***
Total pot $1.08 | Rake $0.04 
Board [5h Ac 5s Jd 3c]
Seat 1: jaaz241 (button) folded before Flop (didn't bet)
Seat 2: demon7521 (small blind) folded on the Flop
Seat 3: Maximus122 (big blind) folded on the Flop
Seat 4: heisenbucket showed [Jc As] and won ($1.04) with two pair, Aces and Jacks
Seat 5: hc agorist folded before Flop (didn't bet)
Seat 6: Hopladi mucked [Ah Ts]



PokerStars Zoom Hand #193804393903:  Hold'em No Limit ($0.01/$0.02) - 2018/11/28 0:29:52 CUST [2018/11/27 11:29:52 ET]
Table 'Halley' 6-max Seat #1 is the button
Seat 1: easywtf ($7.20 in chips) 
Seat 2: high0008 ($2.63 in chips) 
Seat 3: Tmalikis1 ($4.75 in chips) 
Seat 4: flex03041978 ($1.05 in chips) 
Seat 5: birgitt69 ($0.96 in chips) 
Seat 6: hc agorist ($1.03 in chips) 
high0008: posts small blind $0.01
Tmalikis1: posts big blind $0.02
*** HOLE CARDS ***
Dealt to hc agorist [Jd 9d]
flex03041978: folds 
birgitt69: folds 
hc agorist: raises $0.02 to $0.04
easywtf: folds 
high0008: folds 
Tmalikis1: calls $0.02
*** FLOP *** [2h Ah 8s]
Tmalikis1: checks 
hc agorist: bets $0.03
Tmalikis1: folds 
Uncalled bet ($0.03) returned to hc agorist
hc agorist collected $0.09 from pot
hc agorist: doesn't show hand 
*** SUMMARY ***
Total pot $0.09 | Rake $0 
Board [2h Ah 8s]
Seat 1: easywtf (button) folded before Flop (didn't bet)
Seat 2: high0008 (small blind) folded before Flop
Seat 3: Tmalikis1 (big blind) folded on the Flop
Seat 4: flex03041978 folded before Flop (didn't bet)
Seat 5: birgitt69 folded before Flop (didn't bet)
Seat 6: hc agorist collected ($0.09)



PokerStars Zoom Hand #193804409283:  Hold'em No Limit ($0.01/$0.02) - 2018/11/28 0:30:19 CUST [2018/11/27 11:30:19 ET]
Table 'Halley' 6-max Seat #1 is the button
Seat 1: XGzeroGX ($2.30 in chips) 
Seat 2: VVPcmpn ($1.40 in chips) 
Seat 3: Maximus122 ($3.70 in chips) 
Seat 4: Agno$tic ($2 in chips) 
Seat 5: hc agorist ($1.08 in chips) 
Seat 6: psychopathko ($2.34 in chips) 
VVPcmpn: posts small blind $0.01
Maximus122: posts big blind $0.02
*** HOLE CARDS ***
Dealt to hc agorist [3c Ks]
Agno$tic: folds 
hc agorist: folds 
psychopathko: folds 
XGzeroGX: folds 
VVPcmpn: folds 
Uncalled bet ($0.01) returned to Maximus122
Maximus122 collected $0.02 from pot
Maximus122: doesn't show hand 
*** SUMMARY ***
Total pot $0.02 | Rake $0 
Seat 1: XGzeroGX (button) folded before Flop (didn't bet)
Seat 2: VVPcmpn (small blind) folded before Flop
Seat 3: Maximus122 (big blind) collected ($0.02)
Seat 4: Agno$tic folded before Flop (didn't bet)
Seat 5: hc agorist folded before Flop (didn't bet)
Seat 6: psychopathko folded before Flop (didn't bet)



PokerStars Zoom Hand #193804414932:  Hold'em No Limit ($0.01/$0.02) - 2018/11/28 0:30:29 CUST [2018/11/27 11:30:29 ET]
Table 'Halley' 6-max Seat #1 is the button
Seat 1: MariandeDios ($1.91 in chips) 
Seat 2: hc agorist ($1.08 in chips) 
Seat 3: nu_jtiu2007 ($2.71 in chips) 
Seat 4: Daikid0110 ($1.81 in chips) 
Seat 5: SKANER BY ($4.01 in chips) 
Seat 6: D4ns3n ($4.12 in chips) 
hc agorist: posts small blind $0.01
nu_jtiu2007: posts big blind $0.02
*** HOLE CARDS ***
Dealt to hc agorist [9s Ah]
Daikid0110: folds 
SKANER BY: folds 
D4ns3n: folds 
MariandeDios: folds 
hc agorist: raises $0.02 to $0.04
nu_jtiu2007: folds 
Uncalled bet ($0.02) returned to hc agorist
hc agorist collected $0.04 from pot
hc agorist: doesn't show hand 
*** SUMMARY ***
Total pot $0.04 | Rake $0 
Seat 1: MariandeDios (button) folded before Flop (didn't bet)
Seat 2: hc agorist (small blind) collected ($0.04)
Seat 3: nu_jtiu2007 (big blind) folded before Flop
Seat 4: Daikid0110 folded before Flop (didn't bet)
Seat 5: SKANER BY folded before Flop (didn't bet)
Seat 6: D4ns3n folded before Flop (didn't bet)



PokerStars Zoom Hand #193804406243:  Hold'em No Limit ($0.01/$0.02) - 2018/11/28 0:30:14 CUST [2018/11/27 11:30:14 ET]
Table 'Halley' 6-max Seat #1 is the button
Seat 1: hc agorist ($1.08 in chips) 
Seat 2: gary01407 ($3.86 in chips) 
Seat 3: oleg25552 ($0.72 in chips) 
Seat 4: kingkongkk19 ($3.79 in chips) 
Seat 5: skorpions62 ($2.01 in chips) 
Seat 6: Qwkl ($2 in chips) 
gary01407: posts small blind $0.01
oleg25552: posts big blind $0.02
*** HOLE CARDS ***
Dealt to hc agorist [5c 3h]
kingkongkk19: folds 
skorpions62: raises $0.02 to $0.04
Qwkl: folds 
hc agorist: folds 
gary01407: folds 
oleg25552: calls $0.02
*** FLOP *** [Qs As 7h]
oleg25552: bets $0.05
skorpions62: calls $0.05
*** TURN *** [Qs As 7h] [3s]
oleg25552: bets $0.02
skorpions62: calls $0.02
*** RIVER *** [Qs As 7h 3s] [9d]
oleg25552: bets $0.12
skorpions62: folds 
Uncalled bet ($0.12) returned to oleg25552
oleg25552 collected $0.22 from pot
oleg25552: doesn't show hand 
*** SUMMARY ***
Total pot $0.23 | Rake $0.01 
Board [Qs As 7h 3s 9d]
Seat 1: hc agorist (button) folded before Flop (didn't bet)
Seat 2: gary01407 (small blind) folded before Flop
Seat 3: oleg25552 (big blind) collected ($0.22)
Seat 4: kingkongkk19 folded before Flop (didn't bet)
Seat 5: skorpions62 folded on the River
Seat 6: Qwkl folded before Flop (didn't bet)



PokerStars Zoom Hand #193804412140:  Hold'em No Limit ($0.01/$0.02) - 2018/11/28 0:30:24 CUST [2018/11/27 11:30:24 ET]
Table 'Halley' 6-max Seat #1 is the button
Seat 1: 3Iver's3 ($2.03 in chips) 
Seat 2: waswaz332 ($2 in chips) 
Seat 3: logoswort ($2 in chips) 
Seat 4: skseek ($2.11 in chips) 
Seat 5: SweetOli ($2.04 in chips) 
Seat 6: hc agorist ($1.08 in chips) 
waswaz332: posts small blind $0.01
logoswort: posts big blind $0.02
*** HOLE CARDS ***
Dealt to hc agorist [Qs 2c]
skseek: folds 
SweetOli: raises $0.02 to $0.04
hc agorist: folds 
3Iver's3: folds 
waswaz332: folds 
logoswort: calls $0.02
*** FLOP *** [As 6s 3h]
logoswort: checks 
SweetOli: checks 
*** TURN *** [As 6s 3h] [6d]
logoswort: bets $0.06
SweetOli: folds 
Uncalled bet ($0.06) returned to logoswort
logoswort collected $0.09 from pot
logoswort: doesn't show hand 
*** SUMMARY ***
Total pot $0.09 | Rake $0 
Board [As 6s 3h 6d]
Seat 1: 3Iver's3 (button) folded before Flop (didn't bet)
Seat 2: waswaz332 (small blind) folded before Flop
Seat 3: logoswort (big blind) collected ($0.09)
Seat 4: skseek folded before Flop (didn't bet)
Seat 5: SweetOli folded on the Turn
Seat 6: hc agorist folded before Flop (didn't bet)



PokerStars Zoom Hand #193804428389:  Hold'em No Limit ($0.01/$0.02) - 2018/11/28 0:30:53 CUST [2018/11/27 11:30:53 ET]
Table 'Halley' 6-max Seat #1 is the button
Seat 1: léitau ($2 in chips) 
Seat 2: dinarik1104 ($1.28 in chips) 
Seat 3: hc agorist ($1.10 in chips) 
Seat 4: high0008 ($2.25 in chips) 
Seat 5: batiatus72 ($1.14 in chips) 
Seat 6: diddldoc ($1.02 in chips) 
dinarik1104: posts small blind $0.01
hc agorist: posts big blind $0.02
*** HOLE CARDS ***
Dealt to hc agorist [Qc 6h]
high0008: folds 
batiatus72: folds 
diddldoc: folds 
léitau: folds 
dinarik1104: folds 
Uncalled bet ($0.01) returned to hc agorist
hc agorist collected $0.02 from pot
hc agorist: doesn't show hand 
*** SUMMARY ***
Total pot $0.02 | Rake $0 
Seat 1: léitau (button) folded before Flop (didn't bet)
Seat 2: dinarik1104 (small blind) folded before Flop
Seat 3: hc agorist (big blind) collected ($0.02)
Seat 4: high0008 folded before Flop (didn't bet)
Seat 5: batiatus72 folded before Flop (didn't bet)
Seat 6: diddldoc folded before Flop (didn't bet)



PokerStars Zoom Hand #193804423272:  Hold'em No Limit ($0.01/$0.02) - 2018/11/28 0:30:44 CUST [2018/11/27 11:30:44 ET]
Table 'Halley' 6-max Seat #1 is the button
Seat 1: hc agorist ($1.10 in chips) 
Seat 2: pkr_str3368 ($2.01 in chips) 
Seat 3: CEP}I{bIK ($1.96 in chips) 
Seat 4: Lawrence$lim ($2.01 in chips) 
Seat 5: soldim327 ($2.12 in chips) 
Seat 6: Venn7 ($6.02 in chips) 
pkr_str3368: posts small blind $0.01
CEP}I{bIK: posts big blind $0.02
*** HOLE CARDS ***
Dealt to hc agorist [3h 8s]
Lawrence$lim: folds 
soldim327: folds 
Venn7: raises $0.04 to $0.06
hc agorist: folds 
pkr_str3368: raises $0.12 to $0.18
CEP}I{bIK: folds 
Venn7: folds 
Uncalled bet ($0.12) returned to pkr_str3368
pkr_str3368 collected $0.14 from pot
pkr_str3368: doesn't show hand 
*** SUMMARY ***
Total pot $0.14 | Rake $0 
Seat 1: hc agorist (button) folded before Flop (didn't bet)
Seat 2: pkr_str3368 (small blind) collected ($0.14)
Seat 3: CEP}I{bIK (big blind) folded before Flop
Seat 4: Lawrence$lim folded before Flop (didn't bet)
Seat 5: soldim327 folded before Flop (didn't bet)
Seat 6: Venn7 folded before Flop



PokerStars Zoom Hand #193804436747:  Hold'em No Limit ($0.01/$0.02) - 2018/11/28 0:31:08 CUST [2018/11/27 11:31:08 ET]
Table 'Halley' 6-max Seat #1 is the button
Seat 1: Igarrokk ($3.06 in chips) 
Seat 2: Ancas18 ($1.61 in chips) 
Seat 3: FomaFx ($1.13 in chips) 
Seat 4: KArro:(doido ($6.03 in chips) 
Seat 5: helgia82 ($0.86 in chips) 
Seat 6: hc agorist ($1.11 in chips) 
Ancas18: posts small blind $0.01
FomaFx: posts big blind $0.02
*** HOLE CARDS ***
Dealt to hc agorist [7d Kh]
KArro:(doido: folds 
helgia82: folds 
hc agorist: folds 
Igarrokk: folds 
Ancas18: folds 
Uncalled bet ($0.01) returned to FomaFx
FomaFx collected $0.02 from pot
FomaFx: doesn't show hand 
*** SUMMARY ***
Total pot $0.02 | Rake $0 
Seat 1: Igarrokk (button) folded before Flop (didn't bet)
Seat 2: Ancas18 (small blind) folded before Flop
Seat 3: FomaFx (big blind) collected ($0.02)
Seat 4: KArro:(doido folded before Flop (didn't bet)
Seat 5: helgia82 folded before Flop (didn't bet)
Seat 6: hc agorist folded before Flop (didn't bet)



PokerStars Zoom Hand #193804434505:  Hold'em No Limit ($0.01/$0.02) - 2018/11/28 0:31:04 CUST [2018/11/27 11:31:04 ET]
Table 'Halley' 6-max Seat #1 is the button
Seat 1: Neokeynesian ($2.35 in chips) 
Seat 2: manmld ($4.36 in chips) 
Seat 3: Agno$tic ($2 in chips) 
Seat 4: TehLuny ($1.45 in chips) 
Seat 5: hc agorist ($1.11 in chips) 
Seat 6: murasak1 ($2 in chips) 
manmld: posts small blind $0.01
Agno$tic: posts big blind $0.02
*** HOLE CARDS ***
Dealt to hc agorist [6c 3d]
TehLuny: raises $0.04 to $0.06
hc agorist: folds 
murasak1: folds 
Neokeynesian: folds 
manmld: folds 
Agno$tic: folds 
Uncalled bet ($0.04) returned to TehLuny
TehLuny collected $0.05 from pot
TehLuny: doesn't show hand 
*** SUMMARY ***
Total pot $0.05 | Rake $0 
Seat 1: Neokeynesian (button) folded before Flop (didn't bet)
Seat 2: manmld (small blind) folded before Flop
Seat 3: Agno$tic (big blind) folded before Flop
Seat 4: TehLuny collected ($0.05)
Seat 5: hc agorist folded before Flop (didn't bet)
Seat 6: murasak1 folded before Flop (didn't bet)



PokerStars Zoom Hand #193804441344:  Hold'em No Limit ($0.01/$0.02) - 2018/11/28 0:31:16 CUST [2018/11/27 11:31:16 ET]
Table 'Halley' 6-max Seat #1 is the button
Seat 1: goldplay ($2.49 in chips) 
Seat 2: gian1894 ($5.29 in chips) 
Seat 3: Maximus122 ($3.70 in chips) 
Seat 4: hc agorist ($1.11 in chips) 
Seat 5: ivan show276 ($2.09 in chips) 
Seat 6: firebrigadenor ($2.78 in chips) 
gian1894: posts small blind $0.01
Maximus122: posts big blind $0.02
*** HOLE CARDS ***
Dealt to hc agorist [6c 5s]
hc agorist: folds 
ivan show276: folds 
firebrigadenor: raises $0.03 to $0.05
goldplay: folds 
gian1894: raises $0.07 to $0.12
Maximus122: folds 
firebrigadenor: raises $0.17 to $0.29
gian1894: folds 
Uncalled bet ($0.17) returned to firebrigadenor
firebrigadenor collected $0.26 from pot
firebrigadenor: doesn't show hand 
*** SUMMARY ***
Total pot $0.26 | Rake $0 
Seat 1: goldplay (button) folded before Flop (didn't bet)
Seat 2: gian1894 (small blind) folded before Flop
Seat 3: Maximus122 (big blind) folded before Flop
Seat 4: hc agorist folded before Flop (didn't bet)
Seat 5: ivan show276 folded before Flop (didn't bet)
Seat 6: firebrigadenor collected ($0.26)



PokerStars Zoom Hand #193804444736:  Hold'em No Limit ($0.01/$0.02) - 2018/11/28 0:31:22 CUST [2018/11/27 11:31:22 ET]
Table 'Halley' 6-max Seat #1 is the button
Seat 1: hsienko ($2.15 in chips) 
Seat 2: janiboi88 ($2.08 in chips) 
Seat 3: Glokk1 ($5.01 in chips) 
Seat 4: hc agorist ($1.11 in chips) 
Seat 5: psychopathko ($2.31 in chips) 
Seat 6: tucloze ($4.82 in chips) 
janiboi88: posts small blind $0.01
Glokk1: posts big blind $0.02
*** HOLE CARDS ***
Dealt to hc agorist [Jd Ks]
hc agorist: raises $0.04 to $0.06
psychopathko: folds 
tucloze: calls $0.06
hsienko: folds 
janiboi88: calls $0.05
Glokk1: calls $0.04
*** FLOP *** [Ad Kc Kd]
janiboi88: checks 
Glokk1: checks 
hc agorist: bets $0.08
tucloze: calls $0.08
janiboi88: folds 
Glokk1: folds 
*** TURN *** [Ad Kc Kd] [2c]
hc agorist: bets $0.29
tucloze: calls $0.29
*** RIVER *** [Ad Kc Kd 2c] [Jh]
hc agorist: bets $0.68 and is all-in
tucloze: calls $0.68
*** SHOW DOWN ***
hc agorist: shows [Jd Ks] (a full house, Kings full of Jacks)
tucloze: shows [Qd As] (two pair, Aces and Kings)
hc agorist collected $2.26 from pot
*** SUMMARY ***
Total pot $2.34 | Rake $0.08 
Board [Ad Kc Kd 2c Jh]
Seat 1: hsienko (button) folded before Flop (didn't bet)
Seat 2: janiboi88 (small blind) folded on the Flop
Seat 3: Glokk1 (big blind) folded on the Flop
Seat 4: hc agorist showed [Jd Ks] and won ($2.26) with a full house, Kings full of Jacks
Seat 5: psychopathko folded before Flop (didn't bet)
Seat 6: tucloze showed [Qd As] and lost with two pair, Aces and Kings



PokerStars Zoom Hand #193804468402:  Hold'em No Limit ($0.01/$0.02) - 2018/11/28 0:32:04 CUST [2018/11/27 11:32:04 ET]
Table 'Halley' 6-max Seat #1 is the button
Seat 1: Rhatree ($2 in chips) 
Seat 2: hc agorist ($2.26 in chips) 
Seat 3: Kydney ($2.15 in chips) 
Seat 4: mr.taverner ($2.40 in chips) 
Seat 5: tucloze ($3.71 in chips) 
Seat 6: rudolfesK ($1.39 in chips) 
hc agorist: posts small blind $0.01
Kydney: posts big blind $0.02
*** HOLE CARDS ***
Dealt to hc agorist [Kh 2h]
mr.taverner: folds 
tucloze: folds 
rudolfesK: folds 
Rhatree: folds 
hc agorist: folds 
Uncalled bet ($0.01) returned to Kydney
Kydney collected $0.02 from pot
Kydney: doesn't show hand 
*** SUMMARY ***
Total pot $0.02 | Rake $0 
Seat 1: Rhatree (button) folded before Flop (didn't bet)
Seat 2: hc agorist (small blind) folded before Flop
Seat 3: Kydney (big blind) collected ($0.02)
Seat 4: mr.taverner folded before Flop (didn't bet)
Seat 5: tucloze folded before Flop (didn't bet)
Seat 6: rudolfesK folded before Flop (didn't bet)



PokerStars Zoom Hand #193804476776:  Hold'em No Limit ($0.01/$0.02) - 2018/11/28 0:32:19 CUST [2018/11/27 11:32:19 ET]
Table 'Halley' 6-max Seat #1 is the button
Seat 1: tucloze ($3.51 in chips) 
Seat 2: AII0JIJI0H ($1.16 in chips) 
Seat 3: hc agorist ($2.25 in chips) 
Seat 4: felipe_anps ($2.94 in chips) 
Seat 5: sergiy6304 ($1.10 in chips) 
Seat 6: Lehavorkuta ($2.10 in chips) 
AII0JIJI0H: posts small blind $0.01
hc agorist: posts big blind $0.02
*** HOLE CARDS ***
Dealt to hc agorist [9c Ks]
felipe_anps: raises $0.04 to $0.06
sergiy6304: folds 
Lehavorkuta: folds 
tucloze: folds 
AII0JIJI0H: folds 
hc agorist: folds 
Uncalled bet ($0.04) returned to felipe_anps
felipe_anps collected $0.05 from pot
felipe_anps: doesn't show hand 
*** SUMMARY ***
Total pot $0.05 | Rake $0 
Seat 1: tucloze (button) folded before Flop (didn't bet)
Seat 2: AII0JIJI0H (small blind) folded before Flop
Seat 3: hc agorist (big blind) folded before Flop
Seat 4: felipe_anps collected ($0.05)
Seat 5: sergiy6304 folded before Flop (didn't bet)
Seat 6: Lehavorkuta folded before Flop (didn't bet)



PokerStars Zoom Hand #193804486998:  Hold'em No Limit ($0.01/$0.02) - 2018/11/28 0:32:37 CUST [2018/11/27 11:32:37 ET]
Table 'Halley' 6-max Seat #1 is the button
Seat 1: hc agorist ($2.23 in chips) 
Seat 2: yuratan ($2.54 in chips) 
Seat 3: Marcus mrrv ($1.99 in chips) 
Seat 4: firebrigadenor ($2.48 in chips) 
Seat 5: VVPcmpn ($1.18 in chips) 
Seat 6: grajekTeo ($2.23 in chips) 
yuratan: posts small blind $0.01
Marcus mrrv: posts big blind $0.02
*** HOLE CARDS ***
Dealt to hc agorist [7h Td]
firebrigadenor: raises $0.03 to $0.05
VVPcmpn: folds 
grajekTeo: folds 
hc agorist: folds 
yuratan: raises $0.21 to $0.26
Marcus mrrv: folds 
firebrigadenor: folds 
Uncalled bet ($0.21) returned to yuratan
yuratan collected $0.12 from pot
yuratan: doesn't show hand 
*** SUMMARY ***
Total pot $0.12 | Rake $0 
Seat 1: hc agorist (button) folded before Flop (didn't bet)
Seat 2: yuratan (small blind) collected ($0.12)
Seat 3: Marcus mrrv (big blind) folded before Flop
Seat 4: firebrigadenor folded before Flop
Seat 5: VVPcmpn folded before Flop (didn't bet)
Seat 6: grajekTeo folded before Flop (didn't bet)



PokerStars Zoom Hand #193804491508:  Hold'em No Limit ($0.01/$0.02) - 2018/11/28 0:32:45 CUST [2018/11/27 11:32:45 ET]
Table 'Halley' 6-max Seat #1 is the button
Seat 1: mitsinis ($2.82 in chips) 
Seat 2: dmitrii-aleksan ($1.88 in chips) 
Seat 3: Kokosya ($2 in chips) 
Seat 4: Spiridon1980 ($6.15 in chips) 
Seat 5: hc agorist ($2.23 in chips) 
Seat 6: zsmoler ($4.51 in chips) 
dmitrii-aleksan: posts small blind $0.01
Kokosya: posts big blind $0.02
*** HOLE CARDS ***
Dealt to hc agorist [3s 9c]
Spiridon1980: raises $0.03 to $0.05
hc agorist: folds 
zsmoler: folds 
mitsinis: folds 
dmitrii-aleksan: calls $0.04
Kokosya: folds 
*** FLOP *** [Qs Qd 7c]
dmitrii-aleksan: checks 
Spiridon1980: bets $0.12
dmitrii-aleksan: calls $0.12
*** TURN *** [Qs Qd 7c] [9s]
dmitrii-aleksan: checks 
Spiridon1980: bets $0.35
dmitrii-aleksan: calls $0.35
*** RIVER *** [Qs Qd 7c 9s] [Ad]
dmitrii-aleksan: checks 
Spiridon1980: checks 
*** SHOW DOWN ***
dmitrii-aleksan: shows [8d Qh] (three of a kind, Queens)
Spiridon1980: shows [Ks Qc] (three of a kind, Queens - Ace+King kicker)
Spiridon1980 collected $1.02 from pot
*** SUMMARY ***
Total pot $1.06 | Rake $0.04 
Board [Qs Qd 7c 9s Ad]
Seat 1: mitsinis (button) folded before Flop (didn't bet)
Seat 2: dmitrii-aleksan (small blind) showed [8d Qh] and lost with three of a kind, Queens
Seat 3: Kokosya (big blind) folded before Flop
Seat 4: Spiridon1980 showed [Ks Qc] and won ($1.02) with three of a kind, Queens
Seat 5: hc agorist folded before Flop (didn't bet)
Seat 6: zsmoler folded before Flop (didn't bet)



PokerStars Zoom Hand #193804495385:  Hold'em No Limit ($0.01/$0.02) - 2018/11/28 0:32:52 CUST [2018/11/27 11:32:52 ET]
Table 'Halley' 6-max Seat #1 is the button
Seat 1: hc agorist ($2.23 in chips) 
Seat 2: titan148 ($2.49 in chips) 
Seat 3: easywtf ($7.15 in chips) 
Seat 4: naimscorp ($1.73 in chips) 
Seat 5: sousaleandro ($5.29 in chips) 
Seat 6: Dialektik330 ($1.84 in chips) 
titan148: posts small blind $0.01
easywtf: posts big blind $0.02
*** HOLE CARDS ***
Dealt to hc agorist [5s 6s]
naimscorp: folds 
sousaleandro: folds 
Dialektik330: folds 
hc agorist: raises $0.02 to $0.04
titan148: calls $0.03
easywtf: calls $0.02
*** FLOP *** [Kh Kc As]
titan148: checks 
easywtf: checks 
hc agorist: bets $0.04
titan148: calls $0.04
easywtf: folds 
*** TURN *** [Kh Kc As] [2s]
titan148: checks 
hc agorist: checks 
*** RIVER *** [Kh Kc As 2s] [Qh]
titan148: checks 
hc agorist: checks 
*** SHOW DOWN ***
titan148: shows [9c Ac] (two pair, Aces and Kings)
hc agorist: mucks hand 
titan148 collected $0.19 from pot
*** SUMMARY ***
Total pot $0.20 | Rake $0.01 
Board [Kh Kc As 2s Qh]
Seat 1: hc agorist (button) mucked [5s 6s]
Seat 2: titan148 (small blind) showed [9c Ac] and won ($0.19) with two pair, Aces and Kings
Seat 3: easywtf (big blind) folded on the Flop
Seat 4: naimscorp folded before Flop (didn't bet)
Seat 5: sousaleandro folded before Flop (didn't bet)
Seat 6: Dialektik330 folded before Flop (didn't bet)



PokerStars Zoom Hand #193804518434:  Hold'em No Limit ($0.01/$0.02) - 2018/11/28 0:33:33 CUST [2018/11/27 11:33:33 ET]
Table 'Halley' 6-max Seat #1 is the button
Seat 1: Nossna ($2.44 in chips) 
Seat 2: mart404 ($2.85 in chips) 
Seat 3: WoodPeck87 ($2.70 in chips) 
Seat 4: andrqi ($5.37 in chips) 
Seat 5: nikolai55556 ($1.82 in chips) 
Seat 6: hc agorist ($2.15 in chips) 
mart404: posts small blind $0.01
WoodPeck87: posts big blind $0.02
*** HOLE CARDS ***
Dealt to hc agorist [4s 9s]
andrqi: folds 
nikolai55556: raises $0.02 to $0.04
hc agorist: folds 
Nossna: folds 
mart404: folds 
WoodPeck87: folds 
Uncalled bet ($0.02) returned to nikolai55556
nikolai55556 collected $0.05 from pot
nikolai55556: doesn't show hand 
*** SUMMARY ***
Total pot $0.05 | Rake $0 
Seat 1: Nossna (button) folded before Flop (didn't bet)
Seat 2: mart404 (small blind) folded before Flop
Seat 3: WoodPeck87 (big blind) folded before Flop
Seat 4: andrqi folded before Flop (didn't bet)
Seat 5: nikolai55556 collected ($0.05)
Seat 6: hc agorist folded before Flop (didn't bet)



PokerStars Zoom Hand #193804522338:  Hold'em No Limit ($0.01/$0.02) - 2018/11/28 0:33:40 CUST [2018/11/27 11:33:40 ET]
Table 'Halley' 6-max Seat #1 is the button
Seat 1: kers474 ($3.87 in chips) 
Seat 2: darkoldmaker ($2.03 in chips) 
Seat 3: Karel33555 ($1.63 in chips) 
Seat 4: hc agorist ($2.15 in chips) 
Seat 5: AASkinnyJohnAA ($5.54 in chips) 
Seat 6: taurusvit ($1.85 in chips) 
darkoldmaker: posts small blind $0.01
Karel33555: posts big blind $0.02
*** HOLE CARDS ***
Dealt to hc agorist [Kc Ad]
hc agorist: raises $0.04 to $0.06
AASkinnyJohnAA: folds 
taurusvit: folds 
kers474: calls $0.06
darkoldmaker: calls $0.05
Karel33555: folds 
*** FLOP *** [7c 5s Ks]
darkoldmaker: checks 
hc agorist: bets $0.14
kers474: folds 
darkoldmaker: folds 
Uncalled bet ($0.14) returned to hc agorist
hc agorist collected $0.19 from pot
hc agorist: doesn't show hand 
*** SUMMARY ***
Total pot $0.20 | Rake $0.01 
Board [7c 5s Ks]
Seat 1: kers474 (button) folded on the Flop
Seat 2: darkoldmaker (small blind) folded on the Flop
Seat 3: Karel33555 (big blind) folded before Flop
Seat 4: hc agorist collected ($0.19)
Seat 5: AASkinnyJohnAA folded before Flop (didn't bet)
Seat 6: taurusvit folded before Flop (didn't bet)



PokerStars Zoom Hand #193804537079:  Hold'em No Limit ($0.01/$0.02) - 2018/11/28 0:34:06 CUST [2018/11/27 11:34:06 ET]
Table 'Halley' 6-max Seat #1 is the button
Seat 1: Mizepa ($2.13 in chips) 
Seat 2: hc agorist ($2.28 in chips) 
Seat 3: lcstrambi ($2.78 in chips) 
Seat 4: MellivoraSto ($2 in chips) 
Seat 5: don_energo2 ($2 in chips) 
Seat 6: tigr6210 ($2.08 in chips) 
hc agorist: posts small blind $0.01
lcstrambi: posts big blind $0.02
*** HOLE CARDS ***
Dealt to hc agorist [Kd 9c]
MellivoraSto: folds 
don_energo2: raises $0.03 to $0.05
tigr6210: folds 
Mizepa: folds 
hc agorist: folds 
lcstrambi: folds 
Uncalled bet ($0.03) returned to don_energo2
don_energo2 collected $0.05 from pot
don_energo2: doesn't show hand 
*** SUMMARY ***
Total pot $0.05 | Rake $0 
Seat 1: Mizepa (button) folded before Flop (didn't bet)
Seat 2: hc agorist (small blind) folded before Flop
Seat 3: lcstrambi (big blind) folded before Flop
Seat 4: MellivoraSto folded before Flop (didn't bet)
Seat 5: don_energo2 collected ($0.05)
Seat 6: tigr6210 folded before Flop (didn't bet)



PokerStars Zoom Hand #193804541006:  Hold'em No Limit ($0.01/$0.02) - 2018/11/28 0:34:13 CUST [2018/11/27 11:34:13 ET]
Table 'Halley' 6-max Seat #1 is the button
Seat 1: helolele ($2.19 in chips) 
Seat 2: A. Parovozof ($2.01 in chips) 
Seat 3: hc agorist ($2.27 in chips) 
Seat 4: viktor49ru ($2.08 in chips) 
Seat 5: Discco ($1.98 in chips) 
Seat 6: markiz655 ($3.89 in chips) 
A. Parovozof: posts small blind $0.01
hc agorist: posts big blind $0.02
*** HOLE CARDS ***
Dealt to hc agorist [3s 4s]
viktor49ru: folds 
Discco: folds 
markiz655: folds 
helolele: folds 
A. Parovozof: raises $0.04 to $0.06
hc agorist: raises $0.12 to $0.18
A. Parovozof: calls $0.12
*** FLOP *** [As 2c 9s]
A. Parovozof: bets $0.24
hc agorist: calls $0.24
*** TURN *** [As 2c 9s] [2h]
A. Parovozof: bets $0.41
hc agorist: calls $0.41
*** RIVER *** [As 2c 9s 2h] [Jh]
A. Parovozof: bets $0.64
hc agorist: folds 
Uncalled bet ($0.64) returned to A. Parovozof
A. Parovozof collected $1.60 from pot
A. Parovozof: doesn't show hand 
*** SUMMARY ***
Total pot $1.66 | Rake $0.06 
Board [As 2c 9s 2h Jh]
Seat 1: helolele (button) folded before Flop (didn't bet)
Seat 2: A. Parovozof (small blind) collected ($1.60)
Seat 3: hc agorist (big blind) folded on the River
Seat 4: viktor49ru folded before Flop (didn't bet)
Seat 5: Discco folded before Flop (didn't bet)
Seat 6: markiz655 folded before Flop (didn't bet)



PokerStars Zoom Hand #193804574763:  Hold'em No Limit ($0.01/$0.02) - 2018/11/28 0:35:13 CUST [2018/11/27 11:35:13 ET]
Table 'Halley' 6-max Seat #1 is the button
Seat 1: BlaZeR89999 ($2.01 in chips) 
Seat 2: colmcc ($1.89 in chips) 
Seat 3: Pooh_Mecho ($3.58 in chips) 
Seat 4: heisenbucket ($7.95 in chips) 
Seat 5: hc agorist ($1.44 in chips) 
Seat 6: abatur0 ($0.65 in chips) 
colmcc: posts small blind $0.01
Pooh_Mecho: posts big blind $0.02
*** HOLE CARDS ***
Dealt to hc agorist [9c Tc]
heisenbucket: folds 
hc agorist: raises $0.04 to $0.06
abatur0: folds 
BlaZeR89999: folds 
colmcc: folds 
Pooh_Mecho: folds 
Uncalled bet ($0.04) returned to hc agorist
hc agorist collected $0.05 from pot
hc agorist: doesn't show hand 
*** SUMMARY ***
Total pot $0.05 | Rake $0 
Seat 1: BlaZeR89999 (button) folded before Flop (didn't bet)
Seat 2: colmcc (small blind) folded before Flop
Seat 3: Pooh_Mecho (big blind) folded before Flop
Seat 4: heisenbucket folded before Flop (didn't bet)
Seat 5: hc agorist collected ($0.05)
Seat 6: abatur0 folded before Flop (didn't bet)



PokerStars Zoom Hand #193804585421:  Hold'em No Limit ($0.01/$0.02) - 2018/11/28 0:35:32 CUST [2018/11/27 11:35:32 ET]
Table 'Halley' 6-max Seat #1 is the button
Seat 1: fumina.k ($4.70 in chips) 
Seat 2: gkitas10 ($2.28 in chips) 
Seat 3: Algoritmos S ($2.03 in chips) 
Seat 4: IMVV310 ($2.03 in chips) 
Seat 5: Conan0024 ($3.35 in chips) 
Seat 6: hc agorist ($1.47 in chips) 
gkitas10: posts small blind $0.01
Algoritmos S: posts big blind $0.02
*** HOLE CARDS ***
Dealt to hc agorist [5d 6c]
IMVV310: folds 
Conan0024: folds 
hc agorist: raises $0.02 to $0.04
fumina.k: calls $0.04
gkitas10: folds 
Algoritmos S: folds 
*** FLOP *** [6s 4s Jc]
hc agorist: checks 
fumina.k: checks 
*** TURN *** [6s 4s Jc] [6d]
hc agorist: bets $0.10
fumina.k: folds 
Uncalled bet ($0.10) returned to hc agorist
hc agorist collected $0.11 from pot
hc agorist: doesn't show hand 
*** SUMMARY ***
Total pot $0.11 | Rake $0 
Board [6s 4s Jc 6d]
Seat 1: fumina.k (button) folded on the Turn
Seat 2: gkitas10 (small blind) folded before Flop
Seat 3: Algoritmos S (big blind) folded before Flop
Seat 4: IMVV310 folded before Flop (didn't bet)
Seat 5: Conan0024 folded before Flop (didn't bet)
Seat 6: hc agorist collected ($0.11)



PokerStars Zoom Hand #193804607837:  Hold'em No Limit ($0.01/$0.02) - 2018/11/28 0:36:12 CUST [2018/11/27 11:36:12 ET]
Table 'Halley' 6-max Seat #1 is the button
Seat 1: hc agorist ($1.54 in chips) 
Seat 2: mitsinis ($2.59 in chips) 
Seat 3: zsmoler ($4.58 in chips) 
Seat 4: yuratan ($4.23 in chips) 
Seat 5: iizi21 ($2.97 in chips) 
Seat 6: psychopathko ($1.55 in chips) 
mitsinis: posts small blind $0.01
zsmoler: posts big blind $0.02
*** HOLE CARDS ***
Dealt to hc agorist [Qs Ts]
yuratan: folds 
iizi21: folds 
psychopathko: folds 
hc agorist: raises $0.04 to $0.06
mitsinis: calls $0.05
zsmoler: folds 
*** FLOP *** [5c 5s 6s]
mitsinis: checks 
hc agorist: bets $0.05
mitsinis: calls $0.05
*** TURN *** [5c 5s 6s] [2c]
mitsinis: checks 
hc agorist: bets $0.10
mitsinis: folds 
Uncalled bet ($0.10) returned to hc agorist
hc agorist collected $0.23 from pot
hc agorist: doesn't show hand 
*** SUMMARY ***
Total pot $0.24 | Rake $0.01 
Board [5c 5s 6s 2c]
Seat 1: hc agorist (button) collected ($0.23)
Seat 2: mitsinis (small blind) folded on the Turn
Seat 3: zsmoler (big blind) folded before Flop
Seat 4: yuratan folded before Flop (didn't bet)
Seat 5: iizi21 folded before Flop (didn't bet)
Seat 6: psychopathko folded before Flop (didn't bet)



PokerStars Zoom Hand #193804637887:  Hold'em No Limit ($0.01/$0.02) - 2018/11/28 0:37:05 CUST [2018/11/27 11:37:05 ET]
Table 'Halley' 6-max Seat #1 is the button
Seat 1: Pauchok 43ru ($1.24 in chips) 
Seat 2: ForHistory ($10.71 in chips) 
Seat 3: galonpiva ($2.14 in chips) 
Seat 4: hc agorist ($1.66 in chips) 
Seat 5: rychu1906 ($2.04 in chips) 
Seat 6: GRizlik14 ($2 in chips) 
ForHistory: posts small blind $0.01
galonpiva: posts big blind $0.02
*** HOLE CARDS ***
Dealt to hc agorist [Ac Kh]
hc agorist: raises $0.04 to $0.06
rychu1906: folds 
GRizlik14: raises $0.12 to $0.18
Pauchok 43ru: folds 
ForHistory: folds 
galonpiva: folds 
hc agorist: raises $0.22 to $0.40
GRizlik14: raises $1.60 to $2 and is all-in
hc agorist: calls $1.26 and is all-in
Uncalled bet ($0.34) returned to GRizlik14
*** FIRST FLOP *** [Th 3h 4c]
*** FIRST TURN *** [Th 3h 4c] [2h]
*** FIRST RIVER *** [Th 3h 4c 2h] [6s]
*** SECOND FLOP *** [2d Jd 9c]
*** SECOND TURN *** [2d Jd 9c] [3c]
*** SECOND RIVER *** [2d Jd 9c 3c] [Js]
*** FIRST SHOW DOWN ***
hc agorist: shows [Ac Kh] (high card Ace)
GRizlik14: shows [Ks As] (high card Ace)
hc agorist collected $0.81 from pot
GRizlik14 collected $0.81 from pot
*** SECOND SHOW DOWN ***
hc agorist: shows [Ac Kh] (a pair of Jacks)
GRizlik14: shows [Ks As] (a pair of Jacks)
hc agorist collected $0.81 from pot
GRizlik14 collected $0.80 from pot
*** SUMMARY ***
Total pot $3.35 | Rake $0.12 
Hand was run twice
FIRST Board [Th 3h 4c 2h 6s]
SECOND Board [2d Jd 9c 3c Js]
Seat 1: Pauchok 43ru (button) folded before Flop (didn't bet)
Seat 2: ForHistory (small blind) folded before Flop
Seat 3: galonpiva (big blind) folded before Flop
Seat 4: hc agorist showed [Ac Kh] and won ($0.81) with high card Ace, and won ($0.81) with a pair of Jacks
Seat 5: rychu1906 folded before Flop (didn't bet)
Seat 6: GRizlik14 showed [Ks As] and won ($0.81) with high card Ace, and won ($0.80) with a pair of Jacks



PokerStars Zoom Hand #193804661448:  Hold'em No Limit ($0.01/$0.02) - 2018/11/28 0:37:47 CUST [2018/11/27 11:37:47 ET]
Table 'Halley' 6-max Seat #1 is the button
Seat 1: KArro:(doido ($5.81 in chips) 
Seat 2: hc agorist ($1.62 in chips) 
Seat 3: hawkzinbr ($2.61 in chips) 
Seat 4: 3Iver's3 ($2.07 in chips) 
Seat 5: Conan0024 ($4.71 in chips) 
Seat 6: simple s0o ($5.57 in chips) 
hc agorist: posts small blind $0.01
hawkzinbr: posts big blind $0.02
*** HOLE CARDS ***
Dealt to hc agorist [Jh Qh]
3Iver's3: raises $0.04 to $0.06
Conan0024: folds 
simple s0o: folds 
KArro:(doido: calls $0.06
hc agorist: calls $0.05
hawkzinbr: folds 
*** FLOP *** [5c 2d Qc]
hc agorist: checks 
3Iver's3: bets $0.13
KArro:(doido: folds 
hc agorist: calls $0.13
*** TURN *** [5c 2d Qc] [8d]
hc agorist: checks 
3Iver's3: bets $0.33
hc agorist: calls $0.33
*** RIVER *** [5c 2d Qc 8d] [7h]
hc agorist: checks 
3Iver's3: bets $1.55 and is all-in
hc agorist: calls $1.10 and is all-in
Uncalled bet ($0.45) returned to 3Iver's3
*** SHOW DOWN ***
3Iver's3: shows [As Ah] (a pair of Aces)
hc agorist: shows [Jh Qh] (a pair of Queens)
3Iver's3 collected $3.20 from pot
*** SUMMARY ***
Total pot $3.32 | Rake $0.12 
Board [5c 2d Qc 8d 7h]
Seat 1: KArro:(doido (button) folded on the Flop
Seat 2: hc agorist (small blind) showed [Jh Qh] and lost with a pair of Queens
Seat 3: hawkzinbr (big blind) folded before Flop
Seat 4: 3Iver's3 showed [As Ah] and won ($3.20) with a pair of Aces
Seat 5: Conan0024 folded before Flop (didn't bet)
Seat 6: simple s0o folded before Flop (didn't bet)



PokerStars Zoom Hand #193804690279:  Hold'em No Limit ($0.01/$0.02) - 2018/11/28 0:38:38 CUST [2018/11/27 11:38:38 ET]
Table 'Halley' 6-max Seat #1 is the button
Seat 1: goldplay ($3.17 in chips) 
Seat 2: liryka ($2.05 in chips) 
Seat 3: hc agorist ($2 in chips) 
Seat 4: begze ($1.91 in chips) 
Seat 5: MusashiiDen ($2 in chips) 
Seat 6: erioncrazy ($2 in chips) 
liryka: posts small blind $0.01
hc agorist: posts big blind $0.02
*** HOLE CARDS ***
Dealt to hc agorist [8s Ts]
begze: folds 
MusashiiDen: raises $0.04 to $0.06
erioncrazy has timed out
erioncrazy: folds 
goldplay: folds 
liryka: folds 
hc agorist: raises $0.13 to $0.19
MusashiiDen: raises $0.39 to $0.58
hc agorist: folds 
Uncalled bet ($0.39) returned to MusashiiDen
MusashiiDen collected $0.39 from pot
MusashiiDen: doesn't show hand 
*** SUMMARY ***
Total pot $0.39 | Rake $0 
Seat 1: goldplay (button) folded before Flop (didn't bet)
Seat 2: liryka (small blind) folded before Flop
Seat 3: hc agorist (big blind) folded before Flop
Seat 4: begze folded before Flop (didn't bet)
Seat 5: MusashiiDen collected ($0.39)
Seat 6: erioncrazy folded before Flop (didn't bet)



PokerStars Zoom Hand #193804713764:  Hold'em No Limit ($0.01/$0.02) - 2018/11/28 0:39:19 CUST [2018/11/27 11:39:19 ET]
Table 'Halley' 6-max Seat #1 is the button
Seat 1: Williwacker9 ($2 in chips) 
Seat 2: waswaz332 ($2.11 in chips) 
Seat 3: vvk22 ($2 in chips) 
Seat 4: psicopokerr ($3.19 in chips) 
Seat 5: firebrigadenor ($2.46 in chips) 
Seat 6: hc agorist ($1.81 in chips) 
waswaz332: posts small blind $0.01
vvk22: posts big blind $0.02
*** HOLE CARDS ***
Dealt to hc agorist [Ks 6c]
psicopokerr: folds 
firebrigadenor: raises $0.03 to $0.05
hc agorist: folds 
Williwacker9: folds 
waswaz332: raises $0.13 to $0.18
vvk22: folds 
firebrigadenor: folds 
Uncalled bet ($0.13) returned to waswaz332
waswaz332 collected $0.12 from pot
waswaz332: doesn't show hand 
*** SUMMARY ***
Total pot $0.12 | Rake $0 
Seat 1: Williwacker9 (button) folded before Flop (didn't bet)
Seat 2: waswaz332 (small blind) collected ($0.12)
Seat 3: vvk22 (big blind) folded before Flop
Seat 4: psicopokerr folded before Flop (didn't bet)
Seat 5: firebrigadenor folded before Flop
Seat 6: hc agorist folded before Flop (didn't bet)



PokerStars Zoom Hand #193804718933:  Hold'em No Limit ($0.01/$0.02) - 2018/11/28 0:39:28 CUST [2018/11/27 11:39:28 ET]
Table 'Halley' 6-max Seat #1 is the button
Seat 1: hc agorist ($1.81 in chips) 
Seat 2: Geolog800 ($2.07 in chips) 
Seat 3: ivan show276 ($2.23 in chips) 
Seat 4: Trallalak ($1.89 in chips) 
Seat 5: AlexGalimov ($2 in chips) 
Seat 6: ulkiora29 ($1.85 in chips) 
Geolog800: posts small blind $0.01
ivan show276: posts big blind $0.02
*** HOLE CARDS ***
Dealt to hc agorist [4h 9d]
Trallalak: folds 
AlexGalimov: folds 
ulkiora29: folds 
hc agorist: folds 
Geolog800: folds 
Uncalled bet ($0.01) returned to ivan show276
ivan show276 collected $0.02 from pot
ivan show276: doesn't show hand 
*** SUMMARY ***
Total pot $0.02 | Rake $0 
Seat 1: hc agorist (button) folded before Flop (didn't bet)
Seat 2: Geolog800 (small blind) folded before Flop
Seat 3: ivan show276 (big blind) collected ($0.02)
Seat 4: Trallalak folded before Flop (didn't bet)
Seat 5: AlexGalimov folded before Flop (didn't bet)
Seat 6: ulkiora29 folded before Flop (didn't bet)



PokerStars Zoom Hand #193804721899:  Hold'em No Limit ($0.01/$0.02) - 2018/11/28 0:39:33 CUST [2018/11/27 11:39:33 ET]
Table 'Halley' 6-max Seat #1 is the button
Seat 1: SKANER BY ($4.12 in chips) 
Seat 2: Neokeynesian ($3.60 in chips) 
Seat 3: helolele ($4.45 in chips) 
Seat 4: djinn29 ($1.80 in chips) 
Seat 5: hc agorist ($1.81 in chips) 
Seat 6: TEAMPRO10000 ($1.19 in chips) 
Neokeynesian: posts small blind $0.01
helolele: posts big blind $0.02
*** HOLE CARDS ***
Dealt to hc agorist [6s Jc]
djinn29: folds 
hc agorist: folds 
TEAMPRO10000: raises $0.04 to $0.06
SKANER BY: folds 
Neokeynesian: folds 
helolele: calls $0.04
*** FLOP *** [Td 4h 6d]
helolele: checks 
TEAMPRO10000: bets $0.06
helolele: folds 
Uncalled bet ($0.06) returned to TEAMPRO10000
TEAMPRO10000 collected $0.13 from pot
TEAMPRO10000: doesn't show hand 
*** SUMMARY ***
Total pot $0.13 | Rake $0 
Board [Td 4h 6d]
Seat 1: SKANER BY (button) folded before Flop (didn't bet)
Seat 2: Neokeynesian (small blind) folded before Flop
Seat 3: helolele (big blind) folded on the Flop
Seat 4: djinn29 folded before Flop (didn't bet)
Seat 5: hc agorist folded before Flop (didn't bet)
Seat 6: TEAMPRO10000 collected ($0.13)



PokerStars Zoom Hand #193804729250:  Hold'em No Limit ($0.01/$0.02) - 2018/11/28 0:39:46 CUST [2018/11/27 11:39:46 ET]
Table 'Halley' 6-max Seat #1 is the button
Seat 1: Silock ($2.32 in chips) 
Seat 2: hc agorist ($1.81 in chips) 
Seat 3: Honorable_17 ($0.79 in chips) 
Seat 4: dondiabolus ($2.02 in chips) 
Seat 5: IMVV310 ($2 in chips) 
Seat 6: Rusherito87 ($11.92 in chips) 
hc agorist: posts small blind $0.01
Honorable_17: posts big blind $0.02
*** HOLE CARDS ***
Dealt to hc agorist [Ah 6h]
dondiabolus: folds 
IMVV310: folds 
Rusherito87: folds 
Silock: folds 
hc agorist: raises $0.02 to $0.04
Honorable_17: calls $0.02
*** FLOP *** [5d 9s 9d]
hc agorist: bets $0.03
Honorable_17: calls $0.03
*** TURN *** [5d 9s 9d] [7s]
hc agorist: checks 
Honorable_17: bets $0.06
hc agorist: folds 
Uncalled bet ($0.06) returned to Honorable_17
Honorable_17 collected $0.14 from pot
Honorable_17: doesn't show hand 
*** SUMMARY ***
Total pot $0.14 | Rake $0 
Board [5d 9s 9d 7s]
Seat 1: Silock (button) folded before Flop (didn't bet)
Seat 2: hc agorist (small blind) folded on the Turn
Seat 3: Honorable_17 (big blind) collected ($0.14)
Seat 4: dondiabolus folded before Flop (didn't bet)
Seat 5: IMVV310 folded before Flop (didn't bet)
Seat 6: Rusherito87 folded before Flop (didn't bet)



PokerStars Zoom Hand #193804726380:  Hold'em No Limit ($0.01/$0.02) - 2018/11/28 0:39:41 CUST [2018/11/27 11:39:41 ET]
Table 'Halley' 6-max Seat #1 is the button
Seat 1: GRizlik14 ($2 in chips) 
Seat 2: mr.Léthé ($1.09 in chips) 
Seat 3: maxbreak147 ($3.56 in chips) 
Seat 4: hc agorist ($1.81 in chips) 
Seat 5: Simkooo ($2.05 in chips) 
Seat 6: Rimas98 ($3.54 in chips) 
mr.Léthé: posts small blind $0.01
maxbreak147: posts big blind $0.02
*** HOLE CARDS ***
Dealt to hc agorist [5s Jd]
hc agorist: folds 
Simkooo: folds 
Rimas98: folds 
GRizlik14: folds 
mr.Léthé: calls $0.01
maxbreak147: checks 
*** FLOP *** [6d 2s As]
mr.Léthé: checks 
maxbreak147: checks 
*** TURN *** [6d 2s As] [3c]
mr.Léthé: checks 
maxbreak147: bets $0.02
mr.Léthé: folds 
Uncalled bet ($0.02) returned to maxbreak147
maxbreak147 collected $0.04 from pot
maxbreak147: doesn't show hand 
*** SUMMARY ***
Total pot $0.04 | Rake $0 
Board [6d 2s As 3c]
Seat 1: GRizlik14 (button) folded before Flop (didn't bet)
Seat 2: mr.Léthé (small blind) folded on the Turn
Seat 3: maxbreak147 (big blind) collected ($0.04)
Seat 4: hc agorist folded before Flop (didn't bet)
Seat 5: Simkooo folded before Flop (didn't bet)
Seat 6: Rimas98 folded before Flop (didn't bet)



PokerStars Zoom Hand #193804754033:  Hold'em No Limit ($0.01/$0.02) - 2018/11/28 0:40:29 CUST [2018/11/27 11:40:29 ET]
Table 'Halley' 6-max Seat #1 is the button
Seat 1: jaaz241 ($1.95 in chips) 
Seat 2: Pedrosophiaa ($6.29 in chips) 
Seat 3: hc agorist ($1.74 in chips) 
Seat 4: VVPcmpn ($1.11 in chips) 
Seat 5: Mista Live ($2.02 in chips) 
Seat 6: Labrodor999 ($1.22 in chips) 
Pedrosophiaa: posts small blind $0.01
hc agorist: posts big blind $0.02
*** HOLE CARDS ***
Dealt to hc agorist [As Kc]
VVPcmpn: raises $0.02 to $0.04
Mista Live: folds 
Labrodor999: folds 
jaaz241: folds 
Pedrosophiaa: folds 
hc agorist: raises $0.09 to $0.13
VVPcmpn: folds 
Uncalled bet ($0.09) returned to hc agorist
hc agorist collected $0.09 from pot
hc agorist: doesn't show hand 
*** SUMMARY ***
Total pot $0.09 | Rake $0 
Seat 1: jaaz241 (button) folded before Flop (didn't bet)
Seat 2: Pedrosophiaa (small blind) folded before Flop
Seat 3: hc agorist (big blind) collected ($0.09)
Seat 4: VVPcmpn folded before Flop
Seat 5: Mista Live folded before Flop (didn't bet)
Seat 6: Labrodor999 folded before Flop (didn't bet)



PokerStars Zoom Hand #193804763641:  Hold'em No Limit ($0.01/$0.02) - 2018/11/28 0:40:46 CUST [2018/11/27 11:40:46 ET]
Table 'Halley' 6-max Seat #1 is the button
Seat 1: K.Belozerov ($1.97 in chips) 
Seat 2: shato93 ($1.73 in chips) 
Seat 3: Polal19 ($2.21 in chips) 
Seat 4: Mackerel12 ($4.32 in chips) 
Seat 5: SRERAF ($2.07 in chips) 
Seat 6: hc agorist ($1.79 in chips) 
shato93: posts small blind $0.01
Polal19: posts big blind $0.02
*** HOLE CARDS ***
Dealt to hc agorist [Ac 5h]
Mackerel12: folds 
SRERAF: folds 
hc agorist: raises $0.02 to $0.04
K.Belozerov: folds 
shato93: calls $0.03
Polal19: folds 
*** FLOP *** [Qc 7s As]
shato93: checks 
hc agorist: bets $0.08
shato93: folds 
Uncalled bet ($0.08) returned to hc agorist
hc agorist collected $0.10 from pot
hc agorist: doesn't show hand 
*** SUMMARY ***
Total pot $0.10 | Rake $0 
Board [Qc 7s As]
Seat 1: K.Belozerov (button) folded before Flop (didn't bet)
Seat 2: shato93 (small blind) folded on the Flop
Seat 3: Polal19 (big blind) folded before Flop
Seat 4: Mackerel12 folded before Flop (didn't bet)
Seat 5: SRERAF folded before Flop (didn't bet)
Seat 6: hc agorist collected ($0.10)



PokerStars Zoom Hand #193804778837:  Hold'em No Limit ($0.01/$0.02) - 2018/11/28 0:41:13 CUST [2018/11/27 11:41:13 ET]
Table 'Halley' 6-max Seat #1 is the button
Seat 1: tg9718 ($2.42 in chips) 
Seat 2: hc agorist ($1.85 in chips) 
Seat 3: heisenbucket ($5.62 in chips) 
Seat 4: G.Datskov ($2.09 in chips) 
Seat 5: GEKSOGEN0912 ($1.19 in chips) 
Seat 6: Giggio3301 ($4.27 in chips) 
hc agorist: posts small blind $0.01
heisenbucket: posts big blind $0.02
*** HOLE CARDS ***
Dealt to hc agorist [3h Td]
G.Datskov: raises $0.02 to $0.04
GEKSOGEN0912: folds 
Giggio3301: folds 
tg9718: folds 
hc agorist: folds 
heisenbucket: folds 
Uncalled bet ($0.02) returned to G.Datskov
G.Datskov collected $0.05 from pot
G.Datskov: doesn't show hand 
*** SUMMARY ***
Total pot $0.05 | Rake $0 
Seat 1: tg9718 (button) folded before Flop (didn't bet)
Seat 2: hc agorist (small blind) folded before Flop
Seat 3: heisenbucket (big blind) folded before Flop
Seat 4: G.Datskov collected ($0.05)
Seat 5: GEKSOGEN0912 folded before Flop (didn't bet)
Seat 6: Giggio3301 folded before Flop (didn't bet)



PokerStars Zoom Hand #193804775491:  Hold'em No Limit ($0.01/$0.02) - 2018/11/28 0:41:07 CUST [2018/11/27 11:41:07 ET]
Table 'Halley' 6-max Seat #1 is the button
Seat 1: insaneken ($1.21 in chips) 
Seat 2: Olga Berezina ($2.17 in chips) 
Seat 3: okifunnoki ($1.92 in chips) 
Seat 4: Williwacker9 ($2.14 in chips) 
Seat 5: hc agorist ($1.85 in chips) 
Seat 6: Bearpls ($2 in chips) 
Olga Berezina: posts small blind $0.01
okifunnoki: posts big blind $0.02
*** HOLE CARDS ***
Dealt to hc agorist [Ts 2d]
Williwacker9: folds 
hc agorist: folds 
Bearpls: folds 
insaneken: folds 
Olga Berezina: folds 
Uncalled bet ($0.01) returned to okifunnoki
okifunnoki collected $0.02 from pot
okifunnoki: doesn't show hand 
*** SUMMARY ***
Total pot $0.02 | Rake $0 
Seat 1: insaneken (button) folded before Flop (didn't bet)
Seat 2: Olga Berezina (small blind) folded before Flop
Seat 3: okifunnoki (big blind) collected ($0.02)
Seat 4: Williwacker9 folded before Flop (didn't bet)
Seat 5: hc agorist folded before Flop (didn't bet)
Seat 6: Bearpls folded before Flop (didn't bet)



PokerStars Zoom Hand #193804781628:  Hold'em No Limit ($0.01/$0.02) - 2018/11/28 0:41:18 CUST [2018/11/27 11:41:18 ET]
Table 'Halley' 6-max Seat #1 is the button
Seat 1: karasukML ($1.61 in chips) 
Seat 2: naimscorp ($3.40 in chips) 
Seat 3: swnfly41 ($7.29 in chips) 
Seat 4: hc agorist ($1.84 in chips) 
Seat 5: sunzi99 ($3.30 in chips) 
Seat 6: skendroshen ($2.71 in chips) 
naimscorp: posts small blind $0.01
swnfly41: posts big blind $0.02
*** HOLE CARDS ***
Dealt to hc agorist [2s Kd]
hc agorist: folds 
sunzi99: folds 
skendroshen: folds 
karasukML: raises $0.04 to $0.06
naimscorp: folds 
swnfly41: folds 
Uncalled bet ($0.04) returned to karasukML
karasukML collected $0.05 from pot
karasukML: doesn't show hand 
*** SUMMARY ***
Total pot $0.05 | Rake $0 
Seat 1: karasukML (button) collected ($0.05)
Seat 2: naimscorp (small blind) folded before Flop
Seat 3: swnfly41 (big blind) folded before Flop
Seat 4: hc agorist folded before Flop (didn't bet)
Seat 5: sunzi99 folded before Flop (didn't bet)
Seat 6: skendroshen folded before Flop (didn't bet)



PokerStars Zoom Hand #193804784436:  Hold'em No Limit ($0.01/$0.02) - 2018/11/28 0:41:23 CUST [2018/11/27 11:41:23 ET]
Table 'Halley' 6-max Seat #1 is the button
Seat 1: hc agorist ($1.84 in chips) 
Seat 2: rewq333 ($10.87 in chips) 
Seat 3: Giggio3301 ($2.52 in chips) 
Seat 4: Alexarulit ($2 in chips) 
Seat 5: Snegul ($0.51 in chips) 
Seat 6: Conan0024 ($4.20 in chips) 
rewq333: posts small blind $0.01
Giggio3301: posts big blind $0.02
*** HOLE CARDS ***
Dealt to hc agorist [5d Td]
Alexarulit: folds 
Snegul: folds 
Conan0024: raises $0.04 to $0.06
hc agorist: folds 
rewq333: folds 
Giggio3301: folds 
Uncalled bet ($0.04) returned to Conan0024
Conan0024 collected $0.05 from pot
Conan0024: doesn't show hand 
*** SUMMARY ***
Total pot $0.05 | Rake $0 
Seat 1: hc agorist (button) folded before Flop (didn't bet)
Seat 2: rewq333 (small blind) folded before Flop
Seat 3: Giggio3301 (big blind) folded before Flop
Seat 4: Alexarulit folded before Flop (didn't bet)
Seat 5: Snegul folded before Flop (didn't bet)
Seat 6: Conan0024 collected ($0.05)



PokerStars Zoom Hand #193804787764:  Hold'em No Limit ($0.01/$0.02) - 2018/11/28 0:41:29 CUST [2018/11/27 11:41:29 ET]
Table 'Halley' 6-max Seat #1 is the button
Seat 1: nicemitya ($5.76 in chips) 
Seat 2: MellivoraSto ($2.04 in chips) 
Seat 3: Miami27887 ($2 in chips) 
Seat 4: hc agorist ($1.84 in chips) 
Seat 5: pkr_str3368 ($2.26 in chips) 
Seat 6: SRERAF ($2.37 in chips) 
MellivoraSto: posts small blind $0.01
Miami27887: posts big blind $0.02
*** HOLE CARDS ***
Dealt to hc agorist [2d 4s]
hc agorist: folds 
pkr_str3368: folds 
SRERAF: folds 
nicemitya: folds 
MellivoraSto: folds 
Uncalled bet ($0.01) returned to Miami27887
Miami27887 collected $0.02 from pot
Miami27887: doesn't show hand 
*** SUMMARY ***
Total pot $0.02 | Rake $0 
Seat 1: nicemitya (button) folded before Flop (didn't bet)
Seat 2: MellivoraSto (small blind) folded before Flop
Seat 3: Miami27887 (big blind) collected ($0.02)
Seat 4: hc agorist folded before Flop (didn't bet)
Seat 5: pkr_str3368 folded before Flop (didn't bet)
Seat 6: SRERAF folded before Flop (didn't bet)



PokerStars Zoom Hand #193804791729:  Hold'em No Limit ($0.01/$0.02) - 2018/11/28 0:41:36 CUST [2018/11/27 11:41:36 ET]
Table 'Halley' 6-max Seat #1 is the button
Seat 1: olegan.o94 ($1.05 in chips) 
Seat 2: batek_1 ($3.08 in chips) 
Seat 3: hc agorist ($1.84 in chips) 
Seat 4: azcar129 ($3.45 in chips) 
Seat 5: Williwacker9 ($2.02 in chips) 
Seat 6: Clepall99 ($1.40 in chips) 
batek_1: posts small blind $0.01
hc agorist: posts big blind $0.02
*** HOLE CARDS ***
Dealt to hc agorist [Ac 7h]
azcar129: raises $0.04 to $0.06
Williwacker9: folds 
Clepall99: raises $1.34 to $1.40 and is all-in
olegan.o94: folds 
batek_1: folds 
hc agorist: folds 
azcar129: folds 
Uncalled bet ($1.34) returned to Clepall99
Clepall99 collected $0.15 from pot
Clepall99: doesn't show hand 
*** SUMMARY ***
Total pot $0.15 | Rake $0 
Seat 1: olegan.o94 (button) folded before Flop (didn't bet)
Seat 2: batek_1 (small blind) folded before Flop
Seat 3: hc agorist (big blind) folded before Flop
Seat 4: azcar129 folded before Flop
Seat 5: Williwacker9 folded before Flop (didn't bet)
Seat 6: Clepall99 collected ($0.15)



PokerStars Zoom Hand #193804801843:  Hold'em No Limit ($0.01/$0.02) - 2018/11/28 0:41:54 CUST [2018/11/27 11:41:54 ET]
Table 'Halley' 6-max Seat #1 is the button
Seat 1: sousaleandro ($2.08 in chips) 
Seat 2: hc agorist ($1.82 in chips) 
Seat 3: IMVV310 ($2.29 in chips) 
Seat 4: Habo1947 ($2.18 in chips) 
Seat 5: cibor74 ($2.16 in chips) 
Seat 6: Alex78Den ($1.88 in chips) 
hc agorist: posts small blind $0.01
IMVV310: posts big blind $0.02
*** HOLE CARDS ***
Dealt to hc agorist [6h 5h]
Habo1947: calls $0.02
cibor74: folds 
Alex78Den: calls $0.02
sousaleandro: folds 
hc agorist: calls $0.01
IMVV310: checks 
*** FLOP *** [9d Ad 9s]
hc agorist: checks 
IMVV310: checks 
Habo1947: bets $0.08
Alex78Den: folds 
hc agorist: folds 
IMVV310: calls $0.08
*** TURN *** [9d Ad 9s] [4c]
IMVV310: checks 
Habo1947: checks 
*** RIVER *** [9d Ad 9s 4c] [2s]
IMVV310: checks 
Habo1947: checks 
*** SHOW DOWN ***
IMVV310: shows [As 2c] (two pair, Aces and Nines)
Habo1947: shows [8s Ah] (two pair, Aces and Nines - Eight kicker)
Habo1947 collected $0.23 from pot
*** SUMMARY ***
Total pot $0.24 | Rake $0.01 
Board [9d Ad 9s 4c 2s]
Seat 1: sousaleandro (button) folded before Flop (didn't bet)
Seat 2: hc agorist (small blind) folded on the Flop
Seat 3: IMVV310 (big blind) showed [As 2c] and lost with two pair, Aces and Nines
Seat 4: Habo1947 showed [8s Ah] and won ($0.23) with two pair, Aces and Nines
Seat 5: cibor74 folded before Flop (didn't bet)
Seat 6: Alex78Den folded on the Flop



PokerStars Zoom Hand #193804797889:  Hold'em No Limit ($0.01/$0.02) - 2018/11/28 0:41:47 CUST [2018/11/27 11:41:47 ET]
Table 'Halley' 6-max Seat #1 is the button
Seat 1: Merlois ($3.17 in chips) 
Seat 2: swnfly41 ($7.27 in chips) 
Seat 3: Simkooo ($2 in chips) 
Seat 4: BuffmonsterOne ($2.88 in chips) 
Seat 5: edduarth ($2.27 in chips) 
Seat 6: hc agorist ($1.82 in chips) 
swnfly41: posts small blind $0.01
Simkooo: posts big blind $0.02
*** HOLE CARDS ***
Dealt to hc agorist [Ac 2h]
BuffmonsterOne: raises $0.03 to $0.05
edduarth: folds 
hc agorist: folds 
Merlois: calls $0.05
swnfly41: folds 
Simkooo: folds 
*** FLOP *** [4c 3c Qd]
BuffmonsterOne: checks 
Merlois: checks 
*** TURN *** [4c 3c Qd] [8h]
BuffmonsterOne: bets $0.07
Merlois: folds 
Uncalled bet ($0.07) returned to BuffmonsterOne
BuffmonsterOne collected $0.13 from pot
BuffmonsterOne: doesn't show hand 
*** SUMMARY ***
Total pot $0.13 | Rake $0 
Board [4c 3c Qd 8h]
Seat 1: Merlois (button) folded on the Turn
Seat 2: swnfly41 (small blind) folded before Flop
Seat 3: Simkooo (big blind) folded before Flop
Seat 4: BuffmonsterOne collected ($0.13)
Seat 5: edduarth folded before Flop (didn't bet)
Seat 6: hc agorist folded before Flop (didn't bet)



PokerStars Zoom Hand #193804814316:  Hold'em No Limit ($0.01/$0.02) - 2018/11/28 0:42:16 CUST [2018/11/27 11:42:16 ET]
Table 'Halley' 6-max Seat #1 is the button
Seat 1: hc agorist ($1.80 in chips) 
Seat 2: nikonova88 ($5.35 in chips) 
Seat 3: aphokaliptic ($2 in chips) 
Seat 4: torusnegger ($0.77 in chips) 
Seat 5: salpi7 ($2.17 in chips) 
Seat 6: Spiridon1980 ($8.32 in chips) 
nikonova88: posts small blind $0.01
aphokaliptic: posts big blind $0.02
*** HOLE CARDS ***
Dealt to hc agorist [Qh 6h]
torusnegger: folds 
salpi7: folds 
Spiridon1980: folds 
hc agorist: raises $0.02 to $0.04
nikonova88: folds 
aphokaliptic: folds 
Uncalled bet ($0.02) returned to hc agorist
hc agorist collected $0.05 from pot
hc agorist: doesn't show hand 
*** SUMMARY ***
Total pot $0.05 | Rake $0 
Seat 1: hc agorist (button) collected ($0.05)
Seat 2: nikonova88 (small blind) folded before Flop
Seat 3: aphokaliptic (big blind) folded before Flop
Seat 4: torusnegger folded before Flop (didn't bet)
Seat 5: salpi7 folded before Flop (didn't bet)
Seat 6: Spiridon1980 folded before Flop (didn't bet)



PokerStars Zoom Hand #193804826704:  Hold'em No Limit ($0.01/$0.02) - 2018/11/28 0:42:38 CUST [2018/11/27 11:42:38 ET]
Table 'Halley' 6-max Seat #1 is the button
Seat 1: Agno$tic ($4.67 in chips) 
Seat 2: Spiridon1980 ($8.32 in chips) 
Seat 3: MellivoraSto ($2 in chips) 
Seat 4: booktable ($2.12 in chips) 
Seat 5: hc agorist ($1.83 in chips) 
Seat 6: skendroshen ($5.93 in chips) 
Spiridon1980: posts small blind $0.01
MellivoraSto: posts big blind $0.02
*** HOLE CARDS ***
Dealt to hc agorist [9c Kc]
booktable: raises $0.02 to $0.04
hc agorist: raises $0.11 to $0.15
skendroshen: folds 
Agno$tic: folds 
Spiridon1980: folds 
MellivoraSto: folds 
booktable: folds 
Uncalled bet ($0.11) returned to hc agorist
hc agorist collected $0.11 from pot
hc agorist: doesn't show hand 
*** SUMMARY ***
Total pot $0.11 | Rake $0 
Seat 1: Agno$tic (button) folded before Flop (didn't bet)
Seat 2: Spiridon1980 (small blind) folded before Flop
Seat 3: MellivoraSto (big blind) folded before Flop
Seat 4: booktable folded before Flop
Seat 5: hc agorist collected ($0.11)
Seat 6: skendroshen folded before Flop (didn't bet)



PokerStars Zoom Hand #193804835915:  Hold'em No Limit ($0.01/$0.02) - 2018/11/28 0:42:54 CUST [2018/11/27 11:42:54 ET]
Table 'Halley' 6-max Seat #1 is the button
Seat 1: naimscorp ($2.79 in chips) 
Seat 2: andrqi ($5.24 in chips) 
Seat 3: hc agorist ($1.90 in chips) 
Seat 4: vetrov.s ($2.12 in chips) 
Seat 5: amaposh ($2.16 in chips) 
Seat 6: Eveyor ($10.75 in chips) 
andrqi: posts small blind $0.01
hc agorist: posts big blind $0.02
*** HOLE CARDS ***
Dealt to hc agorist [7d 8d]
vetrov.s: folds 
amaposh: folds 
Eveyor: folds 
naimscorp: raises $0.04 to $0.06
andrqi: folds 
hc agorist: raises $0.13 to $0.19
naimscorp: calls $0.13
*** FLOP *** [9d Kh 2h]
hc agorist: checks 
naimscorp: bets $0.19
hc agorist: folds 
Uncalled bet ($0.19) returned to naimscorp
naimscorp collected $0.38 from pot
naimscorp: doesn't show hand 
*** SUMMARY ***
Total pot $0.39 | Rake $0.01 
Board [9d Kh 2h]
Seat 1: naimscorp (button) collected ($0.38)
Seat 2: andrqi (small blind) folded before Flop
Seat 3: hc agorist (big blind) folded on the Flop
Seat 4: vetrov.s folded before Flop (didn't bet)
Seat 5: amaposh folded before Flop (didn't bet)
Seat 6: Eveyor folded before Flop (didn't bet)



PokerStars Zoom Hand #193804851197:  Hold'em No Limit ($0.01/$0.02) - 2018/11/28 0:43:21 CUST [2018/11/27 11:43:21 ET]
Table 'Halley' 6-max Seat #1 is the button
Seat 1: svetogor1991 ($2.08 in chips) 
Seat 2: grv17 ($2 in chips) 
Seat 3: serde4nik ($2.02 in chips) 
Seat 4: D4ns3n ($4.02 in chips) 
Seat 5: hc agorist ($1.71 in chips) 
Seat 6: avirik1 ($2.18 in chips) 
grv17: posts small blind $0.01
serde4nik: posts big blind $0.02
*** HOLE CARDS ***
Dealt to hc agorist [7c 5d]
D4ns3n: folds 
hc agorist: folds 
avirik1: folds 
svetogor1991: folds 
grv17: folds 
Uncalled bet ($0.01) returned to serde4nik
serde4nik collected $0.02 from pot
serde4nik: doesn't show hand 
*** SUMMARY ***
Total pot $0.02 | Rake $0 
Seat 1: svetogor1991 (button) folded before Flop (didn't bet)
Seat 2: grv17 (small blind) folded before Flop
Seat 3: serde4nik (big blind) collected ($0.02)
Seat 4: D4ns3n folded before Flop (didn't bet)
Seat 5: hc agorist folded before Flop (didn't bet)
Seat 6: avirik1 folded before Flop (didn't bet)



PokerStars Zoom Hand #193804855237:  Hold'em No Limit ($0.01/$0.02) - 2018/11/28 0:43:28 CUST [2018/11/27 11:43:28 ET]
Table 'Halley' 6-max Seat #1 is the button
Seat 1: Miami27887 ($2.02 in chips) 
Seat 2: dziad1985 ($1.91 in chips) 
Seat 3: batek_1 ($3.02 in chips) 
Seat 4: hc agorist ($1.71 in chips) 
Seat 5: alexps922 ($2 in chips) 
Seat 6: salpi7 ($2 in chips) 
dziad1985: posts small blind $0.01
batek_1: posts big blind $0.02
*** HOLE CARDS ***
Dealt to hc agorist [6s Js]
hc agorist: raises $0.02 to $0.04
alexps922: raises $0.08 to $0.12
salpi7: folds 
Miami27887: folds 
dziad1985: folds 
batek_1: folds 
hc agorist: folds 
Uncalled bet ($0.08) returned to alexps922
alexps922 collected $0.11 from pot
alexps922: doesn't show hand 
*** SUMMARY ***
Total pot $0.11 | Rake $0 
Seat 1: Miami27887 (button) folded before Flop (didn't bet)
Seat 2: dziad1985 (small blind) folded before Flop
Seat 3: batek_1 (big blind) folded before Flop
Seat 4: hc agorist folded before Flop
Seat 5: alexps922 collected ($0.11)
Seat 6: salpi7 folded before Flop (didn't bet)



PokerStars Zoom Hand #193804861550:  Hold'em No Limit ($0.01/$0.02) - 2018/11/28 0:43:39 CUST [2018/11/27 11:43:39 ET]
Table 'Halley' 6-max Seat #1 is the button
Seat 1: hc agorist ($1.67 in chips) 
Seat 2: Skeptik29 ($2.04 in chips) 
Seat 3: ZOrG011 ($2.15 in chips) 
Seat 4: ZeusCMR ($2.21 in chips) 
Seat 5: Brentyyy ($2.06 in chips) 
Seat 6: Eveyor ($10.75 in chips) 
Skeptik29: posts small blind $0.01
ZOrG011: posts big blind $0.02
*** HOLE CARDS ***
Dealt to hc agorist [5d Kh]
ZeusCMR: folds 
Brentyyy: folds 
Eveyor: folds 
hc agorist: folds 
Skeptik29: folds 
Uncalled bet ($0.01) returned to ZOrG011
ZOrG011 collected $0.02 from pot
ZOrG011: doesn't show hand 
*** SUMMARY ***
Total pot $0.02 | Rake $0 
Seat 1: hc agorist (button) folded before Flop (didn't bet)
Seat 2: Skeptik29 (small blind) folded before Flop
Seat 3: ZOrG011 (big blind) collected ($0.02)
Seat 4: ZeusCMR folded before Flop (didn't bet)
Seat 5: Brentyyy folded before Flop (didn't bet)
Seat 6: Eveyor folded before Flop (didn't bet)



PokerStars Zoom Hand #193804872976:  Hold'em No Limit ($0.01/$0.02) - 2018/11/28 0:43:59 CUST [2018/11/27 11:43:59 ET]
Table 'Halley' 6-max Seat #1 is the button
Seat 1: AAQQQ ($2.01 in chips) 
Seat 2: SAHA3746 ($2.05 in chips) 
Seat 3: hc agorist ($1.66 in chips) 
Seat 4: 1FIC ($3.75 in chips) 
Seat 5: zALEXKAYz ($1.13 in chips) 
Seat 6: xompistas000 ($3.90 in chips) 
SAHA3746: posts small blind $0.01
hc agorist: posts big blind $0.02
*** HOLE CARDS ***
Dealt to hc agorist [Qd 4h]
1FIC: calls $0.02
zALEXKAYz: folds 
xompistas000: folds 
AAQQQ: raises $0.14 to $0.16
SAHA3746: folds 
hc agorist: folds 
1FIC: folds 
Uncalled bet ($0.14) returned to AAQQQ
AAQQQ collected $0.07 from pot
AAQQQ: doesn't show hand 
*** SUMMARY ***
Total pot $0.07 | Rake $0 
Seat 1: AAQQQ (button) collected ($0.07)
Seat 2: SAHA3746 (small blind) folded before Flop
Seat 3: hc agorist (big blind) folded before Flop
Seat 4: 1FIC folded before Flop
Seat 5: zALEXKAYz folded before Flop (didn't bet)
Seat 6: xompistas000 folded before Flop (didn't bet)



PokerStars Zoom Hand #193804870187:  Hold'em No Limit ($0.01/$0.02) - 2018/11/28 0:43:54 CUST [2018/11/27 11:43:54 ET]
Table 'Halley' 6-max Seat #1 is the button
Seat 1: NaumiPar ($2.79 in chips) 
Seat 2: Mizzek ($2 in chips) 
Seat 3: COURT JES264 ($2.04 in chips) 
Seat 4: hc agorist ($1.66 in chips) 
Seat 5: Eveyor ($10.71 in chips) 
Seat 6: xtwocardsx ($2.78 in chips) 
Mizzek: posts small blind $0.01
COURT JES264: posts big blind $0.02
*** HOLE CARDS ***
Dealt to hc agorist [5s Ad]
hc agorist: folds 
Eveyor: raises $0.04 to $0.06
xtwocardsx: calls $0.06
NaumiPar: folds 
Mizzek: folds 
COURT JES264: folds 
*** FLOP *** [4c 4h 3h]
Eveyor: bets $0.09
xtwocardsx: calls $0.09
*** TURN *** [4c 4h 3h] [7h]
Eveyor: checks 
xtwocardsx: checks 
*** RIVER *** [4c 4h 3h 7h] [6d]
Eveyor: checks 
xtwocardsx: bets $0.18
Eveyor: folds 
Uncalled bet ($0.18) returned to xtwocardsx
xtwocardsx collected $0.32 from pot
xtwocardsx: doesn't show hand 
*** SUMMARY ***
Total pot $0.33 | Rake $0.01 
Board [4c 4h 3h 7h 6d]
Seat 1: NaumiPar (button) folded before Flop (didn't bet)
Seat 2: Mizzek (small blind) folded before Flop
Seat 3: COURT JES264 (big blind) folded before Flop
Seat 4: hc agorist folded before Flop (didn't bet)
Seat 5: Eveyor folded on the River
Seat 6: xtwocardsx collected ($0.32)



PokerStars Zoom Hand #193804864409:  Hold'em No Limit ($0.01/$0.02) - 2018/11/28 0:43:44 CUST [2018/11/27 11:43:44 ET]
Table 'Halley' 6-max Seat #1 is the button
Seat 1: nobby57 ($1.67 in chips) 
Seat 2: hc agorist ($1.67 in chips) 
Seat 3: lupu1903 ($1.55 in chips) 
Seat 4: MANDASHIVAN ($0.99 in chips) 
Seat 5: Nenohh0487NL ($2.79 in chips) 
Seat 6: G.Datskov ($2.01 in chips) 
hc agorist: posts small blind $0.01
lupu1903: posts big blind $0.02
*** HOLE CARDS ***
Dealt to hc agorist [6d 2d]
MANDASHIVAN: raises $0.04 to $0.06
Nenohh0487NL: folds 
G.Datskov: folds 
nobby57: calls $0.06
hc agorist: folds 
lupu1903: calls $0.04
*** FLOP *** [7c Kc 5h]
lupu1903: checks 
MANDASHIVAN: checks 
nobby57: bets $0.06
lupu1903: calls $0.06
MANDASHIVAN: calls $0.06
*** TURN *** [7c Kc 5h] [As]
lupu1903: checks 
MANDASHIVAN: checks 
nobby57: bets $0.02
lupu1903: folds 
MANDASHIVAN: calls $0.02
*** RIVER *** [7c Kc 5h As] [3s]
MANDASHIVAN: checks 
nobby57: checks 
*** SHOW DOWN ***
MANDASHIVAN: shows [Jc Qd] (high card Ace)
nobby57: shows [Jh Kh] (a pair of Kings)
nobby57 collected $0.40 from pot
*** SUMMARY ***
Total pot $0.41 | Rake $0.01 
Board [7c Kc 5h As 3s]
Seat 1: nobby57 (button) showed [Jh Kh] and won ($0.40) with a pair of Kings
Seat 2: hc agorist (small blind) folded before Flop
Seat 3: lupu1903 (big blind) folded on the Turn
Seat 4: MANDASHIVAN showed [Jc Qd] and lost with high card Ace
Seat 5: Nenohh0487NL folded before Flop (didn't bet)
Seat 6: G.Datskov folded before Flop (didn't bet)



PokerStars Zoom Hand #193804867344:  Hold'em No Limit ($0.01/$0.02) - 2018/11/28 0:43:49 CUST [2018/11/27 11:43:49 ET]
Table 'Halley' 6-max Seat #1 is the button
Seat 1: sorvasile85 ($2.12 in chips) 
Seat 2: TQRU ($1.48 in chips) 
Seat 3: MLingard ($2 in chips) 
Seat 4: tigr6210 ($1.75 in chips) 
Seat 5: V-SCORPIO-C ($3.75 in chips) 
Seat 6: hc agorist ($1.66 in chips) 
TQRU: posts small blind $0.01
MLingard: posts big blind $0.02
*** HOLE CARDS ***
Dealt to hc agorist [8s 4h]
tigr6210: folds 
V-SCORPIO-C: raises $0.04 to $0.06
hc agorist: folds 
sorvasile85: calls $0.06
TQRU: folds 
MLingard: folds 
*** FLOP *** [3h Ad Th]
V-SCORPIO-C: checks 
sorvasile85: bets $0.06
V-SCORPIO-C: calls $0.06
*** TURN *** [3h Ad Th] [2c]
V-SCORPIO-C: checks 
sorvasile85: bets $0.12
V-SCORPIO-C: calls $0.12
*** RIVER *** [3h Ad Th 2c] [9c]
V-SCORPIO-C: checks 
sorvasile85: bets $1.88 and is all-in
V-SCORPIO-C: folds 
Uncalled bet ($1.88) returned to sorvasile85
sorvasile85 collected $0.49 from pot
sorvasile85: doesn't show hand 
*** SUMMARY ***
Total pot $0.51 | Rake $0.02 
Board [3h Ad Th 2c 9c]
Seat 1: sorvasile85 (button) collected ($0.49)
Seat 2: TQRU (small blind) folded before Flop
Seat 3: MLingard (big blind) folded before Flop
Seat 4: tigr6210 folded before Flop (didn't bet)
Seat 5: V-SCORPIO-C folded on the River
Seat 6: hc agorist folded before Flop (didn't bet)



PokerStars Zoom Hand #193804880966:  Hold'em No Limit ($0.01/$0.02) - 2018/11/28 0:44:13 CUST [2018/11/27 11:44:13 ET]
Table 'Halley' 6-max Seat #1 is the button
Seat 1: supa4444 ($1.08 in chips) 
Seat 2: PRrey ($1.98 in chips) 
Seat 3: 30yyyyyy ($1.35 in chips) 
Seat 4: vatteztaR* ($2.39 in chips) 
Seat 5: Ruslan13581 ($3.15 in chips) 
Seat 6: hc agorist ($1.64 in chips) 
PRrey: posts small blind $0.01
30yyyyyy: posts big blind $0.02
*** HOLE CARDS ***
Dealt to hc agorist [7h 3h]
vatteztaR*: folds 
Ruslan13581: folds 
hc agorist: raises $0.02 to $0.04
supa4444: folds 
PRrey: folds 
30yyyyyy: calls $0.02
*** FLOP *** [Td 8d 3d]
30yyyyyy: checks 
hc agorist: bets $0.03
30yyyyyy: calls $0.03
*** TURN *** [Td 8d 3d] [8c]
30yyyyyy: checks 
hc agorist: checks 
*** RIVER *** [Td 8d 3d 8c] [Jd]
30yyyyyy: checks 
hc agorist: bets $0.24
30yyyyyy: calls $0.24
*** SHOW DOWN ***
hc agorist: shows [7h 3h] (two pair, Eights and Threes)
30yyyyyy: shows [8h Ac] (three of a kind, Eights)
30yyyyyy collected $0.61 from pot
*** SUMMARY ***
Total pot $0.63 | Rake $0.02 
Board [Td 8d 3d 8c Jd]
Seat 1: supa4444 (button) folded before Flop (didn't bet)
Seat 2: PRrey (small blind) folded before Flop
Seat 3: 30yyyyyy (big blind) showed [8h Ac] and won ($0.61) with three of a kind, Eights
Seat 4: vatteztaR* folded before Flop (didn't bet)
Seat 5: Ruslan13581 folded before Flop (didn't bet)
Seat 6: hc agorist showed [7h 3h] and lost with two pair, Eights and Threes



PokerStars Zoom Hand #193804904676:  Hold'em No Limit ($0.01/$0.02) - 2018/11/28 0:44:55 CUST [2018/11/27 11:44:55 ET]
Table 'Halley' 6-max Seat #1 is the button
Seat 1: hc agorist ($1.33 in chips) 
Seat 2: Ramero 34 ($0.42 in chips) 
Seat 3: rychu1906 ($2.12 in chips) 
Seat 4: igor12357 ($2.42 in chips) 
Seat 5: AII0JIJI0H ($0.97 in chips) 
Seat 6: PPYPP ($2.31 in chips) 
Ramero 34: posts small blind $0.01
rychu1906: posts big blind $0.02
*** HOLE CARDS ***
Dealt to hc agorist [2d 7h]
igor12357: folds 
AII0JIJI0H: folds 
PPYPP: folds 
hc agorist: folds 
Ramero 34: folds 
Uncalled bet ($0.01) returned to rychu1906
rychu1906 collected $0.02 from pot
rychu1906: doesn't show hand 
*** SUMMARY ***
Total pot $0.02 | Rake $0 
Seat 1: hc agorist (button) folded before Flop (didn't bet)
Seat 2: Ramero 34 (small blind) folded before Flop
Seat 3: rychu1906 (big blind) collected ($0.02)
Seat 4: igor12357 folded before Flop (didn't bet)
Seat 5: AII0JIJI0H folded before Flop (didn't bet)
Seat 6: PPYPP folded before Flop (didn't bet)



PokerStars Zoom Hand #193804910893:  Hold'em No Limit ($0.01/$0.02) - 2018/11/28 0:45:06 CUST [2018/11/27 11:45:06 ET]
Table 'Halley' 6-max Seat #1 is the button
Seat 1: Flying-Fish-NL ($2.01 in chips) 
Seat 2: hc agorist ($1.33 in chips) 
Seat 3: TheN@kedGun ($4.05 in chips) 
Seat 4: vvk22 ($2.43 in chips) 
Seat 5: salpi7 ($2.05 in chips) 
Seat 6: skendroshen ($4.20 in chips) 
hc agorist: posts small blind $0.01
TheN@kedGun: posts big blind $0.02
*** HOLE CARDS ***
Dealt to hc agorist [6c Jc]
vvk22: folds 
salpi7: folds 
skendroshen: folds 
Flying-Fish-NL: raises $0.03 to $0.05
hc agorist: folds 
TheN@kedGun: folds 
Uncalled bet ($0.03) returned to Flying-Fish-NL
Flying-Fish-NL collected $0.05 from pot
Flying-Fish-NL: doesn't show hand 
*** SUMMARY ***
Total pot $0.05 | Rake $0 
Seat 1: Flying-Fish-NL (button) collected ($0.05)
Seat 2: hc agorist (small blind) folded before Flop
Seat 3: TheN@kedGun (big blind) folded before Flop
Seat 4: vvk22 folded before Flop (didn't bet)
Seat 5: salpi7 folded before Flop (didn't bet)
Seat 6: skendroshen folded before Flop (didn't bet)



PokerStars Zoom Hand #193804908050:  Hold'em No Limit ($0.01/$0.02) - 2018/11/28 0:45:01 CUST [2018/11/27 11:45:01 ET]
Table 'Halley' 6-max Seat #1 is the button
Seat 1: sokoll888 ($0.95 in chips) 
Seat 2: abatur0 ($3.04 in chips) 
Seat 3: vvk22 ($1.28 in chips) 
Seat 4: hc agorist ($1.33 in chips) 
Seat 5: Vanana Roja ($3.35 in chips) 
Seat 6: N4tyN1ce ($2.34 in chips) 
abatur0: posts small blind $0.01
vvk22: posts big blind $0.02
*** HOLE CARDS ***
Dealt to hc agorist [Ad 2h]
hc agorist: folds 
Vanana Roja: folds 
N4tyN1ce: raises $0.03 to $0.05
sokoll888: calls $0.05
abatur0: folds 
vvk22: folds 
*** FLOP *** [2c 3c 4s]
N4tyN1ce: checks 
sokoll888: bets $0.07
N4tyN1ce: folds 
Uncalled bet ($0.07) returned to sokoll888
sokoll888 collected $0.13 from pot
sokoll888: doesn't show hand 
*** SUMMARY ***
Total pot $0.13 | Rake $0 
Board [2c 3c 4s]
Seat 1: sokoll888 (button) collected ($0.13)
Seat 2: abatur0 (small blind) folded before Flop
Seat 3: vvk22 (big blind) folded before Flop
Seat 4: hc agorist folded before Flop (didn't bet)
Seat 5: Vanana Roja folded before Flop (didn't bet)
Seat 6: N4tyN1ce folded on the Flop



PokerStars Zoom Hand #193804916617:  Hold'em No Limit ($0.01/$0.02) - 2018/11/28 0:45:16 CUST [2018/11/27 11:45:16 ET]
Table 'Halley' 6-max Seat #1 is the button
Seat 1: high0008 ($2.25 in chips) 
Seat 2: Brentyyy ($2.15 in chips) 
Seat 3: BHunterrrr ($2.17 in chips) 
Seat 4: MellivoraSto ($2.09 in chips) 
Seat 5: hc agorist ($1.32 in chips) 
Seat 6: salpi7 ($2.35 in chips) 
Brentyyy: posts small blind $0.01
BHunterrrr: posts big blind $0.02
*** HOLE CARDS ***
Dealt to hc agorist [8c Qd]
MellivoraSto: folds 
hc agorist: folds 
salpi7: raises $0.04 to $0.06
high0008: folds 
Brentyyy: folds 
BHunterrrr: folds 
Uncalled bet ($0.04) returned to salpi7
salpi7 collected $0.05 from pot
salpi7: doesn't show hand 
*** SUMMARY ***
Total pot $0.05 | Rake $0 
Seat 1: high0008 (button) folded before Flop (didn't bet)
Seat 2: Brentyyy (small blind) folded before Flop
Seat 3: BHunterrrr (big blind) folded before Flop
Seat 4: MellivoraSto folded before Flop (didn't bet)
Seat 5: hc agorist folded before Flop (didn't bet)
Seat 6: salpi7 collected ($0.05)



PokerStars Zoom Hand #193804920013:  Hold'em No Limit ($0.01/$0.02) - 2018/11/28 0:45:22 CUST [2018/11/27 11:45:22 ET]
Table 'Halley' 6-max Seat #1 is the button
Seat 1: Kala77 ($3.39 in chips) 
Seat 2: Buddaaa ($2.18 in chips) 
Seat 3: hc agorist ($1.32 in chips) 
Seat 4: smalna1 ($3.02 in chips) 
Seat 5: svetogor1991 ($2.12 in chips) 
Seat 6: AcetOne555 ($3.05 in chips) 
Buddaaa: posts small blind $0.01
hc agorist: posts big blind $0.02
*** HOLE CARDS ***
Dealt to hc agorist [8s Ah]
smalna1: folds 
svetogor1991: folds 
AcetOne555: folds 
Kala77: folds 
Buddaaa: raises $0.04 to $0.06
hc agorist: raises $0.12 to $0.18
Buddaaa: calls $0.12
*** FLOP *** [9h 4h Th]
Buddaaa: checks 
hc agorist: bets $0.12
Buddaaa: calls $0.12
*** TURN *** [9h 4h Th] [Qd]
Buddaaa: checks 
hc agorist: checks 
*** RIVER *** [9h 4h Th Qd] [As]
Buddaaa: checks 
hc agorist: bets $1.02 and is all-in
Buddaaa: folds 
Uncalled bet ($1.02) returned to hc agorist
hc agorist collected $0.58 from pot
hc agorist: doesn't show hand 
*** SUMMARY ***
Total pot $0.60 | Rake $0.02 
Board [9h 4h Th Qd As]
Seat 1: Kala77 (button) folded before Flop (didn't bet)
Seat 2: Buddaaa (small blind) folded on the River
Seat 3: hc agorist (big blind) collected ($0.58)
Seat 4: smalna1 folded before Flop (didn't bet)
Seat 5: svetogor1991 folded before Flop (didn't bet)
Seat 6: AcetOne555 folded before Flop (didn't bet)



PokerStars Zoom Hand #193804945227:  Hold'em No Limit ($0.01/$0.02) - 2018/11/28 0:46:06 CUST [2018/11/27 11:46:06 ET]
Table 'Halley' 6-max Seat #1 is the button
Seat 1: hc agorist ($1.60 in chips) 
Seat 2: skystaruk ($1.35 in chips) 
Seat 3: dinarik1104 ($3.86 in chips) 
Seat 4: fazanis4e ($3.14 in chips) 
Seat 5: DevilXGod ($3.78 in chips) 
Seat 6: vatteztaR* ($2.31 in chips) 
skystaruk: posts small blind $0.01
dinarik1104: posts big blind $0.02
*** HOLE CARDS ***
Dealt to hc agorist [9h 6s]
fazanis4e: raises $0.04 to $0.06
DevilXGod: folds 
vatteztaR*: folds 
hc agorist: folds 
skystaruk: calls $0.05
dinarik1104: folds 
*** FLOP *** [2d Ts Qd]
skystaruk: checks 
fazanis4e: bets $0.09
skystaruk: folds 
Uncalled bet ($0.09) returned to fazanis4e
fazanis4e collected $0.14 from pot
fazanis4e: doesn't show hand 
*** SUMMARY ***
Total pot $0.14 | Rake $0 
Board [2d Ts Qd]
Seat 1: hc agorist (button) folded before Flop (didn't bet)
Seat 2: skystaruk (small blind) folded on the Flop
Seat 3: dinarik1104 (big blind) folded before Flop
Seat 4: fazanis4e collected ($0.14)
Seat 5: DevilXGod folded before Flop (didn't bet)
Seat 6: vatteztaR* folded before Flop (didn't bet)



PokerStars Zoom Hand #193804948112:  Hold'em No Limit ($0.01/$0.02) - 2018/11/28 0:46:11 CUST [2018/11/27 11:46:11 ET]
Table 'Halley' 6-max Seat #1 is the button
Seat 1: effortlessly1 ($2 in chips) 
Seat 2: hc agorist ($1.60 in chips) 
Seat 3: supa4444 ($1.86 in chips) 
Seat 4: KebabaiJega ($2.22 in chips) 
Seat 5: viktor49ru ($3.56 in chips) 
Seat 6: AAQQQ ($2.04 in chips) 
hc agorist: posts small blind $0.01
supa4444: posts big blind $0.02
*** HOLE CARDS ***
Dealt to hc agorist [Js 7s]
KebabaiJega: folds 
viktor49ru: folds 
AAQQQ: raises $0.02 to $0.04
effortlessly1: folds 
hc agorist: raises $0.10 to $0.14
supa4444: folds 
AAQQQ: calls $0.10
*** FLOP *** [3d 6d 5d]
hc agorist: bets $0.10
AAQQQ: calls $0.10
*** TURN *** [3d 6d 5d] [6h]
hc agorist: checks 
AAQQQ: bets $0.24
hc agorist: raises $1.12 to $1.36 and is all-in
AAQQQ: folds 
Uncalled bet ($1.12) returned to hc agorist
hc agorist collected $0.95 from pot
hc agorist: doesn't show hand 
*** SUMMARY ***
Total pot $0.98 | Rake $0.03 
Board [3d 6d 5d 6h]
Seat 1: effortlessly1 (button) folded before Flop (didn't bet)
Seat 2: hc agorist (small blind) collected ($0.95)
Seat 3: supa4444 (big blind) folded before Flop
Seat 4: KebabaiJega folded before Flop (didn't bet)
Seat 5: viktor49ru folded before Flop (didn't bet)
Seat 6: AAQQQ folded on the Turn



PokerStars Zoom Hand #193804986938:  Hold'em No Limit ($0.01/$0.02) - 2018/11/28 0:47:19 CUST [2018/11/27 11:47:19 ET]
Table 'Halley' 6-max Seat #1 is the button
Seat 1: TMZ VVV ($0.85 in chips) 
Seat 2: Pelorojo1 ($2.35 in chips) 
Seat 3: Kala77 ($4.56 in chips) 
Seat 4: Buddaaa ($2.02 in chips) 
Seat 5: hc agorist ($2.07 in chips) 
Seat 6: Gugondo ($2.13 in chips) 
Pelorojo1: posts small blind $0.01
Kala77: posts big blind $0.02
*** HOLE CARDS ***
Dealt to hc agorist [8c 3h]
Buddaaa: folds 
hc agorist: folds 
Gugondo: raises $0.04 to $0.06
TMZ VVV: folds 
Pelorojo1: folds 
Kala77: folds 
Uncalled bet ($0.04) returned to Gugondo
Gugondo collected $0.05 from pot
Gugondo: doesn't show hand 
*** SUMMARY ***
Total pot $0.05 | Rake $0 
Seat 1: TMZ VVV (button) folded before Flop (didn't bet)
Seat 2: Pelorojo1 (small blind) folded before Flop
Seat 3: Kala77 (big blind) folded before Flop
Seat 4: Buddaaa folded before Flop (didn't bet)
Seat 5: hc agorist folded before Flop (didn't bet)
Seat 6: Gugondo collected ($0.05)



PokerStars Zoom Hand #193804989764:  Hold'em No Limit ($0.01/$0.02) - 2018/11/28 0:47:24 CUST [2018/11/27 11:47:24 ET]
Table 'Halley' 6-max Seat #1 is the button
Seat 1: wogen5 ($1.28 in chips) 
Seat 2: Silock ($2.11 in chips) 
Seat 3: 3Iver's3 ($3.29 in chips) 
Seat 4: dedmoroz311 ($2.04 in chips) 
Seat 5: hc agorist ($2.07 in chips) 
Seat 6: Pat1992rick ($2.01 in chips) 
Silock: posts small blind $0.01
3Iver's3: posts big blind $0.02
*** HOLE CARDS ***
Dealt to hc agorist [Ks 3d]
dedmoroz311: folds 
hc agorist: folds 
Pat1992rick: folds 
wogen5: raises $0.04 to $0.06
Silock: folds 
3Iver's3: folds 
Uncalled bet ($0.04) returned to wogen5
wogen5 collected $0.05 from pot
wogen5: doesn't show hand 
*** SUMMARY ***
Total pot $0.05 | Rake $0 
Seat 1: wogen5 (button) collected ($0.05)
Seat 2: Silock (small blind) folded before Flop
Seat 3: 3Iver's3 (big blind) folded before Flop
Seat 4: dedmoroz311 folded before Flop (didn't bet)
Seat 5: hc agorist folded before Flop (didn't bet)
Seat 6: Pat1992rick folded before Flop (didn't bet)



PokerStars Zoom Hand #193804982351:  Hold'em No Limit ($0.01/$0.02) - 2018/11/28 0:47:11 CUST [2018/11/27 11:47:11 ET]
Table 'Halley' 6-max Seat #1 is the button
Seat 1: lennyfalk ($2.70 in chips) 
Seat 2: vvk22 ($2.27 in chips) 
Seat 3: Nossna ($2 in chips) 
Seat 4: de_wlnss ($2.11 in chips) 
Seat 5: zALEXKAYz ($1.74 in chips) 
Seat 6: hc agorist ($2.07 in chips) 
vvk22: posts small blind $0.01
Nossna: posts big blind $0.02
*** HOLE CARDS ***
Dealt to hc agorist [Jc 4h]
de_wlnss: folds 
zALEXKAYz: raises $0.04 to $0.06
hc agorist: folds 
lennyfalk: folds 
vvk22: calls $0.05
Nossna: folds 
*** FLOP *** [Qd Qc 8h]
vvk22: checks 
zALEXKAYz: checks 
*** TURN *** [Qd Qc 8h] [4c]
vvk22: checks 
zALEXKAYz: checks 
*** RIVER *** [Qd Qc 8h 4c] [Kd]
vvk22: bets $0.04
zALEXKAYz: folds 
Uncalled bet ($0.04) returned to vvk22
vvk22 collected $0.14 from pot
vvk22: doesn't show hand 
*** SUMMARY ***
Total pot $0.14 | Rake $0 
Board [Qd Qc 8h 4c Kd]
Seat 1: lennyfalk (button) folded before Flop (didn't bet)
Seat 2: vvk22 (small blind) collected ($0.14)
Seat 3: Nossna (big blind) folded before Flop
Seat 4: de_wlnss folded before Flop (didn't bet)
Seat 5: zALEXKAYz folded on the River
Seat 6: hc agorist folded before Flop (didn't bet)



PokerStars Zoom Hand #193805001830:  Hold'em No Limit ($0.01/$0.02) - 2018/11/28 0:47:45 CUST [2018/11/27 11:47:45 ET]
Table 'Halley' 6-max Seat #1 is the button
Seat 1: YV01 ($1.76 in chips) 
Seat 2: Kiizu ($4.12 in chips) 
Seat 3: SRERAF ($2 in chips) 
Seat 4: hc agorist ($2.05 in chips) 
Seat 5: Clepall99 ($0.73 in chips) 
Seat 6: stradywary ($2.07 in chips) 
Kiizu: posts small blind $0.01
SRERAF: posts big blind $0.02
*** HOLE CARDS ***
Dealt to hc agorist [6c As]
hc agorist: folds 
Clepall99: raises $0.71 to $0.73 and is all-in
stradywary: folds 
YV01: folds 
Kiizu: folds 
SRERAF: folds 
Uncalled bet ($0.71) returned to Clepall99
Clepall99 collected $0.05 from pot
Clepall99: doesn't show hand 
*** SUMMARY ***
Total pot $0.05 | Rake $0 
Seat 1: YV01 (button) folded before Flop (didn't bet)
Seat 2: Kiizu (small blind) folded before Flop
Seat 3: SRERAF (big blind) folded before Flop
Seat 4: hc agorist folded before Flop (didn't bet)
Seat 5: Clepall99 collected ($0.05)
Seat 6: stradywary folded before Flop (didn't bet)



PokerStars Zoom Hand #193804992625:  Hold'em No Limit ($0.01/$0.02) - 2018/11/28 0:47:29 CUST [2018/11/27 11:47:29 ET]
Table 'Halley' 6-max Seat #1 is the button
Seat 1: belomor245 ($2.30 in chips) 
Seat 2: AcetOne555 ($3.15 in chips) 
Seat 3: hc agorist ($2.07 in chips) 
Seat 4: David peixe ($2.19 in chips) 
Seat 5: attendant3 ($3.22 in chips) 
Seat 6: Yokirill ($2.03 in chips) 
AcetOne555: posts small blind $0.01
hc agorist: posts big blind $0.02
*** HOLE CARDS ***
Dealt to hc agorist [Ah 8d]
David peixe: folds 
attendant3: folds 
Yokirill: folds 
belomor245: raises $0.02 to $0.04
AcetOne555: raises $0.08 to $0.12
hc agorist: folds 
belomor245: calls $0.08
*** FLOP *** [Tc 9h 4d]
AcetOne555: bets $0.14
belomor245: calls $0.14
*** TURN *** [Tc 9h 4d] [Jd]
AcetOne555: checks 
belomor245: bets $0.26
AcetOne555: calls $0.26
*** RIVER *** [Tc 9h 4d Jd] [7d]
AcetOne555: checks 
belomor245: bets $0.51
AcetOne555: folds 
Uncalled bet ($0.51) returned to belomor245
belomor245 collected $1.02 from pot
belomor245: doesn't show hand 
*** SUMMARY ***
Total pot $1.06 | Rake $0.04 
Board [Tc 9h 4d Jd 7d]
Seat 1: belomor245 (button) collected ($1.02)
Seat 2: AcetOne555 (small blind) folded on the River
Seat 3: hc agorist (big blind) folded before Flop
Seat 4: David peixe folded before Flop (didn't bet)
Seat 5: attendant3 folded before Flop (didn't bet)
Seat 6: Yokirill folded before Flop (didn't bet)



PokerStars Zoom Hand #193805005172:  Hold'em No Limit ($0.01/$0.02) - 2018/11/28 0:47:51 CUST [2018/11/27 11:47:51 ET]
Table 'Halley' 6-max Seat #1 is the button
Seat 1: hc agorist ($2.05 in chips) 
Seat 2: the_Joker'83 ($2.53 in chips) 
Seat 3: karasukML ($1.96 in chips) 
Seat 4: qpsq ($2.34 in chips) 
Seat 5: playmaus 123 ($2.10 in chips) 
Seat 6: Lakchenko ($1.39 in chips) 
the_Joker'83: posts small blind $0.01
karasukML: posts big blind $0.02
*** HOLE CARDS ***
Dealt to hc agorist [Ah 9s]
qpsq: raises $0.05 to $0.07
playmaus 123: calls $0.07
Lakchenko: folds 
hc agorist: folds 
the_Joker'83: folds 
karasukML: folds 
*** FLOP *** [8d Kh Qc]
qpsq: bets $0.11
playmaus 123: calls $0.11
*** TURN *** [8d Kh Qc] [9c]
qpsq: bets $0.25
playmaus 123: calls $0.25
*** RIVER *** [8d Kh Qc 9c] [2d]
qpsq: checks 
playmaus 123: checks 
*** SHOW DOWN ***
qpsq: shows [Tc 8c] (a pair of Eights)
playmaus 123: mucks hand 
qpsq collected $0.86 from pot
*** SUMMARY ***
Total pot $0.89 | Rake $0.03 
Board [8d Kh Qc 9c 2d]
Seat 1: hc agorist (button) folded before Flop (didn't bet)
Seat 2: the_Joker'83 (small blind) folded before Flop
Seat 3: karasukML (big blind) folded before Flop
Seat 4: qpsq showed [Tc 8c] and won ($0.86) with a pair of Eights
Seat 5: playmaus 123 mucked [Ts Ad]
Seat 6: Lakchenko folded before Flop (didn't bet)



PokerStars Zoom Hand #193805010349:  Hold'em No Limit ($0.01/$0.02) - 2018/11/28 0:48:00 CUST [2018/11/27 11:48:00 ET]
Table 'Halley' 6-max Seat #1 is the button
Seat 1: wqd4 ($1.35 in chips) 
Seat 2: Honochin ($1.88 in chips) 
Seat 3: b1uebe11 ($1.19 in chips) 
Seat 4: xtwocardsx ($1.62 in chips) 
Seat 5: azcar129 ($2.41 in chips) 
Seat 6: hc agorist ($2.05 in chips) 
Honochin: posts small blind $0.01
b1uebe11: posts big blind $0.02
*** HOLE CARDS ***
Dealt to hc agorist [Kd 7d]
xtwocardsx: folds 
azcar129: folds 
hc agorist: raises $0.02 to $0.04
wqd4: calls $0.04
Honochin: folds 
b1uebe11: folds 
*** FLOP *** [5c 6s 6c]
hc agorist: checks 
wqd4: bets $0.11
hc agorist: folds 
Uncalled bet ($0.11) returned to wqd4
wqd4 collected $0.11 from pot
wqd4: doesn't show hand 
*** SUMMARY ***
Total pot $0.11 | Rake $0 
Board [5c 6s 6c]
Seat 1: wqd4 (button) collected ($0.11)
Seat 2: Honochin (small blind) folded before Flop
Seat 3: b1uebe11 (big blind) folded before Flop
Seat 4: xtwocardsx folded before Flop (didn't bet)
Seat 5: azcar129 folded before Flop (didn't bet)
Seat 6: hc agorist folded on the Flop



PokerStars Zoom Hand #193805021809:  Hold'em No Limit ($0.01/$0.02) - 2018/11/28 0:48:20 CUST [2018/11/27 11:48:20 ET]
Table 'Halley' 6-max Seat #1 is the button
Seat 1: Qwkl ($2.32 in chips) 
Seat 2: hc agorist ($2.01 in chips) 
Seat 3: Pelorojo1 ($2.41 in chips) 
Seat 4: 3Iver's3 ($3.26 in chips) 
Seat 5: Mizepa ($2 in chips) 
Seat 6: mg-deniz ($2.80 in chips) 
hc agorist: posts small blind $0.01
Pelorojo1: posts big blind $0.02
*** HOLE CARDS ***
Dealt to hc agorist [Jc 5c]
3Iver's3: folds 
Mizepa: folds 
mg-deniz: folds 
Qwkl: raises $0.02 to $0.04
hc agorist: folds 
Pelorojo1: calls $0.02
*** FLOP *** [6s 2s Kd]
Pelorojo1: checks 
Qwkl: bets $0.05
Pelorojo1: calls $0.05
*** TURN *** [6s 2s Kd] [Jh]
Pelorojo1: checks 
Qwkl: checks 
*** RIVER *** [6s 2s Kd Jh] [Qd]
Pelorojo1: checks 
Qwkl: checks 
*** SHOW DOWN ***
Pelorojo1: shows [9d 9h] (a pair of Nines)
Qwkl: shows [9c Jd] (a pair of Jacks)
Qwkl collected $0.18 from pot
*** SUMMARY ***
Total pot $0.19 | Rake $0.01 
Board [6s 2s Kd Jh Qd]
Seat 1: Qwkl (button) showed [9c Jd] and won ($0.18) with a pair of Jacks
Seat 2: hc agorist (small blind) folded before Flop
Seat 3: Pelorojo1 (big blind) showed [9d 9h] and lost with a pair of Nines
Seat 4: 3Iver's3 folded before Flop (didn't bet)
Seat 5: Mizepa folded before Flop (didn't bet)
Seat 6: mg-deniz folded before Flop (didn't bet)



PokerStars Zoom Hand #193805026409:  Hold'em No Limit ($0.01/$0.02) - 2018/11/28 0:48:28 CUST [2018/11/27 11:48:28 ET]
Table 'Halley' 6-max Seat #1 is the button
Seat 1: cuwmek ($1.78 in chips) 
Seat 2: Giggio3301 ($3.04 in chips) 
Seat 3: Lehavorkuta ($2.12 in chips) 
Seat 4: hc agorist ($2 in chips) 
Seat 5: yuratan ($4.53 in chips) 
Seat 6: Ruslan 9729 ($1.21 in chips) 
Giggio3301: posts small blind $0.01
Lehavorkuta: posts big blind $0.02
*** HOLE CARDS ***
Dealt to hc agorist [Ad Kh]
hc agorist: raises $0.04 to $0.06
yuratan: folds 
Ruslan 9729: calls $0.06
cuwmek: calls $0.06
Giggio3301: folds 
Lehavorkuta: folds 
*** FLOP *** [Ac Qd Jc]
hc agorist: bets $0.15
Ruslan 9729: folds 
cuwmek: folds 
Uncalled bet ($0.15) returned to hc agorist
hc agorist collected $0.20 from pot
hc agorist: doesn't show hand 
*** SUMMARY ***
Total pot $0.21 | Rake $0.01 
Board [Ac Qd Jc]
Seat 1: cuwmek (button) folded on the Flop
Seat 2: Giggio3301 (small blind) folded before Flop
Seat 3: Lehavorkuta (big blind) folded before Flop
Seat 4: hc agorist collected ($0.20)
Seat 5: yuratan folded before Flop (didn't bet)
Seat 6: Ruslan 9729 folded on the Flop



PokerStars Zoom Hand #193805044191:  Hold'em No Limit ($0.01/$0.02) - 2018/11/28 0:48:59 CUST [2018/11/27 11:48:59 ET]
Table 'Halley' 6-max Seat #1 is the button
Seat 1: Bloodclub94 ($2.02 in chips) 
Seat 2: jaaz241 ($2.75 in chips) 
Seat 3: hc agorist ($2.14 in chips) 
Seat 4: Brentyyy ($2.58 in chips) 
Seat 5: Qwkl ($2.41 in chips) 
Seat 6: KebabaiJega ($2.27 in chips) 
jaaz241: posts small blind $0.01
hc agorist: posts big blind $0.02
*** HOLE CARDS ***
Dealt to hc agorist [7d Kc]
Brentyyy: folds 
Qwkl: raises $0.04 to $0.06
KebabaiJega: folds 
Bloodclub94: folds 
jaaz241: folds 
hc agorist: folds 
Uncalled bet ($0.04) returned to Qwkl
Qwkl collected $0.05 from pot
Qwkl: doesn't show hand 
*** SUMMARY ***
Total pot $0.05 | Rake $0 
Seat 1: Bloodclub94 (button) folded before Flop (didn't bet)
Seat 2: jaaz241 (small blind) folded before Flop
Seat 3: hc agorist (big blind) folded before Flop
Seat 4: Brentyyy folded before Flop (didn't bet)
Seat 5: Qwkl collected ($0.05)
Seat 6: KebabaiJega folded before Flop (didn't bet)



PokerStars Zoom Hand #193805049308:  Hold'em No Limit ($0.01/$0.02) - 2018/11/28 0:49:08 CUST [2018/11/27 11:49:08 ET]
Table 'Halley' 6-max Seat #1 is the button
Seat 1: David peixe ($2 in chips) 
Seat 2: stradywary ($2.05 in chips) 
Seat 3: wqd4 ($2.07 in chips) 
Seat 4: DiMoWo ($2.08 in chips) 
Seat 5: marta328 ($2.14 in chips) 
Seat 6: hc agorist ($2.12 in chips) 
stradywary: posts small blind $0.01
wqd4: posts big blind $0.02
*** HOLE CARDS ***
Dealt to hc agorist [Th 3h]
DiMoWo: raises $0.04 to $0.06
marta328: folds 
hc agorist: folds 
David peixe: folds 
stradywary: folds 
wqd4: folds 
Uncalled bet ($0.04) returned to DiMoWo
DiMoWo collected $0.05 from pot
DiMoWo: doesn't show hand 
*** SUMMARY ***
Total pot $0.05 | Rake $0 
Seat 1: David peixe (button) folded before Flop (didn't bet)
Seat 2: stradywary (small blind) folded before Flop
Seat 3: wqd4 (big blind) folded before Flop
Seat 4: DiMoWo collected ($0.05)
Seat 5: marta328 folded before Flop (didn't bet)
Seat 6: hc agorist folded before Flop (didn't bet)



PokerStars Zoom Hand #193805057313:  Hold'em No Limit ($0.01/$0.02) - 2018/11/28 0:49:22 CUST [2018/11/27 11:49:22 ET]
Table 'Halley' 6-max Seat #1 is the button
Seat 1: Spinno ($3.11 in chips) 
Seat 2: Thug005 ($1.10 in chips) 
Seat 3: kjonesgg ($2.63 in chips) 
Seat 4: hc agorist ($2.12 in chips) 
Seat 5: Polal19 ($2.53 in chips) 
Seat 6: Brentyyy ($2.06 in chips) 
Thug005: posts small blind $0.01
kjonesgg: posts big blind $0.02
*** HOLE CARDS ***
Dealt to hc agorist [Kd 6h]
hc agorist: folds 
Polal19: raises $0.04 to $0.06
Brentyyy: folds 
Spinno: folds 
Thug005: folds 
kjonesgg: folds 
Uncalled bet ($0.04) returned to Polal19
Polal19 collected $0.05 from pot
Polal19: doesn't show hand 
*** SUMMARY ***
Total pot $0.05 | Rake $0 
Seat 1: Spinno (button) folded before Flop (didn't bet)
Seat 2: Thug005 (small blind) folded before Flop
Seat 3: kjonesgg (big blind) folded before Flop
Seat 4: hc agorist folded before Flop (didn't bet)
Seat 5: Polal19 collected ($0.05)
Seat 6: Brentyyy folded before Flop (didn't bet)



PokerStars Zoom Hand #193805054398:  Hold'em No Limit ($0.01/$0.02) - 2018/11/28 0:49:17 CUST [2018/11/27 11:49:17 ET]
Table 'Halley' 6-max Seat #1 is the button
Seat 1: dinarik1104 ($3.74 in chips) 
Seat 2: sergio666999 ($0.98 in chips) 
Seat 3: MLingard ($2.38 in chips) 
Seat 4: C00kieMnstA ($2.02 in chips) 
Seat 5: hc agorist ($2.12 in chips) 
Seat 6: Simkooo ($2.31 in chips) 
sergio666999: posts small blind $0.01
MLingard: posts big blind $0.02
*** HOLE CARDS ***
Dealt to hc agorist [9d 3h]
C00kieMnstA: folds 
hc agorist: folds 
Simkooo: raises $0.03 to $0.05
dinarik1104: folds 
sergio666999: calls $0.04
MLingard: folds 
*** FLOP *** [8d 7h 9c]
sergio666999: checks 
Simkooo: checks 
*** TURN *** [8d 7h 9c] [2h]
sergio666999: bets $0.12
Simkooo: folds 
Uncalled bet ($0.12) returned to sergio666999
sergio666999 collected $0.12 from pot
sergio666999: doesn't show hand 
*** SUMMARY ***
Total pot $0.12 | Rake $0 
Board [8d 7h 9c 2h]
Seat 1: dinarik1104 (button) folded before Flop (didn't bet)
Seat 2: sergio666999 (small blind) collected ($0.12)
Seat 3: MLingard (big blind) folded before Flop
Seat 4: C00kieMnstA folded before Flop (didn't bet)
Seat 5: hc agorist folded before Flop (didn't bet)
Seat 6: Simkooo folded on the Turn



PokerStars Zoom Hand #193805059625:  Hold'em No Limit ($0.01/$0.02) - 2018/11/28 0:49:26 CUST [2018/11/27 11:49:26 ET]
Table 'Halley' 6-max Seat #1 is the button
Seat 1: NICooLIN333 ($2.20 in chips) 
Seat 2: razzdvatri ($2.22 in chips) 
Seat 3: hc agorist ($2.12 in chips) 
Seat 4: karasukML ($1.91 in chips) 
Seat 5: David peixe ($2.29 in chips) 
Seat 6: G.Datskov ($2.03 in chips) 
razzdvatri: posts small blind $0.01
hc agorist: posts big blind $0.02
*** HOLE CARDS ***
Dealt to hc agorist [9d Js]
karasukML: folds 
David peixe: folds 
G.Datskov: folds 
NICooLIN333: raises $0.03 to $0.05
razzdvatri: folds 
hc agorist: raises $0.11 to $0.16
NICooLIN333: folds 
Uncalled bet ($0.11) returned to hc agorist
hc agorist collected $0.11 from pot
hc agorist: doesn't show hand 
*** SUMMARY ***
Total pot $0.11 | Rake $0 
Seat 1: NICooLIN333 (button) folded before Flop
Seat 2: razzdvatri (small blind) folded before Flop
Seat 3: hc agorist (big blind) collected ($0.11)
Seat 4: karasukML folded before Flop (didn't bet)
Seat 5: David peixe folded before Flop (didn't bet)
Seat 6: G.Datskov folded before Flop (didn't bet)



PokerStars Zoom Hand #193805078940:  Hold'em No Limit ($0.01/$0.02) - 2018/11/28 0:50:00 CUST [2018/11/27 11:50:00 ET]
Table 'Halley' 6-max Seat #1 is the button
Seat 1: waswaz332 ($2.10 in chips) 
Seat 2: hc agorist ($2.18 in chips) 
Seat 3: Pelorojo1 ($2.30 in chips) 
Seat 4: mish732 ($2.96 in chips) 
Seat 5: Kiizu ($4.06 in chips) 
Seat 6: Shamaxxx ($3.95 in chips) 
hc agorist: posts small blind $0.01
Pelorojo1: posts big blind $0.02
*** HOLE CARDS ***
Dealt to hc agorist [2c Kd]
mish732: raises $0.02 to $0.04
Kiizu: folds 
Shamaxxx: folds 
waswaz332: folds 
hc agorist: folds 
Pelorojo1: calls $0.02
*** FLOP *** [5s Jc 8h]
Pelorojo1: checks 
mish732: checks 
*** TURN *** [5s Jc 8h] [4d]
Pelorojo1: checks 
mish732: checks 
*** RIVER *** [5s Jc 8h 4d] [Qs]
Pelorojo1: checks 
mish732: bets $0.08
Pelorojo1: folds 
Uncalled bet ($0.08) returned to mish732
mish732 collected $0.09 from pot
mish732: doesn't show hand 
*** SUMMARY ***
Total pot $0.09 | Rake $0 
Board [5s Jc 8h 4d Qs]
Seat 1: waswaz332 (button) folded before Flop (didn't bet)
Seat 2: hc agorist (small blind) folded before Flop
Seat 3: Pelorojo1 (big blind) folded on the River
Seat 4: mish732 collected ($0.09)
Seat 5: Kiizu folded before Flop (didn't bet)
Seat 6: Shamaxxx folded before Flop (didn't bet)



PokerStars Zoom Hand #193805081734:  Hold'em No Limit ($0.01/$0.02) - 2018/11/28 0:50:05 CUST [2018/11/27 11:50:05 ET]
Table 'Halley' 6-max Seat #1 is the button
Seat 1: hc agorist ($2.17 in chips) 
Seat 2: roach180 ($3.54 in chips) 
Seat 3: joelox25 ($2.13 in chips) 
Seat 4: Tmalikis1 ($7.36 in chips) 
Seat 5: xristosG115 ($0.97 in chips) 
Seat 6: sawa23ru ($2.45 in chips) 
roach180: posts small blind $0.01
joelox25: posts big blind $0.02
*** HOLE CARDS ***
Dealt to hc agorist [5c 2c]
Tmalikis1: folds 
xristosG115: folds 
sawa23ru: folds 
hc agorist: raises $0.02 to $0.04
roach180: calls $0.03
joelox25: calls $0.02
*** FLOP *** [8d 7h 6h]
roach180: checks 
joelox25: checks 
hc agorist: checks 
*** TURN *** [8d 7h 6h] [Jc]
roach180: checks 
joelox25: bets $0.08
hc agorist: folds 
roach180: calls $0.08
*** RIVER *** [8d 7h 6h Jc] [8h]
roach180: bets $0.14
joelox25: raises $0.16 to $0.30
roach180: raises $0.30 to $0.60
joelox25: calls $0.30
*** SHOW DOWN ***
roach180: shows [6c Qc] (two pair, Eights and Sixes)
joelox25: shows [Kh 2h] (a flush, King high)
joelox25 collected $1.43 from pot
*** SUMMARY ***
Total pot $1.48 | Rake $0.05 
Board [8d 7h 6h Jc 8h]
Seat 1: hc agorist (button) folded on the Turn
Seat 2: roach180 (small blind) showed [6c Qc] and lost with two pair, Eights and Sixes
Seat 3: joelox25 (big blind) showed [Kh 2h] and won ($1.43) with a flush, King high
Seat 4: Tmalikis1 folded before Flop (didn't bet)
Seat 5: xristosG115 folded before Flop (didn't bet)
Seat 6: sawa23ru folded before Flop (didn't bet)



PokerStars Zoom Hand #193805122838:  Hold'em No Limit ($0.01/$0.02) - 2018/11/28 0:51:17 CUST [2018/11/27 11:51:17 ET]
Table 'Halley' 6-max Seat #1 is the button
Seat 1: nobby57 ($1.34 in chips) 
Seat 2: EvgenMSN ($4.20 in chips) 
Seat 3: muruboy ($2.42 in chips) 
Seat 4: PoKerChiLLOr ($1.12 in chips) 
Seat 5: Kala77 ($4.44 in chips) 
Seat 6: hc agorist ($2.13 in chips) 
EvgenMSN: posts small blind $0.01
muruboy: posts big blind $0.02
*** HOLE CARDS ***
Dealt to hc agorist [As 8h]
PoKerChiLLOr: raises $0.04 to $0.06
Kala77: folds 
hc agorist: folds 
nobby57: calls $0.06
EvgenMSN: folds 
muruboy: folds 
*** FLOP *** [6d Qc 3h]
PoKerChiLLOr: bets $0.07
nobby57: folds 
Uncalled bet ($0.07) returned to PoKerChiLLOr
PoKerChiLLOr collected $0.14 from pot
PoKerChiLLOr: doesn't show hand 
*** SUMMARY ***
Total pot $0.15 | Rake $0.01 
Board [6d Qc 3h]
Seat 1: nobby57 (button) folded on the Flop
Seat 2: EvgenMSN (small blind) folded before Flop
Seat 3: muruboy (big blind) folded before Flop
Seat 4: PoKerChiLLOr collected ($0.14)
Seat 5: Kala77 folded before Flop (didn't bet)
Seat 6: hc agorist folded before Flop (didn't bet)



PokerStars Zoom Hand #193805117054:  Hold'em No Limit ($0.01/$0.02) - 2018/11/28 0:51:07 CUST [2018/11/27 11:51:07 ET]
Table 'Halley' 6-max Seat #1 is the button
Seat 1: Mackerel12 ($3.92 in chips) 
Seat 2: laugodaw ($2.19 in chips) 
Seat 3: xristosG115 ($0.95 in chips) 
Seat 4: liy731 ($2 in chips) 
Seat 5: hc agorist ($2.13 in chips) 
Seat 6: Sedinkin ($2.45 in chips) 
laugodaw: posts small blind $0.01
xristosG115: posts big blind $0.02
*** HOLE CARDS ***
Dealt to hc agorist [3s 8s]
liy731: raises $0.04 to $0.06
hc agorist: folds 
Sedinkin: folds 
Mackerel12: folds 
laugodaw: folds 
xristosG115: calls $0.04
*** FLOP *** [Ah 7s 9s]
xristosG115: checks 
liy731: bets $0.10
xristosG115: folds 
Uncalled bet ($0.10) returned to liy731
liy731 collected $0.13 from pot
liy731: doesn't show hand 
*** SUMMARY ***
Total pot $0.13 | Rake $0 
Board [Ah 7s 9s]
Seat 1: Mackerel12 (button) folded before Flop (didn't bet)
Seat 2: laugodaw (small blind) folded before Flop
Seat 3: xristosG115 (big blind) folded on the Flop
Seat 4: liy731 collected ($0.13)
Seat 5: hc agorist folded before Flop (didn't bet)
Seat 6: Sedinkin folded before Flop (didn't bet)



PokerStars Zoom Hand #193805126676:  Hold'em No Limit ($0.01/$0.02) - 2018/11/28 0:51:24 CUST [2018/11/27 11:51:24 ET]
Table 'Halley' 6-max Seat #1 is the button
Seat 1: olegan.o94 ($1.01 in chips) 
Seat 2: Olga Berezina ($2 in chips) 
Seat 3: hc agorist ($2.13 in chips) 
Seat 4: maratik ($1.68 in chips) 
Seat 5: xdagg ($5.83 in chips) 
Seat 6: de_wlnss ($2 in chips) 
Olga Berezina: posts small blind $0.01
hc agorist: posts big blind $0.02
*** HOLE CARDS ***
Dealt to hc agorist [Qd As]
maratik: folds 
xdagg: folds 
de_wlnss: folds 
olegan.o94: folds 
Olga Berezina: folds 
Uncalled bet ($0.01) returned to hc agorist
hc agorist collected $0.02 from pot
hc agorist: doesn't show hand 
*** SUMMARY ***
Total pot $0.02 | Rake $0 
Seat 1: olegan.o94 (button) folded before Flop (didn't bet)
Seat 2: Olga Berezina (small blind) folded before Flop
Seat 3: hc agorist (big blind) collected ($0.02)
Seat 4: maratik folded before Flop (didn't bet)
Seat 5: xdagg folded before Flop (didn't bet)
Seat 6: de_wlnss folded before Flop (didn't bet)



PokerStars Zoom Hand #193805139743:  Hold'em No Limit ($0.01/$0.02) - 2018/11/28 0:51:47 CUST [2018/11/27 11:51:47 ET]
Table 'Halley' 6-max Seat #1 is the button
Seat 1: grv17 ($2.43 in chips) 
Seat 2: hc agorist ($2.14 in chips) 
Seat 3: markiz655 ($3.07 in chips) 
Seat 4: razzdvatri ($2.25 in chips) 
Seat 5: Mizepa ($2.02 in chips) 
Seat 6: AlexGalimov ($3.40 in chips) 
hc agorist: posts small blind $0.01
markiz655: posts big blind $0.02
*** HOLE CARDS ***
Dealt to hc agorist [8d Th]
razzdvatri: folds 
Mizepa: folds 
AlexGalimov: folds 
grv17: folds 
hc agorist: folds 
Uncalled bet ($0.01) returned to markiz655
markiz655 collected $0.02 from pot
markiz655: doesn't show hand 
*** SUMMARY ***
Total pot $0.02 | Rake $0 
Seat 1: grv17 (button) folded before Flop (didn't bet)
Seat 2: hc agorist (small blind) folded before Flop
Seat 3: markiz655 (big blind) collected ($0.02)
Seat 4: razzdvatri folded before Flop (didn't bet)
Seat 5: Mizepa folded before Flop (didn't bet)
Seat 6: AlexGalimov folded before Flop (didn't bet)



PokerStars Zoom Hand #193805150640:  Hold'em No Limit ($0.01/$0.02) - 2018/11/28 0:52:06 CUST [2018/11/27 11:52:06 ET]
Table 'Halley' 6-max Seat #1 is the button
Seat 1: Incomitatus ($3.66 in chips) 
Seat 2: Thefoxowl ($2.11 in chips) 
Seat 3: dancayamanda ($3.55 in chips) 
Seat 4: hc agorist ($2.13 in chips) 
Seat 5: feijão84 ($1.25 in chips) 
Seat 6: qpsq ($2.48 in chips) 
Thefoxowl: posts small blind $0.01
dancayamanda: posts big blind $0.02
*** HOLE CARDS ***
Dealt to hc agorist [3h Tc]
hc agorist: folds 
feijão84: folds 
qpsq: folds 
Incomitatus: folds 
Thefoxowl: folds 
Uncalled bet ($0.01) returned to dancayamanda
dancayamanda collected $0.02 from pot
dancayamanda: doesn't show hand 
*** SUMMARY ***
Total pot $0.02 | Rake $0 
Seat 1: Incomitatus (button) folded before Flop (didn't bet)
Seat 2: Thefoxowl (small blind) folded before Flop
Seat 3: dancayamanda (big blind) collected ($0.02)
Seat 4: hc agorist folded before Flop (didn't bet)
Seat 5: feijão84 folded before Flop (didn't bet)
Seat 6: qpsq folded before Flop (didn't bet)



PokerStars Zoom Hand #193805142581:  Hold'em No Limit ($0.01/$0.02) - 2018/11/28 0:51:52 CUST [2018/11/27 11:51:52 ET]
Table 'Halley' 6-max Seat #1 is the button
Seat 1: hc agorist ($2.13 in chips) 
Seat 2: KebabaiJega ($2.20 in chips) 
Seat 3: anasanto ($2.01 in chips) 
Seat 4: zALEXKAYz ($1.14 in chips) 
Seat 5: TQRU ($1.15 in chips) 
Seat 6: sickman7 ($2 in chips) 
KebabaiJega: posts small blind $0.01
anasanto: posts big blind $0.02
*** HOLE CARDS ***
Dealt to hc agorist [3h 9d]
zALEXKAYz: folds 
TQRU: raises $0.04 to $0.06
sickman7: folds 
hc agorist: folds 
KebabaiJega: calls $0.05
anasanto: folds 
*** FLOP *** [9s Ac Th]
KebabaiJega: checks 
TQRU: checks 
*** TURN *** [9s Ac Th] [2d]
KebabaiJega: checks 
TQRU: bets $0.05
KebabaiJega: folds 
Uncalled bet ($0.05) returned to TQRU
TQRU collected $0.14 from pot
TQRU: doesn't show hand 
*** SUMMARY ***
Total pot $0.14 | Rake $0 
Board [9s Ac Th 2d]
Seat 1: hc agorist (button) folded before Flop (didn't bet)
Seat 2: KebabaiJega (small blind) folded on the Turn
Seat 3: anasanto (big blind) folded before Flop
Seat 4: zALEXKAYz folded before Flop (didn't bet)
Seat 5: TQRU collected ($0.14)
Seat 6: sickman7 folded before Flop (didn't bet)



PokerStars Zoom Hand #193805147780:  Hold'em No Limit ($0.01/$0.02) - 2018/11/28 0:52:01 CUST [2018/11/27 11:52:01 ET]
Table 'Halley' 6-max Seat #1 is the button
Seat 1: TEAMPRO10000 ($0.73 in chips) 
Seat 2: aphokaliptic ($2.87 in chips) 
Seat 3: MellivoraSto ($2 in chips) 
Seat 4: Kiizu ($4.06 in chips) 
Seat 5: hc agorist ($2.13 in chips) 
Seat 6: firebrigadenor ($3.16 in chips) 
aphokaliptic: posts small blind $0.01
MellivoraSto: posts big blind $0.02
*** HOLE CARDS ***
Dealt to hc agorist [7h 3s]
Kiizu: folds 
hc agorist: folds 
firebrigadenor: raises $0.05 to $0.07
TEAMPRO10000: calls $0.07
aphokaliptic: folds 
MellivoraSto: folds 
*** FLOP *** [4h Ac 4c]
firebrigadenor: bets $0.12
TEAMPRO10000: calls $0.12
*** TURN *** [4h Ac 4c] [Qd]
firebrigadenor: bets $0.26
TEAMPRO10000: raises $0.28 to $0.54 and is all-in
firebrigadenor: calls $0.28
*** RIVER *** [4h Ac 4c Qd] [9s]
*** SHOW DOWN ***
firebrigadenor: shows [Th Qs] (two pair, Queens and Fours)
TEAMPRO10000: shows [Qh As] (two pair, Aces and Queens)
TEAMPRO10000 collected $1.44 from pot
*** SUMMARY ***
Total pot $1.49 | Rake $0.05 
Board [4h Ac 4c Qd 9s]
Seat 1: TEAMPRO10000 (button) showed [Qh As] and won ($1.44) with two pair, Aces and Queens
Seat 2: aphokaliptic (small blind) folded before Flop
Seat 3: MellivoraSto (big blind) folded before Flop
Seat 4: Kiizu folded before Flop (didn't bet)
Seat 5: hc agorist folded before Flop (didn't bet)
Seat 6: firebrigadenor showed [Th Qs] and lost with two pair, Queens and Fours



PokerStars Zoom Hand #193805153542:  Hold'em No Limit ($0.01/$0.02) - 2018/11/28 0:52:11 CUST [2018/11/27 11:52:11 ET]
Table 'Halley' 6-max Seat #1 is the button
Seat 1: AVyiO ($9.74 in chips) 
Seat 2: Agno$tic ($4.46 in chips) 
Seat 3: darkoldmaker ($2 in chips) 
Seat 4: james009900 ($1.98 in chips) 
Seat 5: hc agorist ($2.13 in chips) 
Seat 6: Marchuk369 ($1.16 in chips) 
Agno$tic: posts small blind $0.01
darkoldmaker: posts big blind $0.02
*** HOLE CARDS ***
Dealt to hc agorist [Qs Qd]
james009900: raises $0.02 to $0.04
hc agorist: raises $0.11 to $0.15
Marchuk369: folds 
AVyiO: folds 
Agno$tic: raises $0.39 to $0.54
darkoldmaker: folds 
james009900: folds 
hc agorist: raises $1.59 to $2.13 and is all-in
Agno$tic: calls $1.59
*** FIRST FLOP *** [Ah 8d Kc]
*** FIRST TURN *** [Ah 8d Kc] [9d]
*** FIRST RIVER *** [Ah 8d Kc 9d] [Jc]
*** SECOND FLOP *** [4c 2h 8s]
*** SECOND TURN *** [4c 2h 8s] [7h]
*** SECOND RIVER *** [4c 2h 8s 7h] [6d]
*** FIRST SHOW DOWN ***
Agno$tic: shows [Kd Kh] (three of a kind, Kings)
hc agorist: shows [Qs Qd] (a pair of Queens)
Agno$tic collected $2.09 from pot
*** SECOND SHOW DOWN ***
Agno$tic: shows [Kd Kh] (a pair of Kings)
hc agorist: shows [Qs Qd] (a pair of Queens)
Agno$tic collected $2.08 from pot
*** SUMMARY ***
Total pot $4.32 | Rake $0.15 
Hand was run twice
FIRST Board [Ah 8d Kc 9d Jc]
SECOND Board [4c 2h 8s 7h 6d]
Seat 1: AVyiO (button) folded before Flop (didn't bet)
Seat 2: Agno$tic (small blind) showed [Kd Kh] and won ($2.09) with three of a kind, Kings, and won ($2.08) with a pair of Kings
Seat 3: darkoldmaker (big blind) folded before Flop
Seat 4: james009900 folded before Flop
Seat 5: hc agorist showed [Qs Qd] and lost with a pair of Queens, and lost with a pair of Queens
Seat 6: Marchuk369 folded before Flop (didn't bet)



PokerStars Zoom Hand #193805190754:  Hold'em No Limit ($0.01/$0.02) - 2018/11/28 0:53:04 CUST [2018/11/27 11:53:04 ET]
Table 'Halley' 6-max Seat #1 is the button
Seat 1: hc agorist ($2 in chips) 
Seat 2: Winik810 ($2 in chips) 
Seat 3: Fixmenem ($2 in chips) 
Seat 4: alexps922 ($2.42 in chips) 
Seat 5: ED_CULLEN666 ($2.28 in chips) 
Seat 6: Ramero 34 ($2.08 in chips) 
Winik810: posts small blind $0.01
Fixmenem: posts big blind $0.02
*** HOLE CARDS ***
Dealt to hc agorist [Qd Ts]
alexps922: folds 
ED_CULLEN666: folds 
Ramero 34: folds 
hc agorist: raises $0.02 to $0.04
Winik810: raises $0.12 to $0.16
Fixmenem: raises $0.30 to $0.46
hc agorist: folds 
Winik810: folds 
Uncalled bet ($0.30) returned to Fixmenem
Fixmenem collected $0.36 from pot
Fixmenem: doesn't show hand 
*** SUMMARY ***
Total pot $0.36 | Rake $0 
Seat 1: hc agorist (button) folded before Flop
Seat 2: Winik810 (small blind) folded before Flop
Seat 3: Fixmenem (big blind) collected ($0.36)
Seat 4: alexps922 folded before Flop (didn't bet)
Seat 5: ED_CULLEN666 folded before Flop (didn't bet)
Seat 6: Ramero 34 folded before Flop (didn't bet)



PokerStars Zoom Hand #193805210900:  Hold'em No Limit ($0.01/$0.02) - 2018/11/28 0:53:39 CUST [2018/11/27 11:53:39 ET]
Table 'Halley' 6-max Seat #1 is the button
Seat 1: Dialektik330 ($0.85 in chips) 
Seat 2: mi$tralx ($2 in chips) 
Seat 3: nikonova88 ($3 in chips) 
Seat 4: seredinsk ($2 in chips) 
Seat 5: NaumiPar ($3.90 in chips) 
Seat 6: hc agorist ($1.96 in chips) 
mi$tralx: posts small blind $0.01
nikonova88: posts big blind $0.02
*** HOLE CARDS ***
Dealt to hc agorist [Qd 6s]
seredinsk: folds 
NaumiPar: folds 
hc agorist: folds 
Dialektik330: raises $0.83 to $0.85 and is all-in
mi$tralx: folds 
nikonova88: folds 
Uncalled bet ($0.83) returned to Dialektik330
Dialektik330 collected $0.05 from pot
Dialektik330: doesn't show hand 
*** SUMMARY ***
Total pot $0.05 | Rake $0 
Seat 1: Dialektik330 (button) collected ($0.05)
Seat 2: mi$tralx (small blind) folded before Flop
Seat 3: nikonova88 (big blind) folded before Flop
Seat 4: seredinsk folded before Flop (didn't bet)
Seat 5: NaumiPar folded before Flop (didn't bet)
Seat 6: hc agorist folded before Flop (didn't bet)



PokerStars Zoom Hand #193805216619:  Hold'em No Limit ($0.01/$0.02) - 2018/11/28 0:53:49 CUST [2018/11/27 11:53:49 ET]
Table 'Halley' 6-max Seat #1 is the button
Seat 1: moskita789 ($3.07 in chips) 
Seat 2: MYlviste ($2 in chips) 
Seat 3: hc agorist ($1.96 in chips) 
Seat 4: Nenohh0487NL ($3.30 in chips) 
Seat 5: nicemitya ($10.04 in chips) 
Seat 6: deannapoker ($2.02 in chips) 
MYlviste: posts small blind $0.01
hc agorist: posts big blind $0.02
*** HOLE CARDS ***
Dealt to hc agorist [5d Ah]
Nenohh0487NL: folds 
nicemitya: folds 
deannapoker: raises $0.04 to $0.06
moskita789: folds 
MYlviste: folds 
hc agorist: folds 
Uncalled bet ($0.04) returned to deannapoker
deannapoker collected $0.05 from pot
deannapoker: doesn't show hand 
*** SUMMARY ***
Total pot $0.05 | Rake $0 
Seat 1: moskita789 (button) folded before Flop (didn't bet)
Seat 2: MYlviste (small blind) folded before Flop
Seat 3: hc agorist (big blind) folded before Flop
Seat 4: Nenohh0487NL folded before Flop (didn't bet)
Seat 5: nicemitya folded before Flop (didn't bet)
Seat 6: deannapoker collected ($0.05)



PokerStars Zoom Hand #193805223502:  Hold'em No Limit ($0.01/$0.02) - 2018/11/28 0:54:01 CUST [2018/11/27 11:54:01 ET]
Table 'Halley' 6-max Seat #1 is the button
Seat 1: Sovlex555 ($1.97 in chips) 
Seat 2: hc agorist ($1.94 in chips) 
Seat 3: darkoldmaker ($2 in chips) 
Seat 4: TehLuny ($2.12 in chips) 
Seat 5: dntp ($6.51 in chips) 
Seat 6: razzdvatri ($5.06 in chips) 
hc agorist: posts small blind $0.01
darkoldmaker: posts big blind $0.02
*** HOLE CARDS ***
Dealt to hc agorist [8h Ah]
TehLuny: folds 
dntp: folds 
razzdvatri: folds 
Sovlex555: folds 
hc agorist: raises $0.02 to $0.04
darkoldmaker: folds 
Uncalled bet ($0.02) returned to hc agorist
hc agorist collected $0.04 from pot
hc agorist: doesn't show hand 
*** SUMMARY ***
Total pot $0.04 | Rake $0 
Seat 1: Sovlex555 (button) folded before Flop (didn't bet)
Seat 2: hc agorist (small blind) collected ($0.04)
Seat 3: darkoldmaker (big blind) folded before Flop
Seat 4: TehLuny folded before Flop (didn't bet)
Seat 5: dntp folded before Flop (didn't bet)
Seat 6: razzdvatri folded before Flop (didn't bet)



PokerStars Zoom Hand #193805234933:  Hold'em No Limit ($0.01/$0.02) - 2018/11/28 0:54:21 CUST [2018/11/27 11:54:21 ET]
Table 'Halley' 6-max Seat #1 is the button
Seat 1: hc agorist ($1.96 in chips) 
Seat 2: supa4444 ($2.23 in chips) 
Seat 3: MYlviste ($2 in chips) 
Seat 4: juliPMK ($2 in chips) 
Seat 5: Miami27887 ($2.56 in chips) 
Seat 6: NaumiPar ($3.87 in chips) 
supa4444: posts small blind $0.01
MYlviste: posts big blind $0.02
*** HOLE CARDS ***
Dealt to hc agorist [3h 2s]
juliPMK: folds 
Miami27887: folds 
NaumiPar: raises $0.03 to $0.05
hc agorist: folds 
supa4444: folds 
MYlviste: folds 
Uncalled bet ($0.03) returned to NaumiPar
NaumiPar collected $0.05 from pot
NaumiPar: doesn't show hand 
*** SUMMARY ***
Total pot $0.05 | Rake $0 
Seat 1: hc agorist (button) folded before Flop (didn't bet)
Seat 2: supa4444 (small blind) folded before Flop
Seat 3: MYlviste (big blind) folded before Flop
Seat 4: juliPMK folded before Flop (didn't bet)
Seat 5: Miami27887 folded before Flop (didn't bet)
Seat 6: NaumiPar collected ($0.05)



PokerStars Zoom Hand #193805232598:  Hold'em No Limit ($0.01/$0.02) - 2018/11/28 0:54:17 CUST [2018/11/27 11:54:17 ET]
Table 'Halley' 6-max Seat #1 is the button
Seat 1: Incomitatus ($3.66 in chips) 
Seat 2: RocknRolla5 ($2.01 in chips) 
Seat 3: a.leuphana ($2.26 in chips) 
Seat 4: hc agorist ($1.96 in chips) 
Seat 5: furyzen1 ($2.34 in chips) 
Seat 6: Kokosya ($2.58 in chips) 
RocknRolla5: posts small blind $0.01
a.leuphana: posts big blind $0.02
*** HOLE CARDS ***
Dealt to hc agorist [3h Qd]
hc agorist: folds 
furyzen1: folds 
Kokosya: folds 
Incomitatus: raises $0.03 to $0.05
RocknRolla5: raises $0.13 to $0.18
a.leuphana: folds 
Incomitatus: folds 
Uncalled bet ($0.13) returned to RocknRolla5
RocknRolla5 collected $0.12 from pot
RocknRolla5: doesn't show hand 
*** SUMMARY ***
Total pot $0.12 | Rake $0 
Seat 1: Incomitatus (button) folded before Flop
Seat 2: RocknRolla5 (small blind) collected ($0.12)
Seat 3: a.leuphana (big blind) folded before Flop
Seat 4: hc agorist folded before Flop (didn't bet)
Seat 5: furyzen1 folded before Flop (didn't bet)
Seat 6: Kokosya folded before Flop (didn't bet)



PokerStars Zoom Hand #193805237763:  Hold'em No Limit ($0.01/$0.02) - 2018/11/28 0:54:26 CUST [2018/11/27 11:54:26 ET]
Table 'Halley' 6-max Seat #1 is the button
Seat 1: moskita789 ($4.67 in chips) 
Seat 2: Puqo ($2 in chips) 
Seat 3: rigel_poker ($5.05 in chips) 
Seat 4: deannapoker ($2.05 in chips) 
Seat 5: MLingard ($2.05 in chips) 
Seat 6: hc agorist ($1.96 in chips) 
Puqo: posts small blind $0.01
rigel_poker: posts big blind $0.02
*** HOLE CARDS ***
Dealt to hc agorist [8h 4s]
deannapoker: raises $0.04 to $0.06
MLingard: folds 
hc agorist: folds 
moskita789: folds 
Puqo: folds 
rigel_poker: folds 
Uncalled bet ($0.04) returned to deannapoker
deannapoker collected $0.05 from pot
deannapoker: doesn't show hand 
*** SUMMARY ***
Total pot $0.05 | Rake $0 
Seat 1: moskita789 (button) folded before Flop (didn't bet)
Seat 2: Puqo (small blind) folded before Flop
Seat 3: rigel_poker (big blind) folded before Flop
Seat 4: deannapoker collected ($0.05)
Seat 5: MLingard folded before Flop (didn't bet)
Seat 6: hc agorist folded before Flop (didn't bet)



PokerStars Zoom Hand #193805241683:  Hold'em No Limit ($0.01/$0.02) - 2018/11/28 0:54:33 CUST [2018/11/27 11:54:33 ET]
Table 'Halley' 6-max Seat #1 is the button
Seat 1: AVyiO ($2.12 in chips) 
Seat 2: high0008 ($3.46 in chips) 
Seat 3: hc agorist ($1.96 in chips) 
Seat 4: luther96 ($2.09 in chips) 
Seat 5: g0suboy ($1.46 in chips) 
Seat 6: ss_hanz-land ($0.87 in chips) 
high0008: posts small blind $0.01
hc agorist: posts big blind $0.02
*** HOLE CARDS ***
Dealt to hc agorist [Kd Ks]
luther96: folds 
g0suboy: folds 
ss_hanz-land: calls $0.02
AVyiO: folds 
high0008: folds 
hc agorist: raises $0.08 to $0.10
ss_hanz-land: calls $0.08
*** FLOP *** [8s 6s 4h]
hc agorist: bets $0.20
ss_hanz-land: folds 
Uncalled bet ($0.20) returned to hc agorist
hc agorist collected $0.20 from pot
hc agorist: doesn't show hand 
*** SUMMARY ***
Total pot $0.21 | Rake $0.01 
Board [8s 6s 4h]
Seat 1: AVyiO (button) folded before Flop (didn't bet)
Seat 2: high0008 (small blind) folded before Flop
Seat 3: hc agorist (big blind) collected ($0.20)
Seat 4: luther96 folded before Flop (didn't bet)
Seat 5: g0suboy folded before Flop (didn't bet)
Seat 6: ss_hanz-land folded on the Flop



PokerStars Zoom Hand #193805260616:  Hold'em No Limit ($0.01/$0.02) - 2018/11/28 0:55:06 CUST [2018/11/27 11:55:06 ET]
Table 'Halley' 6-max Seat #1 is the button
Seat 1: Pelorojo1 ($2.41 in chips) 
Seat 2: hc agorist ($2.06 in chips) 
Seat 3: zuziek79 ($2.01 in chips) 
Seat 4: Ramero 34 ($2.12 in chips) 
Seat 5: rin2737 ($4.98 in chips) 
Seat 6: AlexGalimov ($3.19 in chips) 
hc agorist: posts small blind $0.01
zuziek79: posts big blind $0.02
*** HOLE CARDS ***
Dealt to hc agorist [7s 5d]
Ramero 34: folds 
rin2737: folds 
AlexGalimov: folds 
Pelorojo1: folds 
hc agorist: folds 
Uncalled bet ($0.01) returned to zuziek79
zuziek79 collected $0.02 from pot
zuziek79: doesn't show hand 
*** SUMMARY ***
Total pot $0.02 | Rake $0 
Seat 1: Pelorojo1 (button) folded before Flop (didn't bet)
Seat 2: hc agorist (small blind) folded before Flop
Seat 3: zuziek79 (big blind) collected ($0.02)
Seat 4: Ramero 34 folded before Flop (didn't bet)
Seat 5: rin2737 folded before Flop (didn't bet)
Seat 6: AlexGalimov folded before Flop (didn't bet)



PokerStars Zoom Hand #193805263014:  Hold'em No Limit ($0.01/$0.02) - 2018/11/28 0:55:11 CUST [2018/11/27 11:55:11 ET]
Table 'Halley' 6-max Seat #1 is the button
Seat 1: Egor142NVKZ ($0.29 in chips) 
Seat 2: Ramero 34 ($2.12 in chips) 
Seat 3: smalna1 ($2.86 in chips) 
Seat 4: diegotrader ($3.43 in chips) 
Seat 5: Kotron ($2.01 in chips) 
Seat 6: hc agorist ($2.05 in chips) 
Ramero 34: posts small blind $0.01
smalna1: posts big blind $0.02
*** HOLE CARDS ***
Dealt to hc agorist [2d Ac]
diegotrader: folds 
Kotron: folds 
hc agorist: raises $0.02 to $0.04
Egor142NVKZ: folds 
Ramero 34: calls $0.03
smalna1: raises $0.14 to $0.18
hc agorist: folds 
Ramero 34: folds 
Uncalled bet ($0.14) returned to smalna1
smalna1 collected $0.12 from pot
smalna1: doesn't show hand 
*** SUMMARY ***
Total pot $0.12 | Rake $0 
Seat 1: Egor142NVKZ (button) folded before Flop (didn't bet)
Seat 2: Ramero 34 (small blind) folded before Flop
Seat 3: smalna1 (big blind) collected ($0.12)
Seat 4: diegotrader folded before Flop (didn't bet)
Seat 5: Kotron folded before Flop (didn't bet)
Seat 6: hc agorist folded before Flop



PokerStars Zoom Hand #193805277667:  Hold'em No Limit ($0.01/$0.02) - 2018/11/28 0:55:43 CUST [2018/11/27 11:55:43 ET]
Table 'Halley' 6-max Seat #1 is the button
Seat 1: TeddyTheFace ($2 in chips) 
Seat 2: kensho25 ($0.78 in chips) 
Seat 3: IMVV310 ($2 in chips) 
Seat 4: Indean88 ($1.28 in chips) 
Seat 5: hc agorist ($2.01 in chips) 
Seat 6: vvk22 ($1.73 in chips) 
kensho25: posts small blind $0.01
IMVV310: posts big blind $0.02
*** HOLE CARDS ***
Dealt to hc agorist [Ac 3s]
Indean88: folds 
hc agorist: folds 
vvk22: folds 
TeddyTheFace: folds 
kensho25: folds 
Uncalled bet ($0.01) returned to IMVV310
IMVV310 collected $0.02 from pot
IMVV310: doesn't show hand 
*** SUMMARY ***
Total pot $0.02 | Rake $0 
Seat 1: TeddyTheFace (button) folded before Flop (didn't bet)
Seat 2: kensho25 (small blind) folded before Flop
Seat 3: IMVV310 (big blind) collected ($0.02)
Seat 4: Indean88 folded before Flop (didn't bet)
Seat 5: hc agorist folded before Flop (didn't bet)
Seat 6: vvk22 folded before Flop (didn't bet)



PokerStars Zoom Hand #193805275396:  Hold'em No Limit ($0.01/$0.02) - 2018/11/28 0:55:38 CUST [2018/11/27 11:55:38 ET]
Table 'Halley' 6-max Seat #1 is the button
Seat 1: hc agorist ($2.01 in chips) 
Seat 2: hsbc23 ($3.31 in chips) 
Seat 3: vatteztaR* ($5.12 in chips) 
Seat 4: uratr ($2.30 in chips) 
Seat 5: batek_1 ($3.13 in chips) 
Seat 6: zsolo480 ($1.72 in chips) 
hsbc23: posts small blind $0.01
vatteztaR*: posts big blind $0.02
*** HOLE CARDS ***
Dealt to hc agorist [4c 2h]
uratr: folds 
batek_1: raises $0.04 to $0.06
zsolo480: folds 
hc agorist: folds 
hsbc23: folds 
vatteztaR*: raises $0.16 to $0.22
batek_1: folds 
Uncalled bet ($0.16) returned to vatteztaR*
vatteztaR* collected $0.13 from pot
vatteztaR*: doesn't show hand 
*** SUMMARY ***
Total pot $0.13 | Rake $0 
Seat 1: hc agorist (button) folded before Flop (didn't bet)
Seat 2: hsbc23 (small blind) folded before Flop
Seat 3: vatteztaR* (big blind) collected ($0.13)
Seat 4: uratr folded before Flop (didn't bet)
Seat 5: batek_1 folded before Flop
Seat 6: zsolo480 folded before Flop (didn't bet)



PokerStars Zoom Hand #193805285986:  Hold'em No Limit ($0.01/$0.02) - 2018/11/28 0:56:01 CUST [2018/11/27 11:56:01 ET]
Table 'Halley' 6-max Seat #1 is the button
Seat 1: dancayamanda ($6.17 in chips) 
Seat 2: qpsq ($4.30 in chips) 
Seat 3: hc agorist ($2.01 in chips) 
Seat 4: ForHistory ($2.28 in chips) 
Seat 5: nworkun1 ($2.77 in chips) 
Seat 6: Honorable_17 ($2.26 in chips) 
qpsq: posts small blind $0.01
hc agorist: posts big blind $0.02
*** HOLE CARDS ***
Dealt to hc agorist [3s Qh]
ForHistory: folds 
nworkun1: folds 
Honorable_17: folds 
dancayamanda: folds 
qpsq: folds 
Uncalled bet ($0.01) returned to hc agorist
hc agorist collected $0.02 from pot
hc agorist: doesn't show hand 
*** SUMMARY ***
Total pot $0.02 | Rake $0 
Seat 1: dancayamanda (button) folded before Flop (didn't bet)
Seat 2: qpsq (small blind) folded before Flop
Seat 3: hc agorist (big blind) collected ($0.02)
Seat 4: ForHistory folded before Flop (didn't bet)
Seat 5: nworkun1 folded before Flop (didn't bet)
Seat 6: Honorable_17 folded before Flop (didn't bet)



PokerStars Zoom Hand #193805282266:  Hold'em No Limit ($0.01/$0.02) - 2018/11/28 0:55:53 CUST [2018/11/27 11:55:53 ET]
Table 'Halley' 6-max Seat #1 is the button
Seat 1: Kala77 ($2 in chips) 
Seat 2: Ckrank ($1.32 in chips) 
Seat 3: Polal19 ($2.05 in chips) 
Seat 4: Miami27887 ($2.17 in chips) 
Seat 5: hc agorist ($2.01 in chips) 
Seat 6: Simkooo ($2 in chips) 
Ckrank: posts small blind $0.01
Polal19: posts big blind $0.02
*** HOLE CARDS ***
Dealt to hc agorist [3c Ks]
Miami27887: raises $0.04 to $0.06
hc agorist: folds 
Simkooo: folds 
Kala77: folds 
Ckrank: calls $0.05
Polal19: folds 
*** FLOP *** [Qs 5d 5h]
Ckrank: checks 
Miami27887: checks 
*** TURN *** [Qs 5d 5h] [3s]
Ckrank: bets $0.10
Miami27887: calls $0.10
*** RIVER *** [Qs 5d 5h 3s] [9c]
Ckrank: checks 
Miami27887: checks 
*** SHOW DOWN ***
Ckrank: shows [8c Ac] (a pair of Fives)
Miami27887: shows [Ad Kd] (a pair of Fives - Ace+King kicker)
Miami27887 collected $0.33 from pot
*** SUMMARY ***
Total pot $0.34 | Rake $0.01 
Board [Qs 5d 5h 3s 9c]
Seat 1: Kala77 (button) folded before Flop (didn't bet)
Seat 2: Ckrank (small blind) showed [8c Ac] and lost with a pair of Fives
Seat 3: Polal19 (big blind) folded before Flop
Seat 4: Miami27887 showed [Ad Kd] and won ($0.33) with a pair of Fives
Seat 5: hc agorist folded before Flop (didn't bet)
Seat 6: Simkooo folded before Flop (didn't bet)



PokerStars Zoom Hand #193805291568:  Hold'em No Limit ($0.01/$0.02) - 2018/11/28 0:56:13 CUST [2018/11/27 11:56:13 ET]
Table 'Halley' 6-max Seat #1 is the button
Seat 1: Waldler2 ($2.11 in chips) 
Seat 2: Juliks91 ($5.03 in chips) 
Seat 3: eunsun04922 ($2.79 in chips) 
Seat 4: hc agorist ($2.02 in chips) 
Seat 5: andrqi ($6.71 in chips) 
Seat 6: Sovlex555 ($1.74 in chips) 
Juliks91: posts small blind $0.01
eunsun04922: posts big blind $0.02
*** HOLE CARDS ***
Dealt to hc agorist [9s Kc]
hc agorist: folds 
andrqi: raises $0.04 to $0.06
Sovlex555: folds 
Waldler2: calls $0.06
Juliks91: folds 
eunsun04922: folds 
*** FLOP *** [Jd 8d 7d]
andrqi: checks 
Waldler2: checks 
*** TURN *** [Jd 8d 7d] [6h]
andrqi: bets $0.07
Waldler2: folds 
Uncalled bet ($0.07) returned to andrqi
andrqi collected $0.14 from pot
andrqi: doesn't show hand 
*** SUMMARY ***
Total pot $0.15 | Rake $0.01 
Board [Jd 8d 7d 6h]
Seat 1: Waldler2 (button) folded on the Turn
Seat 2: Juliks91 (small blind) folded before Flop
Seat 3: eunsun04922 (big blind) folded before Flop
Seat 4: hc agorist folded before Flop (didn't bet)
Seat 5: andrqi collected ($0.14)
Seat 6: Sovlex555 folded before Flop (didn't bet)



PokerStars Zoom Hand #193805294260:  Hold'em No Limit ($0.01/$0.02) - 2018/11/28 0:56:19 CUST [2018/11/27 11:56:19 ET]
Table 'Halley' 6-max Seat #1 is the button
Seat 1: Karel33555 ($1.17 in chips) 
Seat 2: sholder1987 ($2 in chips) 
Seat 3: Phil Ounce ($2.76 in chips) 
Seat 4: Preacher_In ($2.04 in chips) 
Seat 5: hc agorist ($2.02 in chips) 
Seat 6: dntp ($2.78 in chips) 
sholder1987: posts small blind $0.01
Phil Ounce: posts big blind $0.02
*** HOLE CARDS ***
Dealt to hc agorist [As Td]
Preacher_In: raises $0.04 to $0.06
hc agorist: raises $0.12 to $0.18
dntp: folds 
Karel33555: folds 
sholder1987: folds 
Phil Ounce: folds 
Preacher_In: folds 
Uncalled bet ($0.12) returned to hc agorist
hc agorist collected $0.15 from pot
hc agorist: doesn't show hand 
*** SUMMARY ***
Total pot $0.15 | Rake $0 
Seat 1: Karel33555 (button) folded before Flop (didn't bet)
Seat 2: sholder1987 (small blind) folded before Flop
Seat 3: Phil Ounce (big blind) folded before Flop
Seat 4: Preacher_In folded before Flop
Seat 5: hc agorist collected ($0.15)
Seat 6: dntp folded before Flop (didn't bet)



PokerStars Zoom Hand #193805308733:  Hold'em No Limit ($0.01/$0.02) - 2018/11/28 0:56:50 CUST [2018/11/27 11:56:50 ET]
Table 'Halley' 6-max Seat #1 is the button
Seat 1: rounder_rf ($2.46 in chips) 
Seat 2: hc agorist ($2.11 in chips) 
Seat 3: vladimirs590 ($0.90 in chips) 
Seat 4: skendroshen ($4.19 in chips) 
Seat 5: Oberon63 ($2 in chips) 
Seat 6: Sanek454 ($2.20 in chips) 
hc agorist: posts small blind $0.01
vladimirs590: posts big blind $0.02
*** HOLE CARDS ***
Dealt to hc agorist [Ks Tc]
skendroshen: folds 
Oberon63: folds 
Sanek454: folds 
rounder_rf: raises $0.02 to $0.04
hc agorist: raises $0.10 to $0.14
vladimirs590: folds 
rounder_rf: folds 
Uncalled bet ($0.10) returned to hc agorist
hc agorist collected $0.10 from pot
hc agorist: doesn't show hand 
*** SUMMARY ***
Total pot $0.10 | Rake $0 
Seat 1: rounder_rf (button) folded before Flop
Seat 2: hc agorist (small blind) collected ($0.10)
Seat 3: vladimirs590 (big blind) folded before Flop
Seat 4: skendroshen folded before Flop (didn't bet)
Seat 5: Oberon63 folded before Flop (didn't bet)
Seat 6: Sanek454 folded before Flop (didn't bet)



PokerStars Zoom Hand #193805328834:  Hold'em No Limit ($0.01/$0.02) - 2018/11/28 0:57:33 CUST [2018/11/27 11:57:33 ET]
Table 'Halley' 6-max Seat #1 is the button
Seat 1: Kotron ($2.34 in chips) 
Seat 2: lennyfalk ($3.01 in chips) 
Seat 3: simple s0o ($6.19 in chips) 
Seat 4: romanshepp ($2.22 in chips) 
Seat 5: TQRU ($1.89 in chips) 
Seat 6: hc agorist ($2.17 in chips) 
lennyfalk: posts small blind $0.01
simple s0o: posts big blind $0.02
*** HOLE CARDS ***
Dealt to hc agorist [Td Qd]
romanshepp: folds 
TQRU: raises $0.04 to $0.06
hc agorist: calls $0.06
Kotron: folds 
lennyfalk: raises $0.18 to $0.24
simple s0o: folds 
TQRU: folds 
hc agorist: calls $0.18
*** FLOP *** [7s 6d 2h]
lennyfalk: bets $0.27
hc agorist: calls $0.27
*** TURN *** [7s 6d 2h] [Ks]
lennyfalk: checks 
hc agorist: bets $0.38
lennyfalk: folds 
Uncalled bet ($0.38) returned to hc agorist
hc agorist collected $1.06 from pot
hc agorist: doesn't show hand 
*** SUMMARY ***
Total pot $1.10 | Rake $0.04 
Board [7s 6d 2h Ks]
Seat 1: Kotron (button) folded before Flop (didn't bet)
Seat 2: lennyfalk (small blind) folded on the Turn
Seat 3: simple s0o (big blind) folded before Flop
Seat 4: romanshepp folded before Flop (didn't bet)
Seat 5: TQRU folded before Flop
Seat 6: hc agorist collected ($1.06)



PokerStars Zoom Hand #193805382315:  Hold'em No Limit ($0.01/$0.02) - 2018/11/28 0:59:26 CUST [2018/11/27 11:59:26 ET]
Table 'Halley' 6-max Seat #1 is the button
Seat 1: KingForester ($2.55 in chips) 
Seat 2: ZeusCMR ($2.03 in chips) 
Seat 3: hc agorist ($2.72 in chips) 
Seat 4: cidgeo1993 ($2.19 in chips) 
Seat 5: DominoPlayer ($2.03 in chips) 
Seat 6: naimscorp ($5.27 in chips) 
ZeusCMR: posts small blind $0.01
hc agorist: posts big blind $0.02
*** HOLE CARDS ***
Dealt to hc agorist [4d 2s]
cidgeo1993: folds 
DominoPlayer: folds 
naimscorp: raises $0.05 to $0.07
KingForester: folds 
ZeusCMR: folds 
hc agorist: folds 
Uncalled bet ($0.05) returned to naimscorp
naimscorp collected $0.05 from pot
naimscorp: doesn't show hand 
*** SUMMARY ***
Total pot $0.05 | Rake $0 
Seat 1: KingForester (button) folded before Flop (didn't bet)
Seat 2: ZeusCMR (small blind) folded before Flop
Seat 3: hc agorist (big blind) folded before Flop
Seat 4: cidgeo1993 folded before Flop (didn't bet)
Seat 5: DominoPlayer folded before Flop (didn't bet)
Seat 6: naimscorp collected ($0.05)



PokerStars Zoom Hand #193805379937:  Hold'em No Limit ($0.01/$0.02) - 2018/11/28 0:59:21 CUST [2018/11/27 11:59:21 ET]
Table 'Halley' 6-max Seat #1 is the button
Seat 1: hc agorist ($2.72 in chips) 
Seat 2: Ramero 34 ($1.88 in chips) 
Seat 3: HeyItsM3 ($2 in chips) 
Seat 4: Miami27887 ($2.22 in chips) 
Seat 5: skendroshen ($3.62 in chips) 
Seat 6: liryka ($2.47 in chips) 
Ramero 34: posts small blind $0.01
HeyItsM3: posts big blind $0.02
*** HOLE CARDS ***
Dealt to hc agorist [3d Th]
Miami27887: raises $0.04 to $0.06
skendroshen: calls $0.06
liryka: folds 
hc agorist: folds 
Ramero 34: calls $0.05
HeyItsM3: folds 
*** FLOP *** [5s 8c Qs]
Ramero 34: checks 
Miami27887: bets $0.09
skendroshen: folds 
Ramero 34: calls $0.09
*** TURN *** [5s 8c Qs] [Kc]
Ramero 34: checks 
Miami27887: bets $0.22
Ramero 34: raises $0.32 to $0.54
Miami27887: raises $1.23 to $1.77
Ramero 34: folds 
Uncalled bet ($1.23) returned to Miami27887
Miami27887 collected $1.41 from pot
Miami27887: doesn't show hand 
*** SUMMARY ***
Total pot $1.46 | Rake $0.05 
Board [5s 8c Qs Kc]
Seat 1: hc agorist (button) folded before Flop (didn't bet)
Seat 2: Ramero 34 (small blind) folded on the Turn
Seat 3: HeyItsM3 (big blind) folded before Flop
Seat 4: Miami27887 collected ($1.41)
Seat 5: skendroshen folded on the Flop
Seat 6: liryka folded before Flop (didn't bet)



PokerStars Zoom Hand #193805387137:  Hold'em No Limit ($0.01/$0.02) - 2018/11/28 0:59:36 CUST [2018/11/27 11:59:36 ET]
Table 'Halley' 6-max Seat #1 is the button
Seat 1: DominoPlayer ($2.01 in chips) 
Seat 2: Hoekoe12 ($1.78 in chips) 
Seat 3: darkoldmaker ($3.16 in chips) 
Seat 4: G.Datskov ($2.01 in chips) 
Seat 5: belomor245 ($2.37 in chips) 
Seat 6: hc agorist ($2.70 in chips) 
Hoekoe12: posts small blind $0.01
darkoldmaker: posts big blind $0.02
*** HOLE CARDS ***
Dealt to hc agorist [6h 4h]
G.Datskov: folds 
belomor245: folds 
hc agorist: raises $0.02 to $0.04
DominoPlayer: calls $0.04
Hoekoe12: folds 
darkoldmaker: folds 
*** FLOP *** [2d 5c 7s]
hc agorist: bets $0.04
DominoPlayer: raises $0.12 to $0.16
hc agorist: calls $0.12
*** TURN *** [2d 5c 7s] [9s]
hc agorist: checks 
DominoPlayer: bets $0.23
hc agorist: calls $0.23
*** RIVER *** [2d 5c 7s 9s] [Ks]
hc agorist: checks 
DominoPlayer: checks 
*** SHOW DOWN ***
hc agorist: shows [6h 4h] (high card King)
DominoPlayer: shows [8s 8d] (a pair of Eights)
DominoPlayer collected $0.86 from pot
*** SUMMARY ***
Total pot $0.89 | Rake $0.03 
Board [2d 5c 7s 9s Ks]
Seat 1: DominoPlayer (button) showed [8s 8d] and won ($0.86) with a pair of Eights
Seat 2: Hoekoe12 (small blind) folded before Flop
Seat 3: darkoldmaker (big blind) folded before Flop
Seat 4: G.Datskov folded before Flop (didn't bet)
Seat 5: belomor245 folded before Flop (didn't bet)
Seat 6: hc agorist showed [6h 4h] and lost with high card King



PokerStars Zoom Hand #193805422663:  Hold'em No Limit ($0.01/$0.02) - 2018/11/28 1:00:49 CUST [2018/11/27 12:00:49 ET]
Table 'Halley' 6-max Seat #1 is the button
Seat 1: elionspecter ($2.47 in chips) 
Seat 2: YaVamNeVeriu ($2.57 in chips) 
Seat 3: Maverick_JPR ($2.64 in chips) 
Seat 4: hc agorist ($2.26 in chips) 
Seat 5: gibbon479 ($4.45 in chips) 
Seat 6: MYlviste ($2.06 in chips) 
YaVamNeVeriu: posts small blind $0.01
Maverick_JPR: posts big blind $0.02
*** HOLE CARDS ***
Dealt to hc agorist [Tc Jc]
hc agorist: raises $0.02 to $0.04
gibbon479: folds 
MYlviste: folds 
elionspecter: folds 
YaVamNeVeriu: folds 
Maverick_JPR: calls $0.02
*** FLOP *** [5h 5s 2h]
Maverick_JPR: checks 
hc agorist: bets $0.03
Maverick_JPR: folds 
Uncalled bet ($0.03) returned to hc agorist
hc agorist collected $0.09 from pot
hc agorist: doesn't show hand 
*** SUMMARY ***
Total pot $0.09 | Rake $0 
Board [5h 5s 2h]
Seat 1: elionspecter (button) folded before Flop (didn't bet)
Seat 2: YaVamNeVeriu (small blind) folded before Flop
Seat 3: Maverick_JPR (big blind) folded on the Flop
Seat 4: hc agorist collected ($0.09)
Seat 5: gibbon479 folded before Flop (didn't bet)
Seat 6: MYlviste folded before Flop (didn't bet)



PokerStars Zoom Hand #193805419682:  Hold'em No Limit ($0.01/$0.02) - 2018/11/28 1:00:43 CUST [2018/11/27 12:00:43 ET]
Table 'Halley' 6-max Seat #1 is the button
Seat 1: G.Datskov ($2.08 in chips) 
Seat 2: hc agorist ($2.27 in chips) 
Seat 3: heinz51 ($3.10 in chips) 
Seat 4: xompistas000 ($2 in chips) 
Seat 5: Rrripl ($1.27 in chips) 
Seat 6: veksy ($2.13 in chips) 
hc agorist: posts small blind $0.01
heinz51: posts big blind $0.02
*** HOLE CARDS ***
Dealt to hc agorist [Th 7c]
xompistas000: folds 
Rrripl: folds 
veksy: raises $0.03 to $0.05
G.Datskov: folds 
hc agorist: folds 
heinz51: calls $0.03
*** FLOP *** [2s Ad 4h]
heinz51: checks 
veksy: checks 
*** TURN *** [2s Ad 4h] [2d]
heinz51: checks 
veksy: bets $0.06
heinz51: calls $0.06
*** RIVER *** [2s Ad 4h 2d] [Ah]
heinz51: checks 
veksy: checks 
*** SHOW DOWN ***
heinz51: shows [4s 5s] (two pair, Aces and Fours)
veksy: mucks hand 
heinz51 collected $0.22 from pot
*** SUMMARY ***
Total pot $0.23 | Rake $0.01 
Board [2s Ad 4h 2d Ah]
Seat 1: G.Datskov (button) folded before Flop (didn't bet)
Seat 2: hc agorist (small blind) folded before Flop
Seat 3: heinz51 (big blind) showed [4s 5s] and won ($0.22) with two pair, Aces and Fours
Seat 4: xompistas000 folded before Flop (didn't bet)
Seat 5: Rrripl folded before Flop (didn't bet)
Seat 6: veksy mucked [Ts Js]



PokerStars Zoom Hand #193805438966:  Hold'em No Limit ($0.01/$0.02) - 2018/11/28 1:01:19 CUST [2018/11/27 12:01:19 ET]
Table 'Halley' 6-max Seat #1 is the button
Seat 1: hc agorist ($2.31 in chips) 
Seat 2: LESHIi56 ($2.52 in chips) 
Seat 3: JuniorVLZ ($2.03 in chips) 
Seat 4: SVG7777 ($2.32 in chips) 
Seat 5: VVPcmpn ($1.14 in chips) 
Seat 6: NORDIK447 ($1.58 in chips) 
LESHIi56: posts small blind $0.01
JuniorVLZ: posts big blind $0.02
*** HOLE CARDS ***
Dealt to hc agorist [3s 3h]
SVG7777: folds 
VVPcmpn: folds 
NORDIK447: folds 
hc agorist: raises $0.02 to $0.04
LESHIi56: calls $0.03
JuniorVLZ: calls $0.02
*** FLOP *** [Js 4c Jd]
LESHIi56: checks 
JuniorVLZ: checks 
hc agorist: bets $0.04
LESHIi56: folds 
JuniorVLZ: raises $0.10 to $0.14
hc agorist: folds 
Uncalled bet ($0.10) returned to JuniorVLZ
JuniorVLZ collected $0.19 from pot
JuniorVLZ: doesn't show hand 
*** SUMMARY ***
Total pot $0.20 | Rake $0.01 
Board [Js 4c Jd]
Seat 1: hc agorist (button) folded on the Flop
Seat 2: LESHIi56 (small blind) folded on the Flop
Seat 3: JuniorVLZ (big blind) collected ($0.19)
Seat 4: SVG7777 folded before Flop (didn't bet)
Seat 5: VVPcmpn folded before Flop (didn't bet)
Seat 6: NORDIK447 folded before Flop (didn't bet)



PokerStars Zoom Hand #193805458636:  Hold'em No Limit ($0.01/$0.02) - 2018/11/28 1:01:55 CUST [2018/11/27 12:01:55 ET]
Table 'Halley' 6-max Seat #1 is the button
Seat 1: Nirvana1970 ($1.86 in chips) 
Seat 2: cidgeo1993 ($2.23 in chips) 
Seat 3: hc agorist ($2.23 in chips) 
Seat 4: dntp ($2.03 in chips) 
Seat 5: JBD101 ($4.79 in chips) 
Seat 6: charlie35000 ($2.03 in chips) 
cidgeo1993: posts small blind $0.01
hc agorist: posts big blind $0.02
*** HOLE CARDS ***
Dealt to hc agorist [8d Qs]
dntp: folds 
JBD101: folds 
charlie35000: raises $0.04 to $0.06
Nirvana1970: raises $0.08 to $0.14
cidgeo1993: folds 
hc agorist: folds 
charlie35000: folds 
Uncalled bet ($0.08) returned to Nirvana1970
Nirvana1970 collected $0.15 from pot
Nirvana1970: doesn't show hand 
*** SUMMARY ***
Total pot $0.15 | Rake $0 
Seat 1: Nirvana1970 (button) collected ($0.15)
Seat 2: cidgeo1993 (small blind) folded before Flop
Seat 3: hc agorist (big blind) folded before Flop
Seat 4: dntp folded before Flop (didn't bet)
Seat 5: JBD101 folded before Flop (didn't bet)
Seat 6: charlie35000 folded before Flop



PokerStars Zoom Hand #193805466484:  Hold'em No Limit ($0.01/$0.02) - 2018/11/28 1:02:09 CUST [2018/11/27 12:02:09 ET]
Table 'Halley' 6-max Seat #1 is the button
Seat 1: taurusvit ($1.91 in chips) 
Seat 2: KostT457 ($1.30 in chips) 
Seat 3: hsbc23 ($3.24 in chips) 
Seat 4: vvk22 ($2.36 in chips) 
Seat 5: askorbin21 ($2.32 in chips) 
Seat 6: hc agorist ($2.21 in chips) 
KostT457: posts small blind $0.01
hsbc23: posts big blind $0.02
*** HOLE CARDS ***
Dealt to hc agorist [2h Ts]
vvk22: folds 
askorbin21: folds 
hc agorist: folds 
taurusvit: folds 
KostT457: folds 
Uncalled bet ($0.01) returned to hsbc23
hsbc23 collected $0.02 from pot
hsbc23: doesn't show hand 
*** SUMMARY ***
Total pot $0.02 | Rake $0 
Seat 1: taurusvit (button) folded before Flop (didn't bet)
Seat 2: KostT457 (small blind) folded before Flop
Seat 3: hsbc23 (big blind) collected ($0.02)
Seat 4: vvk22 folded before Flop (didn't bet)
Seat 5: askorbin21 folded before Flop (didn't bet)
Seat 6: hc agorist folded before Flop (didn't bet)



PokerStars Zoom Hand #193805469573:  Hold'em No Limit ($0.01/$0.02) - 2018/11/28 1:02:14 CUST [2018/11/27 12:02:14 ET]
Table 'Halley' 6-max Seat #1 is the button
Seat 1: V-SCORPIO-C ($4.09 in chips) 
Seat 2: K.Stas71 ($0.92 in chips) 
Seat 3: Nagibator523 ($2 in chips) 
Seat 4: 2040800 ($0.97 in chips) 
Seat 5: hc agorist ($2.21 in chips) 
Seat 6: goldplay ($2.51 in chips) 
K.Stas71: posts small blind $0.01
Nagibator523: posts big blind $0.02
*** HOLE CARDS ***
Dealt to hc agorist [5c Kh]
2040800: raises $0.04 to $0.06
hc agorist: folds 
goldplay: folds 
V-SCORPIO-C: folds 
K.Stas71: folds 
Nagibator523: folds 
Uncalled bet ($0.04) returned to 2040800
2040800 collected $0.05 from pot
2040800: doesn't show hand 
*** SUMMARY ***
Total pot $0.05 | Rake $0 
Seat 1: V-SCORPIO-C (button) folded before Flop (didn't bet)
Seat 2: K.Stas71 (small blind) folded before Flop
Seat 3: Nagibator523 (big blind) folded before Flop
Seat 4: 2040800 collected ($0.05)
Seat 5: hc agorist folded before Flop (didn't bet)
Seat 6: goldplay folded before Flop (didn't bet)



PokerStars Zoom Hand #193805473436:  Hold'em No Limit ($0.01/$0.02) - 2018/11/28 1:02:21 CUST [2018/11/27 12:02:21 ET]
Table 'Halley' 6-max Seat #1 is the button
Seat 1: roran211 ($2.70 in chips) 
Seat 2: hc agorist ($2.21 in chips) 
Seat 3: AGT1960 ($3.57 in chips) 
Seat 4: torrflugan77 ($2.09 in chips) 
Seat 5: BrymanDan ($1.95 in chips) 
Seat 6: vovan100157 ($1.97 in chips) 
hc agorist: posts small blind $0.01
AGT1960: posts big blind $0.02
*** HOLE CARDS ***
Dealt to hc agorist [2s 3c]
torrflugan77: raises $0.03 to $0.05
BrymanDan: folds 
vovan100157: folds 
roran211: folds 
hc agorist: folds 
AGT1960: folds 
Uncalled bet ($0.03) returned to torrflugan77
torrflugan77 collected $0.05 from pot
torrflugan77: doesn't show hand 
*** SUMMARY ***
Total pot $0.05 | Rake $0 
Seat 1: roran211 (button) folded before Flop (didn't bet)
Seat 2: hc agorist (small blind) folded before Flop
Seat 3: AGT1960 (big blind) folded before Flop
Seat 4: torrflugan77 collected ($0.05)
Seat 5: BrymanDan folded before Flop (didn't bet)
Seat 6: vovan100157 folded before Flop (didn't bet)



PokerStars Zoom Hand #193805455794:  Hold'em No Limit ($0.01/$0.02) - 2018/11/28 1:01:50 CUST [2018/11/27 12:01:50 ET]
Table 'Halley' 6-max Seat #1 is the button
Seat 1: Marcus mrrv ($1.80 in chips) 
Seat 2: Lirik0808 ($5.21 in chips) 
Seat 3: HeyItsM3 ($2.03 in chips) 
Seat 4: hc agorist ($2.23 in chips) 
Seat 5: joelox25 ($8.01 in chips) 
Seat 6: eucalyptplebs ($2.23 in chips) 
Lirik0808: posts small blind $0.01
HeyItsM3: posts big blind $0.02
*** HOLE CARDS ***
Dealt to hc agorist [7h Kd]
hc agorist: folds 
joelox25: folds 
eucalyptplebs: folds 
Marcus mrrv: folds 
Lirik0808: raises $0.02 to $0.04
HeyItsM3: calls $0.02
*** FLOP *** [7c 4d 8s]
Lirik0808: checks 
HeyItsM3: checks 
*** TURN *** [7c 4d 8s] [As]
Lirik0808: bets $0.06
HeyItsM3: calls $0.06
*** RIVER *** [7c 4d 8s As] [2d]
Lirik0808: checks 
HeyItsM3: checks 
*** SHOW DOWN ***
Lirik0808: shows [4s Qs] (a pair of Fours)
HeyItsM3: shows [Ad 3d] (a pair of Aces)
HeyItsM3 collected $0.19 from pot
*** SUMMARY ***
Total pot $0.20 | Rake $0.01 
Board [7c 4d 8s As 2d]
Seat 1: Marcus mrrv (button) folded before Flop (didn't bet)
Seat 2: Lirik0808 (small blind) showed [4s Qs] and lost with a pair of Fours
Seat 3: HeyItsM3 (big blind) showed [Ad 3d] and won ($0.19) with a pair of Aces
Seat 4: hc agorist folded before Flop (didn't bet)
Seat 5: joelox25 folded before Flop (didn't bet)
Seat 6: eucalyptplebs folded before Flop (didn't bet)



PokerStars Zoom Hand #193805481352:  Hold'em No Limit ($0.01/$0.02) - 2018/11/28 1:02:35 CUST [2018/11/27 12:02:35 ET]
Table 'Halley' 6-max Seat #1 is the button
Seat 1: hc agorist ($2.20 in chips) 
Seat 2: b1uebe11 ($1 in chips) 
Seat 3: vovan100157 ($1.93 in chips) 
Seat 4: tdo208 ($4.06 in chips) 
Seat 5: DiMoWo ($2.49 in chips) 
Seat 6: Zarec ($2.23 in chips) 
b1uebe11: posts small blind $0.01
vovan100157: posts big blind $0.02
*** HOLE CARDS ***
Dealt to hc agorist [Kc 6s]
tdo208: folds 
DiMoWo: folds 
Zarec: folds 
hc agorist: folds 
b1uebe11: folds 
Uncalled bet ($0.01) returned to vovan100157
vovan100157 collected $0.02 from pot
vovan100157: doesn't show hand 
*** SUMMARY ***
Total pot $0.02 | Rake $0 
Seat 1: hc agorist (button) folded before Flop (didn't bet)
Seat 2: b1uebe11 (small blind) folded before Flop
Seat 3: vovan100157 (big blind) collected ($0.02)
Seat 4: tdo208 folded before Flop (didn't bet)
Seat 5: DiMoWo folded before Flop (didn't bet)
Seat 6: Zarec folded before Flop (didn't bet)



PokerStars Zoom Hand #193805484734:  Hold'em No Limit ($0.01/$0.02) - 2018/11/28 1:02:40 CUST [2018/11/27 12:02:40 ET]
Table 'Halley' 6-max Seat #1 is the button
Seat 1: TeddyTheFace ($3.35 in chips) 
Seat 2: amaposh ($3.12 in chips) 
Seat 3: hc agorist ($2.20 in chips) 
Seat 4: Ilya "rc" T ($2.86 in chips) 
Seat 5: eshan35 ($0.62 in chips) 
Seat 6: VENDETTA 9mm ($1.90 in chips) 
amaposh: posts small blind $0.01
hc agorist: posts big blind $0.02
*** HOLE CARDS ***
Dealt to hc agorist [As 9s]
Ilya "rc" T: folds 
eshan35: folds 
VENDETTA 9mm: folds 
TeddyTheFace: folds 
amaposh: raises $0.03 to $0.05
hc agorist: raises $0.10 to $0.15
amaposh: folds 
Uncalled bet ($0.10) returned to hc agorist
hc agorist collected $0.10 from pot
hc agorist: doesn't show hand 
*** SUMMARY ***
Total pot $0.10 | Rake $0 
Seat 1: TeddyTheFace (button) folded before Flop (didn't bet)
Seat 2: amaposh (small blind) folded before Flop
Seat 3: hc agorist (big blind) collected ($0.10)
Seat 4: Ilya "rc" T folded before Flop (didn't bet)
Seat 5: eshan35 folded before Flop (didn't bet)
Seat 6: VENDETTA 9mm folded before Flop (didn't bet)



PokerStars Zoom Hand #193805492595:  Hold'em No Limit ($0.01/$0.02) - 2018/11/28 1:02:54 CUST [2018/11/27 12:02:54 ET]
Table 'Halley' 6-max Seat #1 is the button
Seat 1: ForHistory ($2.15 in chips) 
Seat 2: prap28 ($4.22 in chips) 
Seat 3: robotlolz ($2.70 in chips) 
Seat 4: logerhansen ($0.85 in chips) 
Seat 5: Crmicz89 ($1.94 in chips) 
Seat 6: hc agorist ($2.25 in chips) 
prap28: posts small blind $0.01
robotlolz: posts big blind $0.02
*** HOLE CARDS ***
Dealt to hc agorist [2d 6s]
logerhansen: raises $0.05 to $0.07
Crmicz89: folds 
hc agorist: folds 
ForHistory: calls $0.07
prap28: folds 
robotlolz: calls $0.05
*** FLOP *** [7s Jc 5c]
robotlolz: checks 
logerhansen: bets $0.14
ForHistory: folds 
robotlolz: folds 
Uncalled bet ($0.14) returned to logerhansen
logerhansen collected $0.21 from pot
logerhansen: doesn't show hand 
*** SUMMARY ***
Total pot $0.22 | Rake $0.01 
Board [7s Jc 5c]
Seat 1: ForHistory (button) folded on the Flop
Seat 2: prap28 (small blind) folded before Flop
Seat 3: robotlolz (big blind) folded on the Flop
Seat 4: logerhansen collected ($0.21)
Seat 5: Crmicz89 folded before Flop (didn't bet)
Seat 6: hc agorist folded before Flop (didn't bet)



PokerStars Zoom Hand #193805476203:  Hold'em No Limit ($0.01/$0.02) - 2018/11/28 1:02:26 CUST [2018/11/27 12:02:26 ET]
Table 'Halley' 6-max Seat #1 is the button
Seat 1: At0rd0ad0 ($0.58 in chips) 
Seat 2: Arfur Melon ($0.98 in chips) 
Seat 3: tdressel ($2.86 in chips) 
Seat 4: V-SCORPIO-C ($4.16 in chips) 
Seat 5: hc agorist ($2.20 in chips) 
Seat 6: Rimas98 ($2.60 in chips) 
Arfur Melon: posts small blind $0.01
tdressel: posts big blind $0.02
*** HOLE CARDS ***
Dealt to hc agorist [7h Ah]
V-SCORPIO-C: raises $0.04 to $0.06
hc agorist: folds 
Rimas98: raises $0.14 to $0.20
At0rd0ad0: folds 
Arfur Melon: folds 
tdressel: folds 
V-SCORPIO-C: calls $0.14
*** FLOP *** [2h 6s Kc]
V-SCORPIO-C: checks 
Rimas98: bets $0.30
V-SCORPIO-C: calls $0.30
*** TURN *** [2h 6s Kc] [2c]
V-SCORPIO-C: checks 
Rimas98: bets $0.60
V-SCORPIO-C: folds 
Uncalled bet ($0.60) returned to Rimas98
Rimas98 collected $0.99 from pot
Rimas98: doesn't show hand 
*** SUMMARY ***
Total pot $1.03 | Rake $0.04 
Board [2h 6s Kc 2c]
Seat 1: At0rd0ad0 (button) folded before Flop (didn't bet)
Seat 2: Arfur Melon (small blind) folded before Flop
Seat 3: tdressel (big blind) folded before Flop
Seat 4: V-SCORPIO-C folded on the Turn
Seat 5: hc agorist folded before Flop (didn't bet)
Seat 6: Rimas98 collected ($0.99)



PokerStars Zoom Hand #193805463040:  Hold'em No Limit ($0.01/$0.02) - 2018/11/28 1:02:03 CUST [2018/11/27 12:02:03 ET]
Table 'Halley' 6-max Seat #1 is the button
Seat 1: Mista Live ($2 in chips) 
Seat 2: mi$tralx ($2 in chips) 
Seat 3: okayib ($2.21 in chips) 
Seat 4: hc agorist ($2.21 in chips) 
Seat 5: sakuraakina ($2.23 in chips) 
Seat 6: Kala77 ($2.36 in chips) 
mi$tralx: posts small blind $0.01
okayib: posts big blind $0.02
*** HOLE CARDS ***
Dealt to hc agorist [2c Ts]
hc agorist: folds 
sakuraakina: folds 
Kala77: raises $0.03 to $0.05
Mista Live: calls $0.05
mi$tralx: folds 
okayib: folds 
*** FLOP *** [Qs Jc 9h]
Kala77: checks 
Mista Live: checks 
*** TURN *** [Qs Jc 9h] [9s]
Kala77: checks 
Mista Live: bets $0.07
Kala77: folds 
Uncalled bet ($0.07) returned to Mista Live
Mista Live collected $0.13 from pot
Mista Live: doesn't show hand 
*** SUMMARY ***
Total pot $0.13 | Rake $0 
Board [Qs Jc 9h 9s]
Seat 1: Mista Live (button) collected ($0.13)
Seat 2: mi$tralx (small blind) folded before Flop
Seat 3: okayib (big blind) folded before Flop
Seat 4: hc agorist folded before Flop (didn't bet)
Seat 5: sakuraakina folded before Flop (didn't bet)
Seat 6: Kala77 folded on the Turn



PokerStars Zoom Hand #193805495427:  Hold'em No Limit ($0.01/$0.02) - 2018/11/28 1:02:59 CUST [2018/11/27 12:02:59 ET]
Table 'Halley' 6-max Seat #1 is the button
Seat 1: Williwacker9 ($2 in chips) 
Seat 2: hc agorist ($2.25 in chips) 
Seat 3: amaposh ($2.05 in chips) 
Seat 4: prap28 ($4.21 in chips) 
Seat 5: Vangede4Life ($2.44 in chips) 
Seat 6: RocknRolla5 ($2.18 in chips) 
hc agorist: posts small blind $0.01
amaposh: posts big blind $0.02
*** HOLE CARDS ***
Dealt to hc agorist [Kc 9c]
prap28: folds 
Vangede4Life: raises $0.04 to $0.06
RocknRolla5: folds 
Williwacker9: folds 
hc agorist: raises $0.14 to $0.20
amaposh: folds 
Vangede4Life: calls $0.14
*** FLOP *** [6h 4c 9d]
hc agorist: checks 
Vangede4Life: bets $0.26
hc agorist: calls $0.26
*** TURN *** [6h 4c 9d] [3c]
hc agorist: checks 
Vangede4Life: bets $0.46
hc agorist: calls $0.46
*** RIVER *** [6h 4c 9d 3c] [9h]
hc agorist: checks 
Vangede4Life: checks 
*** SHOW DOWN ***
hc agorist: shows [Kc 9c] (three of a kind, Nines)
Vangede4Life: mucks hand 
hc agorist collected $1.79 from pot
*** SUMMARY ***
Total pot $1.86 | Rake $0.07 
Board [6h 4c 9d 3c 9h]
Seat 1: Williwacker9 (button) folded before Flop (didn't bet)
Seat 2: hc agorist (small blind) showed [Kc 9c] and won ($1.79) with three of a kind, Nines
Seat 3: amaposh (big blind) folded before Flop
Seat 4: prap28 folded before Flop (didn't bet)
Seat 5: Vangede4Life mucked [Jd Jc]
Seat 6: RocknRolla5 folded before Flop (didn't bet)



PokerStars Zoom Hand #193805541702:  Hold'em No Limit ($0.01/$0.02) - 2018/11/28 1:04:19 CUST [2018/11/27 12:04:19 ET]
Table 'Halley' 6-max Seat #1 is the button
Seat 1: Maverick_JPR ($2.34 in chips) 
Seat 2: taurusvit ($1.95 in chips) 
Seat 3: lizardcmm ($2 in chips) 
Seat 4: hc agorist ($3.10 in chips) 
Seat 5: 2040800 ($1.05 in chips) 
Seat 6: kiralex55 ($2 in chips) 
taurusvit: posts small blind $0.01
lizardcmm: posts big blind $0.02
*** HOLE CARDS ***
Dealt to hc agorist [9d 8d]
hc agorist: raises $0.02 to $0.04
2040800: calls $0.04
kiralex55: folds 
Maverick_JPR: folds 
taurusvit: folds 
lizardcmm: folds 
*** FLOP *** [Qc 4h 6h]
hc agorist: bets $0.04
2040800: calls $0.04
*** TURN *** [Qc 4h 6h] [Qs]
hc agorist: bets $0.06
2040800: folds 
Uncalled bet ($0.06) returned to hc agorist
hc agorist collected $0.18 from pot
hc agorist: doesn't show hand 
*** SUMMARY ***
Total pot $0.19 | Rake $0.01 
Board [Qc 4h 6h Qs]
Seat 1: Maverick_JPR (button) folded before Flop (didn't bet)
Seat 2: taurusvit (small blind) folded before Flop
Seat 3: lizardcmm (big blind) folded before Flop
Seat 4: hc agorist collected ($0.18)
Seat 5: 2040800 folded on the Turn
Seat 6: kiralex55 folded before Flop (didn't bet)



PokerStars Zoom Hand #193805534160:  Hold'em No Limit ($0.01/$0.02) - 2018/11/28 1:04:06 CUST [2018/11/27 12:04:06 ET]
Table 'Halley' 6-max Seat #1 is the button
Seat 1: Diff3r3nt ($2.53 in chips) 
Seat 2: G.Datskov ($3.21 in chips) 
Seat 3: hc agorist ($3.12 in chips) 
Seat 4: goldplay ($9.81 in chips) 
Seat 5: fomik33 ($2 in chips) 
Seat 6: Rockabill408 ($2.03 in chips) 
G.Datskov: posts small blind $0.01
hc agorist: posts big blind $0.02
*** HOLE CARDS ***
Dealt to hc agorist [4c Jc]
goldplay: raises $0.04 to $0.06
fomik33: calls $0.06
Rockabill408: folds 
Diff3r3nt: folds 
G.Datskov: folds 
hc agorist: folds 
*** FLOP *** [Kc Js 9s]
goldplay: bets $0.07
fomik33: calls $0.07
*** TURN *** [Kc Js 9s] [4h]
goldplay: bets $0.20
fomik33: folds 
Uncalled bet ($0.20) returned to goldplay
goldplay collected $0.28 from pot
goldplay: doesn't show hand 
*** SUMMARY ***
Total pot $0.29 | Rake $0.01 
Board [Kc Js 9s 4h]
Seat 1: Diff3r3nt (button) folded before Flop (didn't bet)
Seat 2: G.Datskov (small blind) folded before Flop
Seat 3: hc agorist (big blind) folded before Flop
Seat 4: goldplay collected ($0.28)
Seat 5: fomik33 folded on the Turn
Seat 6: Rockabill408 folded before Flop (didn't bet)



PokerStars Zoom Hand #193805560302:  Hold'em No Limit ($0.01/$0.02) - 2018/11/28 1:04:51 CUST [2018/11/27 12:04:51 ET]
Table 'Halley' 6-max Seat #1 is the button
Seat 1: hc agorist ($3.20 in chips) 
Seat 2: Spinno ($3.18 in chips) 
Seat 3: SILK207 ($2.50 in chips) 
Seat 4: Pelorojo1 ($2.49 in chips) 
Seat 5: Darkymond ($2 in chips) 
Seat 6: MaxProximus ($1.42 in chips) 
Spinno: posts small blind $0.01
SILK207: posts big blind $0.02
*** HOLE CARDS ***
Dealt to hc agorist [Jc Tc]
Pelorojo1: folds 
Darkymond: folds 
MaxProximus: folds 
hc agorist: raises $0.02 to $0.04
Spinno: folds 
SILK207: folds 
Uncalled bet ($0.02) returned to hc agorist
hc agorist collected $0.05 from pot
hc agorist: doesn't show hand 
*** SUMMARY ***
Total pot $0.05 | Rake $0 
Seat 1: hc agorist (button) collected ($0.05)
Seat 2: Spinno (small blind) folded before Flop
Seat 3: SILK207 (big blind) folded before Flop
Seat 4: Pelorojo1 folded before Flop (didn't bet)
Seat 5: Darkymond folded before Flop (didn't bet)
Seat 6: MaxProximus folded before Flop (didn't bet)



PokerStars Zoom Hand #193805556187:  Hold'em No Limit ($0.01/$0.02) - 2018/11/28 1:04:44 CUST [2018/11/27 12:04:44 ET]
Table 'Halley' 6-max Seat #1 is the button
Seat 1: sergei170860 ($1.31 in chips) 
Seat 2: Oswaldoja ($2 in chips) 
Seat 3: aEROplan-JR ($5.43 in chips) 
Seat 4: Rimas98 ($4.02 in chips) 
Seat 5: SILK207 ($1.90 in chips) 
Seat 6: hc agorist ($3.20 in chips) 
Oswaldoja: posts small blind $0.01
aEROplan-JR: posts big blind $0.02
*** HOLE CARDS ***
Dealt to hc agorist [3h Tc]
Rimas98: folds 
SILK207: folds 
hc agorist: folds 
sergei170860: calls $0.02
Oswaldoja: folds 
aEROplan-JR: checks 
*** FLOP *** [7d Jd 8s]
aEROplan-JR: checks 
sergei170860: bets $0.02
aEROplan-JR: calls $0.02
*** TURN *** [7d Jd 8s] [3c]
aEROplan-JR: checks 
sergei170860: bets $0.02
aEROplan-JR: calls $0.02
*** RIVER *** [7d Jd 8s 3c] [6s]
aEROplan-JR: checks 
sergei170860: bets $0.02
aEROplan-JR: calls $0.02
*** SHOW DOWN ***
sergei170860: shows [Jh 9s] (a pair of Jacks)
aEROplan-JR: mucks hand 
sergei170860 collected $0.16 from pot
*** SUMMARY ***
Total pot $0.17 | Rake $0.01 
Board [7d Jd 8s 3c 6s]
Seat 1: sergei170860 (button) showed [Jh 9s] and won ($0.16) with a pair of Jacks
Seat 2: Oswaldoja (small blind) folded before Flop
Seat 3: aEROplan-JR (big blind) mucked [Ac 7s]
Seat 4: Rimas98 folded before Flop (didn't bet)
Seat 5: SILK207 folded before Flop (didn't bet)
Seat 6: hc agorist folded before Flop (didn't bet)



PokerStars Zoom Hand #193805566590:  Hold'em No Limit ($0.01/$0.02) - 2018/11/28 1:05:02 CUST [2018/11/27 12:05:02 ET]
Table 'Halley' 6-max Seat #1 is the button
Seat 1: d2009157 ($7.30 in chips) 
Seat 2: hc agorist ($3.23 in chips) 
Seat 3: bigfreddo86 ($4.06 in chips) 
Seat 4: AVyiO ($4.69 in chips) 
Seat 5: goldplay ($2.54 in chips) 
Seat 6: vovan100157 ($1.98 in chips) 
hc agorist: posts small blind $0.01
bigfreddo86: posts big blind $0.02
*** HOLE CARDS ***
Dealt to hc agorist [4c Kd]
AVyiO: folds 
goldplay: raises $0.02 to $0.04
vovan100157: folds 
d2009157: calls $0.04
hc agorist: folds 
bigfreddo86: calls $0.02
*** FLOP *** [8d 6d 5d]
bigfreddo86: checks 
goldplay: checks 
d2009157: checks 
*** TURN *** [8d 6d 5d] [2d]
bigfreddo86: checks 
goldplay: checks 
d2009157: bets $0.04
bigfreddo86: folds 
goldplay: folds 
Uncalled bet ($0.04) returned to d2009157
d2009157 collected $0.13 from pot
d2009157: doesn't show hand 
*** SUMMARY ***
Total pot $0.13 | Rake $0 
Board [8d 6d 5d 2d]
Seat 1: d2009157 (button) collected ($0.13)
Seat 2: hc agorist (small blind) folded before Flop
Seat 3: bigfreddo86 (big blind) folded on the Turn
Seat 4: AVyiO folded before Flop (didn't bet)
Seat 5: goldplay folded on the Turn
Seat 6: vovan100157 folded before Flop (didn't bet)



PokerStars Zoom Hand #193805574106:  Hold'em No Limit ($0.01/$0.02) - 2018/11/28 1:05:15 CUST [2018/11/27 12:05:15 ET]
Table 'Halley' 6-max Seat #1 is the button
Seat 1: phenix140 ($2.95 in chips) 
Seat 2: anfitamin712 ($2.34 in chips) 
Seat 3: G.Datskov ($3.01 in chips) 
Seat 4: hc agorist ($3.22 in chips) 
Seat 5: TheRedPillx ($2.04 in chips) 
Seat 6: pokers999999 ($2.09 in chips) 
anfitamin712: posts small blind $0.01
G.Datskov: posts big blind $0.02
*** HOLE CARDS ***
Dealt to hc agorist [9d 9s]
hc agorist: raises $0.04 to $0.06
TheRedPillx: folds 
pokers999999: calls $0.06
phenix140: folds 
anfitamin712: calls $0.05
G.Datskov: folds 
*** FLOP *** [Tc Qc 8d]
anfitamin712: checks 
hc agorist: checks 
pokers999999: bets $0.10
anfitamin712: calls $0.10
hc agorist: folds 
*** TURN *** [Tc Qc 8d] [8s]
anfitamin712: checks 
pokers999999: bets $0.20
anfitamin712: folds 
Uncalled bet ($0.20) returned to pokers999999
pokers999999 collected $0.39 from pot
pokers999999: doesn't show hand 
*** SUMMARY ***
Total pot $0.40 | Rake $0.01 
Board [Tc Qc 8d 8s]
Seat 1: phenix140 (button) folded before Flop (didn't bet)
Seat 2: anfitamin712 (small blind) folded on the Turn
Seat 3: G.Datskov (big blind) folded before Flop
Seat 4: hc agorist folded on the Flop
Seat 5: TheRedPillx folded before Flop (didn't bet)
Seat 6: pokers999999 collected ($0.39)



PokerStars Zoom Hand #193805589200:  Hold'em No Limit ($0.01/$0.02) - 2018/11/28 1:05:41 CUST [2018/11/27 12:05:41 ET]
Table 'Halley' 6-max Seat #1 is the button
Seat 1: hc agorist ($3.16 in chips) 
Seat 2: Marcus mrrv ($2.09 in chips) 
Seat 3: booktable ($2 in chips) 
Seat 4: clewric ($2.57 in chips) 
Seat 5: khhg ($3.92 in chips) 
Seat 6: AlexGalimov ($4.29 in chips) 
Marcus mrrv: posts small blind $0.01
booktable: posts big blind $0.02
*** HOLE CARDS ***
Dealt to hc agorist [6h 4s]
clewric: raises $0.03 to $0.05
khhg: folds 
AlexGalimov: folds 
hc agorist: folds 
Marcus mrrv: folds 
booktable: folds 
Uncalled bet ($0.03) returned to clewric
clewric collected $0.05 from pot
clewric: doesn't show hand 
*** SUMMARY ***
Total pot $0.05 | Rake $0 
Seat 1: hc agorist (button) folded before Flop (didn't bet)
Seat 2: Marcus mrrv (small blind) folded before Flop
Seat 3: booktable (big blind) folded before Flop
Seat 4: clewric collected ($0.05)
Seat 5: khhg folded before Flop (didn't bet)
Seat 6: AlexGalimov folded before Flop (didn't bet)



PokerStars Zoom Hand #193805592087:  Hold'em No Limit ($0.01/$0.02) - 2018/11/28 1:05:46 CUST [2018/11/27 12:05:46 ET]
Table 'Halley' 6-max Seat #1 is the button
Seat 1: Eveyor ($6.81 in chips) 
Seat 2: logoswort ($5.55 in chips) 
Seat 3: Chaca273 ($2.21 in chips) 
Seat 4: 2040800 ($0.93 in chips) 
Seat 5: hc agorist ($3.16 in chips) 
Seat 6: hsbc23 ($2.03 in chips) 
logoswort: posts small blind $0.01
Chaca273: posts big blind $0.02
*** HOLE CARDS ***
Dealt to hc agorist [2s 7c]
2040800: folds 
hc agorist: folds 
hsbc23: folds 
Eveyor: folds 
logoswort: raises $0.04 to $0.06
Chaca273: folds 
Uncalled bet ($0.04) returned to logoswort
logoswort collected $0.04 from pot
logoswort: doesn't show hand 
*** SUMMARY ***
Total pot $0.04 | Rake $0 
Seat 1: Eveyor (button) folded before Flop (didn't bet)
Seat 2: logoswort (small blind) collected ($0.04)
Seat 3: Chaca273 (big blind) folded before Flop
Seat 4: 2040800 folded before Flop (didn't bet)
Seat 5: hc agorist folded before Flop (didn't bet)
Seat 6: hsbc23 folded before Flop (didn't bet)



PokerStars Zoom Hand #193805595506:  Hold'em No Limit ($0.01/$0.02) - 2018/11/28 1:05:52 CUST [2018/11/27 12:05:52 ET]
Table 'Halley' 6-max Seat #1 is the button
Seat 1: TheN@kedGun ($2.14 in chips) 
Seat 2: liryka ($3.27 in chips) 
Seat 3: hc agorist ($3.16 in chips) 
Seat 4: Pilich1234 ($2.01 in chips) 
Seat 5: TIBURONA349 ($4.48 in chips) 
Seat 6: joelox25 ($2.72 in chips) 
liryka: posts small blind $0.01
hc agorist: posts big blind $0.02
*** HOLE CARDS ***
Dealt to hc agorist [Ac Ts]
Pilich1234: folds 
TIBURONA349: folds 
joelox25: folds 
TheN@kedGun: folds 
liryka: raises $0.04 to $0.06
hc agorist: raises $0.12 to $0.18
liryka: calls $0.12
*** FLOP *** [5d 3d 4s]
liryka: checks 
hc agorist: checks 
*** TURN *** [5d 3d 4s] [3c]
liryka: checks 
hc agorist: checks 
*** RIVER *** [5d 3d 4s 3c] [4c]
liryka: checks 
hc agorist: bets $0.12
liryka: folds 
Uncalled bet ($0.12) returned to hc agorist
hc agorist collected $0.35 from pot
hc agorist: doesn't show hand 
*** SUMMARY ***
Total pot $0.36 | Rake $0.01 
Board [5d 3d 4s 3c 4c]
Seat 1: TheN@kedGun (button) folded before Flop (didn't bet)
Seat 2: liryka (small blind) folded on the River
Seat 3: hc agorist (big blind) collected ($0.35)
Seat 4: Pilich1234 folded before Flop (didn't bet)
Seat 5: TIBURONA349 folded before Flop (didn't bet)
Seat 6: joelox25 folded before Flop (didn't bet)



PokerStars Zoom Hand #193805623258:  Hold'em No Limit ($0.01/$0.02) - 2018/11/28 1:06:40 CUST [2018/11/27 12:06:40 ET]
Table 'Halley' 6-max Seat #1 is the button
Seat 1: Badreg99 ($1.50 in chips) 
Seat 2: Oberon63 ($2.16 in chips) 
Seat 3: mi$tralx ($2.61 in chips) 
Seat 4: the_Joker'83 ($5.32 in chips) 
Seat 5: veksy ($3.93 in chips) 
Seat 6: hc agorist ($3.33 in chips) 
Oberon63: posts small blind $0.01
mi$tralx: posts big blind $0.02
*** HOLE CARDS ***
Dealt to hc agorist [3s 9c]
the_Joker'83: folds 
veksy: folds 
hc agorist: folds 
Badreg99: folds 
Oberon63: folds 
Uncalled bet ($0.01) returned to mi$tralx
mi$tralx collected $0.02 from pot
mi$tralx: doesn't show hand 
*** SUMMARY ***
Total pot $0.02 | Rake $0 
Seat 1: Badreg99 (button) folded before Flop (didn't bet)
Seat 2: Oberon63 (small blind) folded before Flop
Seat 3: mi$tralx (big blind) collected ($0.02)
Seat 4: the_Joker'83 folded before Flop (didn't bet)
Seat 5: veksy folded before Flop (didn't bet)
Seat 6: hc agorist folded before Flop (didn't bet)



PokerStars Zoom Hand #193805626624:  Hold'em No Limit ($0.01/$0.02) - 2018/11/28 1:06:46 CUST [2018/11/27 12:06:46 ET]
Table 'Halley' 6-max Seat #1 is the button
Seat 1: mg-deniz ($7.10 in chips) 
Seat 2: eshan35 ($0.67 in chips) 
Seat 3: fdoTeam ($2.40 in chips) 
Seat 4: YoSoyArmandoSan ($3.91 in chips) 
Seat 5: hc agorist ($3.33 in chips) 
Seat 6: rewq333 ($9.26 in chips) 
eshan35: posts small blind $0.01
fdoTeam: posts big blind $0.02
*** HOLE CARDS ***
Dealt to hc agorist [Tc 7c]
YoSoyArmandoSan: raises $0.04 to $0.06
hc agorist: folds 
rewq333: folds 
mg-deniz: folds 
eshan35: folds 
fdoTeam: folds 
Uncalled bet ($0.04) returned to YoSoyArmandoSan
YoSoyArmandoSan collected $0.05 from pot
YoSoyArmandoSan: doesn't show hand 
*** SUMMARY ***
Total pot $0.05 | Rake $0 
Seat 1: mg-deniz (button) folded before Flop (didn't bet)
Seat 2: eshan35 (small blind) folded before Flop
Seat 3: fdoTeam (big blind) folded before Flop
Seat 4: YoSoyArmandoSan collected ($0.05)
Seat 5: hc agorist folded before Flop (didn't bet)
Seat 6: rewq333 folded before Flop (didn't bet)



PokerStars Zoom Hand #193805630635:  Hold'em No Limit ($0.01/$0.02) - 2018/11/28 1:06:53 CUST [2018/11/27 12:06:53 ET]
Table 'Halley' 6-max Seat #1 is the button
Seat 1: skendroshen ($4.40 in chips) 
Seat 2: hc agorist ($3.33 in chips) 
Seat 3: TheRedPillx ($2.22 in chips) 
Seat 4: bigfreddo86 ($2.27 in chips) 
Seat 5: Vajdalf92 ($2.96 in chips) 
Seat 6: vovan100157 ($1.85 in chips) 
hc agorist: posts small blind $0.01
TheRedPillx: posts big blind $0.02
*** HOLE CARDS ***
Dealt to hc agorist [Qs As]
bigfreddo86: folds 
Vajdalf92: calls $0.02
vovan100157: folds 
skendroshen: folds 
hc agorist: raises $0.08 to $0.10
TheRedPillx: folds 
Vajdalf92: folds 
Uncalled bet ($0.08) returned to hc agorist
hc agorist collected $0.06 from pot
hc agorist: doesn't show hand 
*** SUMMARY ***
Total pot $0.06 | Rake $0 
Seat 1: skendroshen (button) folded before Flop (didn't bet)
Seat 2: hc agorist (small blind) collected ($0.06)
Seat 3: TheRedPillx (big blind) folded before Flop
Seat 4: bigfreddo86 folded before Flop (didn't bet)
Seat 5: Vajdalf92 folded before Flop
Seat 6: vovan100157 folded before Flop (didn't bet)



PokerStars Zoom Hand #193805644062:  Hold'em No Limit ($0.01/$0.02) - 2018/11/28 1:07:16 CUST [2018/11/27 12:07:16 ET]
Table 'Halley' 6-max Seat #1 is the button
Seat 1: Badreg99 ($1.48 in chips) 
Seat 2: TheRedPillx ($6.47 in chips) 
Seat 3: vatteztaR* ($2.67 in chips) 
Seat 4: danival2 ($5.02 in chips) 
Seat 5: hc agorist ($3.37 in chips) 
Seat 6: Gennadii1935 ($2 in chips) 
TheRedPillx: posts small blind $0.01
vatteztaR*: posts big blind $0.02
*** HOLE CARDS ***
Dealt to hc agorist [Ts 4c]
danival2: folds 
hc agorist: folds 
Gennadii1935: raises $0.04 to $0.06
Badreg99: folds 
TheRedPillx: folds 
vatteztaR*: calls $0.04
*** FLOP *** [2h 3h 9h]
vatteztaR*: checks 
Gennadii1935: checks 
*** TURN *** [2h 3h 9h] [Qc]
vatteztaR*: bets $0.09
Gennadii1935: folds 
Uncalled bet ($0.09) returned to vatteztaR*
vatteztaR* collected $0.13 from pot
vatteztaR*: doesn't show hand 
*** SUMMARY ***
Total pot $0.13 | Rake $0 
Board [2h 3h 9h Qc]
Seat 1: Badreg99 (button) folded before Flop (didn't bet)
Seat 2: TheRedPillx (small blind) folded before Flop
Seat 3: vatteztaR* (big blind) collected ($0.13)
Seat 4: danival2 folded before Flop (didn't bet)
Seat 5: hc agorist folded before Flop (didn't bet)
Seat 6: Gennadii1935 folded on the Turn



PokerStars Zoom Hand #193805647573:  Hold'em No Limit ($0.01/$0.02) - 2018/11/28 1:07:22 CUST [2018/11/27 12:07:22 ET]
Table 'Halley' 6-max Seat #1 is the button
Seat 1: JunioRAng ($4.35 in chips) 
Seat 2: rifa700 ($1.65 in chips) 
Seat 3: Smikuli ($1.47 in chips) 
Seat 4: Phil Ounce ($3.14 in chips) 
Seat 5: skystaruk ($4.81 in chips) 
Seat 6: hc agorist ($3.37 in chips) 
rifa700: posts small blind $0.01
Smikuli: posts big blind $0.02
*** HOLE CARDS ***
Dealt to hc agorist [Td Jc]
Phil Ounce: folds 
skystaruk: folds 
hc agorist: raises $0.02 to $0.04
JunioRAng: folds 
rifa700: folds 
Smikuli: calls $0.02
*** FLOP *** [9h 7s Ah]
Smikuli: bets $0.05
hc agorist: calls $0.05
*** TURN *** [9h 7s Ah] [Kc]
Smikuli: bets $0.09
hc agorist: calls $0.09
*** RIVER *** [9h 7s Ah Kc] [5c]
Smikuli: bets $0.26
hc agorist: folds 
Uncalled bet ($0.26) returned to Smikuli
Smikuli collected $0.36 from pot
Smikuli: doesn't show hand 
*** SUMMARY ***
Total pot $0.37 | Rake $0.01 
Board [9h 7s Ah Kc 5c]
Seat 1: JunioRAng (button) folded before Flop (didn't bet)
Seat 2: rifa700 (small blind) folded before Flop
Seat 3: Smikuli (big blind) collected ($0.36)
Seat 4: Phil Ounce folded before Flop (didn't bet)
Seat 5: skystaruk folded before Flop (didn't bet)
Seat 6: hc agorist folded on the River



PokerStars Zoom Hand #193805670323:  Hold'em No Limit ($0.01/$0.02) - 2018/11/28 1:08:01 CUST [2018/11/27 12:08:01 ET]
Table 'Halley' 6-max Seat #1 is the button
Seat 1: hc agorist ($3.19 in chips) 
Seat 2: maklaund ($1.42 in chips) 
Seat 3: Phil Ounce ($3.13 in chips) 
Seat 4: Conan0024 ($3.19 in chips) 
Seat 5: VSH1973 ($1.08 in chips) 
Seat 6: diddldoc ($2.29 in chips) 
maklaund: posts small blind $0.01
Phil Ounce: posts big blind $0.02
*** HOLE CARDS ***
Dealt to hc agorist [8s 8h]
Conan0024: folds 
VSH1973: folds 
diddldoc: raises $0.02 to $0.04
hc agorist: raises $0.11 to $0.15
maklaund: folds 
Phil Ounce: raises $0.25 to $0.40
diddldoc: folds 
hc agorist: folds 
Uncalled bet ($0.25) returned to Phil Ounce
Phil Ounce collected $0.35 from pot
Phil Ounce: doesn't show hand 
*** SUMMARY ***
Total pot $0.35 | Rake $0 
Seat 1: hc agorist (button) folded before Flop
Seat 2: maklaund (small blind) folded before Flop
Seat 3: Phil Ounce (big blind) collected ($0.35)
Seat 4: Conan0024 folded before Flop (didn't bet)
Seat 5: VSH1973 folded before Flop (didn't bet)
Seat 6: diddldoc folded before Flop



PokerStars Zoom Hand #193805690016:  Hold'em No Limit ($0.01/$0.02) - 2018/11/28 1:08:35 CUST [2018/11/27 12:08:35 ET]
Table 'Halley' 6-max Seat #1 is the button
Seat 1: lizardcmm ($2 in chips) 
Seat 2: svetogor1991 ($2.90 in chips) 
Seat 3: hc agorist ($3.04 in chips) 
Seat 4: Dialektik330 ($1.73 in chips) 
Seat 5: BAH9l ($2.35 in chips) 
Seat 6: g0suboy ($3.04 in chips) 
svetogor1991: posts small blind $0.01
hc agorist: posts big blind $0.02
*** HOLE CARDS ***
Dealt to hc agorist [5c 6s]
Dialektik330: folds 
BAH9l: folds 
g0suboy: folds 
lizardcmm: folds 
svetogor1991: raises $0.04 to $0.06
hc agorist: folds 
Uncalled bet ($0.04) returned to svetogor1991
svetogor1991 collected $0.04 from pot
svetogor1991: doesn't show hand 
*** SUMMARY ***
Total pot $0.04 | Rake $0 
Seat 1: lizardcmm (button) folded before Flop (didn't bet)
Seat 2: svetogor1991 (small blind) collected ($0.04)
Seat 3: hc agorist (big blind) folded before Flop
Seat 4: Dialektik330 folded before Flop (didn't bet)
Seat 5: BAH9l folded before Flop (didn't bet)
Seat 6: g0suboy folded before Flop (didn't bet)



PokerStars Zoom Hand #193805696864:  Hold'em No Limit ($0.01/$0.02) - 2018/11/28 1:08:47 CUST [2018/11/27 12:08:47 ET]
Table 'Halley' 6-max Seat #1 is the button
Seat 1: seluytin ($1.97 in chips) 
Seat 2: zeus11983 ($2.14 in chips) 
Seat 3: evgenvader ($3.09 in chips) 
Seat 4: hc agorist ($3.02 in chips) 
Seat 5: rifa700 ($1.64 in chips) 
Seat 6: torrflugan77 ($2 in chips) 
zeus11983: posts small blind $0.01
evgenvader: posts big blind $0.02
*** HOLE CARDS ***
Dealt to hc agorist [5c Js]
hc agorist: folds 
rifa700: folds 
torrflugan77: folds 
seluytin: folds 
zeus11983: folds 
Uncalled bet ($0.01) returned to evgenvader
evgenvader collected $0.02 from pot
evgenvader: doesn't show hand 
*** SUMMARY ***
Total pot $0.02 | Rake $0 
Seat 1: seluytin (button) folded before Flop (didn't bet)
Seat 2: zeus11983 (small blind) folded before Flop
Seat 3: evgenvader (big blind) collected ($0.02)
Seat 4: hc agorist folded before Flop (didn't bet)
Seat 5: rifa700 folded before Flop (didn't bet)
Seat 6: torrflugan77 folded before Flop (didn't bet)



PokerStars Zoom Hand #193805700345:  Hold'em No Limit ($0.01/$0.02) - 2018/11/28 1:08:53 CUST [2018/11/27 12:08:53 ET]
Table 'Halley' 6-max Seat #1 is the button
Seat 1: nikonova88 ($6.61 in chips) 
Seat 2: hc agorist ($3.02 in chips) 
Seat 3: YaVamNeVeriu ($2.43 in chips) 
Seat 4: goldplay ($5.51 in chips) 
Seat 5: Kokosya ($2.63 in chips) 
Seat 6: XMrMojoRisinX ($2.10 in chips) 
hc agorist: posts small blind $0.01
YaVamNeVeriu: posts big blind $0.02
*** HOLE CARDS ***
Dealt to hc agorist [7h 5s]
goldplay: folds 
Kokosya: folds 
XMrMojoRisinX: folds 
nikonova88: folds 
hc agorist: folds 
Uncalled bet ($0.01) returned to YaVamNeVeriu
YaVamNeVeriu collected $0.02 from pot
YaVamNeVeriu: doesn't show hand 
*** SUMMARY ***
Total pot $0.02 | Rake $0 
Seat 1: nikonova88 (button) folded before Flop (didn't bet)
Seat 2: hc agorist (small blind) folded before Flop
Seat 3: YaVamNeVeriu (big blind) collected ($0.02)
Seat 4: goldplay folded before Flop (didn't bet)
Seat 5: Kokosya folded before Flop (didn't bet)
Seat 6: XMrMojoRisinX folded before Flop (didn't bet)



PokerStars Zoom Hand #193805706230:  Hold'em No Limit ($0.01/$0.02) - 2018/11/28 1:09:03 CUST [2018/11/27 12:09:03 ET]
Table 'Halley' 6-max Seat #1 is the button
Seat 1: phenix140 ($3.67 in chips) 
Seat 2: TheN@kedGun ($2.62 in chips) 
Seat 3: mimiflyy ($9.90 in chips) 
Seat 4: 06romm22 ($2.63 in chips) 
Seat 5: hc agorist ($3.01 in chips) 
Seat 6: Banker Deniz ($2.90 in chips) 
TheN@kedGun: posts small blind $0.01
mimiflyy: posts big blind $0.02
*** HOLE CARDS ***
Dealt to hc agorist [Ad 9d]
06romm22: folds 
hc agorist: raises $0.02 to $0.04
Banker Deniz: folds 
phenix140: folds 
TheN@kedGun: folds 
mimiflyy: calls $0.02
*** FLOP *** [8d 7d Kh]
mimiflyy: checks 
hc agorist: bets $0.08
mimiflyy: calls $0.08
*** TURN *** [8d 7d Kh] [3h]
mimiflyy: checks 
hc agorist: bets $0.18
mimiflyy: calls $0.18
*** RIVER *** [8d 7d Kh 3h] [Tc]
mimiflyy: checks 
hc agorist: checks 
*** SHOW DOWN ***
mimiflyy: shows [6c Kc] (a pair of Kings)
hc agorist: mucks hand 
mimiflyy collected $0.59 from pot
*** SUMMARY ***
Total pot $0.61 | Rake $0.02 
Board [8d 7d Kh 3h Tc]
Seat 1: phenix140 (button) folded before Flop (didn't bet)
Seat 2: TheN@kedGun (small blind) folded before Flop
Seat 3: mimiflyy (big blind) showed [6c Kc] and won ($0.59) with a pair of Kings
Seat 4: 06romm22 folded before Flop (didn't bet)
Seat 5: hc agorist mucked [Ad 9d]
Seat 6: Banker Deniz folded before Flop (didn't bet)



PokerStars Zoom Hand #193805732168:  Hold'em No Limit ($0.01/$0.02) - 2018/11/28 1:09:48 CUST [2018/11/27 12:09:48 ET]
Table 'Halley' 6-max Seat #1 is the button
Seat 1: 3Iver's3 ($2 in chips) 
Seat 2: Lawrence$lim ($2 in chips) 
Seat 3: hc agorist ($2.71 in chips) 
Seat 4: chima36 ($1.85 in chips) 
Seat 5: Pelorojo1 ($2.30 in chips) 
Seat 6: Miami27887 ($3.38 in chips) 
Lawrence$lim: posts small blind $0.01
hc agorist: posts big blind $0.02
*** HOLE CARDS ***
Dealt to hc agorist [Qc 9h]
chima36: folds 
Pelorojo1: folds 
Miami27887: folds 
3Iver's3: folds 
Lawrence$lim: folds 
Uncalled bet ($0.01) returned to hc agorist
hc agorist collected $0.02 from pot
hc agorist: doesn't show hand 
*** SUMMARY ***
Total pot $0.02 | Rake $0 
Seat 1: 3Iver's3 (button) folded before Flop (didn't bet)
Seat 2: Lawrence$lim (small blind) folded before Flop
Seat 3: hc agorist (big blind) collected ($0.02)
Seat 4: chima36 folded before Flop (didn't bet)
Seat 5: Pelorojo1 folded before Flop (didn't bet)
Seat 6: Miami27887 folded before Flop (didn't bet)



PokerStars Zoom Hand #193805737957:  Hold'em No Limit ($0.01/$0.02) - 2018/11/28 1:09:58 CUST [2018/11/27 12:09:58 ET]
Table 'Halley' 6-max Seat #1 is the button
Seat 1: hc agorist ($2.72 in chips) 
Seat 2: Shamaxxx ($3.36 in chips) 
Seat 3: anasanto ($2.98 in chips) 
Seat 4: Bearpls ($3.35 in chips) 
Seat 5: Rockabill408 ($2.02 in chips) 
Seat 6: technofaust ($1.83 in chips) 
Shamaxxx: posts small blind $0.01
anasanto: posts big blind $0.02
*** HOLE CARDS ***
Dealt to hc agorist [Qc Qh]
Bearpls: folds 
Rockabill408: folds 
technofaust: raises $0.04 to $0.06
hc agorist: raises $0.15 to $0.21
Shamaxxx: folds 
anasanto: folds 
technofaust: folds 
Uncalled bet ($0.15) returned to hc agorist
hc agorist collected $0.15 from pot
hc agorist: doesn't show hand 
*** SUMMARY ***
Total pot $0.15 | Rake $0 
Seat 1: hc agorist (button) collected ($0.15)
Seat 2: Shamaxxx (small blind) folded before Flop
Seat 3: anasanto (big blind) folded before Flop
Seat 4: Bearpls folded before Flop (didn't bet)
Seat 5: Rockabill408 folded before Flop (didn't bet)
Seat 6: technofaust folded before Flop



PokerStars Zoom Hand #193805728736:  Hold'em No Limit ($0.01/$0.02) - 2018/11/28 1:09:42 CUST [2018/11/27 12:09:42 ET]
Table 'Halley' 6-max Seat #1 is the button
Seat 1: soldim327 ($2.01 in chips) 
Seat 2: Giggio3301 ($5.17 in chips) 
Seat 3: lennyfalk ($2.06 in chips) 
Seat 4: hc agorist ($2.71 in chips) 
Seat 5: HeyItsM3 ($3.65 in chips) 
Seat 6: logoswort ($5.54 in chips) 
Giggio3301: posts small blind $0.01
lennyfalk: posts big blind $0.02
*** HOLE CARDS ***
Dealt to hc agorist [6s Jh]
hc agorist: folds 
HeyItsM3: folds 
logoswort: raises $0.04 to $0.06
soldim327: raises $0.12 to $0.18
Giggio3301: folds 
lennyfalk: folds 
logoswort: folds 
Uncalled bet ($0.12) returned to soldim327
soldim327 collected $0.15 from pot
soldim327: doesn't show hand 
*** SUMMARY ***
Total pot $0.15 | Rake $0 
Seat 1: soldim327 (button) collected ($0.15)
Seat 2: Giggio3301 (small blind) folded before Flop
Seat 3: lennyfalk (big blind) folded before Flop
Seat 4: hc agorist folded before Flop (didn't bet)
Seat 5: HeyItsM3 folded before Flop (didn't bet)
Seat 6: logoswort folded before Flop



PokerStars Zoom Hand #193805746713:  Hold'em No Limit ($0.01/$0.02) - 2018/11/28 1:10:13 CUST [2018/11/27 12:10:13 ET]
Table 'Halley' 6-max Seat #1 is the button
Seat 1: ForHistory ($2 in chips) 
Seat 2: MYlviste ($4.17 in chips) 
Seat 3: skendroshen ($7.61 in chips) 
Seat 4: hc agorist ($2.81 in chips) 
Seat 5: SiLenUni_Zak ($3.05 in chips) 
Seat 6: BuffmonsterOne ($2.72 in chips) 
MYlviste: posts small blind $0.01
skendroshen: posts big blind $0.02
*** HOLE CARDS ***
Dealt to hc agorist [9s 8h]
hc agorist: folds 
SiLenUni_Zak: folds 
BuffmonsterOne: folds 
ForHistory: folds 
MYlviste: folds 
Uncalled bet ($0.01) returned to skendroshen
skendroshen collected $0.02 from pot
skendroshen: doesn't show hand 
*** SUMMARY ***
Total pot $0.02 | Rake $0 
Seat 1: ForHistory (button) folded before Flop (didn't bet)
Seat 2: MYlviste (small blind) folded before Flop
Seat 3: skendroshen (big blind) collected ($0.02)
Seat 4: hc agorist folded before Flop (didn't bet)
Seat 5: SiLenUni_Zak folded before Flop (didn't bet)
Seat 6: BuffmonsterOne folded before Flop (didn't bet)



PokerStars Zoom Hand #193805759308:  Hold'em No Limit ($0.01/$0.02) - 2018/11/28 1:10:35 CUST [2018/11/27 12:10:35 ET]
Table 'Halley' 6-max Seat #1 is the button
Seat 1: torrflugan77 ($2 in chips) 
Seat 2: macmac399 ($2.01 in chips) 
Seat 3: firebrigadenor ($2.62 in chips) 
Seat 4: bigfreddo86 ($4.17 in chips) 
Seat 5: hc agorist ($2.80 in chips) 
Seat 6: amaposh ($2.10 in chips) 
macmac399: posts small blind $0.01
firebrigadenor: posts big blind $0.02
*** HOLE CARDS ***
Dealt to hc agorist [7s 2c]
bigfreddo86: folds 
hc agorist: folds 
amaposh: folds 
torrflugan77: folds 
macmac399: folds 
Uncalled bet ($0.01) returned to firebrigadenor
firebrigadenor collected $0.02 from pot
firebrigadenor: doesn't show hand 
*** SUMMARY ***
Total pot $0.02 | Rake $0 
Seat 1: torrflugan77 (button) folded before Flop (didn't bet)
Seat 2: macmac399 (small blind) folded before Flop
Seat 3: firebrigadenor (big blind) collected ($0.02)
Seat 4: bigfreddo86 folded before Flop (didn't bet)
Seat 5: hc agorist folded before Flop (didn't bet)
Seat 6: amaposh folded before Flop (didn't bet)



PokerStars Zoom Hand #193805749560:  Hold'em No Limit ($0.01/$0.02) - 2018/11/28 1:10:18 CUST [2018/11/27 12:10:18 ET]
Table 'Halley' 6-max Seat #1 is the button
Seat 1: Tmalikis1 ($7.89 in chips) 
Seat 2: dheganaaa ($1.27 in chips) 
Seat 3: marta328 ($2.03 in chips) 
Seat 4: Danadel ($2.04 in chips) 
Seat 5: pengy1987 ($5.53 in chips) 
Seat 6: hc agorist ($2.81 in chips) 
dheganaaa: posts small blind $0.01
marta328: posts big blind $0.02
*** HOLE CARDS ***
Dealt to hc agorist [Js 9c]
Danadel: raises $0.02 to $0.04
pengy1987: folds 
hc agorist: folds 
Tmalikis1: folds 
dheganaaa: calls $0.03
marta328: calls $0.02
*** FLOP *** [3s 3h 9d]
dheganaaa: bets $0.06
marta328: folds 
Danadel: calls $0.06
*** TURN *** [3s 3h 9d] [As]
dheganaaa: bets $0.12
Danadel: calls $0.12
*** RIVER *** [3s 3h 9d As] [2d]
dheganaaa: bets $0.46
Danadel: calls $0.46
*** SHOW DOWN ***
dheganaaa: shows [8h Jc] (a pair of Threes)
Danadel: shows [Ah Jh] (two pair, Aces and Threes)
Danadel collected $1.35 from pot
*** SUMMARY ***
Total pot $1.40 | Rake $0.05 
Board [3s 3h 9d As 2d]
Seat 1: Tmalikis1 (button) folded before Flop (didn't bet)
Seat 2: dheganaaa (small blind) showed [8h Jc] and lost with a pair of Threes
Seat 3: marta328 (big blind) folded on the Flop
Seat 4: Danadel showed [Ah Jh] and won ($1.35) with two pair, Aces and Threes
Seat 5: pengy1987 folded before Flop (didn't bet)
Seat 6: hc agorist folded before Flop (didn't bet)



PokerStars Zoom Hand #193805772177:  Hold'em No Limit ($0.01/$0.02) - 2018/11/28 1:10:57 CUST [2018/11/27 12:10:57 ET]
Table 'Halley' 6-max Seat #1 is the button
Seat 1: VetrvMaks ($0.87 in chips) 
Seat 2: hc agorist ($2.78 in chips) 
Seat 3: Sovlex555 ($2.93 in chips) 
Seat 4: AVyiO ($9.58 in chips) 
Seat 5: Pedrosophiaa ($2.22 in chips) 
Seat 6: sergiy6304 ($1.65 in chips) 
hc agorist: posts small blind $0.01
Sovlex555: posts big blind $0.02
*** HOLE CARDS ***
Dealt to hc agorist [9c 8d]
AVyiO: folds 
Pedrosophiaa: folds 
sergiy6304: folds 
VetrvMaks: folds 
hc agorist: folds 
Uncalled bet ($0.01) returned to Sovlex555
Sovlex555 collected $0.02 from pot
Sovlex555: doesn't show hand 
*** SUMMARY ***
Total pot $0.02 | Rake $0 
Seat 1: VetrvMaks (button) folded before Flop (didn't bet)
Seat 2: hc agorist (small blind) folded before Flop
Seat 3: Sovlex555 (big blind) collected ($0.02)
Seat 4: AVyiO folded before Flop (didn't bet)
Seat 5: Pedrosophiaa folded before Flop (didn't bet)
Seat 6: sergiy6304 folded before Flop (didn't bet)



PokerStars Zoom Hand #193805775069:  Hold'em No Limit ($0.01/$0.02) - 2018/11/28 1:11:02 CUST [2018/11/27 12:11:02 ET]
Table 'Halley' 6-max Seat #1 is the button
Seat 1: hc agorist ($2.77 in chips) 
Seat 2: P.Cogito ($2 in chips) 
Seat 3: avirik1 ($2.14 in chips) 
Seat 4: WinziF ($2.16 in chips) 
Seat 5: goldenshirt ($1.35 in chips) 
Seat 6: SiLenUni_Zak ($2.29 in chips) 
P.Cogito: posts small blind $0.01
avirik1: posts big blind $0.02
*** HOLE CARDS ***
Dealt to hc agorist [2c 6h]
WinziF: folds 
goldenshirt: folds 
SiLenUni_Zak: folds 
hc agorist: folds 
P.Cogito: folds 
Uncalled bet ($0.01) returned to avirik1
avirik1 collected $0.02 from pot
avirik1: doesn't show hand 
*** SUMMARY ***
Total pot $0.02 | Rake $0 
Seat 1: hc agorist (button) folded before Flop (didn't bet)
Seat 2: P.Cogito (small blind) folded before Flop
Seat 3: avirik1 (big blind) collected ($0.02)
Seat 4: WinziF folded before Flop (didn't bet)
Seat 5: goldenshirt folded before Flop (didn't bet)
Seat 6: SiLenUni_Zak folded before Flop (didn't bet)



PokerStars Zoom Hand #193805762159:  Hold'em No Limit ($0.01/$0.02) - 2018/11/28 1:10:40 CUST [2018/11/27 12:10:40 ET]
Table 'Halley' 6-max Seat #1 is the button
Seat 1: BoJlaHgeMopT ($2.03 in chips) 
Seat 2: Honorable_17 ($3.31 in chips) 
Seat 3: hc agorist ($2.80 in chips) 
Seat 4: Dr_RafaelMF ($2.21 in chips) 
Seat 5: PPYPP ($2.04 in chips) 
Seat 6: VSH1973 ($1.14 in chips) 
Honorable_17: posts small blind $0.01
hc agorist: posts big blind $0.02
*** HOLE CARDS ***
Dealt to hc agorist [9s 4h]
Dr_RafaelMF: folds 
PPYPP: folds 
VSH1973: calls $0.02
BoJlaHgeMopT: folds 
Honorable_17: raises $0.07 to $0.09
hc agorist: folds 
VSH1973: calls $0.07
*** FLOP *** [Ad 6d 5d]
Honorable_17: bets $0.09
VSH1973: calls $0.09
*** TURN *** [Ad 6d 5d] [2s]
Honorable_17: checks 
VSH1973: bets $0.04
Honorable_17: folds 
Uncalled bet ($0.04) returned to VSH1973
VSH1973 collected $0.37 from pot
VSH1973: doesn't show hand 
*** SUMMARY ***
Total pot $0.38 | Rake $0.01 
Board [Ad 6d 5d 2s]
Seat 1: BoJlaHgeMopT (button) folded before Flop (didn't bet)
Seat 2: Honorable_17 (small blind) folded on the Turn
Seat 3: hc agorist (big blind) folded before Flop
Seat 4: Dr_RafaelMF folded before Flop (didn't bet)
Seat 5: PPYPP folded before Flop (didn't bet)
Seat 6: VSH1973 collected ($0.37)



PokerStars Zoom Hand #193805755892:  Hold'em No Limit ($0.01/$0.02) - 2018/11/28 1:10:29 CUST [2018/11/27 12:10:29 ET]
Table 'Halley' 6-max Seat #1 is the button
Seat 1: Maximus122 ($5.60 in chips) 
Seat 2: hc agorist ($2.81 in chips) 
Seat 3: Hernan-pca ($1.87 in chips) 
Seat 4: JuniorVLZ ($2.25 in chips) 
Seat 5: vovan100157 ($3.31 in chips) 
Seat 6: JBD101 ($2.08 in chips) 
hc agorist: posts small blind $0.01
Hernan-pca: posts big blind $0.02
*** HOLE CARDS ***
Dealt to hc agorist [2s Th]
JuniorVLZ: folds 
vovan100157: folds 
JBD101: folds 
Maximus122: raises $0.02 to $0.04
hc agorist: folds 
Hernan-pca: calls $0.02
*** FLOP *** [8s 7s 9s]
Hernan-pca: checks 
Maximus122: bets $0.03
Hernan-pca: calls $0.03
*** TURN *** [8s 7s 9s] [4h]
Hernan-pca: checks 
Maximus122: bets $0.18
Hernan-pca: folds 
Uncalled bet ($0.18) returned to Maximus122
Maximus122 collected $0.14 from pot
Maximus122: doesn't show hand 
*** SUMMARY ***
Total pot $0.15 | Rake $0.01 
Board [8s 7s 9s 4h]
Seat 1: Maximus122 (button) collected ($0.14)
Seat 2: hc agorist (small blind) folded before Flop
Seat 3: Hernan-pca (big blind) folded on the Turn
Seat 4: JuniorVLZ folded before Flop (didn't bet)
Seat 5: vovan100157 folded before Flop (didn't bet)
Seat 6: JBD101 folded before Flop (didn't bet)



PokerStars Zoom Hand #193805777377:  Hold'em No Limit ($0.01/$0.02) - 2018/11/28 1:11:06 CUST [2018/11/27 12:11:06 ET]
Table 'Halley' 6-max Seat #1 is the button
Seat 1: abatur0 ($0.91 in chips) 
Seat 2: gosha - pank ($0.74 in chips) 
Seat 3: Royal81984 ($3.12 in chips) 
Seat 4: hc agorist ($2.77 in chips) 
Seat 5: Lvlvsfrvr ($0.80 in chips) 
Seat 6: aleks118 ($3.76 in chips) 
gosha - pank: posts small blind $0.01
Royal81984: posts big blind $0.02
*** HOLE CARDS ***
Dealt to hc agorist [7c 7d]
hc agorist: raises $0.02 to $0.04
Lvlvsfrvr: raises $0.11 to $0.15
aleks118: calls $0.15
abatur0: folds 
gosha - pank: calls $0.14
Royal81984: calls $0.13
hc agorist: calls $0.11
*** FLOP *** [Js 3h Jh]
gosha - pank: checks 
Royal81984: checks 
hc agorist: checks 
Lvlvsfrvr: bets $0.65 and is all-in
aleks118: folds 
gosha - pank: folds 
Royal81984: folds 
hc agorist: calls $0.65
*** TURN *** [Js 3h Jh] [Jc]
*** RIVER *** [Js 3h Jh Jc] [9h]
*** SHOW DOWN ***
hc agorist: shows [7c 7d] (a full house, Jacks full of Sevens)
Lvlvsfrvr: shows [Kh Ah] (a flush, Ace high)
hc agorist collected $1.98 from pot
*** SUMMARY ***
Total pot $2.05 | Rake $0.07 
Board [Js 3h Jh Jc 9h]
Seat 1: abatur0 (button) folded before Flop (didn't bet)
Seat 2: gosha - pank (small blind) folded on the Flop
Seat 3: Royal81984 (big blind) folded on the Flop
Seat 4: hc agorist showed [7c 7d] and won ($1.98) with a full house, Jacks full of Sevens
Seat 5: Lvlvsfrvr showed [Kh Ah] and lost with a flush, Ace high
Seat 6: aleks118 folded on the Flop



PokerStars Zoom Hand #193805802495:  Hold'em No Limit ($0.01/$0.02) - 2018/11/28 1:11:49 CUST [2018/11/27 12:11:49 ET]
Table 'Halley' 6-max Seat #1 is the button
Seat 1: rigel_poker ($2 in chips) 
Seat 2: Tuxui y)l(ac ($4.97 in chips) 
Seat 3: Brentyyy ($2 in chips) 
Seat 4: AVyiO ($9.55 in chips) 
Seat 5: eunsun04922 ($1.76 in chips) 
Seat 6: hc agorist ($3.95 in chips) 
Tuxui y)l(ac: posts small blind $0.01
Brentyyy: posts big blind $0.02
*** HOLE CARDS ***
Dealt to hc agorist [Qs Jh]
AVyiO: raises $0.04 to $0.06
eunsun04922: folds 
hc agorist: folds 
rigel_poker: folds 
Tuxui y)l(ac: folds 
Brentyyy: folds 
Uncalled bet ($0.04) returned to AVyiO
AVyiO collected $0.05 from pot
AVyiO: doesn't show hand 
*** SUMMARY ***
Total pot $0.05 | Rake $0 
Seat 1: rigel_poker (button) folded before Flop (didn't bet)
Seat 2: Tuxui y)l(ac (small blind) folded before Flop
Seat 3: Brentyyy (big blind) folded before Flop
Seat 4: AVyiO collected ($0.05)
Seat 5: eunsun04922 folded before Flop (didn't bet)
Seat 6: hc agorist folded before Flop (didn't bet)



PokerStars Zoom Hand #193805810620:  Hold'em No Limit ($0.01/$0.02) - 2018/11/28 1:12:03 CUST [2018/11/27 12:12:03 ET]
Table 'Halley' 6-max Seat #1 is the button
Seat 1: Brentyyy ($2 in chips) 
Seat 2: Nemlair ($2 in chips) 
Seat 3: GRizlik14 ($2.15 in chips) 
Seat 4: ksand595 ($3.30 in chips) 
Seat 5: hc agorist ($3.95 in chips) 
Seat 6: flex03041978 ($0.98 in chips) 
Nemlair: posts small blind $0.01
GRizlik14: posts big blind $0.02
*** HOLE CARDS ***
Dealt to hc agorist [Ah 2c]
ksand595: raises $0.04 to $0.06
hc agorist: folds 
flex03041978: folds 
Brentyyy: calls $0.06
Nemlair: folds 
GRizlik14: calls $0.04
*** FLOP *** [2h As Jc]
GRizlik14: checks 
ksand595: checks 
Brentyyy: checks 
*** TURN *** [2h As Jc] [6d]
GRizlik14: checks 
ksand595: checks 
Brentyyy: checks 
*** RIVER *** [2h As Jc 6d] [7s]
GRizlik14: checks 
ksand595: checks 
Brentyyy: checks 
*** SHOW DOWN ***
GRizlik14: shows [Ks Jh] (a pair of Jacks)
ksand595: mucks hand 
Brentyyy: mucks hand 
GRizlik14 collected $0.18 from pot
*** SUMMARY ***
Total pot $0.19 | Rake $0.01 
Board [2h As Jc 6d 7s]
Seat 1: Brentyyy (button) mucked [Th Tc]
Seat 2: Nemlair (small blind) folded before Flop
Seat 3: GRizlik14 (big blind) showed [Ks Jh] and won ($0.18) with a pair of Jacks
Seat 4: ksand595 mucked [Td 9d]
Seat 5: hc agorist folded before Flop (didn't bet)
Seat 6: flex03041978 folded before Flop (didn't bet)



PokerStars Zoom Hand #193805836400:  Hold'em No Limit ($0.01/$0.02) - 2018/11/28 1:12:47 CUST [2018/11/27 12:12:47 ET]
Table 'Halley' 6-max Seat #1 is the button
Seat 1: a.leuphana ($3.82 in chips) 
Seat 2: Leksaha ($2.16 in chips) 
Seat 3: Kala77 ($3.77 in chips) 
Seat 4: hc agorist ($3.89 in chips) 
Seat 5: Kiizu ($2.34 in chips) 
Seat 6: DBFlux ($1.93 in chips) 
Leksaha: posts small blind $0.01
Kala77: posts big blind $0.02
*** HOLE CARDS ***
Dealt to hc agorist [9c 9d]
hc agorist: raises $0.04 to $0.06
Kiizu: folds 
DBFlux: folds 
a.leuphana: calls $0.06
Leksaha: folds 
Kala77: folds 
*** FLOP *** [4h Js 9s]
hc agorist: bets $0.12
a.leuphana: folds 
Uncalled bet ($0.12) returned to hc agorist
hc agorist collected $0.14 from pot
hc agorist: doesn't show hand 
*** SUMMARY ***
Total pot $0.15 | Rake $0.01 
Board [4h Js 9s]
Seat 1: a.leuphana (button) folded on the Flop
Seat 2: Leksaha (small blind) folded before Flop
Seat 3: Kala77 (big blind) folded before Flop
Seat 4: hc agorist collected ($0.14)
Seat 5: Kiizu folded before Flop (didn't bet)
Seat 6: DBFlux folded before Flop (didn't bet)



PokerStars Zoom Hand #193805814778:  Hold'em No Limit ($0.01/$0.02) - 2018/11/28 1:12:10 CUST [2018/11/27 12:12:10 ET]
Table 'Halley' 6-max Seat #1 is the button
Seat 1: jaasso86 ($5.29 in chips) 
Seat 2: madrihcosher ($3.05 in chips) 
Seat 3: hc agorist ($3.95 in chips) 
Seat 4: Outsmoking ($2.08 in chips) 
Seat 5: zeus11983 ($2.12 in chips) 
Seat 6: Destruct1on7 ($2 in chips) 
madrihcosher: posts small blind $0.01
hc agorist: posts big blind $0.02
*** HOLE CARDS ***
Dealt to hc agorist [6h 6c]
Outsmoking: raises $0.04 to $0.06
zeus11983: folds 
Destruct1on7: folds 
jaasso86: calls $0.06
madrihcosher: calls $0.05
hc agorist: calls $0.04
*** FLOP *** [Th Qh 5h]
madrihcosher: checks 
hc agorist: checks 
Outsmoking: bets $0.14
jaasso86: folds 
madrihcosher: calls $0.14
hc agorist: folds 
*** TURN *** [Th Qh 5h] [3c]
madrihcosher: bets $0.26
Outsmoking: calls $0.26
*** RIVER *** [Th Qh 5h 3c] [2h]
madrihcosher: bets $0.80
Outsmoking: folds 
Uncalled bet ($0.80) returned to madrihcosher
madrihcosher collected $1 from pot
madrihcosher: doesn't show hand 
*** SUMMARY ***
Total pot $1.04 | Rake $0.04 
Board [Th Qh 5h 3c 2h]
Seat 1: jaasso86 (button) folded on the Flop
Seat 2: madrihcosher (small blind) collected ($1)
Seat 3: hc agorist (big blind) folded on the Flop
Seat 4: Outsmoking folded on the River
Seat 5: zeus11983 folded before Flop (didn't bet)
Seat 6: Destruct1on7 folded before Flop (didn't bet)



PokerStars Zoom Hand #193805852161:  Hold'em No Limit ($0.01/$0.02) - 2018/11/28 1:13:14 CUST [2018/11/27 12:13:14 ET]
Table 'Halley' 6-max Seat #1 is the button
Seat 1: hc agorist ($3.97 in chips) 
Seat 2: amaposh ($2.29 in chips) 
Seat 3: Fairess ($2.02 in chips) 
Seat 4: yoba_patr ($3.63 in chips) 
Seat 5: Gil`gamesh71 ($2.16 in chips) 
Seat 6: urpyJL989 ($2.08 in chips) 
amaposh: posts small blind $0.01
Fairess: posts big blind $0.02
*** HOLE CARDS ***
Dealt to hc agorist [Jd 8c]
yoba_patr: folds 
Gil`gamesh71: folds 
urpyJL989: raises $0.04 to $0.06
hc agorist: folds 
amaposh: folds 
Fairess: calls $0.04
*** FLOP *** [8s Td Js]
Fairess: checks 
urpyJL989: bets $0.08
Fairess: calls $0.08
*** TURN *** [8s Td Js] [Jc]
Fairess: checks 
urpyJL989: bets $0.18
Fairess: calls $0.18
*** RIVER *** [8s Td Js Jc] [7s]
Fairess: checks 
urpyJL989: bets $0.40
Fairess: folds 
Uncalled bet ($0.40) returned to urpyJL989
urpyJL989 collected $0.63 from pot
urpyJL989: doesn't show hand 
*** SUMMARY ***
Total pot $0.65 | Rake $0.02 
Board [8s Td Js Jc 7s]
Seat 1: hc agorist (button) folded before Flop (didn't bet)
Seat 2: amaposh (small blind) folded before Flop
Seat 3: Fairess (big blind) folded on the River
Seat 4: yoba_patr folded before Flop (didn't bet)
Seat 5: Gil`gamesh71 folded before Flop (didn't bet)
Seat 6: urpyJL989 collected ($0.63)



PokerStars Zoom Hand #193805857449:  Hold'em No Limit ($0.01/$0.02) - 2018/11/28 1:13:23 CUST [2018/11/27 12:13:23 ET]
Table 'Halley' 6-max Seat #1 is the button
Seat 1: viktor49ru ($4.57 in chips) 
Seat 2: hc agorist ($3.97 in chips) 
Seat 3: xompistas000 ($5.03 in chips) 
Seat 4: kerasin885 ($2 in chips) 
Seat 5: Skiv&Aahz ($1.99 in chips) 
Seat 6: Kingprof ($1.50 in chips) 
hc agorist: posts small blind $0.01
xompistas000: posts big blind $0.02
*** HOLE CARDS ***
Dealt to hc agorist [Jc Kd]
kerasin885: folds 
Skiv&Aahz: folds 
Kingprof: folds 
viktor49ru: folds 
hc agorist: raises $0.02 to $0.04
xompistas000: calls $0.02
*** FLOP *** [3d Qs 4d]
hc agorist: checks 
xompistas000: checks 
*** TURN *** [3d Qs 4d] [Tc]
hc agorist: bets $0.08
xompistas000: calls $0.08
*** RIVER *** [3d Qs 4d Tc] [9c]
hc agorist: bets $0.42
xompistas000: folds 
Uncalled bet ($0.42) returned to hc agorist
hc agorist collected $0.23 from pot
hc agorist: doesn't show hand 
*** SUMMARY ***
Total pot $0.24 | Rake $0.01 
Board [3d Qs 4d Tc 9c]
Seat 1: viktor49ru (button) folded before Flop (didn't bet)
Seat 2: hc agorist (small blind) collected ($0.23)
Seat 3: xompistas000 (big blind) folded on the River
Seat 4: kerasin885 folded before Flop (didn't bet)
Seat 5: Skiv&Aahz folded before Flop (didn't bet)
Seat 6: Kingprof folded before Flop (didn't bet)



PokerStars Zoom Hand #193805890392:  Hold'em No Limit ($0.01/$0.02) - 2018/11/28 1:14:19 CUST [2018/11/27 12:14:19 ET]
Table 'Halley' 6-max Seat #1 is the button
Seat 1: Enzonita ($2.02 in chips) 
Seat 2: Williwacker9 ($2 in chips) 
Seat 3: dntp ($3.93 in chips) 
Seat 4: rorygaughan53 ($1.99 in chips) 
Seat 5: jaaz241 ($1.12 in chips) 
Seat 6: hc agorist ($4.08 in chips) 
Williwacker9: posts small blind $0.01
dntp: posts big blind $0.02
*** HOLE CARDS ***
Dealt to hc agorist [Js 9c]
rorygaughan53: calls $0.02
jaaz241: raises $0.08 to $0.10
hc agorist: folds 
Enzonita: folds 
Williwacker9: folds 
dntp: folds 
rorygaughan53: calls $0.08
*** FLOP *** [Td 6d 9d]
rorygaughan53: bets $0.06
jaaz241: calls $0.06
*** TURN *** [Td 6d 9d] [7s]
rorygaughan53: bets $0.06
jaaz241: calls $0.06
*** RIVER *** [Td 6d 9d 7s] [3c]
rorygaughan53: checks 
jaaz241: bets $0.34
rorygaughan53: calls $0.34
*** SHOW DOWN ***
jaaz241: shows [Kh Qc] (high card King)
rorygaughan53: shows [6h Qs] (a pair of Sixes)
rorygaughan53 collected $1.11 from pot
*** SUMMARY ***
Total pot $1.15 | Rake $0.04 
Board [Td 6d 9d 7s 3c]
Seat 1: Enzonita (button) folded before Flop (didn't bet)
Seat 2: Williwacker9 (small blind) folded before Flop
Seat 3: dntp (big blind) folded before Flop
Seat 4: rorygaughan53 showed [6h Qs] and won ($1.11) with a pair of Sixes
Seat 5: jaaz241 showed [Kh Qc] and lost with high card King
Seat 6: hc agorist folded before Flop (didn't bet)



PokerStars Zoom Hand #193805896865:  Hold'em No Limit ($0.01/$0.02) - 2018/11/28 1:14:30 CUST [2018/11/27 12:14:30 ET]
Table 'Halley' 6-max Seat #1 is the button
Seat 1: PLATON82 ($0.98 in chips) 
Seat 2: rychu1906 ($2.55 in chips) 
Seat 3: hc agorist ($4.08 in chips) 
Seat 4: I7ACI7APTY ($3.24 in chips) 
Seat 5: Rimas98 ($1.99 in chips) 
Seat 6: Honochin ($1.72 in chips) 
rychu1906: posts small blind $0.01
hc agorist: posts big blind $0.02
*** HOLE CARDS ***
Dealt to hc agorist [Ad Kd]
I7ACI7APTY: folds 
Rimas98: folds 
Honochin: raises $0.03 to $0.05
PLATON82: calls $0.05
rychu1906: folds 
hc agorist: raises $0.16 to $0.21
Honochin: calls $0.16
PLATON82: calls $0.16
*** FLOP *** [6c 6s Ah]
hc agorist: checks 
Honochin: checks 
PLATON82: checks 
*** TURN *** [6c 6s Ah] [5s]
hc agorist: bets $0.36
Honochin: folds 
PLATON82: calls $0.36
*** RIVER *** [6c 6s Ah 5s] [8d]
hc agorist: bets $0.46
PLATON82: calls $0.41 and is all-in
Uncalled bet ($0.05) returned to hc agorist
*** SHOW DOWN ***
hc agorist: shows [Ad Kd] (two pair, Aces and Sixes)
PLATON82: shows [Ks Kc] (two pair, Kings and Sixes)
hc agorist collected $2.10 from pot
*** SUMMARY ***
Total pot $2.18 | Rake $0.08 
Board [6c 6s Ah 5s 8d]
Seat 1: PLATON82 (button) showed [Ks Kc] and lost with two pair, Kings and Sixes
Seat 2: rychu1906 (small blind) folded before Flop
Seat 3: hc agorist (big blind) showed [Ad Kd] and won ($2.10) with two pair, Aces and Sixes
Seat 4: I7ACI7APTY folded before Flop (didn't bet)
Seat 5: Rimas98 folded before Flop (didn't bet)
Seat 6: Honochin folded on the Turn



PokerStars Zoom Hand #193805939091:  Hold'em No Limit ($0.01/$0.02) - 2018/11/28 1:15:42 CUST [2018/11/27 12:15:42 ET]
Table 'Halley' 6-max Seat #1 is the button
Seat 1: Brentyyy ($2.21 in chips) 
Seat 2: yaroslav932 ($0.75 in chips) 
Seat 3: PRAHANSSS ($1.08 in chips) 
Seat 4: elpsycongr0 ($4.92 in chips) 
Seat 5: hc agorist ($5.20 in chips) 
Seat 6: don_energo2 ($3.82 in chips) 
yaroslav932: posts small blind $0.01
PRAHANSSS: posts big blind $0.02
*** HOLE CARDS ***
Dealt to hc agorist [7s 2c]
elpsycongr0: folds 
hc agorist: folds 
don_energo2: folds 
Brentyyy: raises $0.04 to $0.06
yaroslav932: folds 
PRAHANSSS: calls $0.04
*** FLOP *** [3d Js 4h]
PRAHANSSS: checks 
Brentyyy: bets $0.04
PRAHANSSS: folds 
Uncalled bet ($0.04) returned to Brentyyy
Brentyyy collected $0.13 from pot
Brentyyy: doesn't show hand 
*** SUMMARY ***
Total pot $0.13 | Rake $0 
Board [3d Js 4h]
Seat 1: Brentyyy (button) collected ($0.13)
Seat 2: yaroslav932 (small blind) folded before Flop
Seat 3: PRAHANSSS (big blind) folded on the Flop
Seat 4: elpsycongr0 folded before Flop (didn't bet)
Seat 5: hc agorist folded before Flop (didn't bet)
Seat 6: don_energo2 folded before Flop (didn't bet)



PokerStars Zoom Hand #193805942639:  Hold'em No Limit ($0.01/$0.02) - 2018/11/28 1:15:48 CUST [2018/11/27 12:15:48 ET]
Table 'Halley' 6-max Seat #1 is the button
Seat 1: hc agorist ($5.20 in chips) 
Seat 2: G.Datskov ($2.82 in chips) 
Seat 3: awestr ($1.18 in chips) 
Seat 4: x-sl-x86 ($2.19 in chips) 
Seat 5: John Pascow ($2.04 in chips) 
Seat 6: macmac399 ($2.03 in chips) 
G.Datskov: posts small blind $0.01
awestr: posts big blind $0.02
*** HOLE CARDS ***
Dealt to hc agorist [7d 6s]
x-sl-x86: folds 
John Pascow: folds 
macmac399: folds 
hc agorist: raises $0.02 to $0.04
G.Datskov: calls $0.03
awestr: calls $0.02
*** FLOP *** [5h 7h Td]
G.Datskov: checks 
awestr: checks 
hc agorist: bets $0.10
G.Datskov: folds 
awestr: folds 
Uncalled bet ($0.10) returned to hc agorist
hc agorist collected $0.12 from pot
hc agorist: doesn't show hand 
*** SUMMARY ***
Total pot $0.12 | Rake $0 
Board [5h 7h Td]
Seat 1: hc agorist (button) collected ($0.12)
Seat 2: G.Datskov (small blind) folded on the Flop
Seat 3: awestr (big blind) folded on the Flop
Seat 4: x-sl-x86 folded before Flop (didn't bet)
Seat 5: John Pascow folded before Flop (didn't bet)
Seat 6: macmac399 folded before Flop (didn't bet)



PokerStars Zoom Hand #193805973410:  Hold'em No Limit ($0.01/$0.02) - 2018/11/28 1:16:40 CUST [2018/11/27 12:16:40 ET]
Table 'Halley' 6-max Seat #1 is the button
Seat 1: Aegeides ($2.46 in chips) 
Seat 2: skystaruk ($5.13 in chips) 
Seat 3: Zex K ($4.92 in chips) 
Seat 4: Cobrå ($2 in chips) 
Seat 5: hc agorist ($5.28 in chips) 
Seat 6: 19892310 ($2 in chips) 
skystaruk: posts small blind $0.01
Zex K: posts big blind $0.02
*** HOLE CARDS ***
Dealt to hc agorist [7h 9d]
Cobrå: folds 
hc agorist: folds 
19892310: folds 
Aegeides: raises $0.02 to $0.04
skystaruk: folds 
Zex K: folds 
Uncalled bet ($0.02) returned to Aegeides
Aegeides collected $0.05 from pot
Aegeides: doesn't show hand 
*** SUMMARY ***
Total pot $0.05 | Rake $0 
Seat 1: Aegeides (button) collected ($0.05)
Seat 2: skystaruk (small blind) folded before Flop
Seat 3: Zex K (big blind) folded before Flop
Seat 4: Cobrå folded before Flop (didn't bet)
Seat 5: hc agorist folded before Flop (didn't bet)
Seat 6: 19892310 folded before Flop (didn't bet)



PokerStars Zoom Hand #193805976879:  Hold'em No Limit ($0.01/$0.02) - 2018/11/28 1:16:46 CUST [2018/11/27 12:16:46 ET]
Table 'Halley' 6-max Seat #1 is the button
Seat 1: Fillippe M. ($2.25 in chips) 
Seat 2: hc agorist ($5.28 in chips) 
Seat 3: firebrigadenor ($3.32 in chips) 
Seat 4: TulioMB ($2.77 in chips) 
Seat 5: 27magneto27 ($2 in chips) 
Seat 6: aleks118 ($2.63 in chips) 
hc agorist: posts small blind $0.01
firebrigadenor: posts big blind $0.02
*** HOLE CARDS ***
Dealt to hc agorist [7h Kh]
TulioMB: folds 
27magneto27: folds 
aleks118: folds 
Fillippe M.: folds 
hc agorist: raises $0.02 to $0.04
firebrigadenor: folds 
Uncalled bet ($0.02) returned to hc agorist
hc agorist collected $0.04 from pot
hc agorist: doesn't show hand 
*** SUMMARY ***
Total pot $0.04 | Rake $0 
Seat 1: Fillippe M. (button) folded before Flop (didn't bet)
Seat 2: hc agorist (small blind) collected ($0.04)
Seat 3: firebrigadenor (big blind) folded before Flop
Seat 4: TulioMB folded before Flop (didn't bet)
Seat 5: 27magneto27 folded before Flop (didn't bet)
Seat 6: aleks118 folded before Flop (didn't bet)



PokerStars Zoom Hand #193805969826:  Hold'em No Limit ($0.01/$0.02) - 2018/11/28 1:16:34 CUST [2018/11/27 12:16:34 ET]
Table 'Halley' 6-max Seat #1 is the button
Seat 1: Spinno ($3.18 in chips) 
Seat 2: Kir Paal ($2 in chips) 
Seat 3: lisachok22 ($0.92 in chips) 
Seat 4: BookerDW1912 ($2.03 in chips) 
Seat 5: bbil300 ($1.95 in chips) 
Seat 6: hc agorist ($5.28 in chips) 
Kir Paal: posts small blind $0.01
lisachok22: posts big blind $0.02
*** HOLE CARDS ***
Dealt to hc agorist [6s 7d]
BookerDW1912: raises $0.04 to $0.06
bbil300: folds 
hc agorist: folds 
Spinno: folds 
Kir Paal: folds 
lisachok22: calls $0.04
*** FLOP *** [Qs Th As]
lisachok22: checks 
BookerDW1912: checks 
*** TURN *** [Qs Th As] [3d]
lisachok22: bets $0.06
BookerDW1912: folds 
Uncalled bet ($0.06) returned to lisachok22
lisachok22 collected $0.13 from pot
lisachok22: doesn't show hand 
*** SUMMARY ***
Total pot $0.13 | Rake $0 
Board [Qs Th As 3d]
Seat 1: Spinno (button) folded before Flop (didn't bet)
Seat 2: Kir Paal (small blind) folded before Flop
Seat 3: lisachok22 (big blind) collected ($0.13)
Seat 4: BookerDW1912 folded on the Turn
Seat 5: bbil300 folded before Flop (didn't bet)
Seat 6: hc agorist folded before Flop (didn't bet)



PokerStars Zoom Hand #193805986807:  Hold'em No Limit ($0.01/$0.02) - 2018/11/28 1:17:03 CUST [2018/11/27 12:17:03 ET]
Table 'Halley' 6-max Seat #1 is the button
Seat 1: brasileiro83 ($2 in chips) 
Seat 2: pengy1987 ($5.38 in chips) 
Seat 3: hc agorist ($5.30 in chips) 
Seat 4: COURT JES264 ($3.37 in chips) 
Seat 5: bbil300 ($1.97 in chips) 
Seat 6: HeyItsM3 ($3.69 in chips) 
pengy1987: posts small blind $0.01
hc agorist: posts big blind $0.02
*** HOLE CARDS ***
Dealt to hc agorist [Jh Ts]
COURT JES264: raises $0.04 to $0.06
bbil300: folds 
HeyItsM3: folds 
brasileiro83: folds 
pengy1987: folds 
hc agorist: folds 
Uncalled bet ($0.04) returned to COURT JES264
COURT JES264 collected $0.05 from pot
COURT JES264: doesn't show hand 
*** SUMMARY ***
Total pot $0.05 | Rake $0 
Seat 1: brasileiro83 (button) folded before Flop (didn't bet)
Seat 2: pengy1987 (small blind) folded before Flop
Seat 3: hc agorist (big blind) folded before Flop
Seat 4: COURT JES264 collected ($0.05)
Seat 5: bbil300 folded before Flop (didn't bet)
Seat 6: HeyItsM3 folded before Flop (didn't bet)



PokerStars Zoom Hand #193805991518:  Hold'em No Limit ($0.01/$0.02) - 2018/11/28 1:17:11 CUST [2018/11/27 12:17:11 ET]
Table 'Halley' 6-max Seat #1 is the button
Seat 1: MiuFuringi ($2 in chips) 
Seat 2: Qwkl ($2 in chips) 
Seat 3: hsienko ($2.11 in chips) 
Seat 4: Oswaldoja ($2 in chips) 
Seat 5: hc agorist ($5.28 in chips) 
Seat 6: 6tukatuka ($2 in chips) 
Qwkl: posts small blind $0.01
hsienko: posts big blind $0.02
*** HOLE CARDS ***
Dealt to hc agorist [6c 8s]
Oswaldoja: folds 
hc agorist: folds 
6tukatuka: raises $0.04 to $0.06
MiuFuringi: folds 
Qwkl: folds 
hsienko: folds 
Uncalled bet ($0.04) returned to 6tukatuka
6tukatuka collected $0.05 from pot
6tukatuka: doesn't show hand 
*** SUMMARY ***
Total pot $0.05 | Rake $0 
Seat 1: MiuFuringi (button) folded before Flop (didn't bet)
Seat 2: Qwkl (small blind) folded before Flop
Seat 3: hsienko (big blind) folded before Flop
Seat 4: Oswaldoja folded before Flop (didn't bet)
Seat 5: hc agorist folded before Flop (didn't bet)
Seat 6: 6tukatuka collected ($0.05)



PokerStars Zoom Hand #193805994474:  Hold'em No Limit ($0.01/$0.02) - 2018/11/28 1:17:16 CUST [2018/11/27 12:17:16 ET]
Table 'Halley' 6-max Seat #1 is the button
Seat 1: Lakchenko ($1.90 in chips) 
Seat 2: easywtf ($2.58 in chips) 
Seat 3: oz183 ($1.93 in chips) 
Seat 4: hc agorist ($5.28 in chips) 
Seat 5: Miami27887 ($3.08 in chips) 
Seat 6: Xenoeus1 ($2 in chips) 
easywtf: posts small blind $0.01
oz183: posts big blind $0.02
*** HOLE CARDS ***
Dealt to hc agorist [Kc Qh]
hc agorist: raises $0.04 to $0.06
Miami27887: raises $0.15 to $0.21
Xenoeus1: folds 
Lakchenko: folds 
easywtf: folds 
oz183: folds 
hc agorist: folds 
Uncalled bet ($0.15) returned to Miami27887
Miami27887 collected $0.15 from pot
Miami27887: doesn't show hand 
*** SUMMARY ***
Total pot $0.15 | Rake $0 
Seat 1: Lakchenko (button) folded before Flop (didn't bet)
Seat 2: easywtf (small blind) folded before Flop
Seat 3: oz183 (big blind) folded before Flop
Seat 4: hc agorist folded before Flop
Seat 5: Miami27887 collected ($0.15)
Seat 6: Xenoeus1 folded before Flop (didn't bet)



PokerStars Zoom Hand #193806008017:  Hold'em No Limit ($0.01/$0.02) - 2018/11/28 1:17:39 CUST [2018/11/27 12:17:39 ET]
Table 'Halley' 6-max Seat #1 is the button
Seat 1: hc agorist ($5.22 in chips) 
Seat 2: pinja13 ($0.99 in chips) 
Seat 3: Miami27887 ($3.21 in chips) 
Seat 4: el visitante ($4.36 in chips) 
Seat 5: Akutagawa ($2.02 in chips) 
Seat 6: liryka ($2.23 in chips) 
pinja13: posts small blind $0.01
Miami27887: posts big blind $0.02
*** HOLE CARDS ***
Dealt to hc agorist [Qh 4c]
el visitante: folds 
Akutagawa: folds 
liryka: folds 
hc agorist: folds 
pinja13: folds 
Uncalled bet ($0.01) returned to Miami27887
Miami27887 collected $0.02 from pot
Miami27887: doesn't show hand 
*** SUMMARY ***
Total pot $0.02 | Rake $0 
Seat 1: hc agorist (button) folded before Flop (didn't bet)
Seat 2: pinja13 (small blind) folded before Flop
Seat 3: Miami27887 (big blind) collected ($0.02)
Seat 4: el visitante folded before Flop (didn't bet)
Seat 5: Akutagawa folded before Flop (didn't bet)
Seat 6: liryka folded before Flop (didn't bet)



PokerStars Zoom Hand #193806011500:  Hold'em No Limit ($0.01/$0.02) - 2018/11/28 1:17:45 CUST [2018/11/27 12:17:45 ET]
Table 'Halley' 6-max Seat #1 is the button
Seat 1: cidgeo1993 ($2.08 in chips) 
Seat 2: hc agorist ($5.22 in chips) 
Seat 3: SegaPost ($0.46 in chips) 
Seat 4: korvsoppa14 ($1.64 in chips) 
Seat 5: Okhams Razor ($2.91 in chips) 
Seat 6: Damian36215 ($2 in chips) 
hc agorist: posts small blind $0.01
SegaPost: posts big blind $0.02
*** HOLE CARDS ***
Dealt to hc agorist [Tc 6c]
korvsoppa14: calls $0.02
Okhams Razor: folds 
Damian36215: folds 
cidgeo1993: folds 
hc agorist: calls $0.01
SegaPost: checks 
*** FLOP *** [2d Jd 9c]
hc agorist: checks 
SegaPost: checks 
korvsoppa14: checks 
*** TURN *** [2d Jd 9c] [9h]
hc agorist: checks 
SegaPost: checks 
korvsoppa14: bets $0.16
hc agorist: folds 
SegaPost: folds 
Uncalled bet ($0.16) returned to korvsoppa14
korvsoppa14 collected $0.06 from pot
korvsoppa14: doesn't show hand 
*** SUMMARY ***
Total pot $0.06 | Rake $0 
Board [2d Jd 9c 9h]
Seat 1: cidgeo1993 (button) folded before Flop (didn't bet)
Seat 2: hc agorist (small blind) folded on the Turn
Seat 3: SegaPost (big blind) folded on the Turn
Seat 4: korvsoppa14 collected ($0.06)
Seat 5: Okhams Razor folded before Flop (didn't bet)
Seat 6: Damian36215 folded before Flop (didn't bet)



PokerStars Zoom Hand #193806003873:  Hold'em No Limit ($0.01/$0.02) - 2018/11/28 1:17:32 CUST [2018/11/27 12:17:32 ET]
Table 'Halley' 6-max Seat #1 is the button
Seat 1: LIZA972 ($2 in chips) 
Seat 2: Comandos025 ($3.51 in chips) 
Seat 3: Cobbler43 ($2.67 in chips) 
Seat 4: Discco ($1.99 in chips) 
Seat 5: attendant3 ($5.74 in chips) 
Seat 6: hc agorist ($5.22 in chips) 
Comandos025: posts small blind $0.01
Cobbler43: posts big blind $0.02
*** HOLE CARDS ***
Dealt to hc agorist [7s Kc]
Discco: folds 
attendant3: folds 
hc agorist: folds 
LIZA972: calls $0.02
Comandos025: calls $0.01
Cobbler43: checks 
*** FLOP *** [Qs 6s 9c]
Comandos025: checks 
Cobbler43: checks 
LIZA972: bets $0.06
Comandos025: folds 
Cobbler43: calls $0.06
*** TURN *** [Qs 6s 9c] [3c]
Cobbler43: checks 
LIZA972: checks 
*** RIVER *** [Qs 6s 9c 3c] [Kh]
Cobbler43: bets $0.06
LIZA972: folds 
Uncalled bet ($0.06) returned to Cobbler43
Cobbler43 collected $0.17 from pot
Cobbler43: doesn't show hand 
*** SUMMARY ***
Total pot $0.18 | Rake $0.01 
Board [Qs 6s 9c 3c Kh]
Seat 1: LIZA972 (button) folded on the River
Seat 2: Comandos025 (small blind) folded on the Flop
Seat 3: Cobbler43 (big blind) collected ($0.17)
Seat 4: Discco folded before Flop (didn't bet)
Seat 5: attendant3 folded before Flop (didn't bet)
Seat 6: hc agorist folded before Flop (didn't bet)



PokerStars Zoom Hand #193806031984:  Hold'em No Limit ($0.01/$0.02) - 2018/11/28 1:18:20 CUST [2018/11/27 12:18:20 ET]
Table 'Halley' 6-max Seat #1 is the button
Seat 1: batek_1 ($2.18 in chips) 
Seat 2: newby270389 ($2 in chips) 
Seat 3: hc agorist ($5.20 in chips) 
Seat 4: P.Cogito ($2 in chips) 
Seat 5: yoba_patr ($3.68 in chips) 
Seat 6: Fenan0 ($2.71 in chips) 
newby270389: posts small blind $0.01
hc agorist: posts big blind $0.02
*** HOLE CARDS ***
Dealt to hc agorist [9s Qc]
P.Cogito: folds 
yoba_patr: folds 
Fenan0: folds 
batek_1: folds 
newby270389: raises $0.04 to $0.06
hc agorist: calls $0.04
*** FLOP *** [Tc 5s 9c]
newby270389: checks 
hc agorist: checks 
*** TURN *** [Tc 5s 9c] [6h]
newby270389: checks 
hc agorist: bets $0.10
newby270389: calls $0.10
*** RIVER *** [Tc 5s 9c 6h] [9d]
newby270389: checks 
hc agorist: bets $0.24
newby270389: calls $0.24
*** SHOW DOWN ***
hc agorist: shows [9s Qc] (three of a kind, Nines)
newby270389: mucks hand 
hc agorist collected $0.77 from pot
*** SUMMARY ***
Total pot $0.80 | Rake $0.03 
Board [Tc 5s 9c 6h 9d]
Seat 1: batek_1 (button) folded before Flop (didn't bet)
Seat 2: newby270389 (small blind) mucked [Qh Kd]
Seat 3: hc agorist (big blind) showed [9s Qc] and won ($0.77) with three of a kind, Nines
Seat 4: P.Cogito folded before Flop (didn't bet)
Seat 5: yoba_patr folded before Flop (didn't bet)
Seat 6: Fenan0 folded before Flop (didn't bet)



PokerStars Zoom Hand #193806064667:  Hold'em No Limit ($0.01/$0.02) - 2018/11/28 1:19:16 CUST [2018/11/27 12:19:16 ET]
Table 'Halley' 6-max Seat #1 is the button
Seat 1: HeyItsM3 ($3.33 in chips) 
Seat 2: f1 rES ($3.99 in chips) 
Seat 3: Polal19 ($1.86 in chips) 
Seat 4: Williwacker9 ($2.48 in chips) 
Seat 5: hc agorist ($5.57 in chips) 
Seat 6: elpsycongr0 ($1.77 in chips) 
f1 rES: posts small blind $0.01
Polal19: posts big blind $0.02
*** HOLE CARDS ***
Dealt to hc agorist [8s Qc]
Williwacker9: raises $0.02 to $0.04
hc agorist: folds 
elpsycongr0: folds 
HeyItsM3: folds 
f1 rES: calls $0.03
Polal19: folds 
*** FLOP *** [8c 8d 6d]
f1 rES: checks 
Williwacker9: bets $0.04
f1 rES: calls $0.04
*** TURN *** [8c 8d 6d] [2s]
f1 rES: checks 
Williwacker9: checks 
*** RIVER *** [8c 8d 6d 2s] [Ts]
f1 rES: checks 
Williwacker9: checks 
*** SHOW DOWN ***
f1 rES: shows [Ac 9c] (a pair of Eights)
Williwacker9: mucks hand 
f1 rES collected $0.17 from pot
*** SUMMARY ***
Total pot $0.18 | Rake $0.01 
Board [8c 8d 6d 2s Ts]
Seat 1: HeyItsM3 (button) folded before Flop (didn't bet)
Seat 2: f1 rES (small blind) showed [Ac 9c] and won ($0.17) with a pair of Eights
Seat 3: Polal19 (big blind) folded before Flop
Seat 4: Williwacker9 mucked [Js Ks]
Seat 5: hc agorist folded before Flop (didn't bet)
Seat 6: elpsycongr0 folded before Flop (didn't bet)



PokerStars Zoom Hand #193806072158:  Hold'em No Limit ($0.01/$0.02) - 2018/11/28 1:19:29 CUST [2018/11/27 12:19:29 ET]
Table 'Halley' 6-max Seat #1 is the button
Seat 1: YoSoyArmandoSan ($1.87 in chips) 
Seat 2: fdoTeam ($4.41 in chips) 
Seat 3: evgenvader ($3.51 in chips) 
Seat 4: hc agorist ($5.57 in chips) 
Seat 5: dexter141275 ($2.33 in chips) 
Seat 6: Comandos025 ($3.52 in chips) 
fdoTeam: posts small blind $0.01
evgenvader: posts big blind $0.02
*** HOLE CARDS ***
Dealt to hc agorist [Kc 4d]
hc agorist: folds 
dexter141275: folds 
Comandos025: folds 
YoSoyArmandoSan has timed out
YoSoyArmandoSan: folds 
fdoTeam: folds 
Uncalled bet ($0.01) returned to evgenvader
evgenvader collected $0.02 from pot
evgenvader: doesn't show hand 
*** SUMMARY ***
Total pot $0.02 | Rake $0 
Seat 1: YoSoyArmandoSan (button) folded before Flop (didn't bet)
Seat 2: fdoTeam (small blind) folded before Flop
Seat 3: evgenvader (big blind) collected ($0.02)
Seat 4: hc agorist folded before Flop (didn't bet)
Seat 5: dexter141275 folded before Flop (didn't bet)
Seat 6: Comandos025 folded before Flop (didn't bet)



PokerStars Zoom Hand #193806069222:  Hold'em No Limit ($0.01/$0.02) - 2018/11/28 1:19:24 CUST [2018/11/27 12:19:24 ET]
Table 'Halley' 6-max Seat #1 is the button
Seat 1: G.Datskov ($2.96 in chips) 
Seat 2: EvgenMSN ($2.74 in chips) 
Seat 3: SleveMcDichael2 ($2.48 in chips) 
Seat 4: hc agorist ($5.57 in chips) 
Seat 5: Lvlvsfrvr ($1.99 in chips) 
Seat 6: Evgen1907 ($2.96 in chips) 
EvgenMSN: posts small blind $0.01
SleveMcDichael2: posts big blind $0.02
*** HOLE CARDS ***
Dealt to hc agorist [2h 4h]
hc agorist: folds 
Lvlvsfrvr: calls $0.02
Evgen1907: folds 
G.Datskov: folds 
EvgenMSN: folds 
SleveMcDichael2: raises $0.04 to $0.06
Lvlvsfrvr: calls $0.04
*** FLOP *** [Ac 2d As]
SleveMcDichael2: checks 
Lvlvsfrvr: bets $0.07
SleveMcDichael2: calls $0.07
*** TURN *** [Ac 2d As] [4d]
SleveMcDichael2: bets $0.13
Lvlvsfrvr: folds 
Uncalled bet ($0.13) returned to SleveMcDichael2
SleveMcDichael2 collected $0.26 from pot
SleveMcDichael2: doesn't show hand 
*** SUMMARY ***
Total pot $0.27 | Rake $0.01 
Board [Ac 2d As 4d]
Seat 1: G.Datskov (button) folded before Flop (didn't bet)
Seat 2: EvgenMSN (small blind) folded before Flop
Seat 3: SleveMcDichael2 (big blind) collected ($0.26)
Seat 4: hc agorist folded before Flop (didn't bet)
Seat 5: Lvlvsfrvr folded on the Turn
Seat 6: Evgen1907 folded before Flop (didn't bet)



PokerStars Zoom Hand #193806075097:  Hold'em No Limit ($0.01/$0.02) - 2018/11/28 1:19:34 CUST [2018/11/27 12:19:34 ET]
Table 'Halley' 6-max Seat #1 is the button
Seat 1: hc agorist ($5.57 in chips) 
Seat 2: Shamaxxx ($2.76 in chips) 
Seat 3: fdoTeam ($4.40 in chips) 
Seat 4: 06romm22 ($2.47 in chips) 
Seat 5: Lakchenko ($1.20 in chips) 
Seat 6: Zex K ($5.48 in chips) 
Shamaxxx: posts small blind $0.01
fdoTeam: posts big blind $0.02
*** HOLE CARDS ***
Dealt to hc agorist [Kd 6d]
06romm22: folds 
Lakchenko: raises $0.04 to $0.06
Zex K: calls $0.06
hc agorist: raises $0.21 to $0.27
Shamaxxx: folds 
fdoTeam: folds 
Lakchenko: calls $0.21
Zex K: calls $0.21
*** FLOP *** [Td Ac Js]
Lakchenko: checks 
Zex K: checks 
hc agorist: checks 
*** TURN *** [Td Ac Js] [Ks]
Lakchenko: checks 
Zex K: bets $0.24
hc agorist: folds 
Lakchenko: raises $0.69 to $0.93 and is all-in
Zex K: folds 
Uncalled bet ($0.69) returned to Lakchenko
Lakchenko collected $1.27 from pot
Lakchenko: doesn't show hand 
*** SUMMARY ***
Total pot $1.32 | Rake $0.05 
Board [Td Ac Js Ks]
Seat 1: hc agorist (button) folded on the Turn
Seat 2: Shamaxxx (small blind) folded before Flop
Seat 3: fdoTeam (big blind) folded before Flop
Seat 4: 06romm22 folded before Flop (didn't bet)
Seat 5: Lakchenko collected ($1.27)
Seat 6: Zex K folded on the Turn



PokerStars Zoom Hand #193806102156:  Hold'em No Limit ($0.01/$0.02) - 2018/11/28 1:20:20 CUST [2018/11/27 12:20:20 ET]
Table 'Halley' 6-max Seat #1 is the button
Seat 1: madrihcosher ($3.02 in chips) 
Seat 2: mg-deniz ($1.94 in chips) 
Seat 3: stradywary ($2.06 in chips) 
Seat 4: kensho25 ($0.62 in chips) 
Seat 5: kjonesgg ($7.20 in chips) 
Seat 6: hc agorist ($5.30 in chips) 
mg-deniz: posts small blind $0.01
stradywary: posts big blind $0.02
*** HOLE CARDS ***
Dealt to hc agorist [5s Jh]
kensho25: folds 
kjonesgg: folds 
hc agorist: folds 
madrihcosher: folds 
mg-deniz: folds 
Uncalled bet ($0.01) returned to stradywary
stradywary collected $0.02 from pot
stradywary: doesn't show hand 
*** SUMMARY ***
Total pot $0.02 | Rake $0 
Seat 1: madrihcosher (button) folded before Flop (didn't bet)
Seat 2: mg-deniz (small blind) folded before Flop
Seat 3: stradywary (big blind) collected ($0.02)
Seat 4: kensho25 folded before Flop (didn't bet)
Seat 5: kjonesgg folded before Flop (didn't bet)
Seat 6: hc agorist folded before Flop (didn't bet)



PokerStars Zoom Hand #193806105054:  Hold'em No Limit ($0.01/$0.02) - 2018/11/28 1:20:25 CUST [2018/11/27 12:20:25 ET]
Table 'Halley' 6-max Seat #1 is the button
Seat 1: simon32.ru ($2.01 in chips) 
Seat 2: marta328 ($2.19 in chips) 
Seat 3: hc agorist ($5.30 in chips) 
Seat 4: djafar63 ($3.46 in chips) 
Seat 5: GRizlik14 ($3.84 in chips) 
Seat 6: vatteztaR* ($4.65 in chips) 
marta328: posts small blind $0.01
hc agorist: posts big blind $0.02
*** HOLE CARDS ***
Dealt to hc agorist [As 5c]
djafar63: folds 
GRizlik14: folds 
vatteztaR*: folds 
simon32.ru: raises $0.03 to $0.05
marta328: folds 
hc agorist: raises $0.11 to $0.16
simon32.ru: calls $0.11
*** FLOP *** [8d 6s 2h]
hc agorist: bets $0.11
simon32.ru: calls $0.11
*** TURN *** [8d 6s 2h] [4h]
hc agorist: checks 
simon32.ru: bets $0.27
hc agorist: folds 
Uncalled bet ($0.27) returned to simon32.ru
simon32.ru collected $0.53 from pot
simon32.ru: doesn't show hand 
*** SUMMARY ***
Total pot $0.55 | Rake $0.02 
Board [8d 6s 2h 4h]
Seat 1: simon32.ru (button) collected ($0.53)
Seat 2: marta328 (small blind) folded before Flop
Seat 3: hc agorist (big blind) folded on the Turn
Seat 4: djafar63 folded before Flop (didn't bet)
Seat 5: GRizlik14 folded before Flop (didn't bet)
Seat 6: vatteztaR* folded before Flop (didn't bet)



PokerStars Zoom Hand #193806135834:  Hold'em No Limit ($0.01/$0.02) - 2018/11/28 1:21:17 CUST [2018/11/27 12:21:17 ET]
Table 'Halley' 6-max Seat #1 is the button
Seat 1: Michel Mata ($2.01 in chips) 
Seat 2: hc agorist ($5.03 in chips) 
Seat 3: SKANER BY ($1.69 in chips) 
Seat 4: Lakchenko ($3.39 in chips) 
Seat 5: jimmydwilson12 ($4.32 in chips) 
Seat 6: Darkymond ($2.14 in chips) 
hc agorist: posts small blind $0.01
SKANER BY: posts big blind $0.02
*** HOLE CARDS ***
Dealt to hc agorist [4d 6c]
Lakchenko: folds 
jimmydwilson12: folds 
Darkymond: folds 
Michel Mata: raises $0.04 to $0.06
hc agorist: folds 
SKANER BY: folds 
Uncalled bet ($0.04) returned to Michel Mata
Michel Mata collected $0.05 from pot
Michel Mata: doesn't show hand 
*** SUMMARY ***
Total pot $0.05 | Rake $0 
Seat 1: Michel Mata (button) collected ($0.05)
Seat 2: hc agorist (small blind) folded before Flop
Seat 3: SKANER BY (big blind) folded before Flop
Seat 4: Lakchenko folded before Flop (didn't bet)
Seat 5: jimmydwilson12 folded before Flop (didn't bet)
Seat 6: Darkymond folded before Flop (didn't bet)



PokerStars Zoom Hand #193806144671:  Hold'em No Limit ($0.01/$0.02) - 2018/11/28 1:21:32 CUST [2018/11/27 12:21:32 ET]
Table 'Halley' 6-max Seat #1 is the button
Seat 1: hc agorist ($5.02 in chips) 
Seat 2: romario788 ($2.06 in chips) 
Seat 3: pokerfan3999 ($2.37 in chips) 
Seat 4: Kokosya ($2 in chips) 
Seat 5: DenWhite89 ($2.07 in chips) 
Seat 6: TheRedPillx ($2.50 in chips) 
romario788: posts small blind $0.01
pokerfan3999: posts big blind $0.02
*** HOLE CARDS ***
Dealt to hc agorist [2s Ah]
Kokosya: raises $0.04 to $0.06
DenWhite89: folds 
TheRedPillx: folds 
hc agorist: folds 
romario788: folds 
pokerfan3999: folds 
Uncalled bet ($0.04) returned to Kokosya
Kokosya collected $0.05 from pot
Kokosya: doesn't show hand 
*** SUMMARY ***
Total pot $0.05 | Rake $0 
Seat 1: hc agorist (button) folded before Flop (didn't bet)
Seat 2: romario788 (small blind) folded before Flop
Seat 3: pokerfan3999 (big blind) folded before Flop
Seat 4: Kokosya collected ($0.05)
Seat 5: DenWhite89 folded before Flop (didn't bet)
Seat 6: TheRedPillx folded before Flop (didn't bet)



PokerStars Zoom Hand #193806149300:  Hold'em No Limit ($0.01/$0.02) - 2018/11/28 1:21:40 CUST [2018/11/27 12:21:40 ET]
Table 'Halley' 6-max Seat #1 is the button
Seat 1: Hambooo09 ($1.49 in chips) 
Seat 2: urpyJL989 ($3.18 in chips) 
Seat 3: DeathVortex ($2.10 in chips) 
Seat 4: evgenvader ($3.52 in chips) 
Seat 5: hc agorist ($5.02 in chips) 
Seat 6: vovan100157 ($1.97 in chips) 
urpyJL989: posts small blind $0.01
DeathVortex: posts big blind $0.02
*** HOLE CARDS ***
Dealt to hc agorist [7h Tc]
evgenvader: folds 
hc agorist: folds 
vovan100157: folds 
Hambooo09: folds 
urpyJL989: folds 
Uncalled bet ($0.01) returned to DeathVortex
DeathVortex collected $0.02 from pot
DeathVortex: doesn't show hand 
*** SUMMARY ***
Total pot $0.02 | Rake $0 
Seat 1: Hambooo09 (button) folded before Flop (didn't bet)
Seat 2: urpyJL989 (small blind) folded before Flop
Seat 3: DeathVortex (big blind) collected ($0.02)
Seat 4: evgenvader folded before Flop (didn't bet)
Seat 5: hc agorist folded before Flop (didn't bet)
Seat 6: vovan100157 folded before Flop (didn't bet)



PokerStars Zoom Hand #193806152204:  Hold'em No Limit ($0.01/$0.02) - 2018/11/28 1:21:45 CUST [2018/11/27 12:21:45 ET]
Table 'Halley' 6-max Seat #1 is the button
Seat 1: Oberon63 ($7.46 in chips) 
Seat 2: effortlessly1 ($3.29 in chips) 
Seat 3: batek_1 ($4.35 in chips) 
Seat 4: indextown ($2 in chips) 
Seat 5: bigfreddo86 ($2.02 in chips) 
Seat 6: hc agorist ($5.02 in chips) 
effortlessly1: posts small blind $0.01
batek_1: posts big blind $0.02
*** HOLE CARDS ***
Dealt to hc agorist [8d 4c]
indextown: folds 
bigfreddo86: raises $0.04 to $0.06
hc agorist: folds 
Oberon63: folds 
effortlessly1: calls $0.05
batek_1: folds 
*** FLOP *** [5h 2s Jd]
effortlessly1: checks 
bigfreddo86: bets $0.09
effortlessly1: folds 
Uncalled bet ($0.09) returned to bigfreddo86
bigfreddo86 collected $0.14 from pot
bigfreddo86: doesn't show hand 
*** SUMMARY ***
Total pot $0.14 | Rake $0 
Board [5h 2s Jd]
Seat 1: Oberon63 (button) folded before Flop (didn't bet)
Seat 2: effortlessly1 (small blind) folded on the Flop
Seat 3: batek_1 (big blind) folded before Flop
Seat 4: indextown folded before Flop (didn't bet)
Seat 5: bigfreddo86 collected ($0.14)
Seat 6: hc agorist folded before Flop (didn't bet)



PokerStars Zoom Hand #193806155241:  Hold'em No Limit ($0.01/$0.02) - 2018/11/28 1:21:50 CUST [2018/11/27 12:21:50 ET]
Table 'Halley' 6-max Seat #1 is the button
Seat 1: GreyKeeperRu ($2.49 in chips) 
Seat 2: rifa700 ($1.51 in chips) 
Seat 3: hc agorist ($5.02 in chips) 
Seat 4: COURT JES264 ($4.15 in chips) 
Seat 5: satti1337 ($4.21 in chips) 
Seat 6: benvo97 ($2.24 in chips) 
rifa700: posts small blind $0.01
hc agorist: posts big blind $0.02
*** HOLE CARDS ***
Dealt to hc agorist [6d 6h]
COURT JES264: folds 
satti1337: folds 
benvo97 has timed out while disconnected
benvo97: folds 
GreyKeeperRu: raises $0.04 to $0.06
rifa700: folds 
hc agorist: calls $0.04
*** FLOP *** [Tc 4c 4h]
hc agorist: checks 
GreyKeeperRu: bets $0.04
hc agorist: calls $0.04
*** TURN *** [Tc 4c 4h] [7s]
hc agorist: checks 
GreyKeeperRu: bets $0.06
hc agorist: calls $0.06
*** RIVER *** [Tc 4c 4h 7s] [7c]
hc agorist: checks 
GreyKeeperRu: bets $0.21
hc agorist: raises $0.41 to $0.62
GreyKeeperRu: raises $1.48 to $2.10
hc agorist: folds 
Uncalled bet ($1.48) returned to GreyKeeperRu
GreyKeeperRu collected $1.52 from pot
GreyKeeperRu: doesn't show hand 
*** SUMMARY ***
Total pot $1.57 | Rake $0.05 
Board [Tc 4c 4h 7s 7c]
Seat 1: GreyKeeperRu (button) collected ($1.52)
Seat 2: rifa700 (small blind) folded before Flop
Seat 3: hc agorist (big blind) folded on the River
Seat 4: COURT JES264 folded before Flop (didn't bet)
Seat 5: satti1337 folded before Flop (didn't bet)
Seat 6: benvo97 folded before Flop (didn't bet)



PokerStars Zoom Hand #193806207437:  Hold'em No Limit ($0.01/$0.02) - 2018/11/28 1:23:19 CUST [2018/11/27 12:23:19 ET]
Table 'Halley' 6-max Seat #1 is the button
Seat 1: xompistas000 ($2 in chips) 
Seat 2: hc agorist ($4.24 in chips) 
Seat 3: zeus11983 ($2.03 in chips) 
Seat 4: Dearrr99 ($2 in chips) 
Seat 5: Tuxui y)l(ac ($11.30 in chips) 
Seat 6: RM432 ($2 in chips) 
hc agorist: posts small blind $0.01
zeus11983: posts big blind $0.02
*** HOLE CARDS ***
Dealt to hc agorist [Ah 4d]
Dearrr99: folds 
Tuxui y)l(ac: folds 
RM432: folds 
xompistas000: raises $0.04 to $0.06
hc agorist: folds 
zeus11983: raises $0.13 to $0.19
xompistas000: folds 
Uncalled bet ($0.13) returned to zeus11983
zeus11983 collected $0.13 from pot
zeus11983: doesn't show hand 
*** SUMMARY ***
Total pot $0.13 | Rake $0 
Seat 1: xompistas000 (button) folded before Flop
Seat 2: hc agorist (small blind) folded before Flop
Seat 3: zeus11983 (big blind) collected ($0.13)
Seat 4: Dearrr99 folded before Flop (didn't bet)
Seat 5: Tuxui y)l(ac folded before Flop (didn't bet)
Seat 6: RM432 folded before Flop (didn't bet)



PokerStars Zoom Hand #193806218058:  Hold'em No Limit ($0.01/$0.02) - 2018/11/28 1:23:37 CUST [2018/11/27 12:23:37 ET]
Table 'Halley' 6-max Seat #1 is the button
Seat 1: P.Cogito ($3.57 in chips) 
Seat 2: hc agorist ($4.23 in chips) 
Seat 3: starbli-k ($1.26 in chips) 
Seat 4: 72odonkey ($3.26 in chips) 
Seat 5: titan148 ($2.16 in chips) 
Seat 6: guelek ($3.65 in chips) 
hc agorist: posts small blind $0.01
starbli-k: posts big blind $0.02
*** HOLE CARDS ***
Dealt to hc agorist [2c 4h]
72odonkey: folds 
titan148: folds 
guelek: folds 
P.Cogito: folds 
hc agorist: folds 
Uncalled bet ($0.01) returned to starbli-k
starbli-k collected $0.02 from pot
starbli-k: doesn't show hand 
*** SUMMARY ***
Total pot $0.02 | Rake $0 
Seat 1: P.Cogito (button) folded before Flop (didn't bet)
Seat 2: hc agorist (small blind) folded before Flop
Seat 3: starbli-k (big blind) collected ($0.02)
Seat 4: 72odonkey folded before Flop (didn't bet)
Seat 5: titan148 folded before Flop (didn't bet)
Seat 6: guelek folded before Flop (didn't bet)



PokerStars Zoom Hand #193806210964:  Hold'em No Limit ($0.01/$0.02) - 2018/11/28 1:23:25 CUST [2018/11/27 12:23:25 ET]
Table 'Halley' 6-max Seat #1 is the button
Seat 1: Pokershmok ($2.08 in chips) 
Seat 2: Qwkl ($2.41 in chips) 
Seat 3: MarioAlan ($2 in chips) 
Seat 4: regivasco ($1.52 in chips) 
Seat 5: hc agorist ($4.23 in chips) 
Seat 6: daria130399 ($1.92 in chips) 
Qwkl: posts small blind $0.01
MarioAlan: posts big blind $0.02
*** HOLE CARDS ***
Dealt to hc agorist [5c 6h]
regivasco: folds 
hc agorist: folds 
daria130399: folds 
Pokershmok: folds 
Qwkl: raises $0.03 to $0.05
MarioAlan: calls $0.03
*** FLOP *** [Tc 2d 2s]
Qwkl: bets $0.05
MarioAlan: calls $0.05
*** TURN *** [Tc 2d 2s] [3c]
Qwkl: checks 
MarioAlan: bets $0.16
Qwkl: folds 
Uncalled bet ($0.16) returned to MarioAlan
MarioAlan collected $0.19 from pot
MarioAlan: doesn't show hand 
*** SUMMARY ***
Total pot $0.20 | Rake $0.01 
Board [Tc 2d 2s 3c]
Seat 1: Pokershmok (button) folded before Flop (didn't bet)
Seat 2: Qwkl (small blind) folded on the Turn
Seat 3: MarioAlan (big blind) collected ($0.19)
Seat 4: regivasco folded before Flop (didn't bet)
Seat 5: hc agorist folded before Flop (didn't bet)
Seat 6: daria130399 folded before Flop (didn't bet)



PokerStars Zoom Hand #193806214516:  Hold'em No Limit ($0.01/$0.02) - 2018/11/28 1:23:31 CUST [2018/11/27 12:23:31 ET]
Table 'Halley' 6-max Seat #1 is the button
Seat 1: Raschik ($1.84 in chips) 
Seat 2: babohe1991 ($2 in chips) 
Seat 3: Cobbler43 ($2 in chips) 
Seat 4: hc agorist ($4.23 in chips) 
Seat 5: Williwacker9 ($2.64 in chips) 
Seat 6: satti1337 ($9 in chips) 
babohe1991: posts small blind $0.01
Cobbler43: posts big blind $0.02
*** HOLE CARDS ***
Dealt to hc agorist [2h 8h]
hc agorist: folds 
Williwacker9: folds 
satti1337: raises $0.03 to $0.05
Raschik: folds 
babohe1991: folds 
Cobbler43: calls $0.03
*** FLOP *** [6s 9s Js]
Cobbler43: checks 
satti1337: checks 
*** TURN *** [6s 9s Js] [Ac]
Cobbler43: bets $0.06
satti1337: calls $0.06
*** RIVER *** [6s 9s Js Ac] [6c]
Cobbler43: checks 
satti1337: checks 
*** SHOW DOWN ***
Cobbler43: shows [As 4h] (two pair, Aces and Sixes)
satti1337: mucks hand 
Cobbler43 collected $0.22 from pot
*** SUMMARY ***
Total pot $0.23 | Rake $0.01 
Board [6s 9s Js Ac 6c]
Seat 1: Raschik (button) folded before Flop (didn't bet)
Seat 2: babohe1991 (small blind) folded before Flop
Seat 3: Cobbler43 (big blind) showed [As 4h] and won ($0.22) with two pair, Aces and Sixes
Seat 4: hc agorist folded before Flop (didn't bet)
Seat 5: Williwacker9 folded before Flop (didn't bet)
Seat 6: satti1337 mucked [Jh 9h]



PokerStars Zoom Hand #193806226976:  Hold'em No Limit ($0.01/$0.02) - 2018/11/28 1:23:52 CUST [2018/11/27 12:23:52 ET]
Table 'Halley' 6-max Seat #1 is the button
Seat 1: hc agorist ($4.22 in chips) 
Seat 2: lisiyzidan ($6.21 in chips) 
Seat 3: Discco ($2.14 in chips) 
Seat 4: phenix140 ($4 in chips) 
Seat 5: firebrigadenor ($2 in chips) 
Seat 6: BookerDW1912 ($3.56 in chips) 
lisiyzidan: posts small blind $0.01
Discco: posts big blind $0.02
*** HOLE CARDS ***
Dealt to hc agorist [6h Ad]
phenix140: folds 
firebrigadenor: folds 
BookerDW1912: folds 
hc agorist: raises $0.02 to $0.04
lisiyzidan: folds 
Discco: calls $0.02
*** FLOP *** [4d Ks Qc]
Discco: bets $0.05
hc agorist: raises $0.15 to $0.20
Discco: folds 
Uncalled bet ($0.15) returned to hc agorist
hc agorist collected $0.18 from pot
hc agorist: doesn't show hand 
*** SUMMARY ***
Total pot $0.19 | Rake $0.01 
Board [4d Ks Qc]
Seat 1: hc agorist (button) collected ($0.18)
Seat 2: lisiyzidan (small blind) folded before Flop
Seat 3: Discco (big blind) folded on the Flop
Seat 4: phenix140 folded before Flop (didn't bet)
Seat 5: firebrigadenor folded before Flop (didn't bet)
Seat 6: BookerDW1912 folded before Flop (didn't bet)



PokerStars Zoom Hand #193806240700:  Hold'em No Limit ($0.01/$0.02) - 2018/11/28 1:24:15 CUST [2018/11/27 12:24:15 ET]
Table 'Halley' 6-max Seat #1 is the button
Seat 1: GreyKeeperRu ($2.12 in chips) 
Seat 2: RM432 ($2 in chips) 
Seat 3: Lacoste900 ($1.98 in chips) 
Seat 4: liryka ($2.12 in chips) 
Seat 5: Nooffub ($2.32 in chips) 
Seat 6: hc agorist ($4.31 in chips) 
RM432: posts small blind $0.01
Lacoste900: posts big blind $0.02
*** HOLE CARDS ***
Dealt to hc agorist [6c Ah]
liryka: folds 
Nooffub: folds 
hc agorist: raises $0.02 to $0.04
GreyKeeperRu: folds 
RM432: calls $0.03
Lacoste900: calls $0.02
*** FLOP *** [2h Qs Ks]
RM432: checks 
Lacoste900: checks 
hc agorist: checks 
*** TURN *** [2h Qs Ks] [Th]
RM432: checks 
Lacoste900: checks 
hc agorist: checks 
*** RIVER *** [2h Qs Ks Th] [9c]
RM432: checks 
Lacoste900: bets $0.12
hc agorist: folds 
RM432: folds 
Uncalled bet ($0.12) returned to Lacoste900
Lacoste900 collected $0.12 from pot
Lacoste900: doesn't show hand 
*** SUMMARY ***
Total pot $0.12 | Rake $0 
Board [2h Qs Ks Th 9c]
Seat 1: GreyKeeperRu (button) folded before Flop (didn't bet)
Seat 2: RM432 (small blind) folded on the River
Seat 3: Lacoste900 (big blind) collected ($0.12)
Seat 4: liryka folded before Flop (didn't bet)
Seat 5: Nooffub folded before Flop (didn't bet)
Seat 6: hc agorist folded on the River



PokerStars Zoom Hand #193806251351:  Hold'em No Limit ($0.01/$0.02) - 2018/11/28 1:24:33 CUST [2018/11/27 12:24:33 ET]
Table 'Halley' 6-max Seat #1 is the button
Seat 1: Evgen1907 ($2 in chips) 
Seat 2: Pamposek ($2.46 in chips) 
Seat 3: hc agorist ($4.27 in chips) 
Seat 4: liryka ($3.04 in chips) 
Seat 5: Kokosya ($2 in chips) 
Seat 6: jaasso86 ($2.12 in chips) 
Pamposek: posts small blind $0.01
hc agorist: posts big blind $0.02
*** HOLE CARDS ***
Dealt to hc agorist [9s 5d]
liryka: folds 
Kokosya: folds 
jaasso86: folds 
Evgen1907: folds 
Pamposek: raises $0.04 to $0.06
hc agorist: folds 
Uncalled bet ($0.04) returned to Pamposek
Pamposek collected $0.04 from pot
Pamposek: doesn't show hand 
*** SUMMARY ***
Total pot $0.04 | Rake $0 
Seat 1: Evgen1907 (button) folded before Flop (didn't bet)
Seat 2: Pamposek (small blind) collected ($0.04)
Seat 3: hc agorist (big blind) folded before Flop
Seat 4: liryka folded before Flop (didn't bet)
Seat 5: Kokosya folded before Flop (didn't bet)
Seat 6: jaasso86 folded before Flop (didn't bet)



PokerStars Zoom Hand #193806258597:  Hold'em No Limit ($0.01/$0.02) - 2018/11/28 1:24:45 CUST [2018/11/27 12:24:45 ET]
Table 'Halley' 6-max Seat #1 is the button
Seat 1: de_wlnss ($2.07 in chips) 
Seat 2: Eveyor ($5.89 in chips) 
Seat 3: Kala77 ($4.08 in chips) 
Seat 4: hc agorist ($4.25 in chips) 
Seat 5: Artuzinio ($3.60 in chips) 
Seat 6: WinziF ($2 in chips) 
Eveyor: posts small blind $0.01
Kala77: posts big blind $0.02
*** HOLE CARDS ***
Dealt to hc agorist [6d 7d]
hc agorist: raises $0.02 to $0.04
Artuzinio: folds 
WinziF: folds 
de_wlnss: folds 
Eveyor: folds 
Kala77: calls $0.02
*** FLOP *** [Jc As Kd]
Kala77: checks 
hc agorist: bets $0.03
Kala77: folds 
Uncalled bet ($0.03) returned to hc agorist
hc agorist collected $0.09 from pot
hc agorist: doesn't show hand 
*** SUMMARY ***
Total pot $0.09 | Rake $0 
Board [Jc As Kd]
Seat 1: de_wlnss (button) folded before Flop (didn't bet)
Seat 2: Eveyor (small blind) folded before Flop
Seat 3: Kala77 (big blind) folded on the Flop
Seat 4: hc agorist collected ($0.09)
Seat 5: Artuzinio folded before Flop (didn't bet)
Seat 6: WinziF folded before Flop (didn't bet)



PokerStars Zoom Hand #193806274950:  Hold'em No Limit ($0.01/$0.02) - 2018/11/28 1:25:12 CUST [2018/11/27 12:25:12 ET]
Table 'Halley' 6-max Seat #1 is the button
Seat 1: Damian36215 ($2.97 in chips) 
Seat 2: yuratan ($4.70 in chips) 
Seat 3: kensho25 ($0.55 in chips) 
Seat 4: hc agorist ($4.30 in chips) 
Seat 5: myk 6334797 ($1.56 in chips) 
Seat 6: LexLuther499 ($2.94 in chips) 
yuratan: posts small blind $0.01
kensho25: posts big blind $0.02
*** HOLE CARDS ***
Dealt to hc agorist [8h 6h]
hc agorist: raises $0.02 to $0.04
myk 6334797: folds 
LexLuther499: folds 
Damian36215: folds 
yuratan: folds 
kensho25: folds 
Uncalled bet ($0.02) returned to hc agorist
hc agorist collected $0.05 from pot
hc agorist: doesn't show hand 
*** SUMMARY ***
Total pot $0.05 | Rake $0 
Seat 1: Damian36215 (button) folded before Flop (didn't bet)
Seat 2: yuratan (small blind) folded before Flop
Seat 3: kensho25 (big blind) folded before Flop
Seat 4: hc agorist collected ($0.05)
Seat 5: myk 6334797 folded before Flop (didn't bet)
Seat 6: LexLuther499 folded before Flop (didn't bet)



PokerStars Zoom Hand #193806284565:  Hold'em No Limit ($0.01/$0.02) - 2018/11/28 1:25:28 CUST [2018/11/27 12:25:28 ET]
Table 'Halley' 6-max Seat #1 is the button
Seat 1: hc agorist ($4.33 in chips) 
Seat 2: vovan100157 ($2.10 in chips) 
Seat 3: simensgh ($1.10 in chips) 
Seat 4: pvmonstro ($0.94 in chips) 
Seat 5: Michel Mata ($2.22 in chips) 
Seat 6: Toecloth ($2.51 in chips) 
vovan100157: posts small blind $0.01
simensgh: posts big blind $0.02
*** HOLE CARDS ***
Dealt to hc agorist [6d 8d]
pvmonstro: folds 
Michel Mata: folds 
Toecloth: raises $0.03 to $0.05
hc agorist: calls $0.05
vovan100157: folds 
simensgh: folds 
*** FLOP *** [8c As 9s]
Toecloth: bets $0.07
hc agorist: calls $0.07
*** TURN *** [8c As 9s] [7h]
Toecloth: checks 
hc agorist: checks 
*** RIVER *** [8c As 9s 7h] [9d]
Toecloth: checks 
hc agorist: checks 
*** SHOW DOWN ***
Toecloth: shows [Kh Jc] (a pair of Nines)
hc agorist: shows [6d 8d] (two pair, Nines and Eights)
hc agorist collected $0.26 from pot
*** SUMMARY ***
Total pot $0.27 | Rake $0.01 
Board [8c As 9s 7h 9d]
Seat 1: hc agorist (button) showed [6d 8d] and won ($0.26) with two pair, Nines and Eights
Seat 2: vovan100157 (small blind) folded before Flop
Seat 3: simensgh (big blind) folded before Flop
Seat 4: pvmonstro folded before Flop (didn't bet)
Seat 5: Michel Mata folded before Flop (didn't bet)
Seat 6: Toecloth showed [Kh Jc] and lost with a pair of Nines



PokerStars Zoom Hand #193806309752:  Hold'em No Limit ($0.01/$0.02) - 2018/11/28 1:26:10 CUST [2018/11/27 12:26:10 ET]
Table 'Halley' 6-max Seat #1 is the button
Seat 1: almanik ($1.76 in chips) 
Seat 2: moskita789 ($1.92 in chips) 
Seat 3: MooKoR ($2.21 in chips) 
Seat 4: hc agorist ($4.47 in chips) 
Seat 5: feijão84 ($1.94 in chips) 
Seat 6: Taisei4400 ($2.59 in chips) 
moskita789: posts small blind $0.01
MooKoR: posts big blind $0.02
*** HOLE CARDS ***
Dealt to hc agorist [6h 6c]
hc agorist: raises $0.04 to $0.06
feijão84: folds 
Taisei4400: folds 
almanik: calls $0.06
moskita789: folds 
MooKoR: folds 
*** FLOP *** [Jc 9h 5s]
hc agorist: checks 
almanik: bets $0.07
hc agorist: folds 
Uncalled bet ($0.07) returned to almanik
almanik collected $0.14 from pot
almanik: doesn't show hand 
*** SUMMARY ***
Total pot $0.15 | Rake $0.01 
Board [Jc 9h 5s]
Seat 1: almanik (button) collected ($0.14)
Seat 2: moskita789 (small blind) folded before Flop
Seat 3: MooKoR (big blind) folded before Flop
Seat 4: hc agorist folded on the Flop
Seat 5: feijão84 folded before Flop (didn't bet)
Seat 6: Taisei4400 folded before Flop (didn't bet)



PokerStars Zoom Hand #193806330270:  Hold'em No Limit ($0.01/$0.02) - 2018/11/28 1:26:44 CUST [2018/11/27 12:26:44 ET]
Table 'Halley' 6-max Seat #1 is the button
Seat 1: 27magneto27 ($2.03 in chips) 
Seat 2: Tigor30 ($2.27 in chips) 
Seat 3: bodobogdan1 ($3.70 in chips) 
Seat 4: Arfur Melon ($1.89 in chips) 
Seat 5: sixtyseven67 ($9 in chips) 
Seat 6: hc agorist ($4.41 in chips) 
Tigor30: posts small blind $0.01
bodobogdan1: posts big blind $0.02
*** HOLE CARDS ***
Dealt to hc agorist [3c Th]
Arfur Melon: folds 
sixtyseven67: raises $0.04 to $0.06
hc agorist: folds 
27magneto27: folds 
Tigor30: calls $0.05
bodobogdan1: raises $0.06 to $0.12
sixtyseven67: raises $0.39 to $0.51
Tigor30: folds 
bodobogdan1: folds 
Uncalled bet ($0.39) returned to sixtyseven67
sixtyseven67 collected $0.30 from pot
sixtyseven67: doesn't show hand 
*** SUMMARY ***
Total pot $0.30 | Rake $0 
Seat 1: 27magneto27 (button) folded before Flop (didn't bet)
Seat 2: Tigor30 (small blind) folded before Flop
Seat 3: bodobogdan1 (big blind) folded before Flop
Seat 4: Arfur Melon folded before Flop (didn't bet)
Seat 5: sixtyseven67 collected ($0.30)
Seat 6: hc agorist folded before Flop (didn't bet)



PokerStars Zoom Hand #193806342927:  Hold'em No Limit ($0.01/$0.02) - 2018/11/28 1:27:05 CUST [2018/11/27 12:27:05 ET]
Table 'Halley' 6-max Seat #1 is the button
Seat 1: moskita789 ($1.89 in chips) 
Seat 2: hc agorist ($4.39 in chips) 
Seat 3: viktor49ru ($2.01 in chips) 
Seat 4: DiMoWo ($2.09 in chips) 
Seat 5: yuratan ($6.54 in chips) 
Seat 6: Puqo ($2 in chips) 
hc agorist: posts small blind $0.01
viktor49ru: posts big blind $0.02
*** HOLE CARDS ***
Dealt to hc agorist [7h 8h]
DiMoWo: folds 
yuratan: folds 
Puqo: folds 
moskita789: raises $0.04 to $0.06
hc agorist: raises $0.14 to $0.20
viktor49ru: folds 
moskita789: raises $1.69 to $1.89 and is all-in
hc agorist: folds 
Uncalled bet ($1.69) returned to moskita789
moskita789 collected $0.42 from pot
moskita789: doesn't show hand 
*** SUMMARY ***
Total pot $0.42 | Rake $0 
Seat 1: moskita789 (button) collected ($0.42)
Seat 2: hc agorist (small blind) folded before Flop
Seat 3: viktor49ru (big blind) folded before Flop
Seat 4: DiMoWo folded before Flop (didn't bet)
Seat 5: yuratan folded before Flop (didn't bet)
Seat 6: Puqo folded before Flop (didn't bet)



PokerStars Zoom Hand #193806336226:  Hold'em No Limit ($0.01/$0.02) - 2018/11/28 1:26:54 CUST [2018/11/27 12:26:54 ET]
Table 'Halley' 6-max Seat #1 is the button
Seat 1: amaposh ($2.56 in chips) 
Seat 2: atsuj007 ($1.88 in chips) 
Seat 3: hc agorist ($4.41 in chips) 
Seat 4: MonqoI ($5.17 in chips) 
Seat 5: dawidstr ($2.48 in chips) 
Seat 6: mbw777999777 ($2.72 in chips) 
atsuj007: posts small blind $0.01
hc agorist: posts big blind $0.02
*** HOLE CARDS ***
Dealt to hc agorist [Qh 6s]
MonqoI: folds 
dawidstr: raises $0.04 to $0.06
mbw777999777: folds 
amaposh: folds 
atsuj007: raises $0.04 to $0.10
hc agorist: folds 
dawidstr: calls $0.04
*** FLOP *** [Qd Jd Jh]
atsuj007: checks 
dawidstr: bets $0.14
atsuj007: calls $0.14
*** TURN *** [Qd Jd Jh] [7s]
atsuj007: checks 
dawidstr: bets $0.32
atsuj007: folds 
Uncalled bet ($0.32) returned to dawidstr
dawidstr collected $0.48 from pot
dawidstr: doesn't show hand 
*** SUMMARY ***
Total pot $0.50 | Rake $0.02 
Board [Qd Jd Jh 7s]
Seat 1: amaposh (button) folded before Flop (didn't bet)
Seat 2: atsuj007 (small blind) folded on the Turn
Seat 3: hc agorist (big blind) folded before Flop
Seat 4: MonqoI folded before Flop (didn't bet)
Seat 5: dawidstr collected ($0.48)
Seat 6: mbw777999777 folded before Flop (didn't bet)



PokerStars Zoom Hand #193806365714:  Hold'em No Limit ($0.01/$0.02) - 2018/11/28 1:27:43 CUST [2018/11/27 12:27:43 ET]
Table 'Halley' 6-max Seat #1 is the button
Seat 1: kondzio93 ($0.65 in chips) 
Seat 2: k26_qtxqtx14 ($2 in chips) 
Seat 3: moose7604 ($1.03 in chips) 
Seat 4: Glivera77 ($2.43 in chips) 
Seat 5: hc agorist ($4.19 in chips) 
Seat 6: RM432 ($2.40 in chips) 
k26_qtxqtx14: posts small blind $0.01
moose7604: posts big blind $0.02
*** HOLE CARDS ***
Dealt to hc agorist [Ad 5c]
Glivera77: folds 
hc agorist: folds 
RM432: raises $0.03 to $0.05
kondzio93: folds 
k26_qtxqtx14: folds 
moose7604: folds 
Uncalled bet ($0.03) returned to RM432
RM432 collected $0.05 from pot
RM432: doesn't show hand 
*** SUMMARY ***
Total pot $0.05 | Rake $0 
Seat 1: kondzio93 (button) folded before Flop (didn't bet)
Seat 2: k26_qtxqtx14 (small blind) folded before Flop
Seat 3: moose7604 (big blind) folded before Flop
Seat 4: Glivera77 folded before Flop (didn't bet)
Seat 5: hc agorist folded before Flop (didn't bet)
Seat 6: RM432 collected ($0.05)



PokerStars Zoom Hand #193806371712:  Hold'em No Limit ($0.01/$0.02) - 2018/11/28 1:27:53 CUST [2018/11/27 12:27:53 ET]
Table 'Halley' 6-max Seat #1 is the button
Seat 1: StrikeG312 ($2.08 in chips) 
Seat 2: stevejack222 ($1.98 in chips) 
Seat 3: vins787 ($1.37 in chips) 
Seat 4: zergmiky ($2 in chips) 
Seat 5: PassiStar66X ($2.01 in chips) 
Seat 6: hc agorist ($4.19 in chips) 
stevejack222: posts small blind $0.01
vins787: posts big blind $0.02
*** HOLE CARDS ***
Dealt to hc agorist [3s Js]
zergmiky: raises $0.04 to $0.06
PassiStar66X: folds 
hc agorist: folds 
StrikeG312: folds 
stevejack222: folds 
vins787: folds 
Uncalled bet ($0.04) returned to zergmiky
zergmiky collected $0.05 from pot
zergmiky: doesn't show hand 
*** SUMMARY ***
Total pot $0.05 | Rake $0 
Seat 1: StrikeG312 (button) folded before Flop (didn't bet)
Seat 2: stevejack222 (small blind) folded before Flop
Seat 3: vins787 (big blind) folded before Flop
Seat 4: zergmiky collected ($0.05)
Seat 5: PassiStar66X folded before Flop (didn't bet)
Seat 6: hc agorist folded before Flop (didn't bet)



PokerStars Zoom Hand #193806368768:  Hold'em No Limit ($0.01/$0.02) - 2018/11/28 1:27:48 CUST [2018/11/27 12:27:48 ET]
Table 'Halley' 6-max Seat #1 is the button
Seat 1: hc agorist ($4.19 in chips) 
Seat 2: elpsycongr0 ($4.60 in chips) 
Seat 3: mich051260 ($2 in chips) 
Seat 4: Cobbler43 ($3.27 in chips) 
Seat 5: YuraM26 ($2 in chips) 
Seat 6: Tuxui y)l(ac ($5.11 in chips) 
elpsycongr0: posts small blind $0.01
mich051260: posts big blind $0.02
*** HOLE CARDS ***
Dealt to hc agorist [Jc 7d]
Cobbler43: folds 
YuraM26: folds 
Tuxui y)l(ac: raises $0.04 to $0.06
hc agorist: folds 
elpsycongr0: folds 
mich051260: calls $0.04
*** FLOP *** [5d 5h Qd]
mich051260: bets $0.02
Tuxui y)l(ac: folds 
Uncalled bet ($0.02) returned to mich051260
mich051260 collected $0.13 from pot
mich051260: doesn't show hand 
*** SUMMARY ***
Total pot $0.13 | Rake $0 
Board [5d 5h Qd]
Seat 1: hc agorist (button) folded before Flop (didn't bet)
Seat 2: elpsycongr0 (small blind) folded before Flop
Seat 3: mich051260 (big blind) collected ($0.13)
Seat 4: Cobbler43 folded before Flop (didn't bet)
Seat 5: YuraM26 folded before Flop (didn't bet)
Seat 6: Tuxui y)l(ac folded on the Flop



PokerStars Zoom Hand #193806374772:  Hold'em No Limit ($0.01/$0.02) - 2018/11/28 1:27:58 CUST [2018/11/27 12:27:58 ET]
Table 'Halley' 6-max Seat #1 is the button
Seat 1: guelek ($2 in chips) 
Seat 2: hc agorist ($4.19 in chips) 
Seat 3: DominoPlayer ($4.27 in chips) 
Seat 4: XMrMojoRisinX ($2.10 in chips) 
Seat 5: dawidstr ($2.52 in chips) 
Seat 6: Maru1712 ($1.71 in chips) 
hc agorist: posts small blind $0.01
DominoPlayer: posts big blind $0.02
*** HOLE CARDS ***
Dealt to hc agorist [Kd Kh]
XMrMojoRisinX: folds 
dawidstr: folds 
Maru1712: folds 
guelek: raises $0.03 to $0.05
hc agorist: raises $0.12 to $0.17
DominoPlayer: folds 
guelek: folds 
Uncalled bet ($0.12) returned to hc agorist
hc agorist collected $0.12 from pot
hc agorist: doesn't show hand 
*** SUMMARY ***
Total pot $0.12 | Rake $0 
Seat 1: guelek (button) folded before Flop
Seat 2: hc agorist (small blind) collected ($0.12)
Seat 3: DominoPlayer (big blind) folded before Flop
Seat 4: XMrMojoRisinX folded before Flop (didn't bet)
Seat 5: dawidstr folded before Flop (didn't bet)
Seat 6: Maru1712 folded before Flop (didn't bet)



PokerStars Zoom Hand #193806391528:  Hold'em No Limit ($0.01/$0.02) - 2018/11/28 1:28:26 CUST [2018/11/27 12:28:26 ET]
Table 'Halley' 6-max Seat #1 is the button
Seat 1: V-SCORPIO-C ($3.20 in chips) 
Seat 2: PritkovO ($2.73 in chips) 
Seat 3: hc agorist ($4.26 in chips) 
Seat 4: seluytin ($0.91 in chips) 
Seat 5: amaposh ($2.48 in chips) 
Seat 6: razzdvatri ($2.65 in chips) 
PritkovO: posts small blind $0.01
hc agorist: posts big blind $0.02
*** HOLE CARDS ***
Dealt to hc agorist [Kd 4c]
seluytin: raises $0.04 to $0.06
amaposh: folds 
razzdvatri: folds 
V-SCORPIO-C: folds 
PritkovO: folds 
hc agorist: folds 
Uncalled bet ($0.04) returned to seluytin
seluytin collected $0.05 from pot
seluytin: doesn't show hand 
*** SUMMARY ***
Total pot $0.05 | Rake $0 
Seat 1: V-SCORPIO-C (button) folded before Flop (didn't bet)
Seat 2: PritkovO (small blind) folded before Flop
Seat 3: hc agorist (big blind) folded before Flop
Seat 4: seluytin collected ($0.05)
Seat 5: amaposh folded before Flop (didn't bet)
Seat 6: razzdvatri folded before Flop (didn't bet)



PokerStars Zoom Hand #193806388586:  Hold'em No Limit ($0.01/$0.02) - 2018/11/28 1:28:21 CUST [2018/11/27 12:28:21 ET]
Table 'Halley' 6-max Seat #1 is the button
Seat 1: murasak1 ($2.49 in chips) 
Seat 2: Mackerel12 ($2.24 in chips) 
Seat 3: SerhioGavrilini ($2.10 in chips) 
Seat 4: BlaZeR89999 ($2.11 in chips) 
Seat 5: hc agorist ($4.26 in chips) 
Seat 6: Rimas98 ($4.24 in chips) 
Mackerel12: posts small blind $0.01
SerhioGavrilini: posts big blind $0.02
*** HOLE CARDS ***
Dealt to hc agorist [Tc 5h]
BlaZeR89999: folds 
hc agorist: folds 
Rimas98: folds 
murasak1: raises $0.04 to $0.06
Mackerel12: folds 
SerhioGavrilini: raises $0.08 to $0.14
murasak1: folds 
Uncalled bet ($0.08) returned to SerhioGavrilini
SerhioGavrilini collected $0.13 from pot
SerhioGavrilini: doesn't show hand 
*** SUMMARY ***
Total pot $0.13 | Rake $0 
Seat 1: murasak1 (button) folded before Flop
Seat 2: Mackerel12 (small blind) folded before Flop
Seat 3: SerhioGavrilini (big blind) collected ($0.13)
Seat 4: BlaZeR89999 folded before Flop (didn't bet)
Seat 5: hc agorist folded before Flop (didn't bet)
Seat 6: Rimas98 folded before Flop (didn't bet)



PokerStars Zoom Hand #193806399846:  Hold'em No Limit ($0.01/$0.02) - 2018/11/28 1:28:40 CUST [2018/11/27 12:28:40 ET]
Table 'Halley' 6-max Seat #1 is the button
Seat 1: simensgh ($1.31 in chips) 
Seat 2: Vicoxzjke ($3.06 in chips) 
Seat 3: Evgen1907 ($4.53 in chips) 
Seat 4: Karel33555 ($2.43 in chips) 
Seat 5: hc agorist ($4.24 in chips) 
Seat 6: Bloodclub94 ($3.68 in chips) 
Vicoxzjke: posts small blind $0.01
Evgen1907: posts big blind $0.02
*** HOLE CARDS ***
Dealt to hc agorist [6s Td]
Karel33555: folds 
hc agorist: folds 
Bloodclub94: folds 
simensgh: folds 
Vicoxzjke: raises $0.04 to $0.06
Evgen1907: folds 
Uncalled bet ($0.04) returned to Vicoxzjke
Vicoxzjke collected $0.04 from pot
Vicoxzjke: doesn't show hand 
*** SUMMARY ***
Total pot $0.04 | Rake $0 
Seat 1: simensgh (button) folded before Flop (didn't bet)
Seat 2: Vicoxzjke (small blind) collected ($0.04)
Seat 3: Evgen1907 (big blind) folded before Flop
Seat 4: Karel33555 folded before Flop (didn't bet)
Seat 5: hc agorist folded before Flop (didn't bet)
Seat 6: Bloodclub94 folded before Flop (didn't bet)



PokerStars Zoom Hand #193806402914:  Hold'em No Limit ($0.01/$0.02) - 2018/11/28 1:28:45 CUST [2018/11/27 12:28:45 ET]
Table 'Halley' 6-max Seat #1 is the button
Seat 1: abdyl 1989 ($0.97 in chips) 
Seat 2: elionspecter ($3.01 in chips) 
Seat 3: Chaca273 ($2.07 in chips) 
Seat 4: dedmoroz311 ($2.41 in chips) 
Seat 5: darkoldmaker ($2.13 in chips) 
Seat 6: hc agorist ($4.24 in chips) 
elionspecter: posts small blind $0.01
Chaca273: posts big blind $0.02
*** HOLE CARDS ***
Dealt to hc agorist [Tc Qh]
dedmoroz311: raises $0.02 to $0.04
darkoldmaker: folds 
hc agorist: raises $0.11 to $0.15
abdyl 1989: folds 
elionspecter: folds 
Chaca273: folds 
dedmoroz311: folds 
Uncalled bet ($0.11) returned to hc agorist
hc agorist collected $0.11 from pot
hc agorist: doesn't show hand 
*** SUMMARY ***
Total pot $0.11 | Rake $0 
Seat 1: abdyl 1989 (button) folded before Flop (didn't bet)
Seat 2: elionspecter (small blind) folded before Flop
Seat 3: Chaca273 (big blind) folded before Flop
Seat 4: dedmoroz311 folded before Flop
Seat 5: darkoldmaker folded before Flop (didn't bet)
Seat 6: hc agorist collected ($0.11)



PokerStars Zoom Hand #193806396912:  Hold'em No Limit ($0.01/$0.02) - 2018/11/28 1:28:35 CUST [2018/11/27 12:28:35 ET]
Table 'Halley' 6-max Seat #1 is the button
Seat 1: Prometey1828 ($2.48 in chips) 
Seat 2: Saukra ($2.10 in chips) 
Seat 3: jparkorean ($2 in chips) 
Seat 4: hc agorist ($4.24 in chips) 
Seat 5: Taisei4400 ($3.72 in chips) 
Seat 6: whitefenix16 ($2 in chips) 
Saukra: posts small blind $0.01
jparkorean: posts big blind $0.02
*** HOLE CARDS ***
Dealt to hc agorist [4s 2h]
hc agorist: folds 
Taisei4400: folds 
whitefenix16: folds 
Prometey1828: raises $0.02 to $0.04
Saukra: calls $0.03
jparkorean: folds 
*** FLOP *** [4d 9d 9c]
Saukra: checks 
Prometey1828: bets $0.05
Saukra: calls $0.05
*** TURN *** [4d 9d 9c] [Ac]
Saukra: checks 
Prometey1828: checks 
*** RIVER *** [4d 9d 9c Ac] [Ah]
Saukra: checks 
Prometey1828: checks 
*** SHOW DOWN ***
Saukra: shows [7d 7h] (two pair, Aces and Nines)
Prometey1828: shows [Ts Kh] (two pair, Aces and Nines - King kicker)
Prometey1828 collected $0.19 from pot
*** SUMMARY ***
Total pot $0.20 | Rake $0.01 
Board [4d 9d 9c Ac Ah]
Seat 1: Prometey1828 (button) showed [Ts Kh] and won ($0.19) with two pair, Aces and Nines
Seat 2: Saukra (small blind) showed [7d 7h] and lost with two pair, Aces and Nines
Seat 3: jparkorean (big blind) folded before Flop
Seat 4: hc agorist folded before Flop (didn't bet)
Seat 5: Taisei4400 folded before Flop (didn't bet)
Seat 6: whitefenix16 folded before Flop (didn't bet)



PokerStars Zoom Hand #193806415116:  Hold'em No Limit ($0.01/$0.02) - 2018/11/28 1:29:05 CUST [2018/11/27 12:29:05 ET]
Table 'Halley' 6-max Seat #1 is the button
Seat 1: hc agorist ($4.31 in chips) 
Seat 2: Damian36215 ($2.81 in chips) 
Seat 3: mikhail3434 ($1.89 in chips) 
Seat 4: Alien Surfin ($2.31 in chips) 
Seat 5: Maru1712 ($1.68 in chips) 
Seat 6: XMrMojoRisinX ($2 in chips) 
Damian36215: posts small blind $0.01
mikhail3434: posts big blind $0.02
*** HOLE CARDS ***
Dealt to hc agorist [As 3s]
Alien Surfin: raises $0.04 to $0.06
Maru1712: folds 
XMrMojoRisinX: folds 
hc agorist: calls $0.06
Damian36215: folds 
mikhail3434: folds 
*** FLOP *** [8h 5s 4c]
Alien Surfin: checks 
hc agorist: bets $0.08
Alien Surfin: folds 
Uncalled bet ($0.08) returned to hc agorist
hc agorist collected $0.14 from pot
hc agorist: doesn't show hand 
*** SUMMARY ***
Total pot $0.15 | Rake $0.01 
Board [8h 5s 4c]
Seat 1: hc agorist (button) collected ($0.14)
Seat 2: Damian36215 (small blind) folded before Flop
Seat 3: mikhail3434 (big blind) folded before Flop
Seat 4: Alien Surfin folded on the Flop
Seat 5: Maru1712 folded before Flop (didn't bet)
Seat 6: XMrMojoRisinX folded before Flop (didn't bet)



PokerStars Zoom Hand #193806434869:  Hold'em No Limit ($0.01/$0.02) - 2018/11/28 1:29:38 CUST [2018/11/27 12:29:38 ET]
Table 'Halley' 6-max Seat #1 is the button
Seat 1: sakuraakina ($2.33 in chips) 
Seat 2: AlexGalimov ($2.35 in chips) 
Seat 3: hc agorist ($4.38 in chips) 
Seat 4: 27magneto27 ($2 in chips) 
Seat 5: GreyKeeperRu ($2.07 in chips) 
Seat 6: Gesyy ($2.06 in chips) 
AlexGalimov: posts small blind $0.01
hc agorist: posts big blind $0.02
*** HOLE CARDS ***
Dealt to hc agorist [Qh 4h]
27magneto27: folds 
GreyKeeperRu: folds 
Gesyy: folds 
sakuraakina: folds 
AlexGalimov: folds 
Uncalled bet ($0.01) returned to hc agorist
hc agorist collected $0.02 from pot
hc agorist: doesn't show hand 
*** SUMMARY ***
Total pot $0.02 | Rake $0 
Seat 1: sakuraakina (button) folded before Flop (didn't bet)
Seat 2: AlexGalimov (small blind) folded before Flop
Seat 3: hc agorist (big blind) collected ($0.02)
Seat 4: 27magneto27 folded before Flop (didn't bet)
Seat 5: GreyKeeperRu folded before Flop (didn't bet)
Seat 6: Gesyy folded before Flop (didn't bet)



PokerStars Zoom Hand #193806431792:  Hold'em No Limit ($0.01/$0.02) - 2018/11/28 1:29:33 CUST [2018/11/27 12:29:33 ET]
Table 'Halley' 6-max Seat #1 is the button
Seat 1: dziad1985 ($1.07 in chips) 
Seat 2: hc agorist ($4.39 in chips) 
Seat 3: abatur0 ($1.07 in chips) 
Seat 4: COURT JES264 ($5.52 in chips) 
Seat 5: Banker Deniz ($2.04 in chips) 
Seat 6: lootingcall ($3.40 in chips) 
hc agorist: posts small blind $0.01
abatur0: posts big blind $0.02
*** HOLE CARDS ***
Dealt to hc agorist [Ac 7h]
COURT JES264: folds 
Banker Deniz: raises $0.04 to $0.06
lootingcall: folds 
dziad1985: folds 
hc agorist: folds 
abatur0: folds 
Uncalled bet ($0.04) returned to Banker Deniz
Banker Deniz collected $0.05 from pot
Banker Deniz: doesn't show hand 
*** SUMMARY ***
Total pot $0.05 | Rake $0 
Seat 1: dziad1985 (button) folded before Flop (didn't bet)
Seat 2: hc agorist (small blind) folded before Flop
Seat 3: abatur0 (big blind) folded before Flop
Seat 4: COURT JES264 folded before Flop (didn't bet)
Seat 5: Banker Deniz collected ($0.05)
Seat 6: lootingcall folded before Flop (didn't bet)



PokerStars Zoom Hand #193806445107:  Hold'em No Limit ($0.01/$0.02) - 2018/11/28 1:29:55 CUST [2018/11/27 12:29:55 ET]
Table 'Halley' 6-max Seat #1 is the button
Seat 1: yuratan ($6.47 in chips) 
Seat 2: AlexGalimov ($12.03 in chips) 
Seat 3: shogi17 ($4.39 in chips) 
Seat 4: hc agorist ($4.39 in chips) 
Seat 5: Man Crimea ($1.09 in chips) 
Seat 6: Liddy79 ($2 in chips) 
AlexGalimov: posts small blind $0.01
shogi17: posts big blind $0.02
*** HOLE CARDS ***
Dealt to hc agorist [6h 2d]
hc agorist: folds 
Man Crimea: folds 
Liddy79: raises $0.03 to $0.05
yuratan: folds 
AlexGalimov: folds 
shogi17: calls $0.03
*** FLOP *** [2c 6d 8h]
shogi17: checks 
Liddy79: checks 
*** TURN *** [2c 6d 8h] [2h]
shogi17: bets $0.08
Liddy79: calls $0.08
*** RIVER *** [2c 6d 8h 2h] [Ts]
shogi17: checks 
Liddy79: bets $0.16
shogi17: folds 
Uncalled bet ($0.16) returned to Liddy79
Liddy79 collected $0.26 from pot
Liddy79: doesn't show hand 
*** SUMMARY ***
Total pot $0.27 | Rake $0.01 
Board [2c 6d 8h 2h Ts]
Seat 1: yuratan (button) folded before Flop (didn't bet)
Seat 2: AlexGalimov (small blind) folded before Flop
Seat 3: shogi17 (big blind) folded on the River
Seat 4: hc agorist folded before Flop (didn't bet)
Seat 5: Man Crimea folded before Flop (didn't bet)
Seat 6: Liddy79 collected ($0.26)



PokerStars Zoom Hand #193806442127:  Hold'em No Limit ($0.01/$0.02) - 2018/11/28 1:29:50 CUST [2018/11/27 12:29:50 ET]
Table 'Halley' 6-max Seat #1 is the button
Seat 1: hc agorist ($4.39 in chips) 
Seat 2: a.leuphana ($2.80 in chips) 
Seat 3: djafar63 ($3.55 in chips) 
Seat 4: Krawicz ($2.03 in chips) 
Seat 5: Chaca273 ($2.47 in chips) 
Seat 6: fdoTeam ($2.77 in chips) 
a.leuphana: posts small blind $0.01
djafar63: posts big blind $0.02
*** HOLE CARDS ***
Dealt to hc agorist [3h 2s]
Krawicz: folds 
Chaca273: folds 
fdoTeam: folds 
hc agorist: folds 
a.leuphana: raises $0.05 to $0.07
djafar63: calls $0.05
*** FLOP *** [Kc 9h As]
a.leuphana: bets $0.07
djafar63: calls $0.07
*** TURN *** [Kc 9h As] [Jh]
a.leuphana: bets $0.14
djafar63: folds 
Uncalled bet ($0.14) returned to a.leuphana
a.leuphana collected $0.27 from pot
a.leuphana: doesn't show hand 
*** SUMMARY ***
Total pot $0.28 | Rake $0.01 
Board [Kc 9h As Jh]
Seat 1: hc agorist (button) folded before Flop (didn't bet)
Seat 2: a.leuphana (small blind) collected ($0.27)
Seat 3: djafar63 (big blind) folded on the Turn
Seat 4: Krawicz folded before Flop (didn't bet)
Seat 5: Chaca273 folded before Flop (didn't bet)
Seat 6: fdoTeam folded before Flop (didn't bet)



PokerStars Zoom Hand #193806454177:  Hold'em No Limit ($0.01/$0.02) - 2018/11/28 1:30:10 CUST [2018/11/27 12:30:10 ET]
Table 'Halley' 6-max Seat #1 is the button
Seat 1: MonqoI ($5.09 in chips) 
Seat 2: jigan8181 ($2.01 in chips) 
Seat 3: newby270389 ($2.95 in chips) 
Seat 4: Kokosya ($2.51 in chips) 
Seat 5: gary01407 ($3.86 in chips) 
Seat 6: hc agorist ($4.39 in chips) 
jigan8181: posts small blind $0.01
newby270389: posts big blind $0.02
*** HOLE CARDS ***
Dealt to hc agorist [7h 8h]
Kokosya: folds 
gary01407: folds 
hc agorist: raises $0.02 to $0.04
MonqoI: folds 
jigan8181: folds 
newby270389: calls $0.02
*** FLOP *** [5c 2h Jc]
newby270389: checks 
hc agorist: bets $0.03
newby270389: raises $0.11 to $0.14
hc agorist: folds 
Uncalled bet ($0.11) returned to newby270389
newby270389 collected $0.14 from pot
newby270389: doesn't show hand 
*** SUMMARY ***
Total pot $0.15 | Rake $0.01 
Board [5c 2h Jc]
Seat 1: MonqoI (button) folded before Flop (didn't bet)
Seat 2: jigan8181 (small blind) folded before Flop
Seat 3: newby270389 (big blind) collected ($0.14)
Seat 4: Kokosya folded before Flop (didn't bet)
Seat 5: gary01407 folded before Flop (didn't bet)
Seat 6: hc agorist folded on the Flop



PokerStars Zoom Hand #193806448167:  Hold'em No Limit ($0.01/$0.02) - 2018/11/28 1:30:00 CUST [2018/11/27 12:30:00 ET]
Table 'Halley' 6-max Seat #1 is the button
Seat 1: villian888 ($2.02 in chips) 
Seat 2: XMrMojoRisinX ($2.10 in chips) 
Seat 3: Pokershmok ($2.56 in chips) 
Seat 4: Samarxx ($2.01 in chips) 
Seat 5: hc agorist ($4.39 in chips) 
Seat 6: Pelorojo1 ($2.52 in chips) 
XMrMojoRisinX: posts small blind $0.01
Pokershmok: posts big blind $0.02
*** HOLE CARDS ***
Dealt to hc agorist [Qc 6c]
Samarxx: folds 
hc agorist: folds 
Pelorojo1: raises $0.05 to $0.07
villian888: folds 
XMrMojoRisinX: folds 
Pokershmok: raises $0.15 to $0.22
Pelorojo1: raises $0.27 to $0.49
Pokershmok: folds 
Uncalled bet ($0.27) returned to Pelorojo1
Pelorojo1 collected $0.45 from pot
Pelorojo1: doesn't show hand 
*** SUMMARY ***
Total pot $0.45 | Rake $0 
Seat 1: villian888 (button) folded before Flop (didn't bet)
Seat 2: XMrMojoRisinX (small blind) folded before Flop
Seat 3: Pokershmok (big blind) folded before Flop
Seat 4: Samarxx folded before Flop (didn't bet)
Seat 5: hc agorist folded before Flop (didn't bet)
Seat 6: Pelorojo1 collected ($0.45)



PokerStars Zoom Hand #193806485310:  Hold'em No Limit ($0.01/$0.02) - 2018/11/28 1:31:01 CUST [2018/11/27 12:31:01 ET]
Table 'Halley' 6-max Seat #1 is the button
Seat 1: Rrripl ($1.80 in chips) 
Seat 2: yoba_patr ($3.61 in chips) 
Seat 3: hc agorist ($4.32 in chips) 
Seat 4: MarioAlan ($4.51 in chips) 
Seat 5: fishpupil ($2 in chips) 
Seat 6: rounder_rf ($2.04 in chips) 
yoba_patr: posts small blind $0.01
hc agorist: posts big blind $0.02
*** HOLE CARDS ***
Dealt to hc agorist [Ks Jh]
MarioAlan: folds 
fishpupil: folds 
rounder_rf: folds 
Rrripl: raises $0.02 to $0.04
yoba_patr: raises $0.12 to $0.16
hc agorist: folds 
Rrripl: folds 
Uncalled bet ($0.12) returned to yoba_patr
yoba_patr collected $0.10 from pot
yoba_patr: doesn't show hand 
*** SUMMARY ***
Total pot $0.10 | Rake $0 
Seat 1: Rrripl (button) folded before Flop
Seat 2: yoba_patr (small blind) collected ($0.10)
Seat 3: hc agorist (big blind) folded before Flop
Seat 4: MarioAlan folded before Flop (didn't bet)
Seat 5: fishpupil folded before Flop (didn't bet)
Seat 6: rounder_rf folded before Flop (didn't bet)



PokerStars Zoom Hand #193806481035:  Hold'em No Limit ($0.01/$0.02) - 2018/11/28 1:30:54 CUST [2018/11/27 12:30:54 ET]
Table 'Halley' 6-max Seat #1 is the button
Seat 1: Rimas98 ($3.77 in chips) 
Seat 2: Marcos.Lujan ($4.68 in chips) 
Seat 3: RocknRolla5 ($2.03 in chips) 
Seat 4: yukon Ronald ($3.51 in chips) 
Seat 5: hc agorist ($4.32 in chips) 
Seat 6: mbw777999777 ($2.87 in chips) 
Marcos.Lujan: posts small blind $0.01
RocknRolla5: posts big blind $0.02
*** HOLE CARDS ***
Dealt to hc agorist [9d Qs]
yukon Ronald: calls $0.02
hc agorist: folds 
mbw777999777: folds 
Rimas98: raises $0.08 to $0.10
Marcos.Lujan: folds 
RocknRolla5: folds 
yukon Ronald: folds 
Uncalled bet ($0.08) returned to Rimas98
Rimas98 collected $0.07 from pot
Rimas98: doesn't show hand 
*** SUMMARY ***
Total pot $0.07 | Rake $0 
Seat 1: Rimas98 (button) collected ($0.07)
Seat 2: Marcos.Lujan (small blind) folded before Flop
Seat 3: RocknRolla5 (big blind) folded before Flop
Seat 4: yukon Ronald folded before Flop
Seat 5: hc agorist folded before Flop (didn't bet)
Seat 6: mbw777999777 folded before Flop (didn't bet)



PokerStars Zoom Hand #193806499863:  Hold'em No Limit ($0.01/$0.02) - 2018/11/28 1:31:25 CUST [2018/11/27 12:31:25 ET]
Table 'Halley' 6-max Seat #1 is the button
Seat 1: simensgh ($0.92 in chips) 
Seat 2: suuutt ($2 in chips) 
Seat 3: villian888 ($7.50 in chips) 
Seat 4: hc agorist ($4.29 in chips) 
Seat 5: Tigor30 ($1.88 in chips) 
Seat 6: Darkymond ($2.19 in chips) 
suuutt: posts small blind $0.01
villian888: posts big blind $0.02
*** HOLE CARDS ***
Dealt to hc agorist [8c Kc]
hc agorist: folds 
Tigor30: raises $0.04 to $0.06
Darkymond: folds 
simensgh: folds 
suuutt: raises $0.34 to $0.40
villian888: folds 
Tigor30: folds 
Uncalled bet ($0.34) returned to suuutt
suuutt collected $0.14 from pot
suuutt: doesn't show hand 
*** SUMMARY ***
Total pot $0.14 | Rake $0 
Seat 1: simensgh (button) folded before Flop (didn't bet)
Seat 2: suuutt (small blind) collected ($0.14)
Seat 3: villian888 (big blind) folded before Flop
Seat 4: hc agorist folded before Flop (didn't bet)
Seat 5: Tigor30 folded before Flop
Seat 6: Darkymond folded before Flop (didn't bet)



PokerStars Zoom Hand #193806502897:  Hold'em No Limit ($0.01/$0.02) - 2018/11/28 1:31:30 CUST [2018/11/27 12:31:30 ET]
Table 'Halley' 6-max Seat #1 is the button
Seat 1: rounder_rf ($2.42 in chips) 
Seat 2: SMERSH777 ($2.30 in chips) 
Seat 3: Dorogoi57 ($3.24 in chips) 
Seat 4: stradywary ($2.66 in chips) 
Seat 5: wolverine931 ($1.83 in chips) 
Seat 6: hc agorist ($4.29 in chips) 
SMERSH777: posts small blind $0.01
Dorogoi57: posts big blind $0.02
*** HOLE CARDS ***
Dealt to hc agorist [Qh Kh]
stradywary: folds 
wolverine931: folds 
hc agorist: raises $0.04 to $0.06
rounder_rf: folds 
SMERSH777: folds 
Dorogoi57: calls $0.04
*** FLOP *** [2d Jd 8h]
Dorogoi57: checks 
hc agorist: checks 
*** TURN *** [2d Jd 8h] [4h]
Dorogoi57: checks 
hc agorist: bets $0.12
Dorogoi57: folds 
Uncalled bet ($0.12) returned to hc agorist
hc agorist collected $0.13 from pot
hc agorist: doesn't show hand 
*** SUMMARY ***
Total pot $0.13 | Rake $0 
Board [2d Jd 8h 4h]
Seat 1: rounder_rf (button) folded before Flop (didn't bet)
Seat 2: SMERSH777 (small blind) folded before Flop
Seat 3: Dorogoi57 (big blind) folded on the Turn
Seat 4: stradywary folded before Flop (didn't bet)
Seat 5: wolverine931 folded before Flop (didn't bet)
Seat 6: hc agorist collected ($0.13)



PokerStars Zoom Hand #193806535759:  Hold'em No Limit ($0.01/$0.02) - 2018/11/28 1:32:24 CUST [2018/11/27 12:32:24 ET]
Table 'Halley' 6-max Seat #1 is the button
Seat 1: hc agorist ($4.33 in chips) 
Seat 2: clewric ($1.05 in chips) 
Seat 3: murasak1 ($2.61 in chips) 
Seat 4: DoNotMissMe ($3.54 in chips) 
Seat 5: Poker_Baku99 ($1.55 in chips) 
Seat 6: phenix140 ($2 in chips) 
clewric: posts small blind $0.01
murasak1: posts big blind $0.02
*** HOLE CARDS ***
Dealt to hc agorist [8d Js]
DoNotMissMe: folds 
Poker_Baku99: raises $0.03 to $0.05
phenix140: folds 
hc agorist: folds 
clewric: folds 
murasak1: folds 
Uncalled bet ($0.03) returned to Poker_Baku99
Poker_Baku99 collected $0.05 from pot
Poker_Baku99: doesn't show hand 
*** SUMMARY ***
Total pot $0.05 | Rake $0 
Seat 1: hc agorist (button) folded before Flop (didn't bet)
Seat 2: clewric (small blind) folded before Flop
Seat 3: murasak1 (big blind) folded before Flop
Seat 4: DoNotMissMe folded before Flop (didn't bet)
Seat 5: Poker_Baku99 collected ($0.05)
Seat 6: phenix140 folded before Flop (didn't bet)



PokerStars Zoom Hand #193806495133:  Hold'em No Limit ($0.01/$0.02) - 2018/11/28 1:31:17 CUST [2018/11/27 12:31:17 ET]
Table 'Halley' 6-max Seat #1 is the button
Seat 1: skendroshen ($2.12 in chips) 
Seat 2: hc agorist ($4.30 in chips) 
Seat 3: baddyplayer ($2.22 in chips) 
Seat 4: PalineQ ($2.51 in chips) 
Seat 5: thank100you ($2.45 in chips) 
Seat 6: bullseye187 ($2 in chips) 
hc agorist: posts small blind $0.01
baddyplayer: posts big blind $0.02
*** HOLE CARDS ***
Dealt to hc agorist [Jh 7c]
PalineQ: folds 
thank100you: calls $0.02
bullseye187: folds 
skendroshen: folds 
hc agorist: folds 
baddyplayer: checks 
*** FLOP *** [4s 9c Ac]
baddyplayer: checks 
thank100you: checks 
*** TURN *** [4s 9c Ac] [Th]
baddyplayer: checks 
thank100you: bets $0.02
baddyplayer: calls $0.02
*** RIVER *** [4s 9c Ac Th] [3d]
baddyplayer: checks 
thank100you: bets $0.04
baddyplayer: calls $0.04
*** SHOW DOWN ***
thank100you: shows [Tc Js] (a pair of Tens)
baddyplayer: mucks hand 
thank100you collected $0.16 from pot
*** SUMMARY ***
Total pot $0.17 | Rake $0.01 
Board [4s 9c Ac Th 3d]
Seat 1: skendroshen (button) folded before Flop (didn't bet)
Seat 2: hc agorist (small blind) folded before Flop
Seat 3: baddyplayer (big blind) mucked [9s Kh]
Seat 4: PalineQ folded before Flop (didn't bet)
Seat 5: thank100you showed [Tc Js] and won ($0.16) with a pair of Tens
Seat 6: bullseye187 folded before Flop (didn't bet)



PokerStars Zoom Hand #193806532243:  Hold'em No Limit ($0.01/$0.02) - 2018/11/28 1:32:18 CUST [2018/11/27 12:32:18 ET]
Table 'Halley' 6-max Seat #1 is the button
Seat 1: SMERSH777 ($2 in chips) 
Seat 2: hc agorist ($4.34 in chips) 
Seat 3: sellfish1 ($2 in chips) 
Seat 4: Michel Mata ($3.37 in chips) 
Seat 5: Qwkl ($2.14 in chips) 
Seat 6: Kozlov Rusj ($3.10 in chips) 
hc agorist: posts small blind $0.01
sellfish1: posts big blind $0.02
*** HOLE CARDS ***
Dealt to hc agorist [6s Kc]
Michel Mata: raises $0.04 to $0.06
Qwkl: folds 
Kozlov Rusj: folds 
SMERSH777: raises $0.20 to $0.26
hc agorist: folds 
sellfish1: folds 
Michel Mata: calls $0.20
*** FLOP *** [Jd 3s Kd]
Michel Mata: checks 
SMERSH777: bets $0.32
Michel Mata: folds 
Uncalled bet ($0.32) returned to SMERSH777
SMERSH777 collected $0.53 from pot
SMERSH777: doesn't show hand 
*** SUMMARY ***
Total pot $0.55 | Rake $0.02 
Board [Jd 3s Kd]
Seat 1: SMERSH777 (button) collected ($0.53)
Seat 2: hc agorist (small blind) folded before Flop
Seat 3: sellfish1 (big blind) folded before Flop
Seat 4: Michel Mata folded on the Flop
Seat 5: Qwkl folded before Flop (didn't bet)
Seat 6: Kozlov Rusj folded before Flop (didn't bet)



PokerStars Zoom Hand #193806543193:  Hold'em No Limit ($0.01/$0.02) - 2018/11/28 1:32:36 CUST [2018/11/27 12:32:36 ET]
Table 'Halley' 6-max Seat #1 is the button
Seat 1: MooKoR ($3.45 in chips) 
Seat 2: Simkooo ($2 in chips) 
Seat 3: villian888 ($4.63 in chips) 
Seat 4: egiu28 ($2.73 in chips) 
Seat 5: hc agorist ($4.33 in chips) 
Seat 6: james009900 ($2.05 in chips) 
Simkooo: posts small blind $0.01
villian888: posts big blind $0.02
*** HOLE CARDS ***
Dealt to hc agorist [Ac 9d]
egiu28: raises $0.02 to $0.04
hc agorist: folds 
james009900: folds 
MooKoR: calls $0.04
Simkooo: folds 
villian888: folds 
*** FLOP *** [3s 2c Js]
egiu28: checks 
MooKoR: checks 
*** TURN *** [3s 2c Js] [Qh]
egiu28: bets $0.08
MooKoR: folds 
Uncalled bet ($0.08) returned to egiu28
egiu28 collected $0.11 from pot
egiu28: doesn't show hand 
*** SUMMARY ***
Total pot $0.11 | Rake $0 
Board [3s 2c Js Qh]
Seat 1: MooKoR (button) folded on the Turn
Seat 2: Simkooo (small blind) folded before Flop
Seat 3: villian888 (big blind) folded before Flop
Seat 4: egiu28 collected ($0.11)
Seat 5: hc agorist folded before Flop (didn't bet)
Seat 6: james009900 folded before Flop (didn't bet)



PokerStars Zoom Hand #193806546960:  Hold'em No Limit ($0.01/$0.02) - 2018/11/28 1:32:42 CUST [2018/11/27 12:32:42 ET]
Table 'Halley' 6-max Seat #1 is the button
Seat 1: hc agorist ($4.33 in chips) 
Seat 2: SerhioGavrilini ($1.54 in chips) 
Seat 3: Darunum ($2 in chips) 
Seat 4: Rimas98 ($6.59 in chips) 
Seat 5: Dystany ($2.13 in chips) 
Seat 6: Albinmeister ($3.67 in chips) 
SerhioGavrilini: posts small blind $0.01
Darunum: posts big blind $0.02
*** HOLE CARDS ***
Dealt to hc agorist [Td 6s]
Rimas98: folds 
Dystany: raises $0.04 to $0.06
Albinmeister: folds 
hc agorist: folds 
SerhioGavrilini: calls $0.05
Darunum: folds 
*** FLOP *** [Kd 8d 2d]
SerhioGavrilini: checks 
Dystany: bets $0.09
SerhioGavrilini: calls $0.09
*** TURN *** [Kd 8d 2d] [3s]
SerhioGavrilini: checks 
Dystany: bets $0.20
SerhioGavrilini: calls $0.20
*** RIVER *** [Kd 8d 2d 3s] [4s]
SerhioGavrilini: checks 
Dystany: checks 
*** SHOW DOWN ***
SerhioGavrilini: shows [9s Ks] (a pair of Kings)
Dystany: shows [Ah Kh] (a pair of Kings - Ace kicker)
Dystany collected $0.69 from pot
*** SUMMARY ***
Total pot $0.72 | Rake $0.03 
Board [Kd 8d 2d 3s 4s]
Seat 1: hc agorist (button) folded before Flop (didn't bet)
Seat 2: SerhioGavrilini (small blind) showed [9s Ks] and lost with a pair of Kings
Seat 3: Darunum (big blind) folded before Flop
Seat 4: Rimas98 folded before Flop (didn't bet)
Seat 5: Dystany showed [Ah Kh] and won ($0.69) with a pair of Kings
Seat 6: Albinmeister folded before Flop (didn't bet)



PokerStars Zoom Hand #193806526724:  Hold'em No Limit ($0.01/$0.02) - 2018/11/28 1:32:09 CUST [2018/11/27 12:32:09 ET]
Table 'Halley' 6-max Seat #1 is the button
Seat 1: skendroshen ($2.03 in chips) 
Seat 2: RM432 ($3.15 in chips) 
Seat 3: hc agorist ($4.36 in chips) 
Seat 4: nomis2703 ($2.19 in chips) 
Seat 5: Rockabill408 ($3.21 in chips) 
Seat 6: MiuFuringi ($2.63 in chips) 
RM432: posts small blind $0.01
hc agorist: posts big blind $0.02
*** HOLE CARDS ***
Dealt to hc agorist [8d 4h]
nomis2703: folds 
Rockabill408: folds 
MiuFuringi: raises $0.04 to $0.06
skendroshen: calls $0.06
RM432: folds 
hc agorist: folds 
*** FLOP *** [7c 9d 9c]
MiuFuringi: bets $0.04
skendroshen: calls $0.04
*** TURN *** [7c 9d 9c] [8c]
MiuFuringi: checks 
skendroshen: bets $0.16
MiuFuringi: calls $0.16
*** RIVER *** [7c 9d 9c 8c] [5d]
MiuFuringi: bets $0.31
skendroshen: folds 
Uncalled bet ($0.31) returned to MiuFuringi
MiuFuringi collected $0.53 from pot
MiuFuringi: doesn't show hand 
*** SUMMARY ***
Total pot $0.55 | Rake $0.02 
Board [7c 9d 9c 8c 5d]
Seat 1: skendroshen (button) folded on the River
Seat 2: RM432 (small blind) folded before Flop
Seat 3: hc agorist (big blind) folded before Flop
Seat 4: nomis2703 folded before Flop (didn't bet)
Seat 5: Rockabill408 folded before Flop (didn't bet)
Seat 6: MiuFuringi collected ($0.53)



PokerStars Zoom Hand #193806550710:  Hold'em No Limit ($0.01/$0.02) - 2018/11/28 1:32:48 CUST [2018/11/27 12:32:48 ET]
Table 'Halley' 6-max Seat #1 is the button
Seat 1: brasileiro83 ($2.02 in chips) 
Seat 2: tiga92 ($2.01 in chips) 
Seat 3: qpsq ($3.61 in chips) 
Seat 4: SkyElephant ($2 in chips) 
Seat 5: hc agorist ($4.33 in chips) 
Seat 6: bullseye187 ($2 in chips) 
tiga92: posts small blind $0.01
qpsq: posts big blind $0.02
*** HOLE CARDS ***
Dealt to hc agorist [Td 8d]
SkyElephant: folds 
hc agorist: raises $0.02 to $0.04
bullseye187: folds 
brasileiro83: folds 
tiga92: folds 
qpsq: raises $0.09 to $0.13
hc agorist: calls $0.09
*** FLOP *** [2h 8s 4s]
qpsq: bets $0.17
hc agorist: calls $0.17
*** TURN *** [2h 8s 4s] [9s]
qpsq: bets $0.39
hc agorist: calls $0.39
*** RIVER *** [2h 8s 4s 9s] [2d]
qpsq: checks 
hc agorist: checks 
*** SHOW DOWN ***
qpsq: shows [Ac Js] (a pair of Deuces)
hc agorist: shows [Td 8d] (two pair, Eights and Deuces)
hc agorist collected $1.34 from pot
*** SUMMARY ***
Total pot $1.39 | Rake $0.05 
Board [2h 8s 4s 9s 2d]
Seat 1: brasileiro83 (button) folded before Flop (didn't bet)
Seat 2: tiga92 (small blind) folded before Flop
Seat 3: qpsq (big blind) showed [Ac Js] and lost with a pair of Deuces
Seat 4: SkyElephant folded before Flop (didn't bet)
Seat 5: hc agorist showed [Td 8d] and won ($1.34) with two pair, Eights and Deuces
Seat 6: bullseye187 folded before Flop (didn't bet)



PokerStars Zoom Hand #193806596939:  Hold'em No Limit ($0.01/$0.02) - 2018/11/28 1:34:04 CUST [2018/11/27 12:34:04 ET]
Table 'Halley' 6-max Seat #1 is the button
Seat 1: Destruct1on7 ($2.26 in chips) 
Seat 2: hc agorist ($4.98 in chips) 
Seat 3: DiMoWo ($3.42 in chips) 
Seat 4: YaroslavSet ($1.42 in chips) 
Seat 5: vovan100157 ($2.83 in chips) 
Seat 6: Paviloco ($3.52 in chips) 
hc agorist: posts small blind $0.01
DiMoWo: posts big blind $0.02
*** HOLE CARDS ***
Dealt to hc agorist [6h 4h]
YaroslavSet: folds 
vovan100157: folds 
Paviloco: folds 
Destruct1on7: folds 
hc agorist: raises $0.02 to $0.04
DiMoWo: folds 
Uncalled bet ($0.02) returned to hc agorist
hc agorist collected $0.04 from pot
hc agorist: doesn't show hand 
*** SUMMARY ***
Total pot $0.04 | Rake $0 
Seat 1: Destruct1on7 (button) folded before Flop (didn't bet)
Seat 2: hc agorist (small blind) collected ($0.04)
Seat 3: DiMoWo (big blind) folded before Flop
Seat 4: YaroslavSet folded before Flop (didn't bet)
Seat 5: vovan100157 folded before Flop (didn't bet)
Seat 6: Paviloco folded before Flop (didn't bet)



PokerStars Zoom Hand #193806612720:  Hold'em No Limit ($0.01/$0.02) - 2018/11/28 1:34:30 CUST [2018/11/27 12:34:30 ET]
Table 'Halley' 6-max Seat #1 is the button
Seat 1: junin stars1 ($6.23 in chips) 
Seat 2: Mackerel12 ($3.33 in chips) 
Seat 3: smalna1 ($0.94 in chips) 
Seat 4: hc agorist ($5 in chips) 
Seat 5: satti1337 ($4.47 in chips) 
Seat 6: chobusina ($0.78 in chips) 
Mackerel12: posts small blind $0.01
smalna1: posts big blind $0.02
*** HOLE CARDS ***
Dealt to hc agorist [Qs Kc]
hc agorist: raises $0.04 to $0.06
satti1337: folds 
chobusina: folds 
junin stars1: folds 
Mackerel12: folds 
smalna1: calls $0.04
*** FLOP *** [3s 4d 4h]
smalna1: checks 
hc agorist: bets $0.05
smalna1: folds 
Uncalled bet ($0.05) returned to hc agorist
hc agorist collected $0.13 from pot
hc agorist: doesn't show hand 
*** SUMMARY ***
Total pot $0.13 | Rake $0 
Board [3s 4d 4h]
Seat 1: junin stars1 (button) folded before Flop (didn't bet)
Seat 2: Mackerel12 (small blind) folded before Flop
Seat 3: smalna1 (big blind) folded on the Flop
Seat 4: hc agorist collected ($0.13)
Seat 5: satti1337 folded before Flop (didn't bet)
Seat 6: chobusina folded before Flop (didn't bet)



PokerStars Zoom Hand #193806628027:  Hold'em No Limit ($0.01/$0.02) - 2018/11/28 1:34:55 CUST [2018/11/27 12:34:55 ET]
Table 'Halley' 6-max Seat #1 is the button
Seat 1: abatur0 ($1.05 in chips) 
Seat 2: qpsq ($3.49 in chips) 
Seat 3: hc agorist ($5.07 in chips) 
Seat 4: Dystany ($2.61 in chips) 
Seat 5: stradywary ($4.76 in chips) 
Seat 6: adavida2003 ($2 in chips) 
qpsq: posts small blind $0.01
hc agorist: posts big blind $0.02
*** HOLE CARDS ***
Dealt to hc agorist [Ts 5c]
Dystany: folds 
stradywary: folds 
adavida2003: raises $0.03 to $0.05
abatur0: folds 
qpsq: folds 
hc agorist: folds 
Uncalled bet ($0.03) returned to adavida2003
adavida2003 collected $0.05 from pot
adavida2003: doesn't show hand 
*** SUMMARY ***
Total pot $0.05 | Rake $0 
Seat 1: abatur0 (button) folded before Flop (didn't bet)
Seat 2: qpsq (small blind) folded before Flop
Seat 3: hc agorist (big blind) folded before Flop
Seat 4: Dystany folded before Flop (didn't bet)
Seat 5: stradywary folded before Flop (didn't bet)
Seat 6: adavida2003 collected ($0.05)



PokerStars Zoom Hand #193806641559:  Hold'em No Limit ($0.01/$0.02) - 2018/11/28 1:35:17 CUST [2018/11/27 12:35:17 ET]
Table 'Halley' 6-max Seat #1 is the button
Seat 1: nworkun1 ($2.86 in chips) 
Seat 2: mamaka33 ($2.03 in chips) 
Seat 3: onetha ($0.86 in chips) 
Seat 4: hc agorist ($4.99 in chips) 
Seat 5: Mizzek ($2.56 in chips) 
Seat 6: ciufretto ($3.50 in chips) 
mamaka33: posts small blind $0.01
onetha: posts big blind $0.02
*** HOLE CARDS ***
Dealt to hc agorist [Js 8h]
hc agorist: folds 
Mizzek: folds 
ciufretto: folds 
nworkun1: folds 
mamaka33: folds 
Uncalled bet ($0.01) returned to onetha
onetha collected $0.02 from pot
onetha: doesn't show hand 
*** SUMMARY ***
Total pot $0.02 | Rake $0 
Seat 1: nworkun1 (button) folded before Flop (didn't bet)
Seat 2: mamaka33 (small blind) folded before Flop
Seat 3: onetha (big blind) collected ($0.02)
Seat 4: hc agorist folded before Flop (didn't bet)
Seat 5: Mizzek folded before Flop (didn't bet)
Seat 6: ciufretto folded before Flop (didn't bet)



PokerStars Zoom Hand #193806632978:  Hold'em No Limit ($0.01/$0.02) - 2018/11/28 1:35:03 CUST [2018/11/27 12:35:03 ET]
Table 'Halley' 6-max Seat #1 is the button
Seat 1: Leibham ($1.87 in chips) 
Seat 2: Pamposek ($0.59 in chips) 
Seat 3: pokers999999 ($2 in chips) 
Seat 4: Darkymond ($2.03 in chips) 
Seat 5: Apel11 ($2.67 in chips) 
Seat 6: hc agorist ($5.05 in chips) 
Pamposek: posts small blind $0.01
pokers999999: posts big blind $0.02
*** HOLE CARDS ***
Dealt to hc agorist [7d Ad]
Darkymond: folds 
Apel11: folds 
hc agorist: raises $0.04 to $0.06
Leibham: folds 
Pamposek: raises $0.53 to $0.59 and is all-in
pokers999999: calls $0.57
hc agorist: folds 
*** FLOP *** [8d 8c 3s]
*** TURN *** [8d 8c 3s] [2h]
*** RIVER *** [8d 8c 3s 2h] [5h]
*** SHOW DOWN ***
Pamposek: shows [8s Ah] (three of a kind, Eights)
pokers999999: shows [Ac Qc] (a pair of Eights)
Pamposek collected $1.20 from pot
*** SUMMARY ***
Total pot $1.24 | Rake $0.04 
Board [8d 8c 3s 2h 5h]
Seat 1: Leibham (button) folded before Flop (didn't bet)
Seat 2: Pamposek (small blind) showed [8s Ah] and won ($1.20) with three of a kind, Eights
Seat 3: pokers999999 (big blind) showed [Ac Qc] and lost with a pair of Eights
Seat 4: Darkymond folded before Flop (didn't bet)
Seat 5: Apel11 folded before Flop (didn't bet)
Seat 6: hc agorist folded before Flop



PokerStars Zoom Hand #193806645701:  Hold'em No Limit ($0.01/$0.02) - 2018/11/28 1:35:24 CUST [2018/11/27 12:35:24 ET]
Table 'Halley' 6-max Seat #1 is the button
Seat 1: nikkfurie019 ($2 in chips) 
Seat 2: pokerfan3999 ($2.90 in chips) 
Seat 3: Mizzek ($4.98 in chips) 
Seat 4: Puqo ($2.36 in chips) 
Seat 5: hc agorist ($4.99 in chips) 
Seat 6: bappswe ($0.80 in chips) 
pokerfan3999: posts small blind $0.01
Mizzek: posts big blind $0.02
*** HOLE CARDS ***
Dealt to hc agorist [9c Jh]
Puqo: folds 
hc agorist: folds 
bappswe: folds 
nikkfurie019: raises $0.04 to $0.06
pokerfan3999: raises $0.18 to $0.24
Mizzek: folds 
nikkfurie019: folds 
Uncalled bet ($0.18) returned to pokerfan3999
pokerfan3999 collected $0.14 from pot
pokerfan3999: doesn't show hand 
*** SUMMARY ***
Total pot $0.14 | Rake $0 
Seat 1: nikkfurie019 (button) folded before Flop
Seat 2: pokerfan3999 (small blind) collected ($0.14)
Seat 3: Mizzek (big blind) folded before Flop
Seat 4: Puqo folded before Flop (didn't bet)
Seat 5: hc agorist folded before Flop (didn't bet)
Seat 6: bappswe folded before Flop (didn't bet)



PokerStars Zoom Hand #193806648672:  Hold'em No Limit ($0.01/$0.02) - 2018/11/28 1:35:29 CUST [2018/11/27 12:35:29 ET]
Table 'Halley' 6-max Seat #1 is the button
Seat 1: hc agorist ($4.99 in chips) 
Seat 2: Artuzinio ($2 in chips) 
Seat 3: Marcos.Lujan ($2.58 in chips) 
Seat 4: grv17 ($2.24 in chips) 
Seat 5: glagla87 ($7.02 in chips) 
Seat 6: czerwy ($3.06 in chips) 
Artuzinio: posts small blind $0.01
Marcos.Lujan: posts big blind $0.02
*** HOLE CARDS ***
Dealt to hc agorist [4c 7c]
grv17: folds 
glagla87: folds 
czerwy: raises $0.04 to $0.06
hc agorist: folds 
Artuzinio: folds 
Marcos.Lujan: calls $0.04
*** FLOP *** [3h 6c Js]
Marcos.Lujan: checks 
czerwy: checks 
*** TURN *** [3h 6c Js] [5d]
Marcos.Lujan: checks 
czerwy: checks 
*** RIVER *** [3h 6c Js 5d] [4d]
Marcos.Lujan: checks 
czerwy: checks 
*** SHOW DOWN ***
Marcos.Lujan: shows [Tc Qc] (high card Queen)
czerwy: shows [Ac 5c] (a pair of Fives)
czerwy collected $0.13 from pot
*** SUMMARY ***
Total pot $0.13 | Rake $0 
Board [3h 6c Js 5d 4d]
Seat 1: hc agorist (button) folded before Flop (didn't bet)
Seat 2: Artuzinio (small blind) folded before Flop
Seat 3: Marcos.Lujan (big blind) showed [Tc Qc] and lost with high card Queen
Seat 4: grv17 folded before Flop (didn't bet)
Seat 5: glagla87 folded before Flop (didn't bet)
Seat 6: czerwy showed [Ac 5c] and won ($0.13) with a pair of Fives



