PokerStars Zoom Hand #193766670152:  Hold'em No Limit ($0.01/$0.02) - 2018/11/26 23:40:32 CUST [2018/11/26 10:40:32 ET]
Table 'Halley' 6-max Seat #1 is the button
Seat 1: strimmm0 ($4.72 in chips) 
Seat 2: sbartperm ($1.24 in chips) 
Seat 3: hc agorist ($2 in chips) 
Seat 4: FabryGonnos ($3.40 in chips) 
Seat 5: SkyElephant ($2.01 in chips) 
Seat 6: Gundziar ($2.06 in chips) 
sbartperm: posts small blind $0.01
hc agorist: posts big blind $0.02
*** HOLE CARDS ***
Dealt to hc agorist [5c Th]
FabryGonnos: folds 
SkyElephant: folds 
Gundziar: folds 
strimmm0: folds 
sbartperm: folds 
Uncalled bet ($0.01) returned to hc agorist
hc agorist collected $0.02 from pot
hc agorist: doesn't show hand 
*** SUMMARY ***
Total pot $0.02 | Rake $0 
Seat 1: strimmm0 (button) folded before Flop (didn't bet)
Seat 2: sbartperm (small blind) folded before Flop
Seat 3: hc agorist (big blind) collected ($0.02)
Seat 4: FabryGonnos folded before Flop (didn't bet)
Seat 5: SkyElephant folded before Flop (didn't bet)
Seat 6: Gundziar folded before Flop (didn't bet)



PokerStars Zoom Hand #193766674168:  Hold'em No Limit ($0.01/$0.02) - 2018/11/26 23:40:40 CUST [2018/11/26 10:40:40 ET]
Table 'Halley' 6-max Seat #1 is the button
Seat 1: hc agorist ($2.01 in chips) 
Seat 2: firas2005 ($1.11 in chips) 
Seat 3: 5tr2te9 ($2 in chips) 
Seat 4: toomuchbluffing ($2.10 in chips) 
Seat 5: demisom ($1 in chips) 
Seat 6: berkutrus76 ($2.82 in chips) 
firas2005: posts small blind $0.01
5tr2te9: posts big blind $0.02
*** HOLE CARDS ***
Dealt to hc agorist [3c Ah]
toomuchbluffing: folds 
demisom: folds 
berkutrus76: folds 
hc agorist: raises $0.02 to $0.04
firas2005: folds 
5tr2te9: folds 
Uncalled bet ($0.02) returned to hc agorist
hc agorist collected $0.05 from pot
hc agorist: doesn't show hand 
*** SUMMARY ***
Total pot $0.05 | Rake $0 
Seat 1: hc agorist (button) collected ($0.05)
Seat 2: firas2005 (small blind) folded before Flop
Seat 3: 5tr2te9 (big blind) folded before Flop
Seat 4: toomuchbluffing folded before Flop (didn't bet)
Seat 5: demisom folded before Flop (didn't bet)
Seat 6: berkutrus76 folded before Flop (didn't bet)



PokerStars Zoom Hand #193766682636:  Hold'em No Limit ($0.01/$0.02) - 2018/11/26 23:40:57 CUST [2018/11/26 10:40:57 ET]
Table 'Halley' 6-max Seat #1 is the button
Seat 1: Lvlvsfrvr ($3.64 in chips) 
Seat 2: Cavalo Fla ($2.56 in chips) 
Seat 3: Terlingen11 ($2.35 in chips) 
Seat 4: StraightPR0 ($5.33 in chips) 
Seat 5: Arch1689 ($2 in chips) 
Seat 6: hc agorist ($2.04 in chips) 
Cavalo Fla: posts small blind $0.01
Terlingen11: posts big blind $0.02
*** HOLE CARDS ***
Dealt to hc agorist [4s Qh]
StraightPR0: folds 
Arch1689: folds 
hc agorist: folds 
Lvlvsfrvr: calls $0.02
Cavalo Fla: calls $0.01
Terlingen11: raises $0.06 to $0.08
Lvlvsfrvr: folds 
Cavalo Fla: folds 
Uncalled bet ($0.06) returned to Terlingen11
Terlingen11 collected $0.06 from pot
Terlingen11: doesn't show hand 
*** SUMMARY ***
Total pot $0.06 | Rake $0 
Seat 1: Lvlvsfrvr (button) folded before Flop
Seat 2: Cavalo Fla (small blind) folded before Flop
Seat 3: Terlingen11 (big blind) collected ($0.06)
Seat 4: StraightPR0 folded before Flop (didn't bet)
Seat 5: Arch1689 folded before Flop (didn't bet)
Seat 6: hc agorist folded before Flop (didn't bet)



PokerStars Zoom Hand #193766686574:  Hold'em No Limit ($0.01/$0.02) - 2018/11/26 23:41:05 CUST [2018/11/26 10:41:05 ET]
Table 'Halley' 6-max Seat #1 is the button
Seat 1: Shuv-Oohl ($2.33 in chips) 
Seat 2: hc agorist ($2.04 in chips) 
Seat 3: LeConner ($2.56 in chips) 
Seat 4: D4ns3n ($7.33 in chips) 
Seat 5: booktable ($2.03 in chips) 
Seat 6: sinster_ca85 ($3.85 in chips) 
hc agorist: posts small blind $0.01
LeConner: posts big blind $0.02
*** HOLE CARDS ***
Dealt to hc agorist [4h Jh]
D4ns3n: raises $0.04 to $0.06
booktable: calls $0.06
sinster_ca85: folds 
Shuv-Oohl: calls $0.06
hc agorist: raises $0.26 to $0.32
LeConner: folds 
D4ns3n: raises $7.01 to $7.33 and is all-in
booktable: folds 
Shuv-Oohl: folds 
hc agorist: folds 
Uncalled bet ($7.01) returned to D4ns3n
D4ns3n collected $0.78 from pot
D4ns3n: doesn't show hand 
*** SUMMARY ***
Total pot $0.78 | Rake $0 
Seat 1: Shuv-Oohl (button) folded before Flop
Seat 2: hc agorist (small blind) folded before Flop
Seat 3: LeConner (big blind) folded before Flop
Seat 4: D4ns3n collected ($0.78)
Seat 5: booktable folded before Flop
Seat 6: sinster_ca85 folded before Flop (didn't bet)



PokerStars Zoom Hand #193766707047:  Hold'em No Limit ($0.01/$0.02) - 2018/11/26 23:41:46 CUST [2018/11/26 10:41:46 ET]
Table 'Halley' 6-max Seat #1 is the button
Seat 1: kawauchir1 ($1.65 in chips) 
Seat 2: Mr.DamBo ($4.55 in chips) 
Seat 3: kakoytotip ($4.01 in chips) 
Seat 4: hc agorist ($1.72 in chips) 
Seat 5: joelox25 ($2.10 in chips) 
Seat 6: Coffeatus ($2.40 in chips) 
Mr.DamBo: posts small blind $0.01
kakoytotip: posts big blind $0.02
*** HOLE CARDS ***
Dealt to hc agorist [4d Td]
hc agorist: folds 
joelox25: folds 
Coffeatus: folds 
kawauchir1: folds 
Mr.DamBo: raises $0.03 to $0.05
kakoytotip: folds 
Uncalled bet ($0.03) returned to Mr.DamBo
Mr.DamBo collected $0.04 from pot
Mr.DamBo: doesn't show hand 
*** SUMMARY ***
Total pot $0.04 | Rake $0 
Seat 1: kawauchir1 (button) folded before Flop (didn't bet)
Seat 2: Mr.DamBo (small blind) collected ($0.04)
Seat 3: kakoytotip (big blind) folded before Flop
Seat 4: hc agorist folded before Flop (didn't bet)
Seat 5: joelox25 folded before Flop (didn't bet)
Seat 6: Coffeatus folded before Flop (didn't bet)



PokerStars Zoom Hand #193766709578:  Hold'em No Limit ($0.01/$0.02) - 2018/11/26 23:41:51 CUST [2018/11/26 10:41:51 ET]
Table 'Halley' 6-max Seat #1 is the button
Seat 1: K.Stas71 ($1.15 in chips) 
Seat 2: DANILZOL ($0.98 in chips) 
Seat 3: hc agorist ($1.72 in chips) 
Seat 4: ZeusCMR ($2.14 in chips) 
Seat 5: amartins123 ($2 in chips) 
Seat 6: kilingdude ($2.06 in chips) 
DANILZOL: posts small blind $0.01
hc agorist: posts big blind $0.02
*** HOLE CARDS ***
Dealt to hc agorist [9s 5c]
ZeusCMR: folds 
amartins123: folds 
kilingdude: folds 
K.Stas71: folds 
DANILZOL: folds 
Uncalled bet ($0.01) returned to hc agorist
hc agorist collected $0.02 from pot
hc agorist: doesn't show hand 
*** SUMMARY ***
Total pot $0.02 | Rake $0 
Seat 1: K.Stas71 (button) folded before Flop (didn't bet)
Seat 2: DANILZOL (small blind) folded before Flop
Seat 3: hc agorist (big blind) collected ($0.02)
Seat 4: ZeusCMR folded before Flop (didn't bet)
Seat 5: amartins123 folded before Flop (didn't bet)
Seat 6: kilingdude folded before Flop (didn't bet)



PokerStars Zoom Hand #193766718490:  Hold'em No Limit ($0.01/$0.02) - 2018/11/26 23:42:09 CUST [2018/11/26 10:42:09 ET]
Table 'Halley' 6-max Seat #1 is the button
Seat 1: Gerar NB ($3.43 in chips) 
Seat 2: lucky7wlsrud ($2.21 in chips) 
Seat 3: Gamer577 ($4.37 in chips) 
Seat 4: LexLuther499 ($2.08 in chips) 
Seat 5: averzia ($2 in chips) 
Seat 6: hc agorist ($1.73 in chips) 
lucky7wlsrud: posts small blind $0.01
Gamer577: posts big blind $0.02
*** HOLE CARDS ***
Dealt to hc agorist [6s 9d]
LexLuther499: folds 
averzia: folds 
hc agorist: folds 
Gerar NB: folds 
lucky7wlsrud: folds 
Uncalled bet ($0.01) returned to Gamer577
Gamer577 collected $0.02 from pot
Gamer577: doesn't show hand 
*** SUMMARY ***
Total pot $0.02 | Rake $0 
Seat 1: Gerar NB (button) folded before Flop (didn't bet)
Seat 2: lucky7wlsrud (small blind) folded before Flop
Seat 3: Gamer577 (big blind) collected ($0.02)
Seat 4: LexLuther499 folded before Flop (didn't bet)
Seat 5: averzia folded before Flop (didn't bet)
Seat 6: hc agorist folded before Flop (didn't bet)



PokerStars Zoom Hand #193766704563:  Hold'em No Limit ($0.01/$0.02) - 2018/11/26 23:41:41 CUST [2018/11/26 10:41:41 ET]
Table 'Halley' 6-max Seat #1 is the button
Seat 1: oleym ($1.88 in chips) 
Seat 2: Spinno ($2.10 in chips) 
Seat 3: Lawrence$lim ($2.32 in chips) 
Seat 4: Pokersk999 ($2 in chips) 
Seat 5: hc agorist ($1.72 in chips) 
Seat 6: boss477 ($2.58 in chips) 
Spinno: posts small blind $0.01
Lawrence$lim: posts big blind $0.02
*** HOLE CARDS ***
Dealt to hc agorist [Kh 7s]
Pokersk999: raises $0.03 to $0.05
hc agorist: folds 
boss477: calls $0.05
oleym: folds 
Spinno: folds 
Lawrence$lim: calls $0.03
*** FLOP *** [Ad 3s As]
Lawrence$lim: checks 
Pokersk999: checks 
boss477: checks 
*** TURN *** [Ad 3s As] [4c]
Lawrence$lim: bets $0.10
Pokersk999: folds 
boss477: folds 
Uncalled bet ($0.10) returned to Lawrence$lim
Lawrence$lim collected $0.15 from pot
Lawrence$lim: doesn't show hand 
*** SUMMARY ***
Total pot $0.16 | Rake $0.01 
Board [Ad 3s As 4c]
Seat 1: oleym (button) folded before Flop (didn't bet)
Seat 2: Spinno (small blind) folded before Flop
Seat 3: Lawrence$lim (big blind) collected ($0.15)
Seat 4: Pokersk999 folded on the Turn
Seat 5: hc agorist folded before Flop (didn't bet)
Seat 6: boss477 folded on the Turn



PokerStars Zoom Hand #193766725064:  Hold'em No Limit ($0.01/$0.02) - 2018/11/26 23:42:22 CUST [2018/11/26 10:42:22 ET]
Table 'Halley' 6-max Seat #1 is the button
Seat 1: mikhail3434 ($0.98 in chips) 
Seat 2: hc agorist ($1.73 in chips) 
Seat 3: 30yyyyyy ($1.88 in chips) 
Seat 4: lilawowi ($0.94 in chips) 
Seat 5: demisom ($1 in chips) 
Seat 6: samuelonline ($2.33 in chips) 
hc agorist: posts small blind $0.01
30yyyyyy: posts big blind $0.02
*** HOLE CARDS ***
Dealt to hc agorist [6s 8c]
lilawowi: folds 
demisom: folds 
samuelonline: folds 
mikhail3434: raises $0.04 to $0.06
hc agorist: folds 
30yyyyyy: folds 
Uncalled bet ($0.04) returned to mikhail3434
mikhail3434 collected $0.05 from pot
mikhail3434: doesn't show hand 
*** SUMMARY ***
Total pot $0.05 | Rake $0 
Seat 1: mikhail3434 (button) collected ($0.05)
Seat 2: hc agorist (small blind) folded before Flop
Seat 3: 30yyyyyy (big blind) folded before Flop
Seat 4: lilawowi folded before Flop (didn't bet)
Seat 5: demisom folded before Flop (didn't bet)
Seat 6: samuelonline folded before Flop (didn't bet)



PokerStars Zoom Hand #193766728391:  Hold'em No Limit ($0.01/$0.02) - 2018/11/26 23:42:29 CUST [2018/11/26 10:42:29 ET]
Table 'Halley' 6-max Seat #1 is the button
Seat 1: bbaty123 ($2 in chips) 
Seat 2: ernies666 ($0.22 in chips) 
Seat 3: neo1200 ($1.27 in chips) 
Seat 4: Michel Mill ($2.08 in chips) 
Seat 5: hc agorist ($1.72 in chips) 
Seat 6: demisom ($1 in chips) 
ernies666: posts small blind $0.01
neo1200: posts big blind $0.02
*** HOLE CARDS ***
Dealt to hc agorist [4h 6c]
Michel Mill: raises $0.04 to $0.06
hc agorist: folds 
demisom: folds 
bbaty123: folds 
ernies666: folds 
neo1200: folds 
Uncalled bet ($0.04) returned to Michel Mill
Michel Mill collected $0.05 from pot
Michel Mill: doesn't show hand 
*** SUMMARY ***
Total pot $0.05 | Rake $0 
Seat 1: bbaty123 (button) folded before Flop (didn't bet)
Seat 2: ernies666 (small blind) folded before Flop
Seat 3: neo1200 (big blind) folded before Flop
Seat 4: Michel Mill collected ($0.05)
Seat 5: hc agorist folded before Flop (didn't bet)
Seat 6: demisom folded before Flop (didn't bet)



PokerStars Zoom Hand #193766722538:  Hold'em No Limit ($0.01/$0.02) - 2018/11/26 23:42:17 CUST [2018/11/26 10:42:17 ET]
Table 'Halley' 6-max Seat #1 is the button
Seat 1: hc agorist ($1.73 in chips) 
Seat 2: Paysandu70 ($3.67 in chips) 
Seat 3: SKFin ($3.98 in chips) 
Seat 4: mikhail3434 ($0.98 in chips) 
Seat 5: ded2790 ($3.05 in chips) 
Seat 6: AkoAySugarol ($2.16 in chips) 
Paysandu70: posts small blind $0.01
SKFin: posts big blind $0.02
*** HOLE CARDS ***
Dealt to hc agorist [5c 2c]
mikhail3434: folds 
ded2790: folds 
AkoAySugarol: folds 
hc agorist: folds 
Paysandu70: folds 
Uncalled bet ($0.01) returned to SKFin
SKFin collected $0.02 from pot
SKFin: doesn't show hand 
*** SUMMARY ***
Total pot $0.02 | Rake $0 
Seat 1: hc agorist (button) folded before Flop (didn't bet)
Seat 2: Paysandu70 (small blind) folded before Flop
Seat 3: SKFin (big blind) collected ($0.02)
Seat 4: mikhail3434 folded before Flop (didn't bet)
Seat 5: ded2790 folded before Flop (didn't bet)
Seat 6: AkoAySugarol folded before Flop (didn't bet)



PokerStars Zoom Hand #193766731445:  Hold'em No Limit ($0.01/$0.02) - 2018/11/26 23:42:35 CUST [2018/11/26 10:42:35 ET]
Table 'Halley' 6-max Seat #1 is the button
Seat 1: demisom ($1.06 in chips) 
Seat 2: Pokersk999 ($2.45 in chips) 
Seat 3: olegan.o94 ($0.95 in chips) 
Seat 4: hc agorist ($1.72 in chips) 
Seat 5: Vahenta ($2.47 in chips) 
Seat 6: zwen5 ($0.97 in chips) 
Pokersk999: posts small blind $0.01
olegan.o94: posts big blind $0.02
*** HOLE CARDS ***
Dealt to hc agorist [9s 9d]
hc agorist: raises $0.02 to $0.04
Vahenta: folds 
zwen5: calls $0.04
demisom: folds 
Pokersk999: folds 
olegan.o94: calls $0.02
*** FLOP *** [Jh 2h Ks]
olegan.o94: checks 
hc agorist: checks 
zwen5: checks 
*** TURN *** [Jh 2h Ks] [Jc]
olegan.o94: checks 
hc agorist: bets $0.10
zwen5: folds 
olegan.o94: folds 
Uncalled bet ($0.10) returned to hc agorist
hc agorist collected $0.13 from pot
hc agorist: doesn't show hand 
*** SUMMARY ***
Total pot $0.13 | Rake $0 
Board [Jh 2h Ks Jc]
Seat 1: demisom (button) folded before Flop (didn't bet)
Seat 2: Pokersk999 (small blind) folded before Flop
Seat 3: olegan.o94 (big blind) folded on the Turn
Seat 4: hc agorist collected ($0.13)
Seat 5: Vahenta folded before Flop (didn't bet)
Seat 6: zwen5 folded on the Turn



PokerStars Zoom Hand #193766749050:  Hold'em No Limit ($0.01/$0.02) - 2018/11/26 23:43:10 CUST [2018/11/26 10:43:10 ET]
Table 'Halley' 6-max Seat #1 is the button
Seat 1: Adambl58 ($3.56 in chips) 
Seat 2: technomonkey ($1.99 in chips) 
Seat 3: hc agorist ($1.81 in chips) 
Seat 4: Cobrå ($2.17 in chips) 
Seat 5: sluks ($2.78 in chips) 
Seat 6: JeanHavoc ($2.60 in chips) 
technomonkey: posts small blind $0.01
hc agorist: posts big blind $0.02
*** HOLE CARDS ***
Dealt to hc agorist [6c 3h]
Cobrå: folds 
sluks: raises $0.02 to $0.04
JeanHavoc: folds 
Adambl58: folds 
technomonkey: folds 
hc agorist: folds 
Uncalled bet ($0.02) returned to sluks
sluks collected $0.05 from pot
sluks: doesn't show hand 
*** SUMMARY ***
Total pot $0.05 | Rake $0 
Seat 1: Adambl58 (button) folded before Flop (didn't bet)
Seat 2: technomonkey (small blind) folded before Flop
Seat 3: hc agorist (big blind) folded before Flop
Seat 4: Cobrå folded before Flop (didn't bet)
Seat 5: sluks collected ($0.05)
Seat 6: JeanHavoc folded before Flop (didn't bet)



PokerStars Zoom Hand #193766755659:  Hold'em No Limit ($0.01/$0.02) - 2018/11/26 23:43:23 CUST [2018/11/26 10:43:23 ET]
Table 'Halley' 6-max Seat #1 is the button
Seat 1: hc agorist ($1.79 in chips) 
Seat 2: LexLuther499 ($2.03 in chips) 
Seat 3: sluks ($2.11 in chips) 
Seat 4: SMAYLOVRIF ($3.07 in chips) 
Seat 5: GreyKeeperRu ($2.43 in chips) 
Seat 6: degelcamus ($5.06 in chips) 
LexLuther499: posts small blind $0.01
sluks: posts big blind $0.02
*** HOLE CARDS ***
Dealt to hc agorist [As 9d]
SMAYLOVRIF: raises $0.10 to $0.12
GreyKeeperRu: folds 
degelcamus: folds 
hc agorist: folds 
LexLuther499: folds 
sluks: folds 
Uncalled bet ($0.10) returned to SMAYLOVRIF
SMAYLOVRIF collected $0.05 from pot
SMAYLOVRIF: doesn't show hand 
*** SUMMARY ***
Total pot $0.05 | Rake $0 
Seat 1: hc agorist (button) folded before Flop (didn't bet)
Seat 2: LexLuther499 (small blind) folded before Flop
Seat 3: sluks (big blind) folded before Flop
Seat 4: SMAYLOVRIF collected ($0.05)
Seat 5: GreyKeeperRu folded before Flop (didn't bet)
Seat 6: degelcamus folded before Flop (didn't bet)



PokerStars Zoom Hand #193766764684:  Hold'em No Limit ($0.01/$0.02) - 2018/11/26 23:43:41 CUST [2018/11/26 10:43:41 ET]
Table 'Halley' 6-max Seat #1 is the button
Seat 1: taiszi ($2.11 in chips) 
Seat 2: JeanHavoc ($2.72 in chips) 
Seat 3: xiazhen ($2.02 in chips) 
Seat 4: Suzumusi ($2.43 in chips) 
Seat 5: mine4sure ($2.24 in chips) 
Seat 6: hc agorist ($1.78 in chips) 
JeanHavoc: posts small blind $0.01
xiazhen: posts big blind $0.02
*** HOLE CARDS ***
Dealt to hc agorist [Jd 8h]
Suzumusi: folds 
mine4sure: raises $0.02 to $0.04
hc agorist: folds 
taiszi: raises $0.08 to $0.12
JeanHavoc: folds 
xiazhen: folds 
mine4sure: folds 
Uncalled bet ($0.08) returned to taiszi
taiszi collected $0.11 from pot
taiszi: doesn't show hand 
*** SUMMARY ***
Total pot $0.11 | Rake $0 
Seat 1: taiszi (button) collected ($0.11)
Seat 2: JeanHavoc (small blind) folded before Flop
Seat 3: xiazhen (big blind) folded before Flop
Seat 4: Suzumusi folded before Flop (didn't bet)
Seat 5: mine4sure folded before Flop
Seat 6: hc agorist folded before Flop (didn't bet)



PokerStars Zoom Hand #193766762222:  Hold'em No Limit ($0.01/$0.02) - 2018/11/26 23:43:36 CUST [2018/11/26 10:43:36 ET]
Table 'Halley' 6-max Seat #1 is the button
Seat 1: derek373 ($2.68 in chips) 
Seat 2: Maksbill1 ($2.73 in chips) 
Seat 3: Energetic71 ($2.07 in chips) 
Seat 4: booktable ($2 in chips) 
Seat 5: hc agorist ($1.78 in chips) 
Seat 6: my sapphire ($14.68 in chips) 
Maksbill1: posts small blind $0.01
Energetic71: posts big blind $0.02
*** HOLE CARDS ***
Dealt to hc agorist [2c Kd]
booktable: folds 
hc agorist: folds 
my sapphire: folds 
derek373: raises $0.04 to $0.06
Maksbill1: folds 
Energetic71: raises $0.16 to $0.22
derek373: folds 
Uncalled bet ($0.16) returned to Energetic71
Energetic71 collected $0.13 from pot
Energetic71: doesn't show hand 
*** SUMMARY ***
Total pot $0.13 | Rake $0 
Seat 1: derek373 (button) folded before Flop
Seat 2: Maksbill1 (small blind) folded before Flop
Seat 3: Energetic71 (big blind) collected ($0.13)
Seat 4: booktable folded before Flop (didn't bet)
Seat 5: hc agorist folded before Flop (didn't bet)
Seat 6: my sapphire folded before Flop (didn't bet)



PokerStars Zoom Hand #193766759657:  Hold'em No Limit ($0.01/$0.02) - 2018/11/26 23:43:31 CUST [2018/11/26 10:43:31 ET]
Table 'Halley' 6-max Seat #1 is the button
Seat 1: QQueen playy ($2.06 in chips) 
Seat 2: hc agorist ($1.79 in chips) 
Seat 3: Arch1689 ($2.12 in chips) 
Seat 4: kawauchir1 ($5.41 in chips) 
Seat 5: Genal55 ($2.01 in chips) 
Seat 6: bonja1988 ($0.91 in chips) 
hc agorist: posts small blind $0.01
Arch1689: posts big blind $0.02
*** HOLE CARDS ***
Dealt to hc agorist [Qc 9h]
kawauchir1: folds 
Genal55: calls $0.02
bonja1988: folds 
QQueen playy: raises $0.10 to $0.12
hc agorist: folds 
Arch1689: folds 
Genal55: calls $0.10
*** FLOP *** [7c Ks 6s]
Genal55: checks 
QQueen playy: bets $0.18
Genal55: folds 
Uncalled bet ($0.18) returned to QQueen playy
QQueen playy collected $0.26 from pot
QQueen playy: doesn't show hand 
*** SUMMARY ***
Total pot $0.27 | Rake $0.01 
Board [7c Ks 6s]
Seat 1: QQueen playy (button) collected ($0.26)
Seat 2: hc agorist (small blind) folded before Flop
Seat 3: Arch1689 (big blind) folded before Flop
Seat 4: kawauchir1 folded before Flop (didn't bet)
Seat 5: Genal55 folded on the Flop
Seat 6: bonja1988 folded before Flop (didn't bet)



PokerStars Zoom Hand #193766767649:  Hold'em No Limit ($0.01/$0.02) - 2018/11/26 23:43:47 CUST [2018/11/26 10:43:47 ET]
Table 'Halley' 6-max Seat #1 is the button
Seat 1: werendor ($3.70 in chips) 
Seat 2: Irorek6643 ($0.30 in chips) 
Seat 3: sukisurova ($2.35 in chips) 
Seat 4: 6opusbI4 ($2.37 in chips) 
Seat 5: hc agorist ($1.78 in chips) 
Seat 6: picurul ($2.01 in chips) 
Irorek6643: posts small blind $0.01
sukisurova: posts big blind $0.02
*** HOLE CARDS ***
Dealt to hc agorist [Kd Qs]
6opusbI4: folds 
hc agorist: raises $0.02 to $0.04
picurul has timed out
picurul: folds 
werendor: folds 
Irorek6643: folds 
sukisurova: folds 
Uncalled bet ($0.02) returned to hc agorist
hc agorist collected $0.05 from pot
hc agorist: doesn't show hand 
*** SUMMARY ***
Total pot $0.05 | Rake $0 
Seat 1: werendor (button) folded before Flop (didn't bet)
Seat 2: Irorek6643 (small blind) folded before Flop
Seat 3: sukisurova (big blind) folded before Flop
Seat 4: 6opusbI4 folded before Flop (didn't bet)
Seat 5: hc agorist collected ($0.05)
Seat 6: picurul folded before Flop (didn't bet)



PokerStars Zoom Hand #193766780065:  Hold'em No Limit ($0.01/$0.02) - 2018/11/26 23:44:12 CUST [2018/11/26 10:44:12 ET]
Table 'Halley' 6-max Seat #1 is the button
Seat 1: hc agorist ($1.81 in chips) 
Seat 2: Laser282 ($2.49 in chips) 
Seat 3: aqyl7 ($1 in chips) 
Seat 4: maferna ($2.38 in chips) 
Seat 5: AnAxl ($1.08 in chips) 
Seat 6: veksy ($2 in chips) 
Laser282: posts small blind $0.01
aqyl7: posts big blind $0.02
*** HOLE CARDS ***
Dealt to hc agorist [6h 9h]
maferna: folds 
AnAxl: folds 
veksy: folds 
hc agorist: raises $0.02 to $0.04
Laser282: raises $0.08 to $0.12
aqyl7: calls $0.10
hc agorist: calls $0.08
*** FLOP *** [7h Qc 3h]
Laser282: bets $0.20
aqyl7: calls $0.20
hc agorist: calls $0.20
*** TURN *** [7h Qc 3h] [5h]
Laser282: checks 
aqyl7: bets $0.68 and is all-in
hc agorist: calls $0.68
Laser282: folds 
*** RIVER *** [7h Qc 3h 5h] [Th]
*** SHOW DOWN ***
aqyl7: shows [Ah Jd] (a flush, Ace high)
hc agorist: shows [6h 9h] (a flush, Ten high)
aqyl7 collected $2.24 from pot
*** SUMMARY ***
Total pot $2.32 | Rake $0.08 
Board [7h Qc 3h 5h Th]
Seat 1: hc agorist (button) showed [6h 9h] and lost with a flush, Ten high
Seat 2: Laser282 (small blind) folded on the Turn
Seat 3: aqyl7 (big blind) showed [Ah Jd] and won ($2.24) with a flush, Ace high
Seat 4: maferna folded before Flop (didn't bet)
Seat 5: AnAxl folded before Flop (didn't bet)
Seat 6: veksy folded before Flop (didn't bet)



PokerStars Zoom Hand #193766815021:  Hold'em No Limit ($0.01/$0.02) - 2018/11/26 23:45:22 CUST [2018/11/26 10:45:22 ET]
Table 'Halley' 6-max Seat #1 is the button
Seat 1: Gollenz ($2.17 in chips) 
Seat 2: JBD101 ($3.58 in chips) 
Seat 3: hc agorist ($0.81 in chips) 
Seat 4: WinziF ($2.13 in chips) 
Seat 5: degelcamus ($9.01 in chips) 
Seat 6: ForHistory ($2.74 in chips) 
JBD101: posts small blind $0.01
hc agorist: posts big blind $0.02
*** HOLE CARDS ***
Dealt to hc agorist [Kc 2c]
WinziF: folds 
degelcamus: raises $0.03 to $0.05
ForHistory: calls $0.05
Gollenz: folds 
JBD101: folds 
hc agorist: raises $0.16 to $0.21
degelcamus: folds 
ForHistory: calls $0.16
*** FLOP *** [Jc 5c Qh]
hc agorist: bets $0.22
ForHistory: folds 
Uncalled bet ($0.22) returned to hc agorist
hc agorist collected $0.46 from pot
hc agorist: doesn't show hand 
*** SUMMARY ***
Total pot $0.48 | Rake $0.02 
Board [Jc 5c Qh]
Seat 1: Gollenz (button) folded before Flop (didn't bet)
Seat 2: JBD101 (small blind) folded before Flop
Seat 3: hc agorist (big blind) collected ($0.46)
Seat 4: WinziF folded before Flop (didn't bet)
Seat 5: degelcamus folded before Flop
Seat 6: ForHistory folded on the Flop



PokerStars Zoom Hand #193766828563:  Hold'em No Limit ($0.01/$0.02) - 2018/11/26 23:45:49 CUST [2018/11/26 10:45:49 ET]
Table 'Halley' 6-max Seat #1 is the button
Seat 1: Dorogoi57 ($2.42 in chips) 
Seat 2: hc agorist ($2 in chips) 
Seat 3: Spinno ($2 in chips) 
Seat 4: alexrain600 ($2 in chips) 
Seat 5: ard14 ($2 in chips) 
Seat 6: alexps922 ($2.36 in chips) 
hc agorist: posts small blind $0.01
Spinno: posts big blind $0.02
*** HOLE CARDS ***
Dealt to hc agorist [5d 3d]
alexrain600: folds 
ard14: raises $0.04 to $0.06
alexps922: folds 
Dorogoi57: folds 
hc agorist: folds 
Spinno: folds 
Uncalled bet ($0.04) returned to ard14
ard14 collected $0.05 from pot
ard14: doesn't show hand 
*** SUMMARY ***
Total pot $0.05 | Rake $0 
Seat 1: Dorogoi57 (button) folded before Flop (didn't bet)
Seat 2: hc agorist (small blind) folded before Flop
Seat 3: Spinno (big blind) folded before Flop
Seat 4: alexrain600 folded before Flop (didn't bet)
Seat 5: ard14 collected ($0.05)
Seat 6: alexps922 folded before Flop (didn't bet)



PokerStars Zoom Hand #193766831134:  Hold'em No Limit ($0.01/$0.02) - 2018/11/26 23:45:54 CUST [2018/11/26 10:45:54 ET]
Table 'Halley' 6-max Seat #1 is the button
Seat 1: mine4sure ($4.06 in chips) 
Seat 2: igna4375 ($6.33 in chips) 
Seat 3: 3Iver's3 ($3.15 in chips) 
Seat 4: hc agorist ($1.99 in chips) 
Seat 5: NeVerLie1312 ($1.09 in chips) 
Seat 6: cRaZyEiGhT85 ($5.01 in chips) 
igna4375: posts small blind $0.01
3Iver's3: posts big blind $0.02
*** HOLE CARDS ***
Dealt to hc agorist [7d 9s]
hc agorist: folds 
NeVerLie1312: folds 
cRaZyEiGhT85: folds 
mine4sure: folds 
igna4375: raises $0.04 to $0.06
3Iver's3: folds 
Uncalled bet ($0.04) returned to igna4375
igna4375 collected $0.04 from pot
igna4375: doesn't show hand 
*** SUMMARY ***
Total pot $0.04 | Rake $0 
Seat 1: mine4sure (button) folded before Flop (didn't bet)
Seat 2: igna4375 (small blind) collected ($0.04)
Seat 3: 3Iver's3 (big blind) folded before Flop
Seat 4: hc agorist folded before Flop (didn't bet)
Seat 5: NeVerLie1312 folded before Flop (didn't bet)
Seat 6: cRaZyEiGhT85 folded before Flop (didn't bet)



PokerStars Zoom Hand #193766836515:  Hold'em No Limit ($0.01/$0.02) - 2018/11/26 23:46:05 CUST [2018/11/26 10:46:05 ET]
Table 'Halley' 6-max Seat #1 is the button
Seat 1: Arch1689 ($2.06 in chips) 
Seat 2: pruxaxa ($1.53 in chips) 
Seat 3: Johncort919 ($1.26 in chips) 
Seat 4: sinster_ca85 ($2.22 in chips) 
Seat 5: hc agorist ($1.99 in chips) 
Seat 6: 5tr2te9 ($2 in chips) 
pruxaxa: posts small blind $0.01
Johncort919: posts big blind $0.02
*** HOLE CARDS ***
Dealt to hc agorist [Ks 2s]
sinster_ca85: folds 
hc agorist: folds 
5tr2te9: folds 
Arch1689: folds 
pruxaxa: folds 
Uncalled bet ($0.01) returned to Johncort919
Johncort919 collected $0.02 from pot
Johncort919: doesn't show hand 
*** SUMMARY ***
Total pot $0.02 | Rake $0 
Seat 1: Arch1689 (button) folded before Flop (didn't bet)
Seat 2: pruxaxa (small blind) folded before Flop
Seat 3: Johncort919 (big blind) collected ($0.02)
Seat 4: sinster_ca85 folded before Flop (didn't bet)
Seat 5: hc agorist folded before Flop (didn't bet)
Seat 6: 5tr2te9 folded before Flop (didn't bet)



PokerStars Zoom Hand #193766833059:  Hold'em No Limit ($0.01/$0.02) - 2018/11/26 23:45:58 CUST [2018/11/26 10:45:58 ET]
Table 'Halley' 6-max Seat #1 is the button
Seat 1: TheD1nhoR10 ($2.02 in chips) 
Seat 2: SATUBATU10 ($2.20 in chips) 
Seat 3: bbaty123 ($2 in chips) 
Seat 4: degelcamus ($8.93 in chips) 
Seat 5: Snegul ($0.63 in chips) 
Seat 6: hc agorist ($1.99 in chips) 
SATUBATU10: posts small blind $0.01
bbaty123: posts big blind $0.02
*** HOLE CARDS ***
Dealt to hc agorist [9c 3d]
degelcamus has timed out
degelcamus: folds 
Snegul: folds 
hc agorist: folds 
TheD1nhoR10: folds 
SATUBATU10: folds 
Uncalled bet ($0.01) returned to bbaty123
bbaty123 collected $0.02 from pot
bbaty123: doesn't show hand 
*** SUMMARY ***
Total pot $0.02 | Rake $0 
Seat 1: TheD1nhoR10 (button) folded before Flop (didn't bet)
Seat 2: SATUBATU10 (small blind) folded before Flop
Seat 3: bbaty123 (big blind) collected ($0.02)
Seat 4: degelcamus folded before Flop (didn't bet)
Seat 5: Snegul folded before Flop (didn't bet)
Seat 6: hc agorist folded before Flop (didn't bet)



PokerStars Zoom Hand #193766841105:  Hold'em No Limit ($0.01/$0.02) - 2018/11/26 23:46:14 CUST [2018/11/26 10:46:14 ET]
Table 'Halley' 6-max Seat #1 is the button
Seat 1: EvaldasRa ($2.27 in chips) 
Seat 2: neo1200 ($2.37 in chips) 
Seat 3: RedFox283 ($2.03 in chips) 
Seat 4: hc agorist ($1.99 in chips) 
Seat 5: sens3ii ($4.91 in chips) 
Seat 6: Dzienikarz49 ($6.95 in chips) 
neo1200: posts small blind $0.01
RedFox283: posts big blind $0.02
*** HOLE CARDS ***
Dealt to hc agorist [Jh 7c]
hc agorist: folds 
sens3ii: raises $0.02 to $0.04
Dzienikarz49: raises $0.02 to $0.06
EvaldasRa: folds 
neo1200: folds 
RedFox283: folds 
sens3ii: calls $0.02
*** FLOP *** [Tc 7h 6d]
sens3ii: checks 
Dzienikarz49: checks 
*** TURN *** [Tc 7h 6d] [3c]
sens3ii: bets $0.14
Dzienikarz49: folds 
Uncalled bet ($0.14) returned to sens3ii
sens3ii collected $0.14 from pot
sens3ii: doesn't show hand 
*** SUMMARY ***
Total pot $0.15 | Rake $0.01 
Board [Tc 7h 6d 3c]
Seat 1: EvaldasRa (button) folded before Flop (didn't bet)
Seat 2: neo1200 (small blind) folded before Flop
Seat 3: RedFox283 (big blind) folded before Flop
Seat 4: hc agorist folded before Flop (didn't bet)
Seat 5: sens3ii collected ($0.14)
Seat 6: Dzienikarz49 folded on the Turn



PokerStars Zoom Hand #193766843634:  Hold'em No Limit ($0.01/$0.02) - 2018/11/26 23:46:19 CUST [2018/11/26 10:46:19 ET]
Table 'Halley' 6-max Seat #1 is the button
Seat 1: MR.xvxvxv ($1.56 in chips) 
Seat 2: bard18 ($3.56 in chips) 
Seat 3: hc agorist ($1.99 in chips) 
Seat 4: Alen1511 ($2.28 in chips) 
Seat 5: Gamer577 ($3.07 in chips) 
Seat 6: GinthersRift ($8.96 in chips) 
bard18: posts small blind $0.01
hc agorist: posts big blind $0.02
*** HOLE CARDS ***
Dealt to hc agorist [8c 7d]
Alen1511: folds 
Gamer577: folds 
GinthersRift: raises $0.03 to $0.05
MR.xvxvxv: folds 
bard18: folds 
hc agorist: calls $0.03
*** FLOP *** [Kh 8d 3d]
hc agorist: checks 
GinthersRift: bets $0.06
hc agorist: calls $0.06
*** TURN *** [Kh 8d 3d] [6d]
hc agorist: checks 
GinthersRift: bets $0.04
hc agorist: calls $0.04
*** RIVER *** [Kh 8d 3d 6d] [7h]
hc agorist: checks 
GinthersRift: checks 
*** SHOW DOWN ***
hc agorist: shows [8c 7d] (two pair, Eights and Sevens)
GinthersRift: mucks hand 
hc agorist collected $0.30 from pot
*** SUMMARY ***
Total pot $0.31 | Rake $0.01 
Board [Kh 8d 3d 6d 7h]
Seat 1: MR.xvxvxv (button) folded before Flop (didn't bet)
Seat 2: bard18 (small blind) folded before Flop
Seat 3: hc agorist (big blind) showed [8c 7d] and won ($0.30) with two pair, Eights and Sevens
Seat 4: Alen1511 folded before Flop (didn't bet)
Seat 5: Gamer577 folded before Flop (didn't bet)
Seat 6: GinthersRift mucked [Th 8h]



PokerStars Zoom Hand #193766869665:  Hold'em No Limit ($0.01/$0.02) - 2018/11/26 23:47:11 CUST [2018/11/26 10:47:11 ET]
Table 'Halley' 6-max Seat #1 is the button
Seat 1: hc agorist ($2.13 in chips) 
Seat 2: derek373 ($3.18 in chips) 
Seat 3: Medved219 ($2 in chips) 
Seat 4: xiazhen ($2.12 in chips) 
Seat 5: COURT JES264 ($4.18 in chips) 
Seat 6: koribut ($2 in chips) 
derek373: posts small blind $0.01
Medved219: posts big blind $0.02
*** HOLE CARDS ***
Dealt to hc agorist [4d 7c]
xiazhen: folds 
COURT JES264: folds 
koribut: folds 
hc agorist: folds 
derek373: raises $0.04 to $0.06
Medved219: folds 
Uncalled bet ($0.04) returned to derek373
derek373 collected $0.04 from pot
derek373: doesn't show hand 
*** SUMMARY ***
Total pot $0.04 | Rake $0 
Seat 1: hc agorist (button) folded before Flop (didn't bet)
Seat 2: derek373 (small blind) collected ($0.04)
Seat 3: Medved219 (big blind) folded before Flop
Seat 4: xiazhen folded before Flop (didn't bet)
Seat 5: COURT JES264 folded before Flop (didn't bet)
Seat 6: koribut folded before Flop (didn't bet)



PokerStars Zoom Hand #193766865263:  Hold'em No Limit ($0.01/$0.02) - 2018/11/26 23:47:02 CUST [2018/11/26 10:47:02 ET]
Table 'Halley' 6-max Seat #1 is the button
Seat 1: romanromanro ($3.96 in chips) 
Seat 2: hc agorist ($2.14 in chips) 
Seat 3: semirami2 ($2.16 in chips) 
Seat 4: GinthersRift ($8.81 in chips) 
Seat 5: mendesmg30 ($3.25 in chips) 
Seat 6: bbaty123 ($2.03 in chips) 
hc agorist: posts small blind $0.01
semirami2: posts big blind $0.02
*** HOLE CARDS ***
Dealt to hc agorist [Jc 5d]
GinthersRift: folds 
mendesmg30: folds 
bbaty123: folds 
romanromanro: raises $0.03 to $0.05
hc agorist: folds 
semirami2: folds 
Uncalled bet ($0.03) returned to romanromanro
romanromanro collected $0.05 from pot
romanromanro: doesn't show hand 
*** SUMMARY ***
Total pot $0.05 | Rake $0 
Seat 1: romanromanro (button) collected ($0.05)
Seat 2: hc agorist (small blind) folded before Flop
Seat 3: semirami2 (big blind) folded before Flop
Seat 4: GinthersRift folded before Flop (didn't bet)
Seat 5: mendesmg30 folded before Flop (didn't bet)
Seat 6: bbaty123 folded before Flop (didn't bet)



PokerStars Zoom Hand #193766872214:  Hold'em No Limit ($0.01/$0.02) - 2018/11/26 23:47:16 CUST [2018/11/26 10:47:16 ET]
Table 'Halley' 6-max Seat #1 is the button
Seat 1: dedmoroz311 ($1.09 in chips) 
Seat 2: karimboAA ($2.32 in chips) 
Seat 3: laggi^tl0 ($1.86 in chips) 
Seat 4: Kala77 ($2 in chips) 
Seat 5: Dorogoi57 ($2.61 in chips) 
Seat 6: hc agorist ($2.13 in chips) 
karimboAA: posts small blind $0.01
laggi^tl0: posts big blind $0.02
*** HOLE CARDS ***
Dealt to hc agorist [Qh Kd]
Kala77: folds 
Dorogoi57: folds 
hc agorist: raises $0.02 to $0.04
dedmoroz311: folds 
karimboAA: folds 
laggi^tl0: calls $0.02
*** FLOP *** [As 3d 8s]
laggi^tl0: checks 
hc agorist: bets $0.03
laggi^tl0: folds 
Uncalled bet ($0.03) returned to hc agorist
hc agorist collected $0.09 from pot
hc agorist: doesn't show hand 
*** SUMMARY ***
Total pot $0.09 | Rake $0 
Board [As 3d 8s]
Seat 1: dedmoroz311 (button) folded before Flop (didn't bet)
Seat 2: karimboAA (small blind) folded before Flop
Seat 3: laggi^tl0 (big blind) folded on the Flop
Seat 4: Kala77 folded before Flop (didn't bet)
Seat 5: Dorogoi57 folded before Flop (didn't bet)
Seat 6: hc agorist collected ($0.09)



PokerStars Zoom Hand #193766884252:  Hold'em No Limit ($0.01/$0.02) - 2018/11/26 23:47:40 CUST [2018/11/26 10:47:40 ET]
Table 'Halley' 6-max Seat #1 is the button
Seat 1: hc agorist ($2.18 in chips) 
Seat 2: Lawrence$lim ($2.48 in chips) 
Seat 3: boss477 ($2 in chips) 
Seat 4: ios-801 ($2 in chips) 
Seat 5: Laser282 ($1.43 in chips) 
Seat 6: geebo15 ($0.92 in chips) 
Lawrence$lim: posts small blind $0.01
boss477: posts big blind $0.02
*** HOLE CARDS ***
Dealt to hc agorist [Ts Kd]
ios-801: folds 
Laser282: raises $0.04 to $0.06
geebo15: folds 
hc agorist: calls $0.06
Lawrence$lim: folds 
boss477: calls $0.04
*** FLOP *** [Qd 6c 4d]
boss477: bets $0.14
Laser282: folds 
hc agorist: folds 
Uncalled bet ($0.14) returned to boss477
boss477 collected $0.18 from pot
boss477: doesn't show hand 
*** SUMMARY ***
Total pot $0.19 | Rake $0.01 
Board [Qd 6c 4d]
Seat 1: hc agorist (button) folded on the Flop
Seat 2: Lawrence$lim (small blind) folded before Flop
Seat 3: boss477 (big blind) collected ($0.18)
Seat 4: ios-801 folded before Flop (didn't bet)
Seat 5: Laser282 folded on the Flop
Seat 6: geebo15 folded before Flop (didn't bet)



PokerStars Zoom Hand #193766909217:  Hold'em No Limit ($0.01/$0.02) - 2018/11/26 23:48:30 CUST [2018/11/26 10:48:30 ET]
Table 'Halley' 6-max Seat #1 is the button
Seat 1: vatteztaR* ($2 in chips) 
Seat 2: mich051260 ($12.38 in chips) 
Seat 3: derek373 ($3.20 in chips) 
Seat 4: romanromanro ($3.96 in chips) 
Seat 5: meniasjo ($3.41 in chips) 
Seat 6: hc agorist ($2.09 in chips) 
mich051260: posts small blind $0.01
derek373: posts big blind $0.02
*** HOLE CARDS ***
Dealt to hc agorist [3s Ac]
romanromanro: folds 
meniasjo: folds 
hc agorist: raises $0.02 to $0.04
vatteztaR*: folds 
mich051260: folds 
derek373: folds 
Uncalled bet ($0.02) returned to hc agorist
hc agorist collected $0.05 from pot
hc agorist: doesn't show hand 
*** SUMMARY ***
Total pot $0.05 | Rake $0 
Seat 1: vatteztaR* (button) folded before Flop (didn't bet)
Seat 2: mich051260 (small blind) folded before Flop
Seat 3: derek373 (big blind) folded before Flop
Seat 4: romanromanro folded before Flop (didn't bet)
Seat 5: meniasjo folded before Flop (didn't bet)
Seat 6: hc agorist collected ($0.05)



PokerStars Zoom Hand #193766906252:  Hold'em No Limit ($0.01/$0.02) - 2018/11/26 23:48:24 CUST [2018/11/26 10:48:24 ET]
Table 'Halley' 6-max Seat #1 is the button
Seat 1: Lakchenko ($2.01 in chips) 
Seat 2: hc agorist ($2.10 in chips) 
Seat 3: Geolog800 ($4.63 in chips) 
Seat 4: COURT JES264 ($2.50 in chips) 
Seat 5: kilingdude ($2.05 in chips) 
Seat 6: Artem038rus ($1.13 in chips) 
hc agorist: posts small blind $0.01
Geolog800: posts big blind $0.02
*** HOLE CARDS ***
Dealt to hc agorist [Jh 7d]
COURT JES264: folds 
kilingdude: folds 
Artem038rus: folds 
Lakchenko: raises $0.03 to $0.05
hc agorist: folds 
Geolog800: calls $0.03
*** FLOP *** [Jd 4c 7s]
Geolog800: checks 
Lakchenko: bets $0.07
Geolog800: folds 
Uncalled bet ($0.07) returned to Lakchenko
Lakchenko collected $0.11 from pot
Lakchenko: doesn't show hand 
*** SUMMARY ***
Total pot $0.11 | Rake $0 
Board [Jd 4c 7s]
Seat 1: Lakchenko (button) collected ($0.11)
Seat 2: hc agorist (small blind) folded before Flop
Seat 3: Geolog800 (big blind) folded on the Flop
Seat 4: COURT JES264 folded before Flop (didn't bet)
Seat 5: kilingdude folded before Flop (didn't bet)
Seat 6: Artem038rus folded before Flop (didn't bet)



PokerStars Zoom Hand #193766914787:  Hold'em No Limit ($0.01/$0.02) - 2018/11/26 23:48:41 CUST [2018/11/26 10:48:41 ET]
Table 'Halley' 6-max Seat #1 is the button
Seat 1: sukisurova ($2.91 in chips) 
Seat 2: DenWhite89 ($2.56 in chips) 
Seat 3: Heliodabest ($3.81 in chips) 
Seat 4: vadtea2 ($2.39 in chips) 
Seat 5: hc agorist ($2.12 in chips) 
Seat 6: anzzud ($2 in chips) 
DenWhite89: posts small blind $0.01
Heliodabest: posts big blind $0.02
*** HOLE CARDS ***
Dealt to hc agorist [9h 6h]
vadtea2: folds 
hc agorist: raises $0.02 to $0.04
anzzud: folds 
sukisurova: folds 
DenWhite89: folds 
Heliodabest: folds 
Uncalled bet ($0.02) returned to hc agorist
hc agorist collected $0.05 from pot
hc agorist: doesn't show hand 
*** SUMMARY ***
Total pot $0.05 | Rake $0 
Seat 1: sukisurova (button) folded before Flop (didn't bet)
Seat 2: DenWhite89 (small blind) folded before Flop
Seat 3: Heliodabest (big blind) folded before Flop
Seat 4: vadtea2 folded before Flop (didn't bet)
Seat 5: hc agorist collected ($0.05)
Seat 6: anzzud folded before Flop (didn't bet)



PokerStars Zoom Hand #193766902741:  Hold'em No Limit ($0.01/$0.02) - 2018/11/26 23:48:17 CUST [2018/11/26 10:48:17 ET]
Table 'Halley' 6-max Seat #1 is the button
Seat 1: gv3055 ($3.11 in chips) 
Seat 2: SVG7777 ($0.70 in chips) 
Seat 3: hc agorist ($2.12 in chips) 
Seat 4: Johneik ($2.02 in chips) 
Seat 5: P.Cogito ($2.55 in chips) 
Seat 6: vova270793 ($5.32 in chips) 
SVG7777: posts small blind $0.01
hc agorist: posts big blind $0.02
*** HOLE CARDS ***
Dealt to hc agorist [Td 5h]
Johneik: raises $0.04 to $0.06
P.Cogito: folds 
vova270793: calls $0.06
gv3055: calls $0.06
SVG7777: folds 
hc agorist: folds 
*** FLOP *** [5d 6d 7h]
Johneik: bets $0.11
vova270793: raises $0.17 to $0.28
gv3055: folds 
Johneik: calls $0.17
*** TURN *** [5d 6d 7h] [8c]
Johneik: checks 
vova270793: bets $0.46
Johneik: folds 
Uncalled bet ($0.46) returned to vova270793
vova270793 collected $0.74 from pot
vova270793: doesn't show hand 
*** SUMMARY ***
Total pot $0.77 | Rake $0.03 
Board [5d 6d 7h 8c]
Seat 1: gv3055 (button) folded on the Flop
Seat 2: SVG7777 (small blind) folded before Flop
Seat 3: hc agorist (big blind) folded before Flop
Seat 4: Johneik folded on the Turn
Seat 5: P.Cogito folded before Flop (didn't bet)
Seat 6: vova270793 collected ($0.74)



PokerStars Zoom Hand #193766920795:  Hold'em No Limit ($0.01/$0.02) - 2018/11/26 23:48:53 CUST [2018/11/26 10:48:53 ET]
Table 'Halley' 6-max Seat #1 is the button
Seat 1: Pokersk999 ($2.80 in chips) 
Seat 2: Cyb3r47 ($2 in chips) 
Seat 3: liryka ($2 in chips) 
Seat 4: hc agorist ($2.15 in chips) 
Seat 5: sunnypanther ($2 in chips) 
Seat 6: ProFishAnal ($2 in chips) 
Cyb3r47: posts small blind $0.01
liryka: posts big blind $0.02
*** HOLE CARDS ***
Dealt to hc agorist [As Js]
hc agorist: raises $0.02 to $0.04
sunnypanther: folds 
ProFishAnal: folds 
Pokersk999: folds 
Cyb3r47: folds 
liryka: calls $0.02
*** FLOP *** [3h Kh 9c]
liryka: checks 
hc agorist: bets $0.03
liryka: calls $0.03
*** TURN *** [3h Kh 9c] [6d]
liryka: checks 
hc agorist: checks 
*** RIVER *** [3h Kh 9c 6d] [4d]
liryka: bets $0.08
hc agorist: raises $0.24 to $0.32
liryka: folds 
Uncalled bet ($0.24) returned to hc agorist
hc agorist collected $0.30 from pot
hc agorist: doesn't show hand 
*** SUMMARY ***
Total pot $0.31 | Rake $0.01 
Board [3h Kh 9c 6d 4d]
Seat 1: Pokersk999 (button) folded before Flop (didn't bet)
Seat 2: Cyb3r47 (small blind) folded before Flop
Seat 3: liryka (big blind) folded on the River
Seat 4: hc agorist collected ($0.30)
Seat 5: sunnypanther folded before Flop (didn't bet)
Seat 6: ProFishAnal folded before Flop (didn't bet)



PokerStars Zoom Hand #193766948295:  Hold'em No Limit ($0.01/$0.02) - 2018/11/26 23:49:48 CUST [2018/11/26 10:49:48 ET]
Table 'Halley' 6-max Seat #1 is the button
Seat 1: LaCasa15 ($4.84 in chips) 
Seat 2: xolnikc69 ($2.89 in chips) 
Seat 3: Kala77 ($3.27 in chips) 
Seat 4: XMrMojoRisinX ($2.46 in chips) 
Seat 5: hc agorist ($2.30 in chips) 
Seat 6: JBD101 ($3.17 in chips) 
xolnikc69: posts small blind $0.01
Kala77: posts big blind $0.02
*** HOLE CARDS ***
Dealt to hc agorist [Kc Ad]
XMrMojoRisinX: folds 
hc agorist: raises $0.04 to $0.06
JBD101: folds 
LaCasa15: folds 
xolnikc69: folds 
Kala77: folds 
Uncalled bet ($0.04) returned to hc agorist
hc agorist collected $0.05 from pot
hc agorist: doesn't show hand 
*** SUMMARY ***
Total pot $0.05 | Rake $0 
Seat 1: LaCasa15 (button) folded before Flop (didn't bet)
Seat 2: xolnikc69 (small blind) folded before Flop
Seat 3: Kala77 (big blind) folded before Flop
Seat 4: XMrMojoRisinX folded before Flop (didn't bet)
Seat 5: hc agorist collected ($0.05)
Seat 6: JBD101 folded before Flop (didn't bet)



PokerStars Zoom Hand #193766959420:  Hold'em No Limit ($0.01/$0.02) - 2018/11/26 23:50:10 CUST [2018/11/26 10:50:10 ET]
Table 'Halley' 6-max Seat #1 is the button
Seat 1: fumina.k ($2.29 in chips) 
Seat 2: Igarrokk ($2.18 in chips) 
Seat 3: Nanitto10 ($1.23 in chips) 
Seat 4: hc agorist ($2.33 in chips) 
Seat 5: mine4sure ($4.26 in chips) 
Seat 6: wise pok ($2 in chips) 
Igarrokk: posts small blind $0.01
Nanitto10: posts big blind $0.02
*** HOLE CARDS ***
Dealt to hc agorist [2d Qd]
hc agorist: folds 
mine4sure: raises $0.02 to $0.04
wise pok: folds 
fumina.k: folds 
Igarrokk: folds 
Nanitto10: raises $0.14 to $0.18
mine4sure: folds 
Uncalled bet ($0.14) returned to Nanitto10
Nanitto10 collected $0.09 from pot
Nanitto10: doesn't show hand 
*** SUMMARY ***
Total pot $0.09 | Rake $0 
Seat 1: fumina.k (button) folded before Flop (didn't bet)
Seat 2: Igarrokk (small blind) folded before Flop
Seat 3: Nanitto10 (big blind) collected ($0.09)
Seat 4: hc agorist folded before Flop (didn't bet)
Seat 5: mine4sure folded before Flop
Seat 6: wise pok folded before Flop (didn't bet)



PokerStars Zoom Hand #193766961383:  Hold'em No Limit ($0.01/$0.02) - 2018/11/26 23:50:14 CUST [2018/11/26 10:50:14 ET]
Table 'Halley' 6-max Seat #1 is the button
Seat 1: lucky7wlsrud ($2 in chips) 
Seat 2: GreyKeeperRu ($2.27 in chips) 
Seat 3: hc agorist ($2.33 in chips) 
Seat 4: billy the x ($2.09 in chips) 
Seat 5: Igarrokk ($2.17 in chips) 
Seat 6: samsonnn86 ($2.11 in chips) 
GreyKeeperRu: posts small blind $0.01
hc agorist: posts big blind $0.02
*** HOLE CARDS ***
Dealt to hc agorist [Jh Ad]
billy the x: folds 
Igarrokk: folds 
samsonnn86: raises $0.04 to $0.06
lucky7wlsrud: folds 
GreyKeeperRu: calls $0.05
hc agorist: raises $0.18 to $0.24
samsonnn86: folds 
GreyKeeperRu: folds 
Uncalled bet ($0.18) returned to hc agorist
hc agorist collected $0.18 from pot
hc agorist: doesn't show hand 
*** SUMMARY ***
Total pot $0.18 | Rake $0 
Seat 1: lucky7wlsrud (button) folded before Flop (didn't bet)
Seat 2: GreyKeeperRu (small blind) folded before Flop
Seat 3: hc agorist (big blind) collected ($0.18)
Seat 4: billy the x folded before Flop (didn't bet)
Seat 5: Igarrokk folded before Flop (didn't bet)
Seat 6: samsonnn86 folded before Flop



PokerStars Zoom Hand #193766973395:  Hold'em No Limit ($0.01/$0.02) - 2018/11/26 23:50:38 CUST [2018/11/26 10:50:38 ET]
Table 'Halley' 6-max Seat #1 is the button
Seat 1: ANRI11101988 ($1.44 in chips) 
Seat 2: hc agorist ($2.45 in chips) 
Seat 3: P.Cogito ($2.02 in chips) 
Seat 4: Wadazet00 ($8.62 in chips) 
Seat 5: mine4sure ($2 in chips) 
Seat 6: Michel Mill ($2.03 in chips) 
hc agorist: posts small blind $0.01
P.Cogito: posts big blind $0.02
*** HOLE CARDS ***
Dealt to hc agorist [3h 3d]
Wadazet00: folds 
mine4sure: raises $0.02 to $0.04
Michel Mill: folds 
ANRI11101988: folds 
hc agorist: calls $0.03
P.Cogito: folds 
*** FLOP *** [9d 3s Kh]
hc agorist: checks 
mine4sure: bets $0.05
hc agorist: raises $0.15 to $0.20
mine4sure: calls $0.15
*** TURN *** [9d 3s Kh] [4s]
hc agorist: bets $0.38
mine4sure: folds 
Uncalled bet ($0.38) returned to hc agorist
hc agorist collected $0.48 from pot
hc agorist: doesn't show hand 
*** SUMMARY ***
Total pot $0.50 | Rake $0.02 
Board [9d 3s Kh 4s]
Seat 1: ANRI11101988 (button) folded before Flop (didn't bet)
Seat 2: hc agorist (small blind) collected ($0.48)
Seat 3: P.Cogito (big blind) folded before Flop
Seat 4: Wadazet00 folded before Flop (didn't bet)
Seat 5: mine4sure folded on the Turn
Seat 6: Michel Mill folded before Flop (didn't bet)



PokerStars Zoom Hand #193767001697:  Hold'em No Limit ($0.01/$0.02) - 2018/11/26 23:51:35 CUST [2018/11/26 10:51:35 ET]
Table 'Halley' 6-max Seat #1 is the button
Seat 1: hc agorist ($2.69 in chips) 
Seat 2: papito3000 ($2.71 in chips) 
Seat 3: @nt@nin@ ($2.98 in chips) 
Seat 4: fantazja8 ($2.76 in chips) 
Seat 5: tehBlub ($3.94 in chips) 
Seat 6: mendesmg30 ($1.61 in chips) 
papito3000: posts small blind $0.01
@nt@nin@: posts big blind $0.02
*** HOLE CARDS ***
Dealt to hc agorist [7c Td]
fantazja8: folds 
tehBlub: folds 
mendesmg30: folds 
hc agorist: folds 
papito3000: folds 
Uncalled bet ($0.01) returned to @nt@nin@
@nt@nin@ collected $0.02 from pot
@nt@nin@: doesn't show hand 
*** SUMMARY ***
Total pot $0.02 | Rake $0 
Seat 1: hc agorist (button) folded before Flop (didn't bet)
Seat 2: papito3000 (small blind) folded before Flop
Seat 3: @nt@nin@ (big blind) collected ($0.02)
Seat 4: fantazja8 folded before Flop (didn't bet)
Seat 5: tehBlub folded before Flop (didn't bet)
Seat 6: mendesmg30 folded before Flop (didn't bet)



PokerStars Zoom Hand #193767004631:  Hold'em No Limit ($0.01/$0.02) - 2018/11/26 23:51:41 CUST [2018/11/26 10:51:41 ET]
Table 'Halley' 6-max Seat #1 is the button
Seat 1: Rockabill408 ($2 in chips) 
Seat 2: vova270793 ($2.32 in chips) 
Seat 3: Vorontsov28 ($2.04 in chips) 
Seat 4: AlexMal296 ($1.55 in chips) 
Seat 5: lucky10k ($2.80 in chips) 
Seat 6: hc agorist ($2.69 in chips) 
vova270793: posts small blind $0.01
Vorontsov28: posts big blind $0.02
*** HOLE CARDS ***
Dealt to hc agorist [6h Ts]
AlexMal296: folds 
lucky10k: folds 
hc agorist: folds 
Rockabill408: folds 
vova270793: folds 
Uncalled bet ($0.01) returned to Vorontsov28
Vorontsov28 collected $0.02 from pot
Vorontsov28: doesn't show hand 
*** SUMMARY ***
Total pot $0.02 | Rake $0 
Seat 1: Rockabill408 (button) folded before Flop (didn't bet)
Seat 2: vova270793 (small blind) folded before Flop
Seat 3: Vorontsov28 (big blind) collected ($0.02)
Seat 4: AlexMal296 folded before Flop (didn't bet)
Seat 5: lucky10k folded before Flop (didn't bet)
Seat 6: hc agorist folded before Flop (didn't bet)



PokerStars Zoom Hand #193767007649:  Hold'em No Limit ($0.01/$0.02) - 2018/11/26 23:51:47 CUST [2018/11/26 10:51:47 ET]
Table 'Halley' 6-max Seat #1 is the button
Seat 1: FanT1One ($3.27 in chips) 
Seat 2: DenWhite89 ($2.03 in chips) 
Seat 3: SKFin ($0.89 in chips) 
Seat 4: hc agorist ($2.69 in chips) 
Seat 5: karbool ($1.58 in chips) 
Seat 6: hvorotish ($1.53 in chips) 
DenWhite89: posts small blind $0.01
SKFin: posts big blind $0.02
*** HOLE CARDS ***
Dealt to hc agorist [8h 2s]
hc agorist: folds 
karbool: folds 
hvorotish: folds 
FanT1One: folds 
DenWhite89: folds 
Uncalled bet ($0.01) returned to SKFin
SKFin collected $0.02 from pot
SKFin: doesn't show hand 
*** SUMMARY ***
Total pot $0.02 | Rake $0 
Seat 1: FanT1One (button) folded before Flop (didn't bet)
Seat 2: DenWhite89 (small blind) folded before Flop
Seat 3: SKFin (big blind) collected ($0.02)
Seat 4: hc agorist folded before Flop (didn't bet)
Seat 5: karbool folded before Flop (didn't bet)
Seat 6: hvorotish folded before Flop (didn't bet)



PokerStars Zoom Hand #193767010207:  Hold'em No Limit ($0.01/$0.02) - 2018/11/26 23:51:52 CUST [2018/11/26 10:51:52 ET]
Table 'Halley' 6-max Seat #1 is the button
Seat 1: charlesws25 ($4.05 in chips) 
Seat 2: Khadorjigg ($2.21 in chips) 
Seat 3: koribut ($2 in chips) 
Seat 4: IAmDeathAngel ($5.10 in chips) 
Seat 5: stano5 ($2.77 in chips) 
Seat 6: hc agorist ($2.69 in chips) 
Khadorjigg: posts small blind $0.01
koribut: posts big blind $0.02
*** HOLE CARDS ***
Dealt to hc agorist [4d Qs]
IAmDeathAngel: folds 
stano5: folds 
hc agorist: folds 
charlesws25: folds 
Khadorjigg: folds 
Uncalled bet ($0.01) returned to koribut
koribut collected $0.02 from pot
koribut: doesn't show hand 
*** SUMMARY ***
Total pot $0.02 | Rake $0 
Seat 1: charlesws25 (button) folded before Flop (didn't bet)
Seat 2: Khadorjigg (small blind) folded before Flop
Seat 3: koribut (big blind) collected ($0.02)
Seat 4: IAmDeathAngel folded before Flop (didn't bet)
Seat 5: stano5 folded before Flop (didn't bet)
Seat 6: hc agorist folded before Flop (didn't bet)



PokerStars Zoom Hand #193767015233:  Hold'em No Limit ($0.01/$0.02) - 2018/11/26 23:52:02 CUST [2018/11/26 10:52:02 ET]
Table 'Halley' 6-max Seat #1 is the button
Seat 1: hc agorist ($2.69 in chips) 
Seat 2: astraf89 ($2 in chips) 
Seat 3: ZERO 007728 ($4.35 in chips) 
Seat 4: leuzi5 ($1.96 in chips) 
Seat 5: ZeusCMR ($1.68 in chips) 
Seat 6: neo1200 ($2.84 in chips) 
astraf89: posts small blind $0.01
ZERO 007728: posts big blind $0.02
*** HOLE CARDS ***
Dealt to hc agorist [6h 4c]
leuzi5: folds 
ZeusCMR: folds 
neo1200: folds 
hc agorist: folds 
astraf89: folds 
Uncalled bet ($0.01) returned to ZERO 007728
ZERO 007728 collected $0.02 from pot
ZERO 007728: doesn't show hand 
*** SUMMARY ***
Total pot $0.02 | Rake $0 
Seat 1: hc agorist (button) folded before Flop (didn't bet)
Seat 2: astraf89 (small blind) folded before Flop
Seat 3: ZERO 007728 (big blind) collected ($0.02)
Seat 4: leuzi5 folded before Flop (didn't bet)
Seat 5: ZeusCMR folded before Flop (didn't bet)
Seat 6: neo1200 folded before Flop (didn't bet)



PokerStars Zoom Hand #193767020817:  Hold'em No Limit ($0.01/$0.02) - 2018/11/26 23:52:13 CUST [2018/11/26 10:52:13 ET]
Table 'Halley' 6-max Seat #1 is the button
Seat 1: tg9718 ($2.01 in chips) 
Seat 2: XMrMojoRisinX ($2.59 in chips) 
Seat 3: hc agorist ($2.69 in chips) 
Seat 4: chirva007 ($2 in chips) 
Seat 5: strimmm0 ($11.04 in chips) 
Seat 6: river3623 ($0.97 in chips) 
XMrMojoRisinX: posts small blind $0.01
hc agorist: posts big blind $0.02
*** HOLE CARDS ***
Dealt to hc agorist [2c 5d]
chirva007: folds 
strimmm0: folds 
river3623: folds 
tg9718: raises $0.03 to $0.05
XMrMojoRisinX: raises $0.13 to $0.18
hc agorist: folds 
tg9718: folds 
Uncalled bet ($0.13) returned to XMrMojoRisinX
XMrMojoRisinX collected $0.12 from pot
XMrMojoRisinX: doesn't show hand 
*** SUMMARY ***
Total pot $0.12 | Rake $0 
Seat 1: tg9718 (button) folded before Flop
Seat 2: XMrMojoRisinX (small blind) collected ($0.12)
Seat 3: hc agorist (big blind) folded before Flop
Seat 4: chirva007 folded before Flop (didn't bet)
Seat 5: strimmm0 folded before Flop (didn't bet)
Seat 6: river3623 folded before Flop (didn't bet)



PokerStars Zoom Hand #193767028264:  Hold'em No Limit ($0.01/$0.02) - 2018/11/26 23:52:28 CUST [2018/11/26 10:52:28 ET]
Table 'Halley' 6-max Seat #1 is the button
Seat 1: fsx_70 ($2 in chips) 
Seat 2: hc agorist ($2.67 in chips) 
Seat 3: indextown ($2 in chips) 
Seat 4: Dorogoi57 ($2.77 in chips) 
Seat 5: vatteztaR* ($2 in chips) 
Seat 6: stan779 ($3.95 in chips) 
hc agorist: posts small blind $0.01
indextown: posts big blind $0.02
*** HOLE CARDS ***
Dealt to hc agorist [6s Ac]
Dorogoi57: folds 
vatteztaR*: folds 
stan779: raises $0.03 to $0.05
fsx_70: folds 
hc agorist: raises $0.12 to $0.17
indextown: folds 
stan779: calls $0.12
*** FLOP *** [6d 9c 2d]
hc agorist: checks 
stan779: checks 
*** TURN *** [6d 9c 2d] [8h]
hc agorist: bets $0.26
stan779: folds 
Uncalled bet ($0.26) returned to hc agorist
hc agorist collected $0.35 from pot
hc agorist: doesn't show hand 
*** SUMMARY ***
Total pot $0.36 | Rake $0.01 
Board [6d 9c 2d 8h]
Seat 1: fsx_70 (button) folded before Flop (didn't bet)
Seat 2: hc agorist (small blind) collected ($0.35)
Seat 3: indextown (big blind) folded before Flop
Seat 4: Dorogoi57 folded before Flop (didn't bet)
Seat 5: vatteztaR* folded before Flop (didn't bet)
Seat 6: stan779 folded on the Turn



PokerStars Zoom Hand #193767045718:  Hold'em No Limit ($0.01/$0.02) - 2018/11/26 23:53:03 CUST [2018/11/26 10:53:03 ET]
Table 'Halley' 6-max Seat #1 is the button
Seat 1: hc agorist ($2.85 in chips) 
Seat 2: FabryGonnos ($2.60 in chips) 
Seat 3: kawauchir1 ($4.58 in chips) 
Seat 4: ThunderArmor_v2 ($0.94 in chips) 
Seat 5: craven7777 ($4.04 in chips) 
Seat 6: charlesws25 ($5.73 in chips) 
FabryGonnos: posts small blind $0.01
kawauchir1: posts big blind $0.02
*** HOLE CARDS ***
Dealt to hc agorist [6c 3s]
ThunderArmor_v2: folds 
craven7777: raises $0.04 to $0.06
charlesws25: folds 
hc agorist: folds 
FabryGonnos: folds 
kawauchir1: folds 
Uncalled bet ($0.04) returned to craven7777
craven7777 collected $0.05 from pot
craven7777: doesn't show hand 
*** SUMMARY ***
Total pot $0.05 | Rake $0 
Seat 1: hc agorist (button) folded before Flop (didn't bet)
Seat 2: FabryGonnos (small blind) folded before Flop
Seat 3: kawauchir1 (big blind) folded before Flop
Seat 4: ThunderArmor_v2 folded before Flop (didn't bet)
Seat 5: craven7777 collected ($0.05)
Seat 6: charlesws25 folded before Flop (didn't bet)



PokerStars Zoom Hand #193767048284:  Hold'em No Limit ($0.01/$0.02) - 2018/11/26 23:53:08 CUST [2018/11/26 10:53:08 ET]
Table 'Halley' 6-max Seat #1 is the button
Seat 1: bonja1988 ($1.15 in chips) 
Seat 2: TIBURONA349 ($2.19 in chips) 
Seat 3: Lakchenko ($1.34 in chips) 
Seat 4: gv3055 ($2.27 in chips) 
Seat 5: hc agorist ($2.85 in chips) 
Seat 6: berkutrus76 ($2.36 in chips) 
TIBURONA349: posts small blind $0.01
Lakchenko: posts big blind $0.02
*** HOLE CARDS ***
Dealt to hc agorist [6s 8h]
gv3055: folds 
hc agorist: folds 
berkutrus76: folds 
bonja1988: folds 
TIBURONA349: folds 
Uncalled bet ($0.01) returned to Lakchenko
Lakchenko collected $0.02 from pot
Lakchenko: doesn't show hand 
*** SUMMARY ***
Total pot $0.02 | Rake $0 
Seat 1: bonja1988 (button) folded before Flop (didn't bet)
Seat 2: TIBURONA349 (small blind) folded before Flop
Seat 3: Lakchenko (big blind) collected ($0.02)
Seat 4: gv3055 folded before Flop (didn't bet)
Seat 5: hc agorist folded before Flop (didn't bet)
Seat 6: berkutrus76 folded before Flop (didn't bet)



PokerStars Zoom Hand #193767042662:  Hold'em No Limit ($0.01/$0.02) - 2018/11/26 23:52:57 CUST [2018/11/26 10:52:57 ET]
Table 'Halley' 6-max Seat #1 is the button
Seat 1: DemonSh18 ($1.64 in chips) 
Seat 2: IDElena ($1.98 in chips) 
Seat 3: Energetic71 ($2.30 in chips) 
Seat 4: Roflpain ($5.59 in chips) 
Seat 5: hc agorist ($2.85 in chips) 
Seat 6: Akutagawa ($2 in chips) 
IDElena: posts small blind $0.01
Energetic71: posts big blind $0.02
*** HOLE CARDS ***
Dealt to hc agorist [7s 5h]
Roflpain: folds 
hc agorist: folds 
Akutagawa: folds 
DemonSh18: raises $0.02 to $0.04
IDElena: calls $0.03
Energetic71: calls $0.02
*** FLOP *** [9s 8d 3d]
IDElena: checks 
Energetic71: checks 
DemonSh18: bets $0.08
IDElena: folds 
Energetic71: folds 
Uncalled bet ($0.08) returned to DemonSh18
DemonSh18 collected $0.12 from pot
DemonSh18: doesn't show hand 
*** SUMMARY ***
Total pot $0.12 | Rake $0 
Board [9s 8d 3d]
Seat 1: DemonSh18 (button) collected ($0.12)
Seat 2: IDElena (small blind) folded on the Flop
Seat 3: Energetic71 (big blind) folded on the Flop
Seat 4: Roflpain folded before Flop (didn't bet)
Seat 5: hc agorist folded before Flop (didn't bet)
Seat 6: Akutagawa folded before Flop (didn't bet)



PokerStars Zoom Hand #193767050744:  Hold'em No Limit ($0.01/$0.02) - 2018/11/26 23:53:13 CUST [2018/11/26 10:53:13 ET]
Table 'Halley' 6-max Seat #1 is the button
Seat 1: ChrisCreys ($14.02 in chips) 
Seat 2: hc agorist ($2.85 in chips) 
Seat 3: ravemaster-z ($1.45 in chips) 
Seat 4: Ruslan13581 ($2.08 in chips) 
Seat 5: fumina.k ($2.91 in chips) 
Seat 6: maferna ($2 in chips) 
hc agorist: posts small blind $0.01
ravemaster-z: posts big blind $0.02
*** HOLE CARDS ***
Dealt to hc agorist [Ks Ts]
Ruslan13581: folds 
fumina.k: raises $0.03 to $0.05
maferna: folds 
ChrisCreys: folds 
hc agorist: raises $0.12 to $0.17
ravemaster-z: folds 
fumina.k: folds 
Uncalled bet ($0.12) returned to hc agorist
hc agorist collected $0.12 from pot
hc agorist: doesn't show hand 
*** SUMMARY ***
Total pot $0.12 | Rake $0 
Seat 1: ChrisCreys (button) folded before Flop (didn't bet)
Seat 2: hc agorist (small blind) collected ($0.12)
Seat 3: ravemaster-z (big blind) folded before Flop
Seat 4: Ruslan13581 folded before Flop (didn't bet)
Seat 5: fumina.k folded before Flop
Seat 6: maferna folded before Flop (didn't bet)



PokerStars Zoom Hand #193767062764:  Hold'em No Limit ($0.01/$0.02) - 2018/11/26 23:53:37 CUST [2018/11/26 10:53:37 ET]
Table 'Halley' 6-max Seat #1 is the button
Seat 1: gv3055 ($2.24 in chips) 
Seat 2: marcebur94 ($3.57 in chips) 
Seat 3: hc agorist ($2.92 in chips) 
Seat 4: alexdelpiero23 ($2.59 in chips) 
Seat 5: kers474 ($6.75 in chips) 
Seat 6: Diff3r3nt ($2 in chips) 
marcebur94: posts small blind $0.01
hc agorist: posts big blind $0.02
*** HOLE CARDS ***
Dealt to hc agorist [Qd 2h]
alexdelpiero23: folds 
kers474: folds 
Diff3r3nt: folds 
gv3055: raises $0.03 to $0.05
marcebur94: folds 
hc agorist: folds 
Uncalled bet ($0.03) returned to gv3055
gv3055 collected $0.05 from pot
gv3055: doesn't show hand 
*** SUMMARY ***
Total pot $0.05 | Rake $0 
Seat 1: gv3055 (button) collected ($0.05)
Seat 2: marcebur94 (small blind) folded before Flop
Seat 3: hc agorist (big blind) folded before Flop
Seat 4: alexdelpiero23 folded before Flop (didn't bet)
Seat 5: kers474 folded before Flop (didn't bet)
Seat 6: Diff3r3nt folded before Flop (didn't bet)



PokerStars Zoom Hand #193767067827:  Hold'em No Limit ($0.01/$0.02) - 2018/11/26 23:53:47 CUST [2018/11/26 10:53:47 ET]
Table 'Halley' 6-max Seat #1 is the button
Seat 1: alexandr699 ($2.04 in chips) 
Seat 2: Coffeatus ($2.42 in chips) 
Seat 3: neo1200 ($3.66 in chips) 
Seat 4: hc agorist ($2.90 in chips) 
Seat 5: asposition ($3.93 in chips) 
Seat 6: fumina.k ($2.05 in chips) 
Coffeatus: posts small blind $0.01
neo1200: posts big blind $0.02
*** HOLE CARDS ***
Dealt to hc agorist [Ah 7c]
hc agorist: folds 
asposition said, "s"
asposition: raises $0.04 to $0.06
fumina.k: folds 
alexandr699: folds 
Coffeatus: folds 
neo1200: folds 
Uncalled bet ($0.04) returned to asposition
asposition collected $0.05 from pot
asposition: doesn't show hand 
*** SUMMARY ***
Total pot $0.05 | Rake $0 
Seat 1: alexandr699 (button) folded before Flop (didn't bet)
Seat 2: Coffeatus (small blind) folded before Flop
Seat 3: neo1200 (big blind) folded before Flop
Seat 4: hc agorist folded before Flop (didn't bet)
Seat 5: asposition collected ($0.05)
Seat 6: fumina.k folded before Flop (didn't bet)



PokerStars Zoom Hand #193767070437:  Hold'em No Limit ($0.01/$0.02) - 2018/11/26 23:53:52 CUST [2018/11/26 10:53:52 ET]
Table 'Halley' 6-max Seat #1 is the button
Seat 1: edikan369 ($0.90 in chips) 
Seat 2: tedo1969 ($1.57 in chips) 
Seat 3: sabukpoke375 ($1.42 in chips) 
Seat 4: CowardSquid ($1.60 in chips) 
Seat 5: Kokosya ($2.59 in chips) 
Seat 6: hc agorist ($2.90 in chips) 
tedo1969: posts small blind $0.01
sabukpoke375: posts big blind $0.02
*** HOLE CARDS ***
Dealt to hc agorist [3c Ks]
CowardSquid: folds 
Kokosya: raises $0.04 to $0.06
hc agorist: folds 
edikan369: folds 
tedo1969: calls $0.05
sabukpoke375: folds 
*** FLOP *** [6d 6s 3h]
tedo1969: checks 
Kokosya: checks 
*** TURN *** [6d 6s 3h] [Th]
tedo1969: checks 
Kokosya: checks 
*** RIVER *** [6d 6s 3h Th] [Qd]
tedo1969: checks 
Kokosya: checks 
*** SHOW DOWN ***
tedo1969: shows [7s 7c] (two pair, Sevens and Sixes)
Kokosya: mucks hand 
tedo1969 collected $0.14 from pot
*** SUMMARY ***
Total pot $0.14 | Rake $0 
Board [6d 6s 3h Th Qd]
Seat 1: edikan369 (button) folded before Flop (didn't bet)
Seat 2: tedo1969 (small blind) showed [7s 7c] and won ($0.14) with two pair, Sevens and Sixes
Seat 3: sabukpoke375 (big blind) folded before Flop
Seat 4: CowardSquid folded before Flop (didn't bet)
Seat 5: Kokosya mucked [9s Js]
Seat 6: hc agorist folded before Flop (didn't bet)



PokerStars Zoom Hand #193767075506:  Hold'em No Limit ($0.01/$0.02) - 2018/11/26 23:54:02 CUST [2018/11/26 10:54:02 ET]
Table 'Halley' 6-max Seat #1 is the button
Seat 1: AAANDREIKK ($3.57 in chips) 
Seat 2: SATUBATU10 ($3.41 in chips) 
Seat 3: AnAxl ($2.29 in chips) 
Seat 4: hc agorist ($2.90 in chips) 
Seat 5: skinepete ($1.33 in chips) 
Seat 6: Geolog800 ($4.04 in chips) 
SATUBATU10: posts small blind $0.01
AnAxl: posts big blind $0.02
*** HOLE CARDS ***
Dealt to hc agorist [3c 7c]
hc agorist: folds 
skinepete: folds 
Geolog800: raises $0.02 to $0.04
AAANDREIKK: folds 
SATUBATU10: raises $0.12 to $0.16
AnAxl: folds 
Geolog800: folds 
Uncalled bet ($0.12) returned to SATUBATU10
SATUBATU10 collected $0.10 from pot
SATUBATU10: doesn't show hand 
*** SUMMARY ***
Total pot $0.10 | Rake $0 
Seat 1: AAANDREIKK (button) folded before Flop (didn't bet)
Seat 2: SATUBATU10 (small blind) collected ($0.10)
Seat 3: AnAxl (big blind) folded before Flop
Seat 4: hc agorist folded before Flop (didn't bet)
Seat 5: skinepete folded before Flop (didn't bet)
Seat 6: Geolog800 folded before Flop



PokerStars Zoom Hand #193767081082:  Hold'em No Limit ($0.01/$0.02) - 2018/11/26 23:54:13 CUST [2018/11/26 10:54:13 ET]
Table 'Halley' 6-max Seat #1 is the button
Seat 1: @nt@nin@ ($2.50 in chips) 
Seat 2: piownu ($2.33 in chips) 
Seat 3: hc agorist ($2.90 in chips) 
Seat 4: lucky10k ($2.68 in chips) 
Seat 5: Adambl58 ($4.81 in chips) 
Seat 6: vadik033 ($1.07 in chips) 
piownu: posts small blind $0.01
hc agorist: posts big blind $0.02
*** HOLE CARDS ***
Dealt to hc agorist [Ks 7s]
lucky10k: folds 
Adambl58: raises $0.03 to $0.05
vadik033: folds 
@nt@nin@: folds 
piownu: folds 
hc agorist: raises $0.11 to $0.16
Adambl58: folds 
Uncalled bet ($0.11) returned to hc agorist
hc agorist collected $0.11 from pot
hc agorist: doesn't show hand 
*** SUMMARY ***
Total pot $0.11 | Rake $0 
Seat 1: @nt@nin@ (button) folded before Flop (didn't bet)
Seat 2: piownu (small blind) folded before Flop
Seat 3: hc agorist (big blind) collected ($0.11)
Seat 4: lucky10k folded before Flop (didn't bet)
Seat 5: Adambl58 folded before Flop
Seat 6: vadik033 folded before Flop (didn't bet)



PokerStars Zoom Hand #193767078051:  Hold'em No Limit ($0.01/$0.02) - 2018/11/26 23:54:07 CUST [2018/11/26 10:54:07 ET]
Table 'Halley' 6-max Seat #1 is the button
Seat 1: hc agorist ($2.90 in chips) 
Seat 2: Mr.DamBo ($3.52 in chips) 
Seat 3: Vorontsov28 ($4.85 in chips) 
Seat 4: Adamant_HUN ($3.24 in chips) 
Seat 5: Gerar NB ($3.18 in chips) 
Seat 6: asposition ($3.96 in chips) 
Mr.DamBo: posts small blind $0.01
Vorontsov28: posts big blind $0.02
*** HOLE CARDS ***
Dealt to hc agorist [3s 8h]
Adamant_HUN: folds 
Gerar NB: folds 
asposition: raises $0.04 to $0.06
hc agorist: folds 
Mr.DamBo: folds 
Vorontsov28: folds 
Uncalled bet ($0.04) returned to asposition
asposition collected $0.05 from pot
asposition: doesn't show hand 
*** SUMMARY ***
Total pot $0.05 | Rake $0 
Seat 1: hc agorist (button) folded before Flop (didn't bet)
Seat 2: Mr.DamBo (small blind) folded before Flop
Seat 3: Vorontsov28 (big blind) folded before Flop
Seat 4: Adamant_HUN folded before Flop (didn't bet)
Seat 5: Gerar NB folded before Flop (didn't bet)
Seat 6: asposition collected ($0.05)



PokerStars Zoom Hand #193767072955:  Hold'em No Limit ($0.01/$0.02) - 2018/11/26 23:53:57 CUST [2018/11/26 10:53:57 ET]
Table 'Halley' 6-max Seat #1 is the button
Seat 1: degelcamus ($8.27 in chips) 
Seat 2: swraider ($2 in chips) 
Seat 3: whitepuma4 ($1.48 in chips) 
Seat 4: Cavalo Fla ($3.85 in chips) 
Seat 5: hc agorist ($2.90 in chips) 
Seat 6: -azat-378 ($2.45 in chips) 
swraider: posts small blind $0.01
whitepuma4: posts big blind $0.02
*** HOLE CARDS ***
Dealt to hc agorist [9h 5d]
Cavalo Fla: folds 
hc agorist: folds 
-azat-378: folds 
degelcamus: folds 
swraider: calls $0.01
whitepuma4: raises $0.06 to $0.08
swraider: calls $0.06
*** FLOP *** [3s 9d Js]
swraider: checks 
whitepuma4: bets $0.08
swraider: calls $0.08
*** TURN *** [3s 9d Js] [2s]
swraider: checks 
whitepuma4: checks 
*** RIVER *** [3s 9d Js 2s] [6s]
swraider: checks 
whitepuma4: checks 
*** SHOW DOWN ***
swraider: shows [Td Jh] (a pair of Jacks)
whitepuma4: shows [Ac Jc] (a pair of Jacks - Ace kicker)
whitepuma4 collected $0.31 from pot
*** SUMMARY ***
Total pot $0.32 | Rake $0.01 
Board [3s 9d Js 2s 6s]
Seat 1: degelcamus (button) folded before Flop (didn't bet)
Seat 2: swraider (small blind) showed [Td Jh] and lost with a pair of Jacks
Seat 3: whitepuma4 (big blind) showed [Ac Jc] and won ($0.31) with a pair of Jacks
Seat 4: Cavalo Fla folded before Flop (didn't bet)
Seat 5: hc agorist folded before Flop (didn't bet)
Seat 6: -azat-378 folded before Flop (didn't bet)



PokerStars Zoom Hand #193767089621:  Hold'em No Limit ($0.01/$0.02) - 2018/11/26 23:54:30 CUST [2018/11/26 10:54:30 ET]
Table 'Halley' 6-max Seat #1 is the button
Seat 1: ANRI11101988 ($1 in chips) 
Seat 2: hc agorist ($2.96 in chips) 
Seat 3: Fishkarub ($2.91 in chips) 
Seat 4: FanT1One ($3.24 in chips) 
Seat 5: Bogdan_77936 ($1.66 in chips) 
Seat 6: dmepan ($1.28 in chips) 
hc agorist: posts small blind $0.01
Fishkarub: posts big blind $0.02
*** HOLE CARDS ***
Dealt to hc agorist [As 9c]
FanT1One: folds 
Bogdan_77936: folds 
dmepan: folds 
ANRI11101988: raises $0.04 to $0.06
hc agorist: calls $0.05
Fishkarub: calls $0.04
*** FLOP *** [6s 3s Tc]
hc agorist: checks 
Fishkarub: checks 
ANRI11101988: bets $0.14
hc agorist: folds 
Fishkarub: folds 
Uncalled bet ($0.14) returned to ANRI11101988
ANRI11101988 collected $0.17 from pot
ANRI11101988: doesn't show hand 
*** SUMMARY ***
Total pot $0.18 | Rake $0.01 
Board [6s 3s Tc]
Seat 1: ANRI11101988 (button) collected ($0.17)
Seat 2: hc agorist (small blind) folded on the Flop
Seat 3: Fishkarub (big blind) folded on the Flop
Seat 4: FanT1One folded before Flop (didn't bet)
Seat 5: Bogdan_77936 folded before Flop (didn't bet)
Seat 6: dmepan folded before Flop (didn't bet)



PokerStars Zoom Hand #193767111133:  Hold'em No Limit ($0.01/$0.02) - 2018/11/26 23:55:13 CUST [2018/11/26 10:55:13 ET]
Table 'Halley' 6-max Seat #1 is the button
Seat 1: booktable ($2.15 in chips) 
Seat 2: -azat-378 ($2.48 in chips) 
Seat 3: Arch1689 ($2.15 in chips) 
Seat 4: pokerfan3999 ($3.12 in chips) 
Seat 5: j3fing ($2.45 in chips) 
Seat 6: hc agorist ($2.90 in chips) 
-azat-378: posts small blind $0.01
Arch1689: posts big blind $0.02
*** HOLE CARDS ***
Dealt to hc agorist [Ah Ks]
pokerfan3999: folds 
j3fing: folds 
hc agorist: raises $0.02 to $0.04
booktable: folds 
-azat-378: folds 
Arch1689: folds 
Uncalled bet ($0.02) returned to hc agorist
hc agorist collected $0.05 from pot
hc agorist: doesn't show hand 
*** SUMMARY ***
Total pot $0.05 | Rake $0 
Seat 1: booktable (button) folded before Flop (didn't bet)
Seat 2: -azat-378 (small blind) folded before Flop
Seat 3: Arch1689 (big blind) folded before Flop
Seat 4: pokerfan3999 folded before Flop (didn't bet)
Seat 5: j3fing folded before Flop (didn't bet)
Seat 6: hc agorist collected ($0.05)



PokerStars Zoom Hand #193767120206:  Hold'em No Limit ($0.01/$0.02) - 2018/11/26 23:55:34 CUST [2018/11/26 10:55:34 ET]
Table 'Halley' 6-max Seat #1 is the button
Seat 1: hc agorist ($2.93 in chips) 
Seat 2: tehBlub ($4.23 in chips) 
Seat 3: Akutagawa ($2.02 in chips) 
Seat 4: LongHart ($2.19 in chips) 
Seat 5: oleym ($1.89 in chips) 
Seat 6: djafar63 ($4.52 in chips) 
tehBlub: posts small blind $0.01
Akutagawa: posts big blind $0.02
*** HOLE CARDS ***
Dealt to hc agorist [4s 3c]
LongHart: folds 
oleym: folds 
djafar63: folds 
hc agorist: folds 
tehBlub: folds 
Uncalled bet ($0.01) returned to Akutagawa
Akutagawa collected $0.02 from pot
Akutagawa: doesn't show hand 
*** SUMMARY ***
Total pot $0.02 | Rake $0 
Seat 1: hc agorist (button) folded before Flop (didn't bet)
Seat 2: tehBlub (small blind) folded before Flop
Seat 3: Akutagawa (big blind) collected ($0.02)
Seat 4: LongHart folded before Flop (didn't bet)
Seat 5: oleym folded before Flop (didn't bet)
Seat 6: djafar63 folded before Flop (didn't bet)



PokerStars Zoom Hand #193767115948:  Hold'em No Limit ($0.01/$0.02) - 2018/11/26 23:55:24 CUST [2018/11/26 10:55:24 ET]
Table 'Halley' 6-max Seat #1 is the button
Seat 1: mine4sure ($2.22 in chips) 
Seat 2: averzia ($2.16 in chips) 
Seat 3: Gerar NB ($2.52 in chips) 
Seat 4: 61kiwi ($3.27 in chips) 
Seat 5: hc agorist ($2.93 in chips) 
Seat 6: Silestinus ($1.03 in chips) 
averzia: posts small blind $0.01
Gerar NB: posts big blind $0.02
*** HOLE CARDS ***
Dealt to hc agorist [7d Ks]
61kiwi: folds 
hc agorist: folds 
Silestinus: calls $0.02
mine4sure: folds 
averzia: folds 
Gerar NB: checks 
*** FLOP *** [6d Ac 2h]
Gerar NB: checks 
Silestinus: checks 
*** TURN *** [6d Ac 2h] [5s]
Gerar NB: checks 
Silestinus: checks 
*** RIVER *** [6d Ac 2h 5s] [As]
Gerar NB: checks 
Silestinus: checks 
*** SHOW DOWN ***
Gerar NB: shows [8h 4s] (a pair of Aces)
Silestinus: shows [Ts Qh] (a pair of Aces - Queen kicker)
Silestinus collected $0.05 from pot
*** SUMMARY ***
Total pot $0.05 | Rake $0 
Board [6d Ac 2h 5s As]
Seat 1: mine4sure (button) folded before Flop (didn't bet)
Seat 2: averzia (small blind) folded before Flop
Seat 3: Gerar NB (big blind) showed [8h 4s] and lost with a pair of Aces
Seat 4: 61kiwi folded before Flop (didn't bet)
Seat 5: hc agorist folded before Flop (didn't bet)
Seat 6: Silestinus showed [Ts Qh] and won ($0.05) with a pair of Aces



PokerStars Zoom Hand #193767118019:  Hold'em No Limit ($0.01/$0.02) - 2018/11/26 23:55:29 CUST [2018/11/26 10:55:29 ET]
Table 'Halley' 6-max Seat #1 is the button
Seat 1: SKFin ($0.77 in chips) 
Seat 2: Wossop ($2.35 in chips) 
Seat 3: gabgordula ($2.34 in chips) 
Seat 4: hc agorist ($2.93 in chips) 
Seat 5: KingIrish14 ($1.31 in chips) 
Seat 6: viktor49ru ($2.62 in chips) 
Wossop: posts small blind $0.01
gabgordula: posts big blind $0.02
*** HOLE CARDS ***
Dealt to hc agorist [2h 8c]
hc agorist: folds 
KingIrish14: folds 
viktor49ru: raises $0.04 to $0.06
SKFin: calls $0.06
Wossop: folds 
gabgordula: folds 
*** FLOP *** [8h Jd 4c]
viktor49ru: checks 
SKFin: bets $0.08
viktor49ru: folds 
Uncalled bet ($0.08) returned to SKFin
SKFin collected $0.14 from pot
SKFin: doesn't show hand 
*** SUMMARY ***
Total pot $0.15 | Rake $0.01 
Board [8h Jd 4c]
Seat 1: SKFin (button) collected ($0.14)
Seat 2: Wossop (small blind) folded before Flop
Seat 3: gabgordula (big blind) folded before Flop
Seat 4: hc agorist folded before Flop (didn't bet)
Seat 5: KingIrish14 folded before Flop (didn't bet)
Seat 6: viktor49ru folded on the Flop



PokerStars Zoom Hand #193767122321:  Hold'em No Limit ($0.01/$0.02) - 2018/11/26 23:55:39 CUST [2018/11/26 10:55:39 ET]
Table 'Halley' 6-max Seat #1 is the button
Seat 1: sabukpoke375 ($1.84 in chips) 
Seat 2: letatel ($3.45 in chips) 
Seat 3: hc agorist ($2.93 in chips) 
Seat 4: chirva007 ($2.20 in chips) 
Seat 5: straiki ($1.10 in chips) 
Seat 6: Geolog800 ($4.01 in chips) 
letatel: posts small blind $0.01
hc agorist: posts big blind $0.02
*** HOLE CARDS ***
Dealt to hc agorist [Th Jc]
chirva007: folds 
straiki: folds 
Geolog800: folds 
sabukpoke375: folds 
letatel: raises $0.04 to $0.06
hc agorist: calls $0.04
*** FLOP *** [3s 8d Qc]
letatel: checks 
hc agorist: bets $0.09
letatel: calls $0.09
*** TURN *** [3s 8d Qc] [4d]
letatel: checks 
hc agorist: bets $0.22
letatel: folds 
Uncalled bet ($0.22) returned to hc agorist
hc agorist collected $0.29 from pot
hc agorist: doesn't show hand 
*** SUMMARY ***
Total pot $0.30 | Rake $0.01 
Board [3s 8d Qc 4d]
Seat 1: sabukpoke375 (button) folded before Flop (didn't bet)
Seat 2: letatel (small blind) folded on the Turn
Seat 3: hc agorist (big blind) collected ($0.29)
Seat 4: chirva007 folded before Flop (didn't bet)
Seat 5: straiki folded before Flop (didn't bet)
Seat 6: Geolog800 folded before Flop (didn't bet)



PokerStars Zoom Hand #193767137933:  Hold'em No Limit ($0.01/$0.02) - 2018/11/26 23:56:15 CUST [2018/11/26 10:56:15 ET]
Table 'Halley' 6-max Seat #1 is the button
Seat 1: DoyaRED ($1.86 in chips) 
Seat 2: Symeo208 ($2.04 in chips) 
Seat 3: -azat-378 ($3.87 in chips) 
Seat 4: Tetrus91 ($6.71 in chips) 
Seat 5: yromaniv ($1.98 in chips) 
Seat 6: hc agorist ($3.07 in chips) 
Symeo208: posts small blind $0.01
-azat-378: posts big blind $0.02
*** HOLE CARDS ***
Dealt to hc agorist [8d 9d]
Tetrus91: folds 
yromaniv: folds 
hc agorist: raises $0.02 to $0.04
DoyaRED: folds 
Symeo208: folds 
-azat-378: folds 
Uncalled bet ($0.02) returned to hc agorist
hc agorist collected $0.05 from pot
hc agorist: doesn't show hand 
*** SUMMARY ***
Total pot $0.05 | Rake $0 
Seat 1: DoyaRED (button) folded before Flop (didn't bet)
Seat 2: Symeo208 (small blind) folded before Flop
Seat 3: -azat-378 (big blind) folded before Flop
Seat 4: Tetrus91 folded before Flop (didn't bet)
Seat 5: yromaniv folded before Flop (didn't bet)
Seat 6: hc agorist collected ($0.05)



PokerStars Zoom Hand #193767145262:  Hold'em No Limit ($0.01/$0.02) - 2018/11/26 23:56:32 CUST [2018/11/26 10:56:32 ET]
Table 'Halley' 6-max Seat #1 is the button
Seat 1: Forten55 ($3.19 in chips) 
Seat 2: nikonova88 ($5.25 in chips) 
Seat 3: chirva007 ($2.16 in chips) 
Seat 4: hc agorist ($3.09 in chips) 
Seat 5: Drinker111 ($2 in chips) 
Seat 6: papito3000 ($2.31 in chips) 
nikonova88: posts small blind $0.01
chirva007: posts big blind $0.02
*** HOLE CARDS ***
Dealt to hc agorist [6h 3h]
hc agorist: folds 
Drinker111: folds 
papito3000: folds 
Forten55: folds 
nikonova88: raises $0.03 to $0.05
chirva007: folds 
Uncalled bet ($0.03) returned to nikonova88
nikonova88 collected $0.04 from pot
nikonova88: doesn't show hand 
*** SUMMARY ***
Total pot $0.04 | Rake $0 
Seat 1: Forten55 (button) folded before Flop (didn't bet)
Seat 2: nikonova88 (small blind) collected ($0.04)
Seat 3: chirva007 (big blind) folded before Flop
Seat 4: hc agorist folded before Flop (didn't bet)
Seat 5: Drinker111 folded before Flop (didn't bet)
Seat 6: papito3000 folded before Flop (didn't bet)



PokerStars Zoom Hand #193767142670:  Hold'em No Limit ($0.01/$0.02) - 2018/11/26 23:56:26 CUST [2018/11/26 10:56:26 ET]
Table 'Halley' 6-max Seat #1 is the button
Seat 1: galonpiva ($2.51 in chips) 
Seat 2: hc agorist ($3.10 in chips) 
Seat 3: chechoraiser ($1.97 in chips) 
Seat 4: Arch1689 ($2.26 in chips) 
Seat 5: alexrain600 ($4.10 in chips) 
Seat 6: tehBlub ($4.23 in chips) 
hc agorist: posts small blind $0.01
chechoraiser: posts big blind $0.02
*** HOLE CARDS ***
Dealt to hc agorist [Kh 2h]
Arch1689: folds 
alexrain600: folds 
tehBlub: folds 
galonpiva: raises $0.03 to $0.05
hc agorist: folds 
chechoraiser: calls $0.03
*** FLOP *** [Ad 7h 7d]
chechoraiser: checks 
galonpiva: bets $0.04
chechoraiser: folds 
Uncalled bet ($0.04) returned to galonpiva
galonpiva collected $0.11 from pot
galonpiva: doesn't show hand 
*** SUMMARY ***
Total pot $0.11 | Rake $0 
Board [Ad 7h 7d]
Seat 1: galonpiva (button) collected ($0.11)
Seat 2: hc agorist (small blind) folded before Flop
Seat 3: chechoraiser (big blind) folded on the Flop
Seat 4: Arch1689 folded before Flop (didn't bet)
Seat 5: alexrain600 folded before Flop (didn't bet)
Seat 6: tehBlub folded before Flop (didn't bet)



PokerStars Zoom Hand #193767147412:  Hold'em No Limit ($0.01/$0.02) - 2018/11/26 23:56:37 CUST [2018/11/26 10:56:37 ET]
Table 'Halley' 6-max Seat #1 is the button
Seat 1: semirami2 ($2.44 in chips) 
Seat 2: Cavalo Fla ($3.87 in chips) 
Seat 3: tedo1969 ($1.01 in chips) 
Seat 4: AnAxl ($2.84 in chips) 
Seat 5: hc agorist ($3.09 in chips) 
Seat 6: Kala77 ($2.51 in chips) 
Cavalo Fla: posts small blind $0.01
tedo1969: posts big blind $0.02
*** HOLE CARDS ***
Dealt to hc agorist [7d 4h]
AnAxl: folds 
hc agorist: folds 
Kala77: raises $0.03 to $0.05
semirami2: folds 
Cavalo Fla: folds 
tedo1969: folds 
Uncalled bet ($0.03) returned to Kala77
Kala77 collected $0.05 from pot
Kala77: doesn't show hand 
*** SUMMARY ***
Total pot $0.05 | Rake $0 
Seat 1: semirami2 (button) folded before Flop (didn't bet)
Seat 2: Cavalo Fla (small blind) folded before Flop
Seat 3: tedo1969 (big blind) folded before Flop
Seat 4: AnAxl folded before Flop (didn't bet)
Seat 5: hc agorist folded before Flop (didn't bet)
Seat 6: Kala77 collected ($0.05)



PokerStars Zoom Hand #193767149678:  Hold'em No Limit ($0.01/$0.02) - 2018/11/26 23:56:42 CUST [2018/11/26 10:56:42 ET]
Table 'Halley' 6-max Seat #1 is the button
Seat 1: hc agorist ($3.09 in chips) 
Seat 2: AGT1960 ($3.05 in chips) 
Seat 3: Midukan59 ($1.98 in chips) 
Seat 4: Johneik ($2.18 in chips) 
Seat 5: Mesia198 ($3.84 in chips) 
Seat 6: amaposh ($3.04 in chips) 
AGT1960: posts small blind $0.01
Midukan59: posts big blind $0.02
*** HOLE CARDS ***
Dealt to hc agorist [Ah 8c]
Johneik: folds 
Mesia198: calls $0.02
amaposh: folds 
hc agorist: raises $0.07 to $0.09
AGT1960: folds 
Midukan59: folds 
Mesia198: raises $0.09 to $0.18
hc agorist: calls $0.09
*** FLOP *** [Th 2c 6h]
Mesia198: bets $0.38
hc agorist: folds 
Uncalled bet ($0.38) returned to Mesia198
Mesia198 collected $0.38 from pot
Mesia198: doesn't show hand 
*** SUMMARY ***
Total pot $0.39 | Rake $0.01 
Board [Th 2c 6h]
Seat 1: hc agorist (button) folded on the Flop
Seat 2: AGT1960 (small blind) folded before Flop
Seat 3: Midukan59 (big blind) folded before Flop
Seat 4: Johneik folded before Flop (didn't bet)
Seat 5: Mesia198 collected ($0.38)
Seat 6: amaposh folded before Flop (didn't bet)



PokerStars Zoom Hand #193767162723:  Hold'em No Limit ($0.01/$0.02) - 2018/11/26 23:57:12 CUST [2018/11/26 10:57:12 ET]
Table 'Halley' 6-max Seat #1 is the button
Seat 1: rav79rav ($2.43 in chips) 
Seat 2: @nt@nin@ ($2.03 in chips) 
Seat 3: hc agorist ($2.91 in chips) 
Seat 4: ravemaster-z ($2.33 in chips) 
Seat 5: Mr-under-tam ($2.02 in chips) 
Seat 6: vonvon59640 ($1.65 in chips) 
@nt@nin@: posts small blind $0.01
hc agorist: posts big blind $0.02
*** HOLE CARDS ***
Dealt to hc agorist [6s 6d]
ravemaster-z: raises $0.03 to $0.05
Mr-under-tam: folds 
vonvon59640: folds 
rav79rav: calls $0.05
@nt@nin@: folds 
hc agorist: calls $0.03
*** FLOP *** [3c 2h Qh]
hc agorist: checks 
ravemaster-z: checks 
rav79rav: bets $0.12
hc agorist: folds 
ravemaster-z: folds 
Uncalled bet ($0.12) returned to rav79rav
rav79rav collected $0.15 from pot
rav79rav: doesn't show hand 
*** SUMMARY ***
Total pot $0.16 | Rake $0.01 
Board [3c 2h Qh]
Seat 1: rav79rav (button) collected ($0.15)
Seat 2: @nt@nin@ (small blind) folded before Flop
Seat 3: hc agorist (big blind) folded on the Flop
Seat 4: ravemaster-z folded on the Flop
Seat 5: Mr-under-tam folded before Flop (didn't bet)
Seat 6: vonvon59640 folded before Flop (didn't bet)



PokerStars Zoom Hand #193767176551:  Hold'em No Limit ($0.01/$0.02) - 2018/11/26 23:57:44 CUST [2018/11/26 10:57:44 ET]
Table 'Halley' 6-max Seat #1 is the button
Seat 1: Mariooooo37 ($2.07 in chips) 
Seat 2: hc agorist ($2.86 in chips) 
Seat 3: charlesws25 ($7.43 in chips) 
Seat 4: sinster_ca85 ($2.10 in chips) 
Seat 5: sks133335 ($2 in chips) 
Seat 6: Midar1 ($3.81 in chips) 
hc agorist: posts small blind $0.01
charlesws25: posts big blind $0.02
*** HOLE CARDS ***
Dealt to hc agorist [Ad 2c]
sinster_ca85: folds 
sks133335: calls $0.02
Midar1: folds 
Mariooooo37: folds 
hc agorist: calls $0.01
charlesws25: checks 
*** FLOP *** [6h Kd Jd]
hc agorist: checks 
charlesws25: checks 
sks133335: checks 
*** TURN *** [6h Kd Jd] [As]
hc agorist: bets $0.06
charlesws25: folds 
sks133335: calls $0.06
*** RIVER *** [6h Kd Jd As] [Qs]
hc agorist: checks 
sks133335: checks 
*** SHOW DOWN ***
hc agorist: shows [Ad 2c] (a pair of Aces)
sks133335: shows [9h Ah] (a pair of Aces)
hc agorist collected $0.09 from pot
sks133335 collected $0.08 from pot
*** SUMMARY ***
Total pot $0.18 | Rake $0.01 
Board [6h Kd Jd As Qs]
Seat 1: Mariooooo37 (button) folded before Flop (didn't bet)
Seat 2: hc agorist (small blind) showed [Ad 2c] and won ($0.09) with a pair of Aces
Seat 3: charlesws25 (big blind) folded on the Turn
Seat 4: sinster_ca85 folded before Flop (didn't bet)
Seat 5: sks133335 showed [9h Ah] and won ($0.08) with a pair of Aces
Seat 6: Midar1 folded before Flop (didn't bet)



PokerStars Zoom Hand #193767202228:  Hold'em No Limit ($0.01/$0.02) - 2018/11/26 23:58:43 CUST [2018/11/26 10:58:43 ET]
Table 'Halley' 6-max Seat #1 is the button
Seat 1: TIBURONA349 ($2.36 in chips) 
Seat 2: kensho25 ($0.92 in chips) 
Seat 3: fumina.k ($2.78 in chips) 
Seat 4: Her2827 ($5.30 in chips) 
Seat 5: JBD101 ($2.22 in chips) 
Seat 6: hc agorist ($2.87 in chips) 
kensho25: posts small blind $0.01
fumina.k: posts big blind $0.02
*** HOLE CARDS ***
Dealt to hc agorist [8c 7s]
Her2827: raises $0.04 to $0.06
JBD101: folds 
hc agorist: folds 
TIBURONA349: folds 
kensho25: folds 
fumina.k: folds 
Uncalled bet ($0.04) returned to Her2827
Her2827 collected $0.05 from pot
Her2827: doesn't show hand 
*** SUMMARY ***
Total pot $0.05 | Rake $0 
Seat 1: TIBURONA349 (button) folded before Flop (didn't bet)
Seat 2: kensho25 (small blind) folded before Flop
Seat 3: fumina.k (big blind) folded before Flop
Seat 4: Her2827 collected ($0.05)
Seat 5: JBD101 folded before Flop (didn't bet)
Seat 6: hc agorist folded before Flop (didn't bet)



PokerStars Zoom Hand #193767206164:  Hold'em No Limit ($0.01/$0.02) - 2018/11/26 23:58:52 CUST [2018/11/26 10:58:52 ET]
Table 'Halley' 6-max Seat #1 is the button
Seat 1: Pokersk999 ($2 in chips) 
Seat 2: Midar1 ($3.81 in chips) 
Seat 3: domitorii ($2 in chips) 
Seat 4: hc agorist ($2.87 in chips) 
Seat 5: holywarss ($2.12 in chips) 
Seat 6: guitboxer ($1.97 in chips) 
Midar1: posts small blind $0.01
domitorii: posts big blind $0.02
*** HOLE CARDS ***
Dealt to hc agorist [6d Td]
hc agorist: folds 
holywarss: folds 
guitboxer: folds 
Pokersk999: folds 
Midar1: folds 
Uncalled bet ($0.01) returned to domitorii
domitorii collected $0.02 from pot
domitorii: doesn't show hand 
*** SUMMARY ***
Total pot $0.02 | Rake $0 
Seat 1: Pokersk999 (button) folded before Flop (didn't bet)
Seat 2: Midar1 (small blind) folded before Flop
Seat 3: domitorii (big blind) collected ($0.02)
Seat 4: hc agorist folded before Flop (didn't bet)
Seat 5: holywarss folded before Flop (didn't bet)
Seat 6: guitboxer folded before Flop (didn't bet)



PokerStars Zoom Hand #193767208761:  Hold'em No Limit ($0.01/$0.02) - 2018/11/26 23:58:58 CUST [2018/11/26 10:58:58 ET]
Table 'Halley' 6-max Seat #1 is the button
Seat 1: hc agorist ($2.87 in chips) 
Seat 2: ankandra ($1.08 in chips) 
Seat 3: craven7777 ($4.04 in chips) 
Seat 4: kers474 ($6.10 in chips) 
Seat 5: woskop ($1.10 in chips) 
Seat 6: Rus. Pioneer ($5.90 in chips) 
ankandra: posts small blind $0.01
craven7777: posts big blind $0.02
*** HOLE CARDS ***
Dealt to hc agorist [7s 7d]
kers474: folds 
woskop: folds 
Rus. Pioneer: folds 
hc agorist: raises $0.02 to $0.04
ankandra: folds 
craven7777: folds 
Uncalled bet ($0.02) returned to hc agorist
hc agorist collected $0.05 from pot
hc agorist: doesn't show hand 
*** SUMMARY ***
Total pot $0.05 | Rake $0 
Seat 1: hc agorist (button) collected ($0.05)
Seat 2: ankandra (small blind) folded before Flop
Seat 3: craven7777 (big blind) folded before Flop
Seat 4: kers474 folded before Flop (didn't bet)
Seat 5: woskop folded before Flop (didn't bet)
Seat 6: Rus. Pioneer folded before Flop (didn't bet)



PokerStars Zoom Hand #193767218666:  Hold'em No Limit ($0.01/$0.02) - 2018/11/26 23:59:21 CUST [2018/11/26 10:59:21 ET]
Table 'Halley' 6-max Seat #1 is the button
Seat 1: lucky10k ($2.07 in chips) 
Seat 2: SKFin ($0.81 in chips) 
Seat 3: Forten55 ($3.09 in chips) 
Seat 4: hc agorist ($2.90 in chips) 
Seat 5: lucianocamil ($3.35 in chips) 
Seat 6: Sobaka635 ($1.38 in chips) 
SKFin: posts small blind $0.01
Forten55: posts big blind $0.02
*** HOLE CARDS ***
Dealt to hc agorist [Ac 4c]
hc agorist: raises $0.02 to $0.04
lucianocamil: raises $0.14 to $0.18
Sobaka635: folds 
lucky10k: folds 
SKFin: folds 
Forten55: folds 
hc agorist: folds 
Uncalled bet ($0.14) returned to lucianocamil
lucianocamil collected $0.11 from pot
lucianocamil: doesn't show hand 
*** SUMMARY ***
Total pot $0.11 | Rake $0 
Seat 1: lucky10k (button) folded before Flop (didn't bet)
Seat 2: SKFin (small blind) folded before Flop
Seat 3: Forten55 (big blind) folded before Flop
Seat 4: hc agorist folded before Flop
Seat 5: lucianocamil collected ($0.11)
Seat 6: Sobaka635 folded before Flop (didn't bet)



PokerStars Zoom Hand #193767228144:  Hold'em No Limit ($0.01/$0.02) - 2018/11/26 23:59:43 CUST [2018/11/26 10:59:43 ET]
Table 'Halley' 6-max Seat #1 is the button
Seat 1: caribe818 ($2.16 in chips) 
Seat 2: BlackLutpik ($2.87 in chips) 
Seat 3: hc agorist ($2.86 in chips) 
Seat 4: viorellll ($0.83 in chips) 
Seat 5: alexandr699 ($2 in chips) 
Seat 6: Peca87 ($1.59 in chips) 
BlackLutpik: posts small blind $0.01
hc agorist: posts big blind $0.02
*** HOLE CARDS ***
Dealt to hc agorist [As 5s]
viorellll: calls $0.02
alexandr699: folds 
Peca87: calls $0.02
caribe818: folds 
BlackLutpik: folds 
hc agorist: checks 
*** FLOP *** [Kd Ah Jc]
hc agorist: bets $0.07
viorellll: folds 
Peca87: folds 
Uncalled bet ($0.07) returned to hc agorist
hc agorist collected $0.07 from pot
hc agorist: doesn't show hand 
*** SUMMARY ***
Total pot $0.07 | Rake $0 
Board [Kd Ah Jc]
Seat 1: caribe818 (button) folded before Flop (didn't bet)
Seat 2: BlackLutpik (small blind) folded before Flop
Seat 3: hc agorist (big blind) collected ($0.07)
Seat 4: viorellll folded on the Flop
Seat 5: alexandr699 folded before Flop (didn't bet)
Seat 6: Peca87 folded on the Flop



PokerStars Zoom Hand #193767238073:  Hold'em No Limit ($0.01/$0.02) - 2018/11/27 0:00:06 CUST [2018/11/26 11:00:06 ET]
Table 'Halley' 6-max Seat #1 is the button
Seat 1: galonpiva ($2.01 in chips) 
Seat 2: pastyr777 ($2.98 in chips) 
Seat 3: samsonnn86 ($3.63 in chips) 
Seat 4: vova270793 ($4.61 in chips) 
Seat 5: hc agorist ($2.91 in chips) 
Seat 6: Kala77 ($2.25 in chips) 
pastyr777: posts small blind $0.01
samsonnn86: posts big blind $0.02
*** HOLE CARDS ***
Dealt to hc agorist [9d 7h]
vova270793: folds 
hc agorist: folds 
Kala77: folds 
galonpiva: raises $0.03 to $0.05
pastyr777: folds 
samsonnn86: folds 
Uncalled bet ($0.03) returned to galonpiva
galonpiva collected $0.05 from pot
galonpiva: doesn't show hand 
*** SUMMARY ***
Total pot $0.05 | Rake $0 
Seat 1: galonpiva (button) collected ($0.05)
Seat 2: pastyr777 (small blind) folded before Flop
Seat 3: samsonnn86 (big blind) folded before Flop
Seat 4: vova270793 folded before Flop (didn't bet)
Seat 5: hc agorist folded before Flop (didn't bet)
Seat 6: Kala77 folded before Flop (didn't bet)



PokerStars Zoom Hand #193767241126:  Hold'em No Limit ($0.01/$0.02) - 2018/11/27 0:00:13 CUST [2018/11/26 11:00:13 ET]
Table 'Halley' 6-max Seat #1 is the button
Seat 1: naxier ($3.20 in chips) 
Seat 2: Mr.MG19 ($1.61 in chips) 
Seat 3: cacao73 ($3.38 in chips) 
Seat 4: nikonova88 ($3.07 in chips) 
Seat 5: strimmm0 ($2.18 in chips) 
Seat 6: hc agorist ($2.91 in chips) 
Mr.MG19: posts small blind $0.01
cacao73: posts big blind $0.02
*** HOLE CARDS ***
Dealt to hc agorist [Ah Kh]
nikonova88: folds 
strimmm0: folds 
hc agorist: raises $0.04 to $0.06
naxier: folds 
Mr.MG19: calls $0.05
cacao73: folds 
*** FLOP *** [6c 9d 8h]
Mr.MG19: checks 
hc agorist: checks 
*** TURN *** [6c 9d 8h] [Js]
Mr.MG19: bets $0.02
hc agorist: calls $0.02
*** RIVER *** [6c 9d 8h Js] [9h]
Mr.MG19: bets $0.02
hc agorist: calls $0.02
*** SHOW DOWN ***
Mr.MG19: shows [3s 3h] (two pair, Nines and Threes)
hc agorist: mucks hand 
Mr.MG19 collected $0.21 from pot
*** SUMMARY ***
Total pot $0.22 | Rake $0.01 
Board [6c 9d 8h Js 9h]
Seat 1: naxier (button) folded before Flop (didn't bet)
Seat 2: Mr.MG19 (small blind) showed [3s 3h] and won ($0.21) with two pair, Nines and Threes
Seat 3: cacao73 (big blind) folded before Flop
Seat 4: nikonova88 folded before Flop (didn't bet)
Seat 5: strimmm0 folded before Flop (didn't bet)
Seat 6: hc agorist mucked [Ah Kh]



PokerStars Zoom Hand #193767262954:  Hold'em No Limit ($0.01/$0.02) - 2018/11/27 0:01:01 CUST [2018/11/26 11:01:01 ET]
Table 'Halley' 6-max Seat #1 is the button
Seat 1: felsandric ($0.48 in chips) 
Seat 2: DANILZOL ($0.69 in chips) 
Seat 3: grotespeler98 ($2.96 in chips) 
Seat 4: zsolo480 ($1.90 in chips) 
Seat 5: hc agorist ($2.80 in chips) 
Seat 6: Vigorous580 ($9.89 in chips) 
DANILZOL: posts small blind $0.01
grotespeler98: posts big blind $0.02
*** HOLE CARDS ***
Dealt to hc agorist [Th 8c]
zsolo480: folds 
hc agorist: folds 
Vigorous580: raises $0.02 to $0.04
felsandric: calls $0.04
DANILZOL: folds 
grotespeler98: calls $0.02
*** FLOP *** [7h 9h 8h]
grotespeler98: checks 
Vigorous580: bets $0.13
felsandric: raises $0.31 to $0.44 and is all-in
grotespeler98: folds 
Vigorous580: calls $0.31
*** TURN *** [7h 9h 8h] [Jd]
*** RIVER *** [7h 9h 8h Jd] [4h]
*** SHOW DOWN ***
Vigorous580: shows [Td 2c] (a straight, Seven to Jack)
felsandric: shows [7d 9d] (two pair, Nines and Sevens)
Vigorous580 collected $0.97 from pot
*** SUMMARY ***
Total pot $1.01 | Rake $0.04 
Board [7h 9h 8h Jd 4h]
Seat 1: felsandric (button) showed [7d 9d] and lost with two pair, Nines and Sevens
Seat 2: DANILZOL (small blind) folded before Flop
Seat 3: grotespeler98 (big blind) folded on the Flop
Seat 4: zsolo480 folded before Flop (didn't bet)
Seat 5: hc agorist folded before Flop (didn't bet)
Seat 6: Vigorous580 showed [Td 2c] and won ($0.97) with a straight, Seven to Jack



PokerStars Zoom Hand #193767259591:  Hold'em No Limit ($0.01/$0.02) - 2018/11/27 0:00:54 CUST [2018/11/26 11:00:54 ET]
Table 'Halley' 6-max Seat #1 is the button
Seat 1: easywtf ($6.04 in chips) 
Seat 2: hc agorist ($2.81 in chips) 
Seat 3: Cavalo Fla ($3.71 in chips) 
Seat 4: MaximGusev ($2.30 in chips) 
Seat 5: dawidstr ($2.01 in chips) 
Seat 6: ninugaf ($2.83 in chips) 
hc agorist: posts small blind $0.01
Cavalo Fla: posts big blind $0.02
*** HOLE CARDS ***
Dealt to hc agorist [3c Th]
MaximGusev: folds 
dawidstr: folds 
ninugaf: folds 
easywtf is disconnected 
easywtf has timed out while being disconnected
easywtf: folds 
hc agorist: folds 
Uncalled bet ($0.01) returned to Cavalo Fla
Cavalo Fla collected $0.02 from pot
Cavalo Fla: doesn't show hand 
*** SUMMARY ***
Total pot $0.02 | Rake $0 
Seat 1: easywtf (button) folded before Flop (didn't bet)
Seat 2: hc agorist (small blind) folded before Flop
Seat 3: Cavalo Fla (big blind) collected ($0.02)
Seat 4: MaximGusev folded before Flop (didn't bet)
Seat 5: dawidstr folded before Flop (didn't bet)
Seat 6: ninugaf folded before Flop (didn't bet)



PokerStars Zoom Hand #193767265299:  Hold'em No Limit ($0.01/$0.02) - 2018/11/27 0:01:06 CUST [2018/11/26 11:01:06 ET]
Table 'Halley' 6-max Seat #1 is the button
Seat 1: hc agorist ($2.80 in chips) 
Seat 2: mK.92*INC ($2.03 in chips) 
Seat 3: barrgand ($2 in chips) 
Seat 4: boislan ($2.52 in chips) 
Seat 5: Bogdan_77936 ($0.88 in chips) 
Seat 6: azulut ($2.03 in chips) 
mK.92*INC: posts small blind $0.01
barrgand: posts big blind $0.02
*** HOLE CARDS ***
Dealt to hc agorist [9s 8d]
boislan: folds 
Bogdan_77936: folds 
azulut: folds 
hc agorist: raises $0.02 to $0.04
mK.92*INC: folds 
barrgand: calls $0.02
*** FLOP *** [6d 2c 5h]
barrgand: checks 
hc agorist: bets $0.03
barrgand: raises $0.08 to $0.11
hc agorist: calls $0.08
*** TURN *** [6d 2c 5h] [Tc]
barrgand: bets $0.15
hc agorist: calls $0.15
*** RIVER *** [6d 2c 5h Tc] [Qh]
barrgand: bets $0.30
hc agorist: folds 
Uncalled bet ($0.30) returned to barrgand
barrgand collected $0.59 from pot
barrgand: doesn't show hand 
*** SUMMARY ***
Total pot $0.61 | Rake $0.02 
Board [6d 2c 5h Tc Qh]
Seat 1: hc agorist (button) folded on the River
Seat 2: mK.92*INC (small blind) folded before Flop
Seat 3: barrgand (big blind) collected ($0.59)
Seat 4: boislan folded before Flop (didn't bet)
Seat 5: Bogdan_77936 folded before Flop (didn't bet)
Seat 6: azulut folded before Flop (didn't bet)



PokerStars Zoom Hand #193767290585:  Hold'em No Limit ($0.01/$0.02) - 2018/11/27 0:01:57 CUST [2018/11/26 11:01:57 ET]
Table 'Halley' 6-max Seat #1 is the button
Seat 1: Forten55 ($3.40 in chips) 
Seat 2: boss477 ($4.25 in chips) 
Seat 3: hc agorist ($2.50 in chips) 
Seat 4: billy the x ($2.24 in chips) 
Seat 5: TRAMADOL2288 ($1.10 in chips) 
Seat 6: tg9718 ($2.01 in chips) 
boss477: posts small blind $0.01
hc agorist: posts big blind $0.02
*** HOLE CARDS ***
Dealt to hc agorist [4d 9h]
billy the x: folds 
TRAMADOL2288: folds 
tg9718: raises $0.03 to $0.05
Forten55: folds 
boss477: folds 
hc agorist: folds 
Uncalled bet ($0.03) returned to tg9718
tg9718 collected $0.05 from pot
tg9718: doesn't show hand 
*** SUMMARY ***
Total pot $0.05 | Rake $0 
Seat 1: Forten55 (button) folded before Flop (didn't bet)
Seat 2: boss477 (small blind) folded before Flop
Seat 3: hc agorist (big blind) folded before Flop
Seat 4: billy the x folded before Flop (didn't bet)
Seat 5: TRAMADOL2288 folded before Flop (didn't bet)
Seat 6: tg9718 collected ($0.05)



PokerStars Zoom Hand #193767301074:  Hold'em No Limit ($0.01/$0.02) - 2018/11/27 0:02:18 CUST [2018/11/26 11:02:18 ET]
Table 'Halley' 6-max Seat #1 is the button
Seat 1: bolita8587 ($3.81 in chips) 
Seat 2: hc agorist ($2.48 in chips) 
Seat 3: SKFin ($6.99 in chips) 
Seat 4: chirva007 ($2.12 in chips) 
Seat 5: MiuFuringi ($3.24 in chips) 
Seat 6: goldenblck ($2.13 in chips) 
hc agorist: posts small blind $0.01
SKFin: posts big blind $0.02
*** HOLE CARDS ***
Dealt to hc agorist [3h 5h]
chirva007: folds 
MiuFuringi: folds 
goldenblck: folds 
bolita8587: folds 
hc agorist: raises $0.02 to $0.04
SKFin: folds 
Uncalled bet ($0.02) returned to hc agorist
hc agorist collected $0.04 from pot
hc agorist: doesn't show hand 
*** SUMMARY ***
Total pot $0.04 | Rake $0 
Seat 1: bolita8587 (button) folded before Flop (didn't bet)
Seat 2: hc agorist (small blind) collected ($0.04)
Seat 3: SKFin (big blind) folded before Flop
Seat 4: chirva007 folded before Flop (didn't bet)
Seat 5: MiuFuringi folded before Flop (didn't bet)
Seat 6: goldenblck folded before Flop (didn't bet)



PokerStars Zoom Hand #193767294965:  Hold'em No Limit ($0.01/$0.02) - 2018/11/27 0:02:06 CUST [2018/11/26 11:02:06 ET]
Table 'Halley' 6-max Seat #1 is the button
Seat 1: megastore24 ($2.03 in chips) 
Seat 2: sens3ii ($1.95 in chips) 
Seat 3: Lawrence$lim ($2.87 in chips) 
Seat 4: hc agorist ($2.48 in chips) 
Seat 5: averzia ($2 in chips) 
Seat 6: xzOLOtx ($2.03 in chips) 
sens3ii: posts small blind $0.01
Lawrence$lim: posts big blind $0.02
*** HOLE CARDS ***
Dealt to hc agorist [Qs 8h]
hc agorist: folds 
averzia: folds 
xzOLOtx: raises $0.03 to $0.05
megastore24: folds 
sens3ii: calls $0.04
Lawrence$lim: folds 
*** FLOP *** [6c Ks 9h]
sens3ii: checks 
xzOLOtx: bets $0.05
sens3ii: folds 
Uncalled bet ($0.05) returned to xzOLOtx
xzOLOtx collected $0.12 from pot
xzOLOtx: doesn't show hand 
*** SUMMARY ***
Total pot $0.12 | Rake $0 
Board [6c Ks 9h]
Seat 1: megastore24 (button) folded before Flop (didn't bet)
Seat 2: sens3ii (small blind) folded on the Flop
Seat 3: Lawrence$lim (big blind) folded before Flop
Seat 4: hc agorist folded before Flop (didn't bet)
Seat 5: averzia folded before Flop (didn't bet)
Seat 6: xzOLOtx collected ($0.12)



PokerStars Zoom Hand #193767297592:  Hold'em No Limit ($0.01/$0.02) - 2018/11/27 0:02:11 CUST [2018/11/26 11:02:11 ET]
Table 'Halley' 6-max Seat #1 is the button
Seat 1: ZeusCMR ($2.07 in chips) 
Seat 2: LaCasa15 ($2.13 in chips) 
Seat 3: Tanja214 ($4.60 in chips) 
Seat 4: gosha - pank ($1.17 in chips) 
Seat 5: tchelos123 ($2 in chips) 
Seat 6: hc agorist ($2.48 in chips) 
LaCasa15: posts small blind $0.01
Tanja214: posts big blind $0.02
*** HOLE CARDS ***
Dealt to hc agorist [5c 6d]
gosha - pank: folds 
tchelos123: folds 
hc agorist: folds 
ZeusCMR: raises $0.04 to $0.06
LaCasa15: folds 
Tanja214: calls $0.04
*** FLOP *** [7c 5s Th]
Tanja214: checks 
ZeusCMR: bets $0.07
Tanja214: calls $0.07
*** TURN *** [7c 5s Th] [7h]
Tanja214: bets $0.08
ZeusCMR: calls $0.08
*** RIVER *** [7c 5s Th 7h] [6c]
Tanja214: bets $0.20
ZeusCMR: calls $0.20
*** SHOW DOWN ***
Tanja214: shows [8d Qd] (a pair of Sevens)
ZeusCMR: shows [Ks Td] (two pair, Tens and Sevens)
ZeusCMR collected $0.80 from pot
*** SUMMARY ***
Total pot $0.83 | Rake $0.03 
Board [7c 5s Th 7h 6c]
Seat 1: ZeusCMR (button) showed [Ks Td] and won ($0.80) with two pair, Tens and Sevens
Seat 2: LaCasa15 (small blind) folded before Flop
Seat 3: Tanja214 (big blind) showed [8d Qd] and lost with a pair of Sevens
Seat 4: gosha - pank folded before Flop (didn't bet)
Seat 5: tchelos123 folded before Flop (didn't bet)
Seat 6: hc agorist folded before Flop (didn't bet)



PokerStars Zoom Hand #193767308575:  Hold'em No Limit ($0.01/$0.02) - 2018/11/27 0:02:33 CUST [2018/11/26 11:02:33 ET]
Table 'Halley' 6-max Seat #1 is the button
Seat 1: CuttingCobra ($2 in chips) 
Seat 2: alexps922 ($2.80 in chips) 
Seat 3: Rrripl ($1.42 in chips) 
Seat 4: shamfat ($2.14 in chips) 
Seat 5: hc agorist ($2.50 in chips) 
Seat 6: astraf89 ($2.06 in chips) 
alexps922: posts small blind $0.01
Rrripl: posts big blind $0.02
*** HOLE CARDS ***
Dealt to hc agorist [Kd 5d]
shamfat: folds 
hc agorist: raises $0.02 to $0.04
astraf89: folds 
CuttingCobra: folds 
alexps922: folds 
Rrripl: folds 
Uncalled bet ($0.02) returned to hc agorist
hc agorist collected $0.05 from pot
hc agorist: doesn't show hand 
*** SUMMARY ***
Total pot $0.05 | Rake $0 
Seat 1: CuttingCobra (button) folded before Flop (didn't bet)
Seat 2: alexps922 (small blind) folded before Flop
Seat 3: Rrripl (big blind) folded before Flop
Seat 4: shamfat folded before Flop (didn't bet)
Seat 5: hc agorist collected ($0.05)
Seat 6: astraf89 folded before Flop (didn't bet)



PokerStars Zoom Hand #193767319569:  Hold'em No Limit ($0.01/$0.02) - 2018/11/27 0:02:55 CUST [2018/11/26 11:02:55 ET]
Table 'Halley' 6-max Seat #1 is the button
Seat 1: kakoytotip ($6.37 in chips) 
Seat 2: naimscorp ($2.46 in chips) 
Seat 3: AJ4XX ($2 in chips) 
Seat 4: hc agorist ($2.53 in chips) 
Seat 5: streetwalka ($2 in chips) 
Seat 6: Midar1 ($3.55 in chips) 
naimscorp: posts small blind $0.01
AJ4XX: posts big blind $0.02
*** HOLE CARDS ***
Dealt to hc agorist [5d 5h]
hc agorist: raises $0.02 to $0.04
streetwalka: folds 
Midar1: calls $0.04
kakoytotip: folds 
naimscorp: folds 
AJ4XX: calls $0.02
*** FLOP *** [4s Jd 3h]
AJ4XX: checks 
hc agorist: bets $0.05
Midar1: calls $0.05
AJ4XX: folds 
*** TURN *** [4s Jd 3h] [Qc]
hc agorist: checks 
Midar1: bets $0.11
hc agorist: folds 
Uncalled bet ($0.11) returned to Midar1
Midar1 collected $0.22 from pot
Midar1: doesn't show hand 
*** SUMMARY ***
Total pot $0.23 | Rake $0.01 
Board [4s Jd 3h Qc]
Seat 1: kakoytotip (button) folded before Flop (didn't bet)
Seat 2: naimscorp (small blind) folded before Flop
Seat 3: AJ4XX (big blind) folded on the Flop
Seat 4: hc agorist folded on the Turn
Seat 5: streetwalka folded before Flop (didn't bet)
Seat 6: Midar1 collected ($0.22)



PokerStars Zoom Hand #193767341817:  Hold'em No Limit ($0.01/$0.02) - 2018/11/27 0:03:39 CUST [2018/11/26 11:03:39 ET]
Table 'Halley' 6-max Seat #1 is the button
Seat 1: grajekTeo ($2.05 in chips) 
Seat 2: djafar63 ($2 in chips) 
Seat 3: hc agorist ($2.44 in chips) 
Seat 4: Dairyujin ($1.62 in chips) 
Seat 5: graves80 ($3.05 in chips) 
Seat 6: xolnikc69 ($2.86 in chips) 
djafar63: posts small blind $0.01
hc agorist: posts big blind $0.02
*** HOLE CARDS ***
Dealt to hc agorist [5d 2h]
Dairyujin: folds 
graves80: folds 
xolnikc69: folds 
grajekTeo: folds 
djafar63: folds 
Uncalled bet ($0.01) returned to hc agorist
hc agorist collected $0.02 from pot
hc agorist: doesn't show hand 
*** SUMMARY ***
Total pot $0.02 | Rake $0 
Seat 1: grajekTeo (button) folded before Flop (didn't bet)
Seat 2: djafar63 (small blind) folded before Flop
Seat 3: hc agorist (big blind) collected ($0.02)
Seat 4: Dairyujin folded before Flop (didn't bet)
Seat 5: graves80 folded before Flop (didn't bet)
Seat 6: xolnikc69 folded before Flop (didn't bet)



PokerStars Zoom Hand #193767348013:  Hold'em No Limit ($0.01/$0.02) - 2018/11/27 0:03:51 CUST [2018/11/26 11:03:51 ET]
Table 'Halley' 6-max Seat #1 is the button
Seat 1: neo1200 ($3.70 in chips) 
Seat 2: hc agorist ($2.45 in chips) 
Seat 3: Ag_nyan ($2 in chips) 
Seat 4: piterstone ($3.11 in chips) 
Seat 5: papaguee ($4.69 in chips) 
Seat 6: BadVincent ($1.64 in chips) 
hc agorist: posts small blind $0.01
Ag_nyan: posts big blind $0.02
*** HOLE CARDS ***
Dealt to hc agorist [Kd 3s]
piterstone: folds 
papaguee: folds 
BadVincent: folds 
neo1200: folds 
hc agorist: folds 
Uncalled bet ($0.01) returned to Ag_nyan
Ag_nyan collected $0.02 from pot
Ag_nyan: doesn't show hand 
*** SUMMARY ***
Total pot $0.02 | Rake $0 
Seat 1: neo1200 (button) folded before Flop (didn't bet)
Seat 2: hc agorist (small blind) folded before Flop
Seat 3: Ag_nyan (big blind) collected ($0.02)
Seat 4: piterstone folded before Flop (didn't bet)
Seat 5: papaguee folded before Flop (didn't bet)
Seat 6: BadVincent folded before Flop (didn't bet)



PokerStars Zoom Hand #193767350546:  Hold'em No Limit ($0.01/$0.02) - 2018/11/27 0:03:56 CUST [2018/11/26 11:03:56 ET]
Table 'Halley' 6-max Seat #1 is the button
Seat 1: hc agorist ($2.44 in chips) 
Seat 2: SVG7777 ($1.32 in chips) 
Seat 3: TrabenTra ($3.14 in chips) 
Seat 4: abatur0 ($0.94 in chips) 
Seat 5: booktable ($2 in chips) 
Seat 6: Mariooooo37 ($2.20 in chips) 
SVG7777: posts small blind $0.01
TrabenTra: posts big blind $0.02
*** HOLE CARDS ***
Dealt to hc agorist [2c 3h]
abatur0: folds 
booktable: raises $0.02 to $0.04
Mariooooo37: folds 
hc agorist: folds 
SVG7777: folds 
TrabenTra: folds 
Uncalled bet ($0.02) returned to booktable
booktable collected $0.05 from pot
booktable: doesn't show hand 
*** SUMMARY ***
Total pot $0.05 | Rake $0 
Seat 1: hc agorist (button) folded before Flop (didn't bet)
Seat 2: SVG7777 (small blind) folded before Flop
Seat 3: TrabenTra (big blind) folded before Flop
Seat 4: abatur0 folded before Flop (didn't bet)
Seat 5: booktable collected ($0.05)
Seat 6: Mariooooo37 folded before Flop (didn't bet)



PokerStars Zoom Hand #193767357712:  Hold'em No Limit ($0.01/$0.02) - 2018/11/27 0:04:10 CUST [2018/11/26 11:04:10 ET]
Table 'Halley' 6-max Seat #1 is the button
Seat 1: Denellus ($2.03 in chips) 
Seat 2: TrabenTra ($2.13 in chips) 
Seat 3: olamoon ($2.04 in chips) 
Seat 4: boss477 ($5.73 in chips) 
Seat 5: hc agorist ($2.44 in chips) 
Seat 6: Coffeatus ($2.21 in chips) 
TrabenTra: posts small blind $0.01
olamoon: posts big blind $0.02
*** HOLE CARDS ***
Dealt to hc agorist [4h 5d]
boss477: folds 
hc agorist: folds 
Coffeatus: folds 
Denellus: folds 
TrabenTra: folds 
Uncalled bet ($0.01) returned to olamoon
olamoon collected $0.02 from pot
olamoon: doesn't show hand 
*** SUMMARY ***
Total pot $0.02 | Rake $0 
Seat 1: Denellus (button) folded before Flop (didn't bet)
Seat 2: TrabenTra (small blind) folded before Flop
Seat 3: olamoon (big blind) collected ($0.02)
Seat 4: boss477 folded before Flop (didn't bet)
Seat 5: hc agorist folded before Flop (didn't bet)
Seat 6: Coffeatus folded before Flop (didn't bet)



PokerStars Zoom Hand #193767362837:  Hold'em No Limit ($0.01/$0.02) - 2018/11/27 0:04:20 CUST [2018/11/26 11:04:20 ET]
Table 'Halley' 6-max Seat #1 is the button
Seat 1: hc agorist ($2.44 in chips) 
Seat 2: taurusvit ($2.74 in chips) 
Seat 3: StraightPR0 ($2.10 in chips) 
Seat 4: zequi1998 ($3.26 in chips) 
Seat 5: SanDmitri4 ($2.11 in chips) 
Seat 6: Cyb3r47 ($4.35 in chips) 
taurusvit: posts small blind $0.01
StraightPR0: posts big blind $0.02
*** HOLE CARDS ***
Dealt to hc agorist [3h 7d]
zequi1998: folds 
SanDmitri4: folds 
Cyb3r47: folds 
hc agorist: folds 
taurusvit: folds 
Uncalled bet ($0.01) returned to StraightPR0
StraightPR0 collected $0.02 from pot
StraightPR0: doesn't show hand 
*** SUMMARY ***
Total pot $0.02 | Rake $0 
Seat 1: hc agorist (button) folded before Flop (didn't bet)
Seat 2: taurusvit (small blind) folded before Flop
Seat 3: StraightPR0 (big blind) collected ($0.02)
Seat 4: zequi1998 folded before Flop (didn't bet)
Seat 5: SanDmitri4 folded before Flop (didn't bet)
Seat 6: Cyb3r47 folded before Flop (didn't bet)



PokerStars Zoom Hand #193767353591:  Hold'em No Limit ($0.01/$0.02) - 2018/11/27 0:04:02 CUST [2018/11/26 11:04:02 ET]
Table 'Halley' 6-max Seat #1 is the button
Seat 1: nick.wu.sst ($2.63 in chips) 
Seat 2: bezik9 ($1.61 in chips) 
Seat 3: lucasjc1 ($5.62 in chips) 
Seat 4: Flok1TTFU ($2.87 in chips) 
Seat 5: Lvlvsfrvr ($5.22 in chips) 
Seat 6: hc agorist ($2.44 in chips) 
bezik9: posts small blind $0.01
lucasjc1: posts big blind $0.02
*** HOLE CARDS ***
Dealt to hc agorist [2s Jh]
Flok1TTFU: folds 
Lvlvsfrvr: calls $0.02
hc agorist: folds 
nick.wu.sst: folds 
bezik9: calls $0.01
lucasjc1: checks 
*** FLOP *** [Jd 7c 6d]
bezik9: checks 
lucasjc1: checks 
Lvlvsfrvr: bets $0.03
bezik9: calls $0.03
lucasjc1: folds 
*** TURN *** [Jd 7c 6d] [Kd]
bezik9: checks 
Lvlvsfrvr: bets $0.06
bezik9: calls $0.06
*** RIVER *** [Jd 7c 6d Kd] [Ah]
bezik9: checks 
Lvlvsfrvr: checks 
*** SHOW DOWN ***
bezik9: shows [Kc 3c] (a pair of Kings)
Lvlvsfrvr: mucks hand 
bezik9 collected $0.23 from pot
*** SUMMARY ***
Total pot $0.24 | Rake $0.01 
Board [Jd 7c 6d Kd Ah]
Seat 1: nick.wu.sst (button) folded before Flop (didn't bet)
Seat 2: bezik9 (small blind) showed [Kc 3c] and won ($0.23) with a pair of Kings
Seat 3: lucasjc1 (big blind) folded on the Flop
Seat 4: Flok1TTFU folded before Flop (didn't bet)
Seat 5: Lvlvsfrvr mucked [Jc Qc]
Seat 6: hc agorist folded before Flop (didn't bet)



PokerStars Zoom Hand #193767360246:  Hold'em No Limit ($0.01/$0.02) - 2018/11/27 0:04:15 CUST [2018/11/26 11:04:15 ET]
Table 'Halley' 6-max Seat #1 is the button
Seat 1: papaguee ($4.67 in chips) 
Seat 2: m@xim25 ($8.21 in chips) 
Seat 3: kalmar1958 ($1 in chips) 
Seat 4: hc agorist ($2.44 in chips) 
Seat 5: pastyr777 ($2 in chips) 
Seat 6: 1blanqueanu1 ($2.10 in chips) 
m@xim25: posts small blind $0.01
kalmar1958: posts big blind $0.02
*** HOLE CARDS ***
Dealt to hc agorist [5h 9c]
hc agorist: folds 
pastyr777: folds 
1blanqueanu1: folds 
papaguee: calls $0.02
m@xim25: folds 
kalmar1958: checks 
*** FLOP *** [6h 3h 8s]
kalmar1958: bets $0.02
papaguee: raises $0.12 to $0.14
kalmar1958: folds 
Uncalled bet ($0.12) returned to papaguee
papaguee collected $0.09 from pot
papaguee: doesn't show hand 
*** SUMMARY ***
Total pot $0.09 | Rake $0 
Board [6h 3h 8s]
Seat 1: papaguee (button) collected ($0.09)
Seat 2: m@xim25 (small blind) folded before Flop
Seat 3: kalmar1958 (big blind) folded on the Flop
Seat 4: hc agorist folded before Flop (didn't bet)
Seat 5: pastyr777 folded before Flop (didn't bet)
Seat 6: 1blanqueanu1 folded before Flop (didn't bet)



PokerStars Zoom Hand #193767365930:  Hold'em No Limit ($0.01/$0.02) - 2018/11/27 0:04:26 CUST [2018/11/26 11:04:26 ET]
Table 'Halley' 6-max Seat #1 is the button
Seat 1: sinster_ca85 ($4.44 in chips) 
Seat 2: dawidstr ($2.03 in chips) 
Seat 3: hc agorist ($2.44 in chips) 
Seat 4: Glivera77 ($3.18 in chips) 
Seat 5: zequi1998 ($3.26 in chips) 
Seat 6: grotespeler98 ($5.36 in chips) 
dawidstr: posts small blind $0.01
hc agorist: posts big blind $0.02
*** HOLE CARDS ***
Dealt to hc agorist [5h 5s]
Glivera77: folds 
zequi1998: folds 
grotespeler98: raises $0.04 to $0.06
sinster_ca85: folds 
dawidstr: calls $0.05
hc agorist: calls $0.04
*** FLOP *** [Qd 8h 6s]
dawidstr: checks 
hc agorist: checks 
grotespeler98: checks 
*** TURN *** [Qd 8h 6s] [8s]
dawidstr: checks 
hc agorist: bets $0.36
grotespeler98: folds 
dawidstr: folds 
Uncalled bet ($0.36) returned to hc agorist
hc agorist collected $0.17 from pot
hc agorist: doesn't show hand 
*** SUMMARY ***
Total pot $0.18 | Rake $0.01 
Board [Qd 8h 6s 8s]
Seat 1: sinster_ca85 (button) folded before Flop (didn't bet)
Seat 2: dawidstr (small blind) folded on the Turn
Seat 3: hc agorist (big blind) collected ($0.17)
Seat 4: Glivera77 folded before Flop (didn't bet)
Seat 5: zequi1998 folded before Flop (didn't bet)
Seat 6: grotespeler98 folded on the Turn



PokerStars Zoom Hand #193767385513:  Hold'em No Limit ($0.01/$0.02) - 2018/11/27 0:05:04 CUST [2018/11/26 11:05:04 ET]
Table 'Halley' 6-max Seat #1 is the button
Seat 1: N4tyN1ce ($2.25 in chips) 
Seat 2: hc agorist ($2.55 in chips) 
Seat 3: Shuler 17 ($1.46 in chips) 
Seat 4: m@xim25 ($2.97 in chips) 
Seat 5: averzia ($2.07 in chips) 
Seat 6: oravrattas ($1.54 in chips) 
hc agorist: posts small blind $0.01
Shuler 17: posts big blind $0.02
*** HOLE CARDS ***
Dealt to hc agorist [8h 8s]
m@xim25: folds 
averzia: raises $0.04 to $0.06
oravrattas: calls $0.06
N4tyN1ce: folds 
hc agorist: calls $0.05
Shuler 17: calls $0.04
*** FLOP *** [Qc 3s Td]
hc agorist: checks 
Shuler 17: bets $0.04
averzia: calls $0.04
oravrattas: calls $0.04
hc agorist: calls $0.04
*** TURN *** [Qc 3s Td] [5h]
hc agorist: checks 
Shuler 17: checks 
averzia: checks 
oravrattas: checks 
*** RIVER *** [Qc 3s Td 5h] [Qs]
hc agorist: checks 
Shuler 17: bets $0.04
averzia: folds 
oravrattas: folds 
hc agorist: calls $0.04
*** SHOW DOWN ***
Shuler 17: shows [Kd Th] (two pair, Queens and Tens)
hc agorist: mucks hand 
Shuler 17 collected $0.46 from pot
*** SUMMARY ***
Total pot $0.48 | Rake $0.02 
Board [Qc 3s Td 5h Qs]
Seat 1: N4tyN1ce (button) folded before Flop (didn't bet)
Seat 2: hc agorist (small blind) mucked [8h 8s]
Seat 3: Shuler 17 (big blind) showed [Kd Th] and won ($0.46) with two pair, Queens and Tens
Seat 4: m@xim25 folded before Flop (didn't bet)
Seat 5: averzia folded on the River
Seat 6: oravrattas folded on the River



PokerStars Zoom Hand #193767437821:  Hold'em No Limit ($0.01/$0.02) - 2018/11/27 0:06:43 CUST [2018/11/26 11:06:43 ET]
Table 'Halley' 6-max Seat #1 is the button
Seat 1: F4lconetti ($1.90 in chips) 
Seat 2: datuti9 ($2.98 in chips) 
Seat 3: anasanto ($6.18 in chips) 
Seat 4: bolita8587 ($2.66 in chips) 
Seat 5: olamoon ($2.50 in chips) 
Seat 6: hc agorist ($2.41 in chips) 
datuti9: posts small blind $0.01
anasanto: posts big blind $0.02
*** HOLE CARDS ***
Dealt to hc agorist [5c 3d]
bolita8587: folds 
olamoon: raises $0.04 to $0.06
hc agorist: folds 
F4lconetti: folds 
datuti9: folds 
anasanto: folds 
Uncalled bet ($0.04) returned to olamoon
olamoon collected $0.05 from pot
olamoon: doesn't show hand 
*** SUMMARY ***
Total pot $0.05 | Rake $0 
Seat 1: F4lconetti (button) folded before Flop (didn't bet)
Seat 2: datuti9 (small blind) folded before Flop
Seat 3: anasanto (big blind) folded before Flop
Seat 4: bolita8587 folded before Flop (didn't bet)
Seat 5: olamoon collected ($0.05)
Seat 6: hc agorist folded before Flop (didn't bet)



PokerStars Zoom Hand #193767435154:  Hold'em No Limit ($0.01/$0.02) - 2018/11/27 0:06:38 CUST [2018/11/26 11:06:38 ET]
Table 'Halley' 6-max Seat #1 is the button
Seat 1: Rrripl ($1.25 in chips) 
Seat 2: ninugaf ($3.09 in chips) 
Seat 3: 1MAPTA ($1.18 in chips) 
Seat 4: hc agorist ($2.41 in chips) 
Seat 5: Treuteller ($1.78 in chips) 
Seat 6: Innerwuss ($2.05 in chips) 
ninugaf: posts small blind $0.01
1MAPTA: posts big blind $0.02
*** HOLE CARDS ***
Dealt to hc agorist [Qd 6c]
hc agorist: folds 
Treuteller: folds 
Innerwuss: folds 
Rrripl: raises $0.02 to $0.04
ninugaf: folds 
1MAPTA: calls $0.02
*** FLOP *** [5c 3s 5s]
1MAPTA: bets $0.02
Rrripl: calls $0.02
*** TURN *** [5c 3s 5s] [Qs]
1MAPTA: bets $0.02
Rrripl: folds 
Uncalled bet ($0.02) returned to 1MAPTA
1MAPTA collected $0.13 from pot
1MAPTA: doesn't show hand 
*** SUMMARY ***
Total pot $0.13 | Rake $0 
Board [5c 3s 5s Qs]
Seat 1: Rrripl (button) folded on the Turn
Seat 2: ninugaf (small blind) folded before Flop
Seat 3: 1MAPTA (big blind) collected ($0.13)
Seat 4: hc agorist folded before Flop (didn't bet)
Seat 5: Treuteller folded before Flop (didn't bet)
Seat 6: Innerwuss folded before Flop (didn't bet)



PokerStars Zoom Hand #193767448462:  Hold'em No Limit ($0.01/$0.02) - 2018/11/27 0:07:03 CUST [2018/11/26 11:07:03 ET]
Table 'Halley' 6-max Seat #1 is the button
Seat 1: oleym ($5.07 in chips) 
Seat 2: Artuzinio ($2 in chips) 
Seat 3: hc agorist ($2.41 in chips) 
Seat 4: Arch1689 ($2.10 in chips) 
Seat 5: Midukan59 ($0.59 in chips) 
Seat 6: Mistbaer ($2.11 in chips) 
Artuzinio: posts small blind $0.01
hc agorist: posts big blind $0.02
*** HOLE CARDS ***
Dealt to hc agorist [As Ac]
Arch1689: raises $0.03 to $0.05
Midukan59: folds 
Mistbaer: folds 
oleym: folds 
Artuzinio: folds 
hc agorist: raises $0.15 to $0.20
Arch1689: folds 
Uncalled bet ($0.15) returned to hc agorist
hc agorist collected $0.11 from pot
hc agorist: doesn't show hand 
*** SUMMARY ***
Total pot $0.11 | Rake $0 
Seat 1: oleym (button) folded before Flop (didn't bet)
Seat 2: Artuzinio (small blind) folded before Flop
Seat 3: hc agorist (big blind) collected ($0.11)
Seat 4: Arch1689 folded before Flop
Seat 5: Midukan59 folded before Flop (didn't bet)
Seat 6: Mistbaer folded before Flop (didn't bet)



PokerStars Zoom Hand #193767445829:  Hold'em No Limit ($0.01/$0.02) - 2018/11/27 0:06:58 CUST [2018/11/26 11:06:58 ET]
Table 'Halley' 6-max Seat #1 is the button
Seat 1: AdamLaw33 ($2.90 in chips) 
Seat 2: charlesws25 ($3.62 in chips) 
Seat 3: 111kasper777 ($2.71 in chips) 
Seat 4: hc agorist ($2.41 in chips) 
Seat 5: Cobbler43 ($3.79 in chips) 
Seat 6: alek7777700 ($1.65 in chips) 
charlesws25: posts small blind $0.01
111kasper777: posts big blind $0.02
*** HOLE CARDS ***
Dealt to hc agorist [2c 7s]
hc agorist: folds 
Cobbler43: folds 
alek7777700: folds 
AdamLaw33: raises $0.04 to $0.06
charlesws25: folds 
111kasper777: calls $0.04
*** FLOP *** [5s 9d 9s]
111kasper777: checks 
AdamLaw33: bets $0.08
111kasper777: folds 
Uncalled bet ($0.08) returned to AdamLaw33
AdamLaw33 collected $0.13 from pot
AdamLaw33: doesn't show hand 
*** SUMMARY ***
Total pot $0.13 | Rake $0 
Board [5s 9d 9s]
Seat 1: AdamLaw33 (button) collected ($0.13)
Seat 2: charlesws25 (small blind) folded before Flop
Seat 3: 111kasper777 (big blind) folded on the Flop
Seat 4: hc agorist folded before Flop (didn't bet)
Seat 5: Cobbler43 folded before Flop (didn't bet)
Seat 6: alek7777700 folded before Flop (didn't bet)



PokerStars Zoom Hand #193767484261:  Hold'em No Limit ($0.01/$0.02) - 2018/11/27 0:08:10 CUST [2018/11/26 11:08:10 ET]
Table 'Halley' 6-max Seat #1 is the button
Seat 1: Bruels ($2.97 in chips) 
Seat 2: lucky_4it ($2.06 in chips) 
Seat 3: hc agorist ($2.39 in chips) 
Seat 4: craven7777 ($3.95 in chips) 
Seat 5: FrontKjemper ($2.25 in chips) 
Seat 6: pocketfetish ($3.78 in chips) 
lucky_4it: posts small blind $0.01
hc agorist: posts big blind $0.02
*** HOLE CARDS ***
Dealt to hc agorist [Qs 4c]
craven7777: folds 
FrontKjemper: folds 
pocketfetish: folds 
Bruels: raises $0.02 to $0.04
lucky_4it: folds 
hc agorist: folds 
Uncalled bet ($0.02) returned to Bruels
Bruels collected $0.05 from pot
Bruels: doesn't show hand 
*** SUMMARY ***
Total pot $0.05 | Rake $0 
Seat 1: Bruels (button) collected ($0.05)
Seat 2: lucky_4it (small blind) folded before Flop
Seat 3: hc agorist (big blind) folded before Flop
Seat 4: craven7777 folded before Flop (didn't bet)
Seat 5: FrontKjemper folded before Flop (didn't bet)
Seat 6: pocketfetish folded before Flop (didn't bet)



PokerStars Zoom Hand #193767460748:  Hold'em No Limit ($0.01/$0.02) - 2018/11/27 0:07:26 CUST [2018/11/26 11:07:26 ET]
Table 'Halley' 6-max Seat #1 is the button
Seat 1: grajekTeo ($2.32 in chips) 
Seat 2: hc agorist ($2.47 in chips) 
Seat 3: dawidstr ($2 in chips) 
Seat 4: anasanto ($2 in chips) 
Seat 5: DoyaRED ($1.35 in chips) 
Seat 6: JTbukowski ($1.86 in chips) 
hc agorist: posts small blind $0.01
dawidstr: posts big blind $0.02
*** HOLE CARDS ***
Dealt to hc agorist [Jd 2c]
anasanto: folds 
DoyaRED: folds 
JTbukowski: folds 
grajekTeo: raises $0.03 to $0.05
hc agorist: folds 
dawidstr: calls $0.03
*** FLOP *** [2h Td Kh]
dawidstr: checks 
grajekTeo: checks 
*** TURN *** [2h Td Kh] [8c]
dawidstr: checks 
grajekTeo: checks 
*** RIVER *** [2h Td Kh 8c] [Ks]
dawidstr: checks 
grajekTeo: bets $0.04
dawidstr: folds 
Uncalled bet ($0.04) returned to grajekTeo
grajekTeo collected $0.11 from pot
grajekTeo: doesn't show hand 
*** SUMMARY ***
Total pot $0.11 | Rake $0 
Board [2h Td Kh 8c Ks]
Seat 1: grajekTeo (button) collected ($0.11)
Seat 2: hc agorist (small blind) folded before Flop
Seat 3: dawidstr (big blind) folded on the River
Seat 4: anasanto folded before Flop (didn't bet)
Seat 5: DoyaRED folded before Flop (didn't bet)
Seat 6: JTbukowski folded before Flop (didn't bet)



PokerStars Zoom Hand #193767492175:  Hold'em No Limit ($0.01/$0.02) - 2018/11/27 0:08:25 CUST [2018/11/26 11:08:25 ET]
Table 'Halley' 6-max Seat #1 is the button
Seat 1: pocketfetish ($3.81 in chips) 
Seat 2: strimmm0 ($4.37 in chips) 
Seat 3: galonpiva ($2.12 in chips) 
Seat 4: Gollenz ($2.25 in chips) 
Seat 5: pirdolyj ($2.35 in chips) 
Seat 6: hc agorist ($2.37 in chips) 
strimmm0: posts small blind $0.01
galonpiva: posts big blind $0.02
*** HOLE CARDS ***
Dealt to hc agorist [Tc 9h]
Gollenz: folds 
pirdolyj: folds 
hc agorist: raises $0.02 to $0.04
pocketfetish: folds 
strimmm0: folds 
galonpiva: folds 
Uncalled bet ($0.02) returned to hc agorist
hc agorist collected $0.05 from pot
hc agorist: doesn't show hand 
*** SUMMARY ***
Total pot $0.05 | Rake $0 
Seat 1: pocketfetish (button) folded before Flop (didn't bet)
Seat 2: strimmm0 (small blind) folded before Flop
Seat 3: galonpiva (big blind) folded before Flop
Seat 4: Gollenz folded before Flop (didn't bet)
Seat 5: pirdolyj folded before Flop (didn't bet)
Seat 6: hc agorist collected ($0.05)



PokerStars Zoom Hand #193767442593:  Hold'em No Limit ($0.01/$0.02) - 2018/11/27 0:06:52 CUST [2018/11/26 11:06:52 ET]
Table 'Halley' 6-max Seat #1 is the button
Seat 1: holywarss ($2 in chips) 
Seat 2: kilingdude ($2.12 in chips) 
Seat 3: ZAVODchani22 ($2 in chips) 
Seat 4: madrihcosher ($2 in chips) 
Seat 5: hc agorist ($2.41 in chips) 
Seat 6: asposition ($4.07 in chips) 
kilingdude: posts small blind $0.01
ZAVODchani22: posts big blind $0.02
*** HOLE CARDS ***
Dealt to hc agorist [6d Ks]
madrihcosher: folds 
hc agorist: folds 
asposition: raises $0.04 to $0.06
holywarss: calls $0.06
kilingdude: folds 
ZAVODchani22: calls $0.04
*** FLOP *** [Ad 7h Th]
ZAVODchani22: bets $0.12
asposition: folds 
holywarss: calls $0.12
*** TURN *** [Ad 7h Th] [7c]
ZAVODchani22: checks 
holywarss: checks 
*** RIVER *** [Ad 7h Th 7c] [As]
ZAVODchani22: checks 
holywarss: checks 
*** SHOW DOWN ***
ZAVODchani22: shows [9h Qh] (two pair, Aces and Sevens)
holywarss: shows [Qs Kd] (two pair, Aces and Sevens - King kicker)
holywarss collected $0.41 from pot
*** SUMMARY ***
Total pot $0.43 | Rake $0.02 
Board [Ad 7h Th 7c As]
Seat 1: holywarss (button) showed [Qs Kd] and won ($0.41) with two pair, Aces and Sevens
Seat 2: kilingdude (small blind) folded before Flop
Seat 3: ZAVODchani22 (big blind) showed [9h Qh] and lost with two pair, Aces and Sevens
Seat 4: madrihcosher folded before Flop (didn't bet)
Seat 5: hc agorist folded before Flop (didn't bet)
Seat 6: asposition folded on the Flop



PokerStars Zoom Hand #193767463893:  Hold'em No Limit ($0.01/$0.02) - 2018/11/27 0:07:32 CUST [2018/11/26 11:07:32 ET]
Table 'Halley' 6-max Seat #1 is the button
Seat 1: hc agorist ($2.46 in chips) 
Seat 2: lpk2 ($1 in chips) 
Seat 3: don_energo2 ($2.03 in chips) 
Seat 4: tanawarat666 ($0.75 in chips) 
Seat 5: dori_vedimak ($1.20 in chips) 
Seat 6: JuicyPenn ($1.79 in chips) 
lpk2: posts small blind $0.01
don_energo2: posts big blind $0.02
*** HOLE CARDS ***
Dealt to hc agorist [Qh Ks]
tanawarat666: folds 
dori_vedimak: raises $0.05 to $0.07
JuicyPenn: folds 
hc agorist: calls $0.07
lpk2: calls $0.06
don_energo2: calls $0.05
*** FLOP *** [Tc 5c 7c]
lpk2: checks 
don_energo2: checks 
dori_vedimak: bets $0.14
hc agorist: folds 
lpk2: calls $0.14
don_energo2: folds 
*** TURN *** [Tc 5c 7c] [6s]
lpk2: checks 
dori_vedimak: bets $0.26
lpk2: calls $0.26
*** RIVER *** [Tc 5c 7c 6s] [Qd]
lpk2: checks 
dori_vedimak: bets $0.73 and is all-in
lpk2: folds 
Uncalled bet ($0.73) returned to dori_vedimak
dori_vedimak collected $1.04 from pot
dori_vedimak: doesn't show hand 
*** SUMMARY ***
Total pot $1.08 | Rake $0.04 
Board [Tc 5c 7c 6s Qd]
Seat 1: hc agorist (button) folded on the Flop
Seat 2: lpk2 (small blind) folded on the River
Seat 3: don_energo2 (big blind) folded on the Flop
Seat 4: tanawarat666 folded before Flop (didn't bet)
Seat 5: dori_vedimak collected ($1.04)
Seat 6: JuicyPenn folded before Flop (didn't bet)



PokerStars Zoom Hand #193767499535:  Hold'em No Limit ($0.01/$0.02) - 2018/11/27 0:08:39 CUST [2018/11/26 11:08:39 ET]
Table 'Halley' 6-max Seat #1 is the button
Seat 1: Kyle1998s ($2.02 in chips) 
Seat 2: coolman2004 ($2.18 in chips) 
Seat 3: ZERO 007728 ($1.92 in chips) 
Seat 4: ThunderArmor_v2 ($2 in chips) 
Seat 5: hc agorist ($2.40 in chips) 
Seat 6: erioncrazy ($2.02 in chips) 
coolman2004: posts small blind $0.01
ZERO 007728: posts big blind $0.02
*** HOLE CARDS ***
Dealt to hc agorist [4h 5s]
ThunderArmor_v2: folds 
hc agorist: folds 
erioncrazy: raises $0.04 to $0.06
Kyle1998s: folds 
coolman2004: folds 
ZERO 007728: calls $0.04
*** FLOP *** [Qc 9d Td]
ZERO 007728: checks 
erioncrazy: bets $0.08
ZERO 007728: folds 
Uncalled bet ($0.08) returned to erioncrazy
erioncrazy collected $0.13 from pot
erioncrazy: doesn't show hand 
*** SUMMARY ***
Total pot $0.13 | Rake $0 
Board [Qc 9d Td]
Seat 1: Kyle1998s (button) folded before Flop (didn't bet)
Seat 2: coolman2004 (small blind) folded before Flop
Seat 3: ZERO 007728 (big blind) folded on the Flop
Seat 4: ThunderArmor_v2 folded before Flop (didn't bet)
Seat 5: hc agorist folded before Flop (didn't bet)
Seat 6: erioncrazy collected ($0.13)



PokerStars Zoom Hand #193767502176:  Hold'em No Limit ($0.01/$0.02) - 2018/11/27 0:08:44 CUST [2018/11/26 11:08:44 ET]
Table 'Halley' 6-max Seat #1 is the button
Seat 1: hc agorist ($2.40 in chips) 
Seat 2: ded2790 ($4.53 in chips) 
Seat 3: babiloniaxxx ($2.17 in chips) 
Seat 4: sabukpoke375 ($3.83 in chips) 
Seat 5: ChrisCreys ($14.80 in chips) 
Seat 6: sunnypanther ($2.96 in chips) 
ded2790: posts small blind $0.01
babiloniaxxx: posts big blind $0.02
*** HOLE CARDS ***
Dealt to hc agorist [Ah 8h]
sabukpoke375: raises $0.04 to $0.06
ChrisCreys: folds 
sunnypanther: folds 
hc agorist: calls $0.06
ded2790: folds 
babiloniaxxx: calls $0.04
*** FLOP *** [6s 9d Th]
babiloniaxxx: checks 
sabukpoke375: checks 
hc agorist: bets $0.16
babiloniaxxx: calls $0.16
sabukpoke375: raises $0.32 to $0.48
hc agorist: folds 
babiloniaxxx: calls $0.32
*** TURN *** [6s 9d Th] [6d]
babiloniaxxx: checks 
sabukpoke375: checks 
*** RIVER *** [6s 9d Th 6d] [Kc]
babiloniaxxx: bets $1.63 and is all-in
sabukpoke375: calls $1.63
*** SHOW DOWN ***
babiloniaxxx: shows [Jc Qc] (a straight, Nine to King)
sabukpoke375: shows [Td Ts] (a full house, Tens full of Sixes)
sabukpoke375 collected $4.41 from pot
*** SUMMARY ***
Total pot $4.57 | Rake $0.16 
Board [6s 9d Th 6d Kc]
Seat 1: hc agorist (button) folded on the Flop
Seat 2: ded2790 (small blind) folded before Flop
Seat 3: babiloniaxxx (big blind) showed [Jc Qc] and lost with a straight, Nine to King
Seat 4: sabukpoke375 showed [Td Ts] and won ($4.41) with a full house, Tens full of Sixes
Seat 5: ChrisCreys folded before Flop (didn't bet)
Seat 6: sunnypanther folded before Flop (didn't bet)



PokerStars Zoom Hand #193767529652:  Hold'em No Limit ($0.01/$0.02) - 2018/11/27 0:09:36 CUST [2018/11/26 11:09:36 ET]
Table 'Halley' 6-max Seat #1 is the button
Seat 1: tehBlub ($4.23 in chips) 
Seat 2: hc agorist ($2.18 in chips) 
Seat 3: Lawrence$lim ($2.98 in chips) 
Seat 4: o_siro ($2 in chips) 
Seat 5: Rrripl ($1.31 in chips) 
Seat 6: TaymyrGER ($2.64 in chips) 
hc agorist: posts small blind $0.01
Lawrence$lim: posts big blind $0.02
*** HOLE CARDS ***
Dealt to hc agorist [Ac 2c]
o_siro: folds 
Rrripl: folds 
TaymyrGER: raises $0.02 to $0.04
tehBlub: folds 
hc agorist: raises $0.10 to $0.14
Lawrence$lim: folds 
TaymyrGER: folds 
Uncalled bet ($0.10) returned to hc agorist
hc agorist collected $0.10 from pot
hc agorist: doesn't show hand 
*** SUMMARY ***
Total pot $0.10 | Rake $0 
Seat 1: tehBlub (button) folded before Flop (didn't bet)
Seat 2: hc agorist (small blind) collected ($0.10)
Seat 3: Lawrence$lim (big blind) folded before Flop
Seat 4: o_siro folded before Flop (didn't bet)
Seat 5: Rrripl folded before Flop (didn't bet)
Seat 6: TaymyrGER folded before Flop



PokerStars Zoom Hand #193767526956:  Hold'em No Limit ($0.01/$0.02) - 2018/11/27 0:09:31 CUST [2018/11/26 11:09:31 ET]
Table 'Halley' 6-max Seat #1 is the button
Seat 1: 2.Versuch140 ($2 in chips) 
Seat 2: treffer99 ($1.11 in chips) 
Seat 3: valdes755 ($1.29 in chips) 
Seat 4: hc agorist ($2.18 in chips) 
Seat 5: Zhan1975 ($5 in chips) 
Seat 6: erioncrazy ($2 in chips) 
treffer99: posts small blind $0.01
valdes755: posts big blind $0.02
*** HOLE CARDS ***
Dealt to hc agorist [8s 7c]
hc agorist: folds 
Zhan1975: raises $0.08 to $0.10
erioncrazy: folds 
2.Versuch140: raises $0.14 to $0.24
treffer99: folds 
valdes755: folds 
Zhan1975: calls $0.14
*** FLOP *** [6s 9d Ad]
Zhan1975: checks 
2.Versuch140: bets $0.16
Zhan1975: raises $4.60 to $4.76 and is all-in
2.Versuch140: folds 
Uncalled bet ($4.60) returned to Zhan1975
Zhan1975 collected $0.80 from pot
Zhan1975: doesn't show hand 
*** SUMMARY ***
Total pot $0.83 | Rake $0.03 
Board [6s 9d Ad]
Seat 1: 2.Versuch140 (button) folded on the Flop
Seat 2: treffer99 (small blind) folded before Flop
Seat 3: valdes755 (big blind) folded before Flop
Seat 4: hc agorist folded before Flop (didn't bet)
Seat 5: Zhan1975 collected ($0.80)
Seat 6: erioncrazy folded before Flop (didn't bet)



PokerStars Zoom Hand #193767540320:  Hold'em No Limit ($0.01/$0.02) - 2018/11/27 0:09:56 CUST [2018/11/26 11:09:56 ET]
Table 'Halley' 6-max Seat #1 is the button
Seat 1: shkap ($0.53 in chips) 
Seat 2: Post64 ($1.67 in chips) 
Seat 3: pa1nback ($2.68 in chips) 
Seat 4: meniasjo ($3.92 in chips) 
Seat 5: juliPMK ($2.06 in chips) 
Seat 6: hc agorist ($2.24 in chips) 
Post64: posts small blind $0.01
pa1nback: posts big blind $0.02
*** HOLE CARDS ***
Dealt to hc agorist [Th 2h]
meniasjo: raises $0.04 to $0.06
juliPMK: folds 
hc agorist: folds 
shkap: folds 
Post64: folds 
pa1nback: folds 
Uncalled bet ($0.04) returned to meniasjo
meniasjo collected $0.05 from pot
meniasjo: doesn't show hand 
*** SUMMARY ***
Total pot $0.05 | Rake $0 
Seat 1: shkap (button) folded before Flop (didn't bet)
Seat 2: Post64 (small blind) folded before Flop
Seat 3: pa1nback (big blind) folded before Flop
Seat 4: meniasjo collected ($0.05)
Seat 5: juliPMK folded before Flop (didn't bet)
Seat 6: hc agorist folded before Flop (didn't bet)



PokerStars Zoom Hand #193767551433:  Hold'em No Limit ($0.01/$0.02) - 2018/11/27 0:10:17 CUST [2018/11/26 11:10:17 ET]
Table 'Halley' 6-max Seat #1 is the button
Seat 1: Energetic71 ($2.01 in chips) 
Seat 2: tehBlub ($4.26 in chips) 
Seat 3: hc agorist ($2.23 in chips) 
Seat 4: NANCYDREW726 ($2.22 in chips) 
Seat 5: picurul ($2.22 in chips) 
Seat 6: FabryGonnos ($2.36 in chips) 
tehBlub: posts small blind $0.01
hc agorist: posts big blind $0.02
*** HOLE CARDS ***
Dealt to hc agorist [Td Ac]
NANCYDREW726: folds 
picurul: raises $0.03 to $0.05
FabryGonnos: calls $0.05
Energetic71: folds 
tehBlub: folds 
hc agorist: raises $0.16 to $0.21
picurul: folds 
FabryGonnos: calls $0.16
*** FLOP *** [8c 3c 8h]
hc agorist: bets $0.16
FabryGonnos: folds 
Uncalled bet ($0.16) returned to hc agorist
hc agorist collected $0.46 from pot
hc agorist: doesn't show hand 
*** SUMMARY ***
Total pot $0.48 | Rake $0.02 
Board [8c 3c 8h]
Seat 1: Energetic71 (button) folded before Flop (didn't bet)
Seat 2: tehBlub (small blind) folded before Flop
Seat 3: hc agorist (big blind) collected ($0.46)
Seat 4: NANCYDREW726 folded before Flop (didn't bet)
Seat 5: picurul folded before Flop
Seat 6: FabryGonnos folded on the Flop



PokerStars Zoom Hand #193767565202:  Hold'em No Limit ($0.01/$0.02) - 2018/11/27 0:10:43 CUST [2018/11/26 11:10:43 ET]
Table 'Halley' 6-max Seat #1 is the button
Seat 1: hc agorist ($2.48 in chips) 
Seat 2: pa1nback ($2.69 in chips) 
Seat 3: N4tyN1ce ($2.17 in chips) 
Seat 4: d2009157 ($2.28 in chips) 
Seat 5: barrgand ($2.05 in chips) 
Seat 6: Mr-under-tam ($5.38 in chips) 
pa1nback: posts small blind $0.01
N4tyN1ce: posts big blind $0.02
*** HOLE CARDS ***
Dealt to hc agorist [6s Tc]
d2009157: folds 
barrgand: folds 
Mr-under-tam: folds 
hc agorist: folds 
pa1nback: folds 
Uncalled bet ($0.01) returned to N4tyN1ce
N4tyN1ce collected $0.02 from pot
N4tyN1ce: doesn't show hand 
*** SUMMARY ***
Total pot $0.02 | Rake $0 
Seat 1: hc agorist (button) folded before Flop (didn't bet)
Seat 2: pa1nback (small blind) folded before Flop
Seat 3: N4tyN1ce (big blind) collected ($0.02)
Seat 4: d2009157 folded before Flop (didn't bet)
Seat 5: barrgand folded before Flop (didn't bet)
Seat 6: Mr-under-tam folded before Flop (didn't bet)



PokerStars Zoom Hand #193767567975:  Hold'em No Limit ($0.01/$0.02) - 2018/11/27 0:10:48 CUST [2018/11/26 11:10:48 ET]
Table 'Halley' 6-max Seat #1 is the button
Seat 1: galonpiva ($2.36 in chips) 
Seat 2: violero_clas ($2.29 in chips) 
Seat 3: juliPMK ($2.24 in chips) 
Seat 4: Arch1689 ($2 in chips) 
Seat 5: stealtime ($2.19 in chips) 
Seat 6: hc agorist ($2.48 in chips) 
violero_clas: posts small blind $0.01
juliPMK: posts big blind $0.02
*** HOLE CARDS ***
Dealt to hc agorist [9d Jh]
Arch1689: folds 
stealtime: folds 
hc agorist: raises $0.02 to $0.04
galonpiva: folds 
violero_clas: folds 
juliPMK: folds 
Uncalled bet ($0.02) returned to hc agorist
hc agorist collected $0.05 from pot
hc agorist: doesn't show hand 
*** SUMMARY ***
Total pot $0.05 | Rake $0 
Seat 1: galonpiva (button) folded before Flop (didn't bet)
Seat 2: violero_clas (small blind) folded before Flop
Seat 3: juliPMK (big blind) folded before Flop
Seat 4: Arch1689 folded before Flop (didn't bet)
Seat 5: stealtime folded before Flop (didn't bet)
Seat 6: hc agorist collected ($0.05)



PokerStars Zoom Hand #193767548790:  Hold'em No Limit ($0.01/$0.02) - 2018/11/27 0:10:12 CUST [2018/11/26 11:10:12 ET]
Table 'Halley' 6-max Seat #1 is the button
Seat 1: sukisurova ($2.84 in chips) 
Seat 2: hc agorist ($2.24 in chips) 
Seat 3: Gollenz ($2 in chips) 
Seat 4: stupid_bear1 ($2.27 in chips) 
Seat 5: m@xim25 ($2.13 in chips) 
Seat 6: Dimov ($2.38 in chips) 
hc agorist: posts small blind $0.01
Gollenz: posts big blind $0.02
*** HOLE CARDS ***
Dealt to hc agorist [Js 7h]
stupid_bear1: folds 
m@xim25: folds 
Dimov: raises $0.02 to $0.04
sukisurova: raises $0.11 to $0.15
hc agorist: folds 
Gollenz: folds 
Dimov: calls $0.11
*** FLOP *** [Td Th 5s]
Dimov: checks 
sukisurova: bets $0.26
Dimov: calls $0.26
*** TURN *** [Td Th 5s] [4d]
Dimov: checks 
sukisurova: checks 
*** RIVER *** [Td Th 5s 4d] [9d]
Dimov: bets $0.40
sukisurova: calls $0.40
*** SHOW DOWN ***
Dimov: shows [Jc Ts] (three of a kind, Tens)
sukisurova: mucks hand 
Dimov collected $1.59 from pot
*** SUMMARY ***
Total pot $1.65 | Rake $0.06 
Board [Td Th 5s 4d 9d]
Seat 1: sukisurova (button) mucked [Ac Kh]
Seat 2: hc agorist (small blind) folded before Flop
Seat 3: Gollenz (big blind) folded before Flop
Seat 4: stupid_bear1 folded before Flop (didn't bet)
Seat 5: m@xim25 folded before Flop (didn't bet)
Seat 6: Dimov showed [Jc Ts] and won ($1.59) with three of a kind, Tens



PokerStars Zoom Hand #193767577523:  Hold'em No Limit ($0.01/$0.02) - 2018/11/27 0:11:06 CUST [2018/11/26 11:11:06 ET]
Table 'Halley' 6-max Seat #1 is the button
Seat 1: streetwalka ($2.33 in chips) 
Seat 2: m@xim25 ($2 in chips) 
Seat 3: Chameleon996 ($3.48 in chips) 
Seat 4: fool xayc777 ($1.71 in chips) 
Seat 5: hc agorist ($2.51 in chips) 
Seat 6: mendesmg30 ($2.79 in chips) 
m@xim25: posts small blind $0.01
Chameleon996: posts big blind $0.02
*** HOLE CARDS ***
Dealt to hc agorist [4h 2d]
fool xayc777: folds 
hc agorist: folds 
mendesmg30: folds 
streetwalka: raises $0.04 to $0.06
m@xim25: folds 
Chameleon996: folds 
Uncalled bet ($0.04) returned to streetwalka
streetwalka collected $0.05 from pot
streetwalka: doesn't show hand 
*** SUMMARY ***
Total pot $0.05 | Rake $0 
Seat 1: streetwalka (button) collected ($0.05)
Seat 2: m@xim25 (small blind) folded before Flop
Seat 3: Chameleon996 (big blind) folded before Flop
Seat 4: fool xayc777 folded before Flop (didn't bet)
Seat 5: hc agorist folded before Flop (didn't bet)
Seat 6: mendesmg30 folded before Flop (didn't bet)



PokerStars Zoom Hand #193767580290:  Hold'em No Limit ($0.01/$0.02) - 2018/11/27 0:11:11 CUST [2018/11/26 11:11:11 ET]
Table 'Halley' 6-max Seat #1 is the button
Seat 1: tehBlub ($5.20 in chips) 
Seat 2: Treuteller ($1.91 in chips) 
Seat 3: vagasstar ($1.11 in chips) 
Seat 4: anasanto ($2.20 in chips) 
Seat 5: hc agorist ($2.51 in chips) 
Seat 6: treffer99 ($1.04 in chips) 
Treuteller: posts small blind $0.01
vagasstar: posts big blind $0.02
*** HOLE CARDS ***
Dealt to hc agorist [Th Qs]
anasanto: folds 
hc agorist: raises $0.02 to $0.04
treffer99: folds 
tehBlub: folds 
Treuteller: folds 
vagasstar: folds 
Uncalled bet ($0.02) returned to hc agorist
hc agorist collected $0.05 from pot
hc agorist: doesn't show hand 
*** SUMMARY ***
Total pot $0.05 | Rake $0 
Seat 1: tehBlub (button) folded before Flop (didn't bet)
Seat 2: Treuteller (small blind) folded before Flop
Seat 3: vagasstar (big blind) folded before Flop
Seat 4: anasanto folded before Flop (didn't bet)
Seat 5: hc agorist collected ($0.05)
Seat 6: treffer99 folded before Flop (didn't bet)



PokerStars Zoom Hand #193767588810:  Hold'em No Limit ($0.01/$0.02) - 2018/11/27 0:11:27 CUST [2018/11/26 11:11:27 ET]
Table 'Halley' 6-max Seat #1 is the button
Seat 1: fartovii232323 ($1.61 in chips) 
Seat 2: stealtime ($3.18 in chips) 
Seat 3: MaksBanker ($1.99 in chips) 
Seat 4: hc agorist ($2.54 in chips) 
Seat 5: Druideholm ($2.49 in chips) 
Seat 6: Mistbaer ($2 in chips) 
stealtime: posts small blind $0.01
MaksBanker: posts big blind $0.02
*** HOLE CARDS ***
Dealt to hc agorist [Qs Jd]
hc agorist: raises $0.02 to $0.04
Druideholm: folds 
Mistbaer: folds 
fartovii232323: folds 
stealtime: folds 
MaksBanker: folds 
Uncalled bet ($0.02) returned to hc agorist
hc agorist collected $0.05 from pot
hc agorist: doesn't show hand 
*** SUMMARY ***
Total pot $0.05 | Rake $0 
Seat 1: fartovii232323 (button) folded before Flop (didn't bet)
Seat 2: stealtime (small blind) folded before Flop
Seat 3: MaksBanker (big blind) folded before Flop
Seat 4: hc agorist collected ($0.05)
Seat 5: Druideholm folded before Flop (didn't bet)
Seat 6: Mistbaer folded before Flop (didn't bet)



PokerStars Zoom Hand #193767594220:  Hold'em No Limit ($0.01/$0.02) - 2018/11/27 0:11:37 CUST [2018/11/26 11:11:37 ET]
Table 'Halley' 6-max Seat #1 is the button
Seat 1: boss477 ($5.56 in chips) 
Seat 2: sunnypanther ($2.53 in chips) 
Seat 3: hc agorist ($2.57 in chips) 
Seat 4: bezik9 ($2.20 in chips) 
Seat 5: Chameleon996 ($3.48 in chips) 
Seat 6: Lawrence$lim ($2.71 in chips) 
sunnypanther: posts small blind $0.01
hc agorist: posts big blind $0.02
*** HOLE CARDS ***
Dealt to hc agorist [8c 2h]
bezik9: calls $0.02
Chameleon996: raises $0.07 to $0.09
Lawrence$lim: folds 
boss477: calls $0.09
sunnypanther: folds 
hc agorist: folds 
bezik9: calls $0.07
*** FLOP *** [Jh 5h 5c]
bezik9: checks 
Chameleon996: bets $0.20
boss477: folds 
bezik9: folds 
Uncalled bet ($0.20) returned to Chameleon996
Chameleon996 collected $0.29 from pot
Chameleon996: doesn't show hand 
*** SUMMARY ***
Total pot $0.30 | Rake $0.01 
Board [Jh 5h 5c]
Seat 1: boss477 (button) folded on the Flop
Seat 2: sunnypanther (small blind) folded before Flop
Seat 3: hc agorist (big blind) folded before Flop
Seat 4: bezik9 folded on the Flop
Seat 5: Chameleon996 collected ($0.29)
Seat 6: Lawrence$lim folded before Flop (didn't bet)



PokerStars Zoom Hand #193767599068:  Hold'em No Limit ($0.01/$0.02) - 2018/11/27 0:11:46 CUST [2018/11/26 11:11:46 ET]
Table 'Halley' 6-max Seat #1 is the button
Seat 1: sergant201 ($2.80 in chips) 
Seat 2: markiz655 ($2.62 in chips) 
Seat 3: Karel33555 ($1.15 in chips) 
Seat 4: hc agorist ($2.55 in chips) 
Seat 5: fumina.k ($2.67 in chips) 
Seat 6: P.Cogito ($13.84 in chips) 
markiz655: posts small blind $0.01
Karel33555: posts big blind $0.02
*** HOLE CARDS ***
Dealt to hc agorist [3c 7c]
hc agorist: raises $0.02 to $0.04
fumina.k: folds 
P.Cogito: folds 
sergant201: calls $0.04
markiz655: folds 
Karel33555: calls $0.02
*** FLOP *** [Ac 9d 6s]
Karel33555: checks 
hc agorist: bets $0.05
sergant201: folds 
Karel33555: calls $0.05
*** TURN *** [Ac 9d 6s] [4c]
Karel33555: checks 
hc agorist: checks 
*** RIVER *** [Ac 9d 6s 4c] [8c]
Karel33555: checks 
hc agorist: bets $0.44
Karel33555: folds 
Uncalled bet ($0.44) returned to hc agorist
hc agorist collected $0.22 from pot
hc agorist: doesn't show hand 
*** SUMMARY ***
Total pot $0.23 | Rake $0.01 
Board [Ac 9d 6s 4c 8c]
Seat 1: sergant201 (button) folded on the Flop
Seat 2: markiz655 (small blind) folded before Flop
Seat 3: Karel33555 (big blind) folded on the River
Seat 4: hc agorist collected ($0.22)
Seat 5: fumina.k folded before Flop (didn't bet)
Seat 6: P.Cogito folded before Flop (didn't bet)



PokerStars Zoom Hand #193767624724:  Hold'em No Limit ($0.01/$0.02) - 2018/11/27 0:12:34 CUST [2018/11/26 11:12:34 ET]
Table 'Halley' 6-max Seat #1 is the button
Seat 1: hc agorist ($2.68 in chips) 
Seat 2: BoJi0313 ($2.37 in chips) 
Seat 3: wqd4 ($1.80 in chips) 
Seat 4: tchelos123 ($2.09 in chips) 
Seat 5: Gamer577 ($4.17 in chips) 
Seat 6: BuffmonsterOne ($2.53 in chips) 
BoJi0313: posts small blind $0.01
wqd4: posts big blind $0.02
*** HOLE CARDS ***
Dealt to hc agorist [2d 9c]
tchelos123: folds 
Gamer577: folds 
BuffmonsterOne: raises $0.03 to $0.05
hc agorist: folds 
BoJi0313: folds 
wqd4: folds 
Uncalled bet ($0.03) returned to BuffmonsterOne
BuffmonsterOne collected $0.05 from pot
BuffmonsterOne: doesn't show hand 
*** SUMMARY ***
Total pot $0.05 | Rake $0 
Seat 1: hc agorist (button) folded before Flop (didn't bet)
Seat 2: BoJi0313 (small blind) folded before Flop
Seat 3: wqd4 (big blind) folded before Flop
Seat 4: tchelos123 folded before Flop (didn't bet)
Seat 5: Gamer577 folded before Flop (didn't bet)
Seat 6: BuffmonsterOne collected ($0.05)



PokerStars Zoom Hand #193767629534:  Hold'em No Limit ($0.01/$0.02) - 2018/11/27 0:12:43 CUST [2018/11/26 11:12:43 ET]
Table 'Halley' 6-max Seat #1 is the button
Seat 1: Shatl555 ($0.44 in chips) 
Seat 2: hc agorist ($2.68 in chips) 
Seat 3: billymedin ($2.22 in chips) 
Seat 4: svetilium ($1.77 in chips) 
Seat 5: takpat ($1.69 in chips) 
Seat 6: 6markan65 ($4.27 in chips) 
hc agorist: posts small blind $0.01
billymedin: posts big blind $0.02
*** HOLE CARDS ***
Dealt to hc agorist [3c Jd]
svetilium: folds 
takpat: folds 
6markan65: folds 
Shatl555: folds 
hc agorist: folds 
Uncalled bet ($0.01) returned to billymedin
billymedin collected $0.02 from pot
billymedin: doesn't show hand 
*** SUMMARY ***
Total pot $0.02 | Rake $0 
Seat 1: Shatl555 (button) folded before Flop (didn't bet)
Seat 2: hc agorist (small blind) folded before Flop
Seat 3: billymedin (big blind) collected ($0.02)
Seat 4: svetilium folded before Flop (didn't bet)
Seat 5: takpat folded before Flop (didn't bet)
Seat 6: 6markan65 folded before Flop (didn't bet)



PokerStars Zoom Hand #193767634847:  Hold'em No Limit ($0.01/$0.02) - 2018/11/27 0:12:53 CUST [2018/11/26 11:12:53 ET]
Table 'Halley' 6-max Seat #1 is the button
Seat 1: varguitas84 ($2 in chips) 
Seat 2: Tanja214 ($2.77 in chips) 
Seat 3: ChingHsuanT ($2.22 in chips) 
Seat 4: Fun 1956 ($2 in chips) 
Seat 5: DoyaRED ($0.78 in chips) 
Seat 6: hc agorist ($2.67 in chips) 
Tanja214: posts small blind $0.01
ChingHsuanT: posts big blind $0.02
*** HOLE CARDS ***
Dealt to hc agorist [4h 6h]
Fun 1956: folds 
DoyaRED: folds 
hc agorist: raises $0.02 to $0.04
varguitas84: folds 
Tanja214: folds 
ChingHsuanT: folds 
Uncalled bet ($0.02) returned to hc agorist
hc agorist collected $0.05 from pot
hc agorist: doesn't show hand 
*** SUMMARY ***
Total pot $0.05 | Rake $0 
Seat 1: varguitas84 (button) folded before Flop (didn't bet)
Seat 2: Tanja214 (small blind) folded before Flop
Seat 3: ChingHsuanT (big blind) folded before Flop
Seat 4: Fun 1956 folded before Flop (didn't bet)
Seat 5: DoyaRED folded before Flop (didn't bet)
Seat 6: hc agorist collected ($0.05)



PokerStars Zoom Hand #193767647860:  Hold'em No Limit ($0.01/$0.02) - 2018/11/27 0:13:17 CUST [2018/11/26 11:13:17 ET]
Table 'Halley' 6-max Seat #1 is the button
Seat 1: booktable ($2.27 in chips) 
Seat 2: Zaakable ($2.04 in chips) 
Seat 3: tchelos123 ($2.63 in chips) 
Seat 4: KingIrish14 ($5.39 in chips) 
Seat 5: hc agorist ($2.68 in chips) 
Seat 6: markiz655 ($3.10 in chips) 
Zaakable: posts small blind $0.01
tchelos123: posts big blind $0.02
*** HOLE CARDS ***
Dealt to hc agorist [2c Jd]
KingIrish14: folds 
hc agorist: folds 
markiz655: folds 
booktable: folds 
Zaakable: folds 
Uncalled bet ($0.01) returned to tchelos123
tchelos123 collected $0.02 from pot
tchelos123: doesn't show hand 
*** SUMMARY ***
Total pot $0.02 | Rake $0 
Seat 1: booktable (button) folded before Flop (didn't bet)
Seat 2: Zaakable (small blind) folded before Flop
Seat 3: tchelos123 (big blind) collected ($0.02)
Seat 4: KingIrish14 folded before Flop (didn't bet)
Seat 5: hc agorist folded before Flop (didn't bet)
Seat 6: markiz655 folded before Flop (didn't bet)



PokerStars Zoom Hand #193767643526:  Hold'em No Limit ($0.01/$0.02) - 2018/11/27 0:13:09 CUST [2018/11/26 11:13:09 ET]
Table 'Halley' 6-max Seat #1 is the button
Seat 1: vagasstar ($1.14 in chips) 
Seat 2: NikWatt ($1.55 in chips) 
Seat 3: hc agorist ($2.70 in chips) 
Seat 4: kilingdude ($2.01 in chips) 
Seat 5: RECHUK ($2.38 in chips) 
Seat 6: amaposh ($2 in chips) 
NikWatt: posts small blind $0.01
hc agorist: posts big blind $0.02
*** HOLE CARDS ***
Dealt to hc agorist [6h Ts]
kilingdude: raises $0.03 to $0.05
RECHUK: folds 
amaposh: folds 
vagasstar: folds 
NikWatt: calls $0.04
hc agorist: folds 
*** FLOP *** [3h Jh 5s]
NikWatt: checks 
kilingdude: bets $0.08
NikWatt: folds 
Uncalled bet ($0.08) returned to kilingdude
kilingdude collected $0.12 from pot
kilingdude: doesn't show hand 
*** SUMMARY ***
Total pot $0.12 | Rake $0 
Board [3h Jh 5s]
Seat 1: vagasstar (button) folded before Flop (didn't bet)
Seat 2: NikWatt (small blind) folded on the Flop
Seat 3: hc agorist (big blind) folded before Flop
Seat 4: kilingdude collected ($0.12)
Seat 5: RECHUK folded before Flop (didn't bet)
Seat 6: amaposh folded before Flop (didn't bet)



PokerStars Zoom Hand #193767650553:  Hold'em No Limit ($0.01/$0.02) - 2018/11/27 0:13:22 CUST [2018/11/26 11:13:22 ET]
Table 'Halley' 6-max Seat #1 is the button
Seat 1: hc agorist ($2.68 in chips) 
Seat 2: BenGurionn ($2.20 in chips) 
Seat 3: N4tyN1ce ($2.38 in chips) 
Seat 4: dedmoroz311 ($2.13 in chips) 
Seat 5: Shuv-Oohl ($2.45 in chips) 
Seat 6: Mark141278 ($2.25 in chips) 
BenGurionn: posts small blind $0.01
N4tyN1ce: posts big blind $0.02
*** HOLE CARDS ***
Dealt to hc agorist [Ac 5c]
dedmoroz311: raises $0.02 to $0.04
Shuv-Oohl: folds 
Mark141278: folds 
hc agorist: calls $0.04
BenGurionn: folds 
N4tyN1ce: folds 
*** FLOP *** [Ks Qs Qc]
dedmoroz311: bets $0.02
hc agorist: calls $0.02
*** TURN *** [Ks Qs Qc] [4c]
dedmoroz311: bets $0.02
hc agorist: raises $0.18 to $0.20
dedmoroz311: folds 
Uncalled bet ($0.18) returned to hc agorist
hc agorist collected $0.18 from pot
hc agorist: doesn't show hand 
*** SUMMARY ***
Total pot $0.19 | Rake $0.01 
Board [Ks Qs Qc 4c]
Seat 1: hc agorist (button) collected ($0.18)
Seat 2: BenGurionn (small blind) folded before Flop
Seat 3: N4tyN1ce (big blind) folded before Flop
Seat 4: dedmoroz311 folded on the Turn
Seat 5: Shuv-Oohl folded before Flop (didn't bet)
Seat 6: Mark141278 folded before Flop (didn't bet)



PokerStars Zoom Hand #193767664135:  Hold'em No Limit ($0.01/$0.02) - 2018/11/27 0:13:47 CUST [2018/11/26 11:13:47 ET]
Table 'Halley' 6-max Seat #1 is the button
Seat 1: sukisurova ($2.55 in chips) 
Seat 2: Cobbler43 ($3.50 in chips) 
Seat 3: carita230 ($2.39 in chips) 
Seat 4: hc agorist ($2.78 in chips) 
Seat 5: Gerar NB ($3.41 in chips) 
Seat 6: varguitas84 ($2.01 in chips) 
Cobbler43: posts small blind $0.01
carita230: posts big blind $0.02
*** HOLE CARDS ***
Dealt to hc agorist [3h 8c]
hc agorist: folds 
Gerar NB: raises $0.04 to $0.06
varguitas84: folds 
sukisurova: folds 
Cobbler43: folds 
carita230: folds 
Uncalled bet ($0.04) returned to Gerar NB
Gerar NB collected $0.05 from pot
Gerar NB: doesn't show hand 
*** SUMMARY ***
Total pot $0.05 | Rake $0 
Seat 1: sukisurova (button) folded before Flop (didn't bet)
Seat 2: Cobbler43 (small blind) folded before Flop
Seat 3: carita230 (big blind) folded before Flop
Seat 4: hc agorist folded before Flop (didn't bet)
Seat 5: Gerar NB collected ($0.05)
Seat 6: varguitas84 folded before Flop (didn't bet)



PokerStars Zoom Hand #193767671099:  Hold'em No Limit ($0.01/$0.02) - 2018/11/27 0:14:00 CUST [2018/11/26 11:14:00 ET]
Table 'Halley' 6-max Seat #1 is the button
Seat 1: Treuteller ($1.97 in chips) 
Seat 2: Olga Berezina ($2 in chips) 
Seat 3: mi1zz ($2 in chips) 
Seat 4: Medved219 ($2.25 in chips) 
Seat 5: wise pok ($3.36 in chips) 
Seat 6: hc agorist ($2.77 in chips) 
Olga Berezina: posts small blind $0.01
mi1zz: posts big blind $0.02
*** HOLE CARDS ***
Dealt to hc agorist [9c Kd]
Medved219: folds 
wise pok: folds 
hc agorist: folds 
Treuteller: folds 
Olga Berezina: folds 
Uncalled bet ($0.01) returned to mi1zz
mi1zz collected $0.02 from pot
mi1zz: doesn't show hand 
*** SUMMARY ***
Total pot $0.02 | Rake $0 
Seat 1: Treuteller (button) folded before Flop (didn't bet)
Seat 2: Olga Berezina (small blind) folded before Flop
Seat 3: mi1zz (big blind) collected ($0.02)
Seat 4: Medved219 folded before Flop (didn't bet)
Seat 5: wise pok folded before Flop (didn't bet)
Seat 6: hc agorist folded before Flop (didn't bet)



PokerStars Zoom Hand #193767666764:  Hold'em No Limit ($0.01/$0.02) - 2018/11/27 0:13:52 CUST [2018/11/26 11:13:52 ET]
Table 'Halley' 6-max Seat #1 is the button
Seat 1: boislan ($2.90 in chips) 
Seat 2: hc agorist ($2.78 in chips) 
Seat 3: Shatl555 ($0.68 in chips) 
Seat 4: Roflpain ($3.39 in chips) 
Seat 5: Mizepa ($2.33 in chips) 
Seat 6: strimmm0 ($4.30 in chips) 
hc agorist: posts small blind $0.01
Shatl555: posts big blind $0.02
*** HOLE CARDS ***
Dealt to hc agorist [6c Ah]
Roflpain: raises $0.03 to $0.05
Mizepa: folds 
strimmm0: folds 
boislan: folds 
hc agorist: folds 
Shatl555: calls $0.03
*** FLOP *** [8h 7c Ac]
Shatl555: checks 
Roflpain: bets $0.07
Shatl555: folds 
Uncalled bet ($0.07) returned to Roflpain
Roflpain collected $0.11 from pot
Roflpain: doesn't show hand 
*** SUMMARY ***
Total pot $0.11 | Rake $0 
Board [8h 7c Ac]
Seat 1: boislan (button) folded before Flop (didn't bet)
Seat 2: hc agorist (small blind) folded before Flop
Seat 3: Shatl555 (big blind) folded on the Flop
Seat 4: Roflpain collected ($0.11)
Seat 5: Mizepa folded before Flop (didn't bet)
Seat 6: strimmm0 folded before Flop (didn't bet)



PokerStars Zoom Hand #193767673712:  Hold'em No Limit ($0.01/$0.02) - 2018/11/27 0:14:05 CUST [2018/11/26 11:14:05 ET]
Table 'Halley' 6-max Seat #1 is the button
Seat 1: Shuv-Oohl ($2.45 in chips) 
Seat 2: guitboxer ($4.57 in chips) 
Seat 3: DoyaRED ($0.71 in chips) 
Seat 4: lpk2 ($1.61 in chips) 
Seat 5: hc agorist ($2.77 in chips) 
Seat 6: Zaakable ($2.03 in chips) 
guitboxer: posts small blind $0.01
DoyaRED: posts big blind $0.02
*** HOLE CARDS ***
Dealt to hc agorist [Qd 2d]
lpk2: folds 
hc agorist: raises $0.02 to $0.04
Zaakable: folds 
Shuv-Oohl: folds 
guitboxer: folds 
DoyaRED: folds 
Uncalled bet ($0.02) returned to hc agorist
hc agorist collected $0.05 from pot
hc agorist: doesn't show hand 
*** SUMMARY ***
Total pot $0.05 | Rake $0 
Seat 1: Shuv-Oohl (button) folded before Flop (didn't bet)
Seat 2: guitboxer (small blind) folded before Flop
Seat 3: DoyaRED (big blind) folded before Flop
Seat 4: lpk2 folded before Flop (didn't bet)
Seat 5: hc agorist collected ($0.05)
Seat 6: Zaakable folded before Flop (didn't bet)



PokerStars Zoom Hand #193767683386:  Hold'em No Limit ($0.01/$0.02) - 2018/11/27 0:14:23 CUST [2018/11/26 11:14:23 ET]
Table 'Halley' 6-max Seat #1 is the button
Seat 1: Vajdalf92 ($2.17 in chips) 
Seat 2: I7ACI7APTY ($2.04 in chips) 
Seat 3: hc agorist ($2.80 in chips) 
Seat 4: bilibao ($1.60 in chips) 
Seat 5: Denellus ($2.58 in chips) 
Seat 6: Gollenz ($2.60 in chips) 
I7ACI7APTY: posts small blind $0.01
hc agorist: posts big blind $0.02
*** HOLE CARDS ***
Dealt to hc agorist [5c 5s]
bilibao: folds 
Denellus: folds 
Gollenz: raises $0.04 to $0.06
Vajdalf92: calls $0.06
I7ACI7APTY: folds 
hc agorist: calls $0.04
*** FLOP *** [7s 2h 9s]
hc agorist: checks 
Gollenz: checks 
Vajdalf92: checks 
*** TURN *** [7s 2h 9s] [Qc]
hc agorist: bets $0.18
Gollenz: folds 
Vajdalf92: folds 
Uncalled bet ($0.18) returned to hc agorist
hc agorist collected $0.18 from pot
hc agorist: doesn't show hand 
*** SUMMARY ***
Total pot $0.19 | Rake $0.01 
Board [7s 2h 9s Qc]
Seat 1: Vajdalf92 (button) folded on the Turn
Seat 2: I7ACI7APTY (small blind) folded before Flop
Seat 3: hc agorist (big blind) collected ($0.18)
Seat 4: bilibao folded before Flop (didn't bet)
Seat 5: Denellus folded before Flop (didn't bet)
Seat 6: Gollenz folded on the Turn



PokerStars Zoom Hand #193767698372:  Hold'em No Limit ($0.01/$0.02) - 2018/11/27 0:14:51 CUST [2018/11/26 11:14:51 ET]
Table 'Halley' 6-max Seat #1 is the button
Seat 1: ard14 ($3.12 in chips) 
Seat 2: hc agorist ($2.92 in chips) 
Seat 3: arezo69 ($2 in chips) 
Seat 4: Vinni 1675 ($0.91 in chips) 
Seat 5: meniasjo ($3.97 in chips) 
Seat 6: Papa_Prey ($2.93 in chips) 
hc agorist: posts small blind $0.01
arezo69: posts big blind $0.02
*** HOLE CARDS ***
Dealt to hc agorist [Qh Jc]
Vinni 1675: folds 
meniasjo: folds 
Papa_Prey: folds 
ard14: folds 
hc agorist: raises $0.02 to $0.04
arezo69: calls $0.02
*** FLOP *** [7h 2h Tc]
hc agorist: bets $0.06
arezo69: calls $0.06
*** TURN *** [7h 2h Tc] [Qs]
hc agorist: bets $0.14
arezo69: calls $0.14
*** RIVER *** [7h 2h Tc Qs] [Ad]
hc agorist: bets $0.16
arezo69: folds 
Uncalled bet ($0.16) returned to hc agorist
hc agorist collected $0.46 from pot
hc agorist: doesn't show hand 
*** SUMMARY ***
Total pot $0.48 | Rake $0.02 
Board [7h 2h Tc Qs Ad]
Seat 1: ard14 (button) folded before Flop (didn't bet)
Seat 2: hc agorist (small blind) collected ($0.46)
Seat 3: arezo69 (big blind) folded on the River
Seat 4: Vinni 1675 folded before Flop (didn't bet)
Seat 5: meniasjo folded before Flop (didn't bet)
Seat 6: Papa_Prey folded before Flop (didn't bet)



PokerStars Zoom Hand #193767740657:  Hold'em No Limit ($0.01/$0.02) - 2018/11/27 0:16:09 CUST [2018/11/26 11:16:09 ET]
Table 'Halley' 6-max Seat #1 is the button
Seat 1: hc agorist ($3.14 in chips) 
Seat 2: f44444 ($3.20 in chips) 
Seat 3: Loshkorev ($0.38 in chips) 
Seat 4: LaCasa15 ($2 in chips) 
Seat 5: alexrain600 ($3.42 in chips) 
Seat 6: ard14 ($2.94 in chips) 
f44444: posts small blind $0.01
Loshkorev: posts big blind $0.02
*** HOLE CARDS ***
Dealt to hc agorist [Kh Th]
LaCasa15: folds 
alexrain600: folds 
ard14: raises $0.03 to $0.05
hc agorist: raises $0.13 to $0.18
f44444: folds 
Loshkorev: folds 
ard14: calls $0.13
*** FLOP *** [Ts As 3c]
ard14: checks 
hc agorist: bets $0.13
ard14: calls $0.13
*** TURN *** [Ts As 3c] [Td]
ard14: checks 
hc agorist: bets $0.43
ard14: calls $0.43
*** RIVER *** [Ts As 3c Td] [Kd]
ard14: checks 
hc agorist: bets $2.40 and is all-in
ard14 said, "nice value"
ard14: folds 
Uncalled bet ($2.40) returned to hc agorist
hc agorist collected $1.46 from pot
hc agorist: doesn't show hand 
*** SUMMARY ***
Total pot $1.51 | Rake $0.05 
Board [Ts As 3c Td Kd]
Seat 1: hc agorist (button) collected ($1.46)
Seat 2: f44444 (small blind) folded before Flop
Seat 3: Loshkorev (big blind) folded before Flop
Seat 4: LaCasa15 folded before Flop (didn't bet)
Seat 5: alexrain600 folded before Flop (didn't bet)
Seat 6: ard14 folded on the River



PokerStars Zoom Hand #193767782795:  Hold'em No Limit ($0.01/$0.02) - 2018/11/27 0:17:26 CUST [2018/11/26 11:17:26 ET]
Table 'Halley' 6-max Seat #1 is the button
Seat 1: 78obender ($2 in chips) 
Seat 2: AnAxl ($2.91 in chips) 
Seat 3: deadmouse77 ($2.20 in chips) 
Seat 4: hc agorist ($3.86 in chips) 
Seat 5: xtp44_01b ($3.96 in chips) 
Seat 6: averzia ($2 in chips) 
AnAxl: posts small blind $0.01
deadmouse77: posts big blind $0.02
*** HOLE CARDS ***
Dealt to hc agorist [8c Th]
hc agorist: folds 
xtp44_01b: folds 
averzia: folds 
78obender: folds 
AnAxl: folds 
Uncalled bet ($0.01) returned to deadmouse77
deadmouse77 collected $0.02 from pot
deadmouse77: doesn't show hand 
*** SUMMARY ***
Total pot $0.02 | Rake $0 
Seat 1: 78obender (button) folded before Flop (didn't bet)
Seat 2: AnAxl (small blind) folded before Flop
Seat 3: deadmouse77 (big blind) collected ($0.02)
Seat 4: hc agorist folded before Flop (didn't bet)
Seat 5: xtp44_01b folded before Flop (didn't bet)
Seat 6: averzia folded before Flop (didn't bet)



PokerStars Zoom Hand #193767780103:  Hold'em No Limit ($0.01/$0.02) - 2018/11/27 0:17:21 CUST [2018/11/26 11:17:21 ET]
Table 'Halley' 6-max Seat #1 is the button
Seat 1: casanoastra ($0.62 in chips) 
Seat 2: Roflpain ($2.86 in chips) 
Seat 3: Treuteller ($2.12 in chips) 
Seat 4: ForHistory ($5.96 in chips) 
Seat 5: barrgand ($2.04 in chips) 
Seat 6: hc agorist ($3.86 in chips) 
Roflpain: posts small blind $0.01
Treuteller: posts big blind $0.02
*** HOLE CARDS ***
Dealt to hc agorist [8d 4c]
ForHistory: folds 
barrgand: folds 
hc agorist: folds 
casanoastra: calls $0.02
Roflpain: calls $0.01
Treuteller: checks 
*** FLOP *** [3h 3d Qc]
Roflpain: bets $0.05
Treuteller: folds 
casanoastra: folds 
Uncalled bet ($0.05) returned to Roflpain
Roflpain collected $0.06 from pot
Roflpain: doesn't show hand 
*** SUMMARY ***
Total pot $0.06 | Rake $0 
Board [3h 3d Qc]
Seat 1: casanoastra (button) folded on the Flop
Seat 2: Roflpain (small blind) collected ($0.06)
Seat 3: Treuteller (big blind) folded on the Flop
Seat 4: ForHistory folded before Flop (didn't bet)
Seat 5: barrgand folded before Flop (didn't bet)
Seat 6: hc agorist folded before Flop (didn't bet)



PokerStars Zoom Hand #193767786163:  Hold'em No Limit ($0.01/$0.02) - 2018/11/27 0:17:32 CUST [2018/11/26 11:17:32 ET]
Table 'Halley' 6-max Seat #1 is the button
Seat 1: gary01407 ($3.47 in chips) 
Seat 2: alex1148 ($1.37 in chips) 
Seat 3: ForHistory ($3.54 in chips) 
Seat 4: COURT JES264 ($2 in chips) 
Seat 5: hc agorist ($3.86 in chips) 
Seat 6: parhimka ($2 in chips) 
alex1148: posts small blind $0.01
ForHistory: posts big blind $0.02
*** HOLE CARDS ***
Dealt to hc agorist [Qc Jc]
COURT JES264: folds 
hc agorist: raises $0.02 to $0.04
parhimka: folds 
gary01407: folds 
alex1148: folds 
ForHistory: calls $0.02
*** FLOP *** [9c 4s Jh]
ForHistory: checks 
hc agorist: bets $0.07
ForHistory: folds 
Uncalled bet ($0.07) returned to hc agorist
hc agorist collected $0.09 from pot
hc agorist: doesn't show hand 
*** SUMMARY ***
Total pot $0.09 | Rake $0 
Board [9c 4s Jh]
Seat 1: gary01407 (button) folded before Flop (didn't bet)
Seat 2: alex1148 (small blind) folded before Flop
Seat 3: ForHistory (big blind) folded on the Flop
Seat 4: COURT JES264 folded before Flop (didn't bet)
Seat 5: hc agorist collected ($0.09)
Seat 6: parhimka folded before Flop (didn't bet)



PokerStars Zoom Hand #193767796598:  Hold'em No Limit ($0.01/$0.02) - 2018/11/27 0:17:51 CUST [2018/11/26 11:17:51 ET]
Table 'Halley' 6-max Seat #1 is the button
Seat 1: praxis321 ($2 in chips) 
Seat 2: sinster_ca85 ($3.73 in chips) 
Seat 3: hc agorist ($3.91 in chips) 
Seat 4: RealSage ($2.19 in chips) 
Seat 5: babohe1991 ($2.44 in chips) 
Seat 6: Rus. Pioneer ($2.41 in chips) 
sinster_ca85: posts small blind $0.01
hc agorist: posts big blind $0.02
*** HOLE CARDS ***
Dealt to hc agorist [Td 9d]
RealSage: folds 
babohe1991: folds 
Rus. Pioneer: folds 
praxis321: folds 
sinster_ca85: raises $0.03 to $0.05
hc agorist: calls $0.03
*** FLOP *** [As 8s Qd]
sinster_ca85: bets $0.05
hc agorist: calls $0.05
*** TURN *** [As 8s Qd] [Kc]
sinster_ca85: bets $0.10
hc agorist: raises $0.25 to $0.35
sinster_ca85: calls $0.25
*** RIVER *** [As 8s Qd Kc] [Jd]
sinster_ca85: checks 
hc agorist: bets $0.65
sinster_ca85: folds 
Uncalled bet ($0.65) returned to hc agorist
hc agorist collected $0.87 from pot
hc agorist: doesn't show hand 
*** SUMMARY ***
Total pot $0.90 | Rake $0.03 
Board [As 8s Qd Kc Jd]
Seat 1: praxis321 (button) folded before Flop (didn't bet)
Seat 2: sinster_ca85 (small blind) folded on the River
Seat 3: hc agorist (big blind) collected ($0.87)
Seat 4: RealSage folded before Flop (didn't bet)
Seat 5: babohe1991 folded before Flop (didn't bet)
Seat 6: Rus. Pioneer folded before Flop (didn't bet)



PokerStars Zoom Hand #193767834243:  Hold'em No Limit ($0.01/$0.02) - 2018/11/27 0:19:00 CUST [2018/11/26 11:19:00 ET]
Table 'Halley' 6-max Seat #1 is the button
Seat 1: hc agorist ($4.33 in chips) 
Seat 2: galonpiva ($2 in chips) 
Seat 3: Lawrence$lim ($2 in chips) 
Seat 4: nicemitya ($2.86 in chips) 
Seat 5: Jhaman1988 ($1.24 in chips) 
Seat 6: stupid_bear1 ($1.40 in chips) 
galonpiva: posts small blind $0.01
Lawrence$lim: posts big blind $0.02
*** HOLE CARDS ***
Dealt to hc agorist [9h 5s]
nicemitya: folds 
Jhaman1988: folds 
stupid_bear1: folds 
hc agorist: folds 
galonpiva: raises $0.04 to $0.06
Lawrence$lim: folds 
Uncalled bet ($0.04) returned to galonpiva
galonpiva collected $0.04 from pot
galonpiva: doesn't show hand 
*** SUMMARY ***
Total pot $0.04 | Rake $0 
Seat 1: hc agorist (button) folded before Flop (didn't bet)
Seat 2: galonpiva (small blind) collected ($0.04)
Seat 3: Lawrence$lim (big blind) folded before Flop
Seat 4: nicemitya folded before Flop (didn't bet)
Seat 5: Jhaman1988 folded before Flop (didn't bet)
Seat 6: stupid_bear1 folded before Flop (didn't bet)



PokerStars Zoom Hand #193767837516:  Hold'em No Limit ($0.01/$0.02) - 2018/11/27 0:19:06 CUST [2018/11/26 11:19:06 ET]
Table 'Halley' 6-max Seat #1 is the button
Seat 1: N4tyN1ce ($2 in chips) 
Seat 2: lmmunity ($1.54 in chips) 
Seat 3: Torso88 ($2.04 in chips) 
Seat 4: hc agorist ($4.33 in chips) 
Seat 5: KF Furiak ($1.98 in chips) 
Seat 6: rolyeah ($2.44 in chips) 
lmmunity: posts small blind $0.01
Torso88: posts big blind $0.02
*** HOLE CARDS ***
Dealt to hc agorist [Qs Jh]
hc agorist: raises $0.02 to $0.04
KF Furiak: raises $0.08 to $0.12
rolyeah: folds 
N4tyN1ce: folds 
lmmunity: folds 
Torso88: folds 
hc agorist: folds 
Uncalled bet ($0.08) returned to KF Furiak
KF Furiak collected $0.11 from pot
KF Furiak: doesn't show hand 
*** SUMMARY ***
Total pot $0.11 | Rake $0 
Seat 1: N4tyN1ce (button) folded before Flop (didn't bet)
Seat 2: lmmunity (small blind) folded before Flop
Seat 3: Torso88 (big blind) folded before Flop
Seat 4: hc agorist folded before Flop
Seat 5: KF Furiak collected ($0.11)
Seat 6: rolyeah folded before Flop (didn't bet)



PokerStars Zoom Hand #193767845182:  Hold'em No Limit ($0.01/$0.02) - 2018/11/27 0:19:20 CUST [2018/11/26 11:19:20 ET]
Table 'Halley' 6-max Seat #1 is the button
Seat 1: ard14 ($2 in chips) 
Seat 2: hc agorist ($4.29 in chips) 
Seat 3: d2009157 ($2.89 in chips) 
Seat 4: Tangros ($2.01 in chips) 
Seat 5: pocketfetish ($2 in chips) 
Seat 6: RealSage ($2 in chips) 
hc agorist: posts small blind $0.01
d2009157: posts big blind $0.02
*** HOLE CARDS ***
Dealt to hc agorist [6h 4d]
Tangros: folds 
pocketfetish: folds 
RealSage: folds 
ard14: raises $0.03 to $0.05
hc agorist: folds 
d2009157: folds 
Uncalled bet ($0.03) returned to ard14
ard14 collected $0.05 from pot
ard14: doesn't show hand 
*** SUMMARY ***
Total pot $0.05 | Rake $0 
Seat 1: ard14 (button) collected ($0.05)
Seat 2: hc agorist (small blind) folded before Flop
Seat 3: d2009157 (big blind) folded before Flop
Seat 4: Tangros folded before Flop (didn't bet)
Seat 5: pocketfetish folded before Flop (didn't bet)
Seat 6: RealSage folded before Flop (didn't bet)



PokerStars Zoom Hand #193767847867:  Hold'em No Limit ($0.01/$0.02) - 2018/11/27 0:19:25 CUST [2018/11/26 11:19:25 ET]
Table 'Halley' 6-max Seat #1 is the button
Seat 1: hc agorist ($4.28 in chips) 
Seat 2: JavierMaxter ($0.87 in chips) 
Seat 3: EI Niño9 ($0.74 in chips) 
Seat 4: francisflore ($4.30 in chips) 
Seat 5: BOB7bobo ($2 in chips) 
Seat 6: the_n3w3r_guy ($2.19 in chips) 
JavierMaxter: posts small blind $0.01
EI Niño9: posts big blind $0.02
*** HOLE CARDS ***
Dealt to hc agorist [Qc Kh]
francisflore: folds 
BOB7bobo: folds 
the_n3w3r_guy: folds 
hc agorist: raises $0.02 to $0.04
JavierMaxter: folds 
EI Niño9: folds 
Uncalled bet ($0.02) returned to hc agorist
hc agorist collected $0.05 from pot
hc agorist: doesn't show hand 
*** SUMMARY ***
Total pot $0.05 | Rake $0 
Seat 1: hc agorist (button) collected ($0.05)
Seat 2: JavierMaxter (small blind) folded before Flop
Seat 3: EI Niño9 (big blind) folded before Flop
Seat 4: francisflore folded before Flop (didn't bet)
Seat 5: BOB7bobo folded before Flop (didn't bet)
Seat 6: the_n3w3r_guy folded before Flop (didn't bet)



PokerStars Zoom Hand #193767857104:  Hold'em No Limit ($0.01/$0.02) - 2018/11/27 0:19:42 CUST [2018/11/26 11:19:42 ET]
Table 'Halley' 6-max Seat #1 is the button
Seat 1: stupid_bear1 ($1.37 in chips) 
Seat 2: Spi4ek ($1 in chips) 
Seat 3: markiz655 ($3.09 in chips) 
Seat 4: sukisurova ($2.22 in chips) 
Seat 5: hc agorist ($4.31 in chips) 
Seat 6: barrgand ($3.90 in chips) 
Spi4ek: posts small blind $0.01
markiz655: posts big blind $0.02
*** HOLE CARDS ***
Dealt to hc agorist [Ks Jc]
sukisurova: folds 
hc agorist: raises $0.02 to $0.04
barrgand: folds 
stupid_bear1: calls $0.04
Spi4ek: calls $0.03
markiz655: folds 
*** FLOP *** [Js 4c 4h]
Spi4ek: checks 
hc agorist: bets $0.05
stupid_bear1: folds 
Spi4ek: folds 
Uncalled bet ($0.05) returned to hc agorist
hc agorist collected $0.14 from pot
hc agorist: doesn't show hand 
*** SUMMARY ***
Total pot $0.14 | Rake $0 
Board [Js 4c 4h]
Seat 1: stupid_bear1 (button) folded on the Flop
Seat 2: Spi4ek (small blind) folded on the Flop
Seat 3: markiz655 (big blind) folded before Flop
Seat 4: sukisurova folded before Flop (didn't bet)
Seat 5: hc agorist collected ($0.14)
Seat 6: barrgand folded before Flop (didn't bet)



PokerStars Zoom Hand #193767853852:  Hold'em No Limit ($0.01/$0.02) - 2018/11/27 0:19:36 CUST [2018/11/26 11:19:36 ET]
Table 'Halley' 6-max Seat #1 is the button
Seat 1: wolfi 2013 ($3.59 in chips) 
Seat 2: V1p.504 ($2.76 in chips) 
Seat 3: azulut ($2 in chips) 
Seat 4: Coffeatus ($2.06 in chips) 
Seat 5: LaCasa15 ($2.80 in chips) 
Seat 6: hc agorist ($4.31 in chips) 
V1p.504: posts small blind $0.01
azulut: posts big blind $0.02
*** HOLE CARDS ***
Dealt to hc agorist [3d Tc]
Coffeatus: folds 
LaCasa15: folds 
hc agorist: folds 
wolfi 2013: folds 
V1p.504: raises $0.04 to $0.06
azulut: calls $0.04
*** FLOP *** [Qc Kd 9h]
V1p.504: bets $0.09
azulut: calls $0.09
*** TURN *** [Qc Kd 9h] [Ac]
V1p.504: bets $0.22
azulut: calls $0.22
*** RIVER *** [Qc Kd 9h Ac] [2c]
V1p.504: checks 
azulut: checks 
*** SHOW DOWN ***
V1p.504: shows [Jh Ad] (a pair of Aces)
azulut: shows [Js Ah] (a pair of Aces)
V1p.504 collected $0.36 from pot
azulut collected $0.35 from pot
*** SUMMARY ***
Total pot $0.74 | Rake $0.03 
Board [Qc Kd 9h Ac 2c]
Seat 1: wolfi 2013 (button) folded before Flop (didn't bet)
Seat 2: V1p.504 (small blind) showed [Jh Ad] and won ($0.36) with a pair of Aces
Seat 3: azulut (big blind) showed [Js Ah] and won ($0.35) with a pair of Aces
Seat 4: Coffeatus folded before Flop (didn't bet)
Seat 5: LaCasa15 folded before Flop (didn't bet)
Seat 6: hc agorist folded before Flop (didn't bet)



PokerStars Zoom Hand #193767873979:  Hold'em No Limit ($0.01/$0.02) - 2018/11/27 0:20:13 CUST [2018/11/26 11:20:13 ET]
Table 'Halley' 6-max Seat #1 is the button
Seat 1: Rus. Pioneer ($4.33 in chips) 
Seat 2: KF Furiak ($2.27 in chips) 
Seat 3: denstronk ($2.71 in chips) 
Seat 4: hc agorist ($4.41 in chips) 
Seat 5: alexps922 ($3.36 in chips) 
Seat 6: Mizepa ($2 in chips) 
KF Furiak: posts small blind $0.01
denstronk: posts big blind $0.02
*** HOLE CARDS ***
Dealt to hc agorist [8d Kd]
hc agorist: raises $0.02 to $0.04
alexps922: folds 
Mizepa: raises $0.11 to $0.15
Rus. Pioneer: folds 
KF Furiak: folds 
denstronk: folds 
hc agorist: folds 
Uncalled bet ($0.11) returned to Mizepa
Mizepa collected $0.11 from pot
Mizepa: doesn't show hand 
*** SUMMARY ***
Total pot $0.11 | Rake $0 
Seat 1: Rus. Pioneer (button) folded before Flop (didn't bet)
Seat 2: KF Furiak (small blind) folded before Flop
Seat 3: denstronk (big blind) folded before Flop
Seat 4: hc agorist folded before Flop
Seat 5: alexps922 folded before Flop (didn't bet)
Seat 6: Mizepa collected ($0.11)



PokerStars Zoom Hand #193767884446:  Hold'em No Limit ($0.01/$0.02) - 2018/11/27 0:20:32 CUST [2018/11/26 11:20:32 ET]
Table 'Halley' 6-max Seat #1 is the button
Seat 1: id11739 ($3.12 in chips) 
Seat 2: JBD101 ($5.01 in chips) 
Seat 3: hc agorist ($4.37 in chips) 
Seat 4: HareKrosh ($1.31 in chips) 
Seat 5: neo1200 ($3.66 in chips) 
Seat 6: Mark141278 ($3.20 in chips) 
JBD101: posts small blind $0.01
hc agorist: posts big blind $0.02
*** HOLE CARDS ***
Dealt to hc agorist [Kd 5h]
HareKrosh: folds 
neo1200: folds 
Mark141278: folds 
id11739: raises $0.02 to $0.04
JBD101: folds 
hc agorist: folds 
Uncalled bet ($0.02) returned to id11739
id11739 collected $0.05 from pot
id11739: doesn't show hand 
*** SUMMARY ***
Total pot $0.05 | Rake $0 
Seat 1: id11739 (button) collected ($0.05)
Seat 2: JBD101 (small blind) folded before Flop
Seat 3: hc agorist (big blind) folded before Flop
Seat 4: HareKrosh folded before Flop (didn't bet)
Seat 5: neo1200 folded before Flop (didn't bet)
Seat 6: Mark141278 folded before Flop (didn't bet)



PokerStars Zoom Hand #193767890560:  Hold'em No Limit ($0.01/$0.02) - 2018/11/27 0:20:43 CUST [2018/11/26 11:20:43 ET]
Table 'Halley' 6-max Seat #1 is the button
Seat 1: Hylwmhyl ($1.61 in chips) 
Seat 2: pocketfetish ($5.24 in chips) 
Seat 3: degelcamus ($7.63 in chips) 
Seat 4: Roflpain ($7.12 in chips) 
Seat 5: hc agorist ($4.35 in chips) 
Seat 6: Richochet79 ($3.01 in chips) 
pocketfetish: posts small blind $0.01
degelcamus: posts big blind $0.02
*** HOLE CARDS ***
Dealt to hc agorist [7d 9h]
Roflpain: folds 
hc agorist: folds 
Richochet79: folds 
Hylwmhyl: folds 
pocketfetish: raises $0.03 to $0.05
degelcamus: calls $0.03
*** FLOP *** [4d Td Ad]
pocketfetish: checks 
degelcamus: bets $0.03
pocketfetish: folds 
Uncalled bet ($0.03) returned to degelcamus
degelcamus collected $0.10 from pot
degelcamus: doesn't show hand 
*** SUMMARY ***
Total pot $0.10 | Rake $0 
Board [4d Td Ad]
Seat 1: Hylwmhyl (button) folded before Flop (didn't bet)
Seat 2: pocketfetish (small blind) folded on the Flop
Seat 3: degelcamus (big blind) collected ($0.10)
Seat 4: Roflpain folded before Flop (didn't bet)
Seat 5: hc agorist folded before Flop (didn't bet)
Seat 6: Richochet79 folded before Flop (didn't bet)



PokerStars Zoom Hand #193767898805:  Hold'em No Limit ($0.01/$0.02) - 2018/11/27 0:20:58 CUST [2018/11/26 11:20:58 ET]
Table 'Halley' 6-max Seat #1 is the button
Seat 1: mine4sure ($2 in chips) 
Seat 2: marcelim12 ($2.07 in chips) 
Seat 3: liryka ($2.34 in chips) 
Seat 4: hc agorist ($4.34 in chips) 
Seat 5: domitorii ($2 in chips) 
Seat 6: Lehavorkuta ($2.34 in chips) 
marcelim12: posts small blind $0.01
liryka: posts big blind $0.02
*** HOLE CARDS ***
Dealt to hc agorist [8c 5h]
hc agorist: folds 
domitorii: raises $0.04 to $0.06
Lehavorkuta: folds 
mine4sure: folds 
marcelim12: folds 
liryka: folds 
Uncalled bet ($0.04) returned to domitorii
domitorii collected $0.05 from pot
domitorii: doesn't show hand 
*** SUMMARY ***
Total pot $0.05 | Rake $0 
Seat 1: mine4sure (button) folded before Flop (didn't bet)
Seat 2: marcelim12 (small blind) folded before Flop
Seat 3: liryka (big blind) folded before Flop
Seat 4: hc agorist folded before Flop (didn't bet)
Seat 5: domitorii collected ($0.05)
Seat 6: Lehavorkuta folded before Flop (didn't bet)



PokerStars Zoom Hand #193767903813:  Hold'em No Limit ($0.01/$0.02) - 2018/11/27 0:21:07 CUST [2018/11/26 11:21:07 ET]
Table 'Halley' 6-max Seat #1 is the button
Seat 1: hc agorist ($4.34 in chips) 
Seat 2: 2.Versuch140 ($2.54 in chips) 
Seat 3: MaximGusev ($4.13 in chips) 
Seat 4: TT7emuR ($0.94 in chips) 
Seat 5: mischlott ($1.44 in chips) 
Seat 6: Leetch82 ($2.17 in chips) 
2.Versuch140: posts small blind $0.01
MaximGusev: posts big blind $0.02
*** HOLE CARDS ***
Dealt to hc agorist [Jc 7d]
TT7emuR: folds 
mischlott: folds 
Leetch82: folds 
hc agorist: folds 
2.Versuch140: raises $0.04 to $0.06
MaximGusev: folds 
Uncalled bet ($0.04) returned to 2.Versuch140
2.Versuch140 collected $0.04 from pot
2.Versuch140: doesn't show hand 
*** SUMMARY ***
Total pot $0.04 | Rake $0 
Seat 1: hc agorist (button) folded before Flop (didn't bet)
Seat 2: 2.Versuch140 (small blind) collected ($0.04)
Seat 3: MaximGusev (big blind) folded before Flop
Seat 4: TT7emuR folded before Flop (didn't bet)
Seat 5: mischlott folded before Flop (didn't bet)
Seat 6: Leetch82 folded before Flop (didn't bet)



PokerStars Zoom Hand #193767893289:  Hold'em No Limit ($0.01/$0.02) - 2018/11/27 0:20:48 CUST [2018/11/26 11:20:48 ET]
Table 'Halley' 6-max Seat #1 is the button
Seat 1: odinsmith41 ($2.47 in chips) 
Seat 2: hc agorist ($4.35 in chips) 
Seat 3: wqd4 ($0.68 in chips) 
Seat 4: Unconform ($2.12 in chips) 
Seat 5: Andrey Kuz50 ($1 in chips) 
Seat 6: luther96 ($3.19 in chips) 
hc agorist: posts small blind $0.01
wqd4: posts big blind $0.02
*** HOLE CARDS ***
Dealt to hc agorist [3h 7s]
Unconform: folds 
Andrey Kuz50: raises $0.04 to $0.06
luther96: folds 
odinsmith41: folds 
hc agorist: folds 
wqd4: raises $0.62 to $0.68 and is all-in
Andrey Kuz50: calls $0.62
*** FLOP *** [2d Ah 5h]
*** TURN *** [2d Ah 5h] [2c]
*** RIVER *** [2d Ah 5h 2c] [3c]
*** SHOW DOWN ***
wqd4: shows [Th Ad] (two pair, Aces and Deuces)
Andrey Kuz50: shows [6d 6c] (two pair, Sixes and Deuces)
wqd4 collected $1.32 from pot
*** SUMMARY ***
Total pot $1.37 | Rake $0.05 
Board [2d Ah 5h 2c 3c]
Seat 1: odinsmith41 (button) folded before Flop (didn't bet)
Seat 2: hc agorist (small blind) folded before Flop
Seat 3: wqd4 (big blind) showed [Th Ad] and won ($1.32) with two pair, Aces and Deuces
Seat 4: Unconform folded before Flop (didn't bet)
Seat 5: Andrey Kuz50 showed [6d 6c] and lost with two pair, Sixes and Deuces
Seat 6: luther96 folded before Flop (didn't bet)



PokerStars Zoom Hand #193767906518:  Hold'em No Limit ($0.01/$0.02) - 2018/11/27 0:21:12 CUST [2018/11/26 11:21:12 ET]
Table 'Halley' 6-max Seat #1 is the button
Seat 1: MiuFuringi ($2.05 in chips) 
Seat 2: to1R ($2.12 in chips) 
Seat 3: TIBURONA349 ($2 in chips) 
Seat 4: SeaWolfff ($2.20 in chips) 
Seat 5: alisk0 ($1.79 in chips) 
Seat 6: hc agorist ($4.34 in chips) 
to1R: posts small blind $0.01
TIBURONA349: posts big blind $0.02
*** HOLE CARDS ***
Dealt to hc agorist [9s Tc]
SeaWolfff: folds 
alisk0 has timed out
alisk0: folds 
hc agorist: raises $0.02 to $0.04
MiuFuringi: folds 
to1R: folds 
TIBURONA349: folds 
Uncalled bet ($0.02) returned to hc agorist
hc agorist collected $0.05 from pot
hc agorist: doesn't show hand 
*** SUMMARY ***
Total pot $0.05 | Rake $0 
Seat 1: MiuFuringi (button) folded before Flop (didn't bet)
Seat 2: to1R (small blind) folded before Flop
Seat 3: TIBURONA349 (big blind) folded before Flop
Seat 4: SeaWolfff folded before Flop (didn't bet)
Seat 5: alisk0 folded before Flop (didn't bet)
Seat 6: hc agorist collected ($0.05)



PokerStars Zoom Hand #193767942101:  Hold'em No Limit ($0.01/$0.02) - 2018/11/27 0:22:16 CUST [2018/11/26 11:22:16 ET]
Table 'Halley' 6-max Seat #1 is the button
Seat 1: BOB7bobo ($2.46 in chips) 
Seat 2: nonsensever ($3.10 in chips) 
Seat 3: Vajdalf92 ($2 in chips) 
Seat 4: hc agorist ($4.37 in chips) 
Seat 5: Heliodabest ($2.08 in chips) 
Seat 6: SharkBoy1994 ($2.83 in chips) 
nonsensever: posts small blind $0.01
Vajdalf92: posts big blind $0.02
*** HOLE CARDS ***
Dealt to hc agorist [9c 6h]
hc agorist: folds 
Heliodabest: folds 
SharkBoy1994: raises $0.04 to $0.06
BOB7bobo: folds 
nonsensever: folds 
Vajdalf92: folds 
Uncalled bet ($0.04) returned to SharkBoy1994
SharkBoy1994 collected $0.05 from pot
SharkBoy1994: doesn't show hand 
*** SUMMARY ***
Total pot $0.05 | Rake $0 
Seat 1: BOB7bobo (button) folded before Flop (didn't bet)
Seat 2: nonsensever (small blind) folded before Flop
Seat 3: Vajdalf92 (big blind) folded before Flop
Seat 4: hc agorist folded before Flop (didn't bet)
Seat 5: Heliodabest folded before Flop (didn't bet)
Seat 6: SharkBoy1994 collected ($0.05)



PokerStars Zoom Hand #193767944795:  Hold'em No Limit ($0.01/$0.02) - 2018/11/27 0:22:21 CUST [2018/11/26 11:22:21 ET]
Table 'Halley' 6-max Seat #1 is the button
Seat 1: tehBlub ($2.84 in chips) 
Seat 2: idkhowtoplaypkr ($3.92 in chips) 
Seat 3: hc agorist ($4.37 in chips) 
Seat 4: markiz655 ($2.10 in chips) 
Seat 5: kenjisiroma ($1.39 in chips) 
Seat 6: to1R ($2.07 in chips) 
idkhowtoplaypkr: posts small blind $0.01
hc agorist: posts big blind $0.02
*** HOLE CARDS ***
Dealt to hc agorist [Qd 4c]
markiz655: folds 
kenjisiroma: calls $0.02
to1R: folds 
tehBlub: folds 
idkhowtoplaypkr: calls $0.01
hc agorist: checks 
*** FLOP *** [7c 9h 7h]
idkhowtoplaypkr: bets $0.16
hc agorist: folds 
kenjisiroma: calls $0.16
*** TURN *** [7c 9h 7h] [Kd]
idkhowtoplaypkr: bets $0.14
kenjisiroma: raises $1.07 to $1.21 and is all-in
idkhowtoplaypkr: calls $1.07
*** RIVER *** [7c 9h 7h Kd] [3d]
*** SHOW DOWN ***
idkhowtoplaypkr: shows [7d 4s] (three of a kind, Sevens)
kenjisiroma: shows [Qh 8h] (a pair of Sevens)
idkhowtoplaypkr collected $2.70 from pot
*** SUMMARY ***
Total pot $2.80 | Rake $0.10 
Board [7c 9h 7h Kd 3d]
Seat 1: tehBlub (button) folded before Flop (didn't bet)
Seat 2: idkhowtoplaypkr (small blind) showed [7d 4s] and won ($2.70) with three of a kind, Sevens
Seat 3: hc agorist (big blind) folded on the Flop
Seat 4: markiz655 folded before Flop (didn't bet)
Seat 5: kenjisiroma showed [Qh 8h] and lost with a pair of Sevens
Seat 6: to1R folded before Flop (didn't bet)



PokerStars Zoom Hand #193767957601:  Hold'em No Limit ($0.01/$0.02) - 2018/11/27 0:22:44 CUST [2018/11/26 11:22:44 ET]
Table 'Halley' 6-max Seat #1 is the button
Seat 1: rolyeah ($2.03 in chips) 
Seat 2: hc agorist ($4.35 in chips) 
Seat 3: Br0@dw@y ($2.88 in chips) 
Seat 4: NoobPrix ($4.54 in chips) 
Seat 5: ANRI11101988 ($1.09 in chips) 
Seat 6: Ag_nyan ($1.95 in chips) 
hc agorist: posts small blind $0.01
Br0@dw@y: posts big blind $0.02
*** HOLE CARDS ***
Dealt to hc agorist [Kh 9s]
NoobPrix: raises $0.04 to $0.06
ANRI11101988: calls $0.06
Ag_nyan: folds 
rolyeah: folds 
hc agorist: folds 
Br0@dw@y: calls $0.04
*** FLOP *** [5s 3h 7c]
Br0@dw@y: bets $0.09
NoobPrix: calls $0.09
ANRI11101988: folds 
*** TURN *** [5s 3h 7c] [7s]
Br0@dw@y: bets $0.18
NoobPrix: raises $0.22 to $0.40
Br0@dw@y: raises $0.22 to $0.62
NoobPrix: calls $0.22
*** RIVER *** [5s 3h 7c 7s] [Th]
Br0@dw@y: bets $0.78
NoobPrix: folds 
Uncalled bet ($0.78) returned to Br0@dw@y
Br0@dw@y collected $1.55 from pot
Br0@dw@y: doesn't show hand 
*** SUMMARY ***
Total pot $1.61 | Rake $0.06 
Board [5s 3h 7c 7s Th]
Seat 1: rolyeah (button) folded before Flop (didn't bet)
Seat 2: hc agorist (small blind) folded before Flop
Seat 3: Br0@dw@y (big blind) collected ($1.55)
Seat 4: NoobPrix folded on the River
Seat 5: ANRI11101988 folded on the Flop
Seat 6: Ag_nyan folded before Flop (didn't bet)



PokerStars Zoom Hand #193767962071:  Hold'em No Limit ($0.01/$0.02) - 2018/11/27 0:22:52 CUST [2018/11/26 11:22:52 ET]
Table 'Halley' 6-max Seat #1 is the button
Seat 1: ForHistory ($3.59 in chips) 
Seat 2: don_energo2 ($2 in chips) 
Seat 3: kaspwell ($3.32 in chips) 
Seat 4: sems3 ($0.92 in chips) 
Seat 5: Lawrence$lim ($2 in chips) 
Seat 6: hc agorist ($4.34 in chips) 
don_energo2: posts small blind $0.01
kaspwell: posts big blind $0.02
*** HOLE CARDS ***
Dealt to hc agorist [Ah As]
sems3: raises $0.02 to $0.04
Lawrence$lim: folds 
hc agorist: raises $0.11 to $0.15
ForHistory: calls $0.15
don_energo2: folds 
kaspwell: calls $0.13
sems3: folds 
*** FLOP *** [9c 3s 7h]
kaspwell: checks 
hc agorist: bets $0.28
ForHistory: calls $0.28
kaspwell: folds 
*** TURN *** [9c 3s 7h] [2s]
hc agorist: checks 
ForHistory: bets $0.64
hc agorist: calls $0.64
*** RIVER *** [9c 3s 7h 2s] [Jc]
hc agorist: checks 
ForHistory: bets $1.72
hc agorist: calls $1.72
*** SHOW DOWN ***
ForHistory: shows [9s 9d] (three of a kind, Nines)
hc agorist: mucks hand 
ForHistory collected $5.58 from pot
*** SUMMARY ***
Total pot $5.78 | Rake $0.20 
Board [9c 3s 7h 2s Jc]
Seat 1: ForHistory (button) showed [9s 9d] and won ($5.58) with three of a kind, Nines
Seat 2: don_energo2 (small blind) folded before Flop
Seat 3: kaspwell (big blind) folded on the Flop
Seat 4: sems3 folded before Flop
Seat 5: Lawrence$lim folded before Flop (didn't bet)
Seat 6: hc agorist mucked [Ah As]



PokerStars Zoom Hand #193768009847:  Hold'em No Limit ($0.01/$0.02) - 2018/11/27 0:24:18 CUST [2018/11/26 11:24:18 ET]
Table 'Halley' 6-max Seat #1 is the button
Seat 1: Medved219 ($2.31 in chips) 
Seat 2: Davo111111 ($2.81 in chips) 
Seat 3: koribut ($2 in chips) 
Seat 4: bolita8587 ($7.78 in chips) 
Seat 5: hc agorist ($1.55 in chips) 
Seat 6: felakers ($2.01 in chips) 
Davo111111: posts small blind $0.01
koribut: posts big blind $0.02
*** HOLE CARDS ***
Dealt to hc agorist [Qh 6c]
bolita8587: folds 
hc agorist: folds 
felakers: folds 
Medved219: raises $0.02 to $0.04
Davo111111: raises $0.02 to $0.06
koribut: folds 
Medved219: calls $0.02
*** FLOP *** [Ah 6s 3d]
Davo111111: checks 
Medved219: checks 
*** TURN *** [Ah 6s 3d] [7s]
Davo111111: checks 
Medved219: bets $0.11
Davo111111: folds 
Uncalled bet ($0.11) returned to Medved219
Medved219 collected $0.14 from pot
Medved219: doesn't show hand 
*** SUMMARY ***
Total pot $0.14 | Rake $0 
Board [Ah 6s 3d 7s]
Seat 1: Medved219 (button) collected ($0.14)
Seat 2: Davo111111 (small blind) folded on the Turn
Seat 3: koribut (big blind) folded before Flop
Seat 4: bolita8587 folded before Flop (didn't bet)
Seat 5: hc agorist folded before Flop (didn't bet)
Seat 6: felakers folded before Flop (didn't bet)



PokerStars Zoom Hand #193768013605:  Hold'em No Limit ($0.01/$0.02) - 2018/11/27 0:24:25 CUST [2018/11/26 11:24:25 ET]
Table 'Halley' 6-max Seat #1 is the button
Seat 1: Vahenta ($9.85 in chips) 
Seat 2: stano5 ($2.17 in chips) 
Seat 3: hc agorist ($1.55 in chips) 
Seat 4: BOB7bobo ($3.92 in chips) 
Seat 5: dawidstr ($2 in chips) 
Seat 6: marcelim12 ($2.01 in chips) 
stano5: posts small blind $0.01
hc agorist: posts big blind $0.02
*** HOLE CARDS ***
Dealt to hc agorist [9c Th]
BOB7bobo: folds 
dawidstr: folds 
marcelim12: folds 
Vahenta: raises $0.02 to $0.04
stano5: raises $0.08 to $0.12
hc agorist: calls $0.10
Vahenta: folds 
*** FLOP *** [8h 5h 5d]
stano5: checks 
hc agorist: bets $0.09
stano5: folds 
Uncalled bet ($0.09) returned to hc agorist
hc agorist collected $0.27 from pot
hc agorist: doesn't show hand 
*** SUMMARY ***
Total pot $0.28 | Rake $0.01 
Board [8h 5h 5d]
Seat 1: Vahenta (button) folded before Flop
Seat 2: stano5 (small blind) folded on the Flop
Seat 3: hc agorist (big blind) collected ($0.27)
Seat 4: BOB7bobo folded before Flop (didn't bet)
Seat 5: dawidstr folded before Flop (didn't bet)
Seat 6: marcelim12 folded before Flop (didn't bet)



PokerStars Zoom Hand #193768038290:  Hold'em No Limit ($0.01/$0.02) - 2018/11/27 0:25:10 CUST [2018/11/26 11:25:10 ET]
Table 'Halley' 6-max Seat #1 is the button
Seat 1: kisté ($3.09 in chips) 
Seat 2: hc agorist ($1.70 in chips) 
Seat 3: Oswaldoja ($2.20 in chips) 
Seat 4: Bhz2905 ($2.20 in chips) 
Seat 5: pruxaxa ($2.94 in chips) 
Seat 6: naimscorp ($1.88 in chips) 
hc agorist: posts small blind $0.01
Oswaldoja: posts big blind $0.02
*** HOLE CARDS ***
Dealt to hc agorist [7s 4s]
Bhz2905: folds 
pruxaxa: folds 
naimscorp: folds 
kisté: raises $0.04 to $0.06
hc agorist: raises $0.14 to $0.20
Oswaldoja: folds 
kisté: folds 
Uncalled bet ($0.14) returned to hc agorist
hc agorist collected $0.14 from pot
hc agorist: doesn't show hand 
*** SUMMARY ***
Total pot $0.14 | Rake $0 
Seat 1: kisté (button) folded before Flop
Seat 2: hc agorist (small blind) collected ($0.14)
Seat 3: Oswaldoja (big blind) folded before Flop
Seat 4: Bhz2905 folded before Flop (didn't bet)
Seat 5: pruxaxa folded before Flop (didn't bet)
Seat 6: naimscorp folded before Flop (didn't bet)



PokerStars Zoom Hand #193768052149:  Hold'em No Limit ($0.01/$0.02) - 2018/11/27 0:25:35 CUST [2018/11/26 11:25:35 ET]
Table 'Halley' 6-max Seat #1 is the button
Seat 1: hc agorist ($1.78 in chips) 
Seat 2: MR.xvxvxv ($1.29 in chips) 
Seat 3: macmac399 ($2.98 in chips) 
Seat 4: charlesws25 ($6.56 in chips) 
Seat 5: Kyle1998s ($2.65 in chips) 
Seat 6: koribut ($2 in chips) 
MR.xvxvxv: posts small blind $0.01
macmac399: posts big blind $0.02
*** HOLE CARDS ***
Dealt to hc agorist [Qs Jc]
charlesws25: folds 
Kyle1998s: folds 
koribut: folds 
hc agorist: raises $0.02 to $0.04
MR.xvxvxv: folds 
macmac399: folds 
Uncalled bet ($0.02) returned to hc agorist
hc agorist collected $0.05 from pot
hc agorist: doesn't show hand 
*** SUMMARY ***
Total pot $0.05 | Rake $0 
Seat 1: hc agorist (button) collected ($0.05)
Seat 2: MR.xvxvxv (small blind) folded before Flop
Seat 3: macmac399 (big blind) folded before Flop
Seat 4: charlesws25 folded before Flop (didn't bet)
Seat 5: Kyle1998s folded before Flop (didn't bet)
Seat 6: koribut folded before Flop (didn't bet)



PokerStars Zoom Hand #193768059948:  Hold'em No Limit ($0.01/$0.02) - 2018/11/27 0:25:49 CUST [2018/11/26 11:25:49 ET]
Table 'Halley' 6-max Seat #1 is the button
Seat 1: grajekTeo ($4.17 in chips) 
Seat 2: d2009157 ($2.72 in chips) 
Seat 3: xiazhen ($2.09 in chips) 
Seat 4: markiz655 ($3.29 in chips) 
Seat 5: anitisqui ($2.06 in chips) 
Seat 6: hc agorist ($1.81 in chips) 
d2009157: posts small blind $0.01
xiazhen: posts big blind $0.02
*** HOLE CARDS ***
Dealt to hc agorist [7s Kd]
markiz655: folds 
anitisqui: raises $0.03 to $0.05
hc agorist: folds 
grajekTeo: folds 
d2009157: folds 
xiazhen: folds 
Uncalled bet ($0.03) returned to anitisqui
anitisqui collected $0.05 from pot
anitisqui: doesn't show hand 
*** SUMMARY ***
Total pot $0.05 | Rake $0 
Seat 1: grajekTeo (button) folded before Flop (didn't bet)
Seat 2: d2009157 (small blind) folded before Flop
Seat 3: xiazhen (big blind) folded before Flop
Seat 4: markiz655 folded before Flop (didn't bet)
Seat 5: anitisqui collected ($0.05)
Seat 6: hc agorist folded before Flop (didn't bet)



PokerStars Zoom Hand #193768062698:  Hold'em No Limit ($0.01/$0.02) - 2018/11/27 0:25:54 CUST [2018/11/26 11:25:54 ET]
Table 'Halley' 6-max Seat #1 is the button
Seat 1: pruxaxa ($2.48 in chips) 
Seat 2: penzkocsi ($2.45 in chips) 
Seat 3: SKFin ($3.38 in chips) 
Seat 4: deadmouse77 ($1.97 in chips) 
Seat 5: hc agorist ($1.81 in chips) 
Seat 6: CuttingCobra ($2 in chips) 
penzkocsi: posts small blind $0.01
SKFin: posts big blind $0.02
*** HOLE CARDS ***
Dealt to hc agorist [4c 2h]
deadmouse77: folds 
hc agorist: folds 
CuttingCobra: raises $0.04 to $0.06
pruxaxa: raises $0.04 to $0.10
penzkocsi: folds 
SKFin: folds 
CuttingCobra: calls $0.04
*** FLOP *** [6s Kd Ks]
CuttingCobra: checks 
pruxaxa: bets $0.11
CuttingCobra: folds 
Uncalled bet ($0.11) returned to pruxaxa
pruxaxa collected $0.22 from pot
pruxaxa: doesn't show hand 
*** SUMMARY ***
Total pot $0.23 | Rake $0.01 
Board [6s Kd Ks]
Seat 1: pruxaxa (button) collected ($0.22)
Seat 2: penzkocsi (small blind) folded before Flop
Seat 3: SKFin (big blind) folded before Flop
Seat 4: deadmouse77 folded before Flop (didn't bet)
Seat 5: hc agorist folded before Flop (didn't bet)
Seat 6: CuttingCobra folded on the Flop



PokerStars Zoom Hand #193768077186:  Hold'em No Limit ($0.01/$0.02) - 2018/11/27 0:26:20 CUST [2018/11/26 11:26:20 ET]
Table 'Halley' 6-max Seat #1 is the button
Seat 1: domitorii ($2 in chips) 
Seat 2: hc agorist ($1.79 in chips) 
Seat 3: strimmm0 ($14.90 in chips) 
Seat 4: sickman7 ($3.39 in chips) 
Seat 5: koribut ($2 in chips) 
Seat 6: stano5 ($2.02 in chips) 
hc agorist: posts small blind $0.01
strimmm0: posts big blind $0.02
*** HOLE CARDS ***
Dealt to hc agorist [Ah 2d]
sickman7: raises $0.04 to $0.06
koribut: folds 
stano5: folds 
domitorii: folds 
hc agorist: folds 
strimmm0: calls $0.04
*** FLOP *** [8s 6c 9d]
strimmm0: checks 
sickman7: bets $0.08
strimmm0: folds 
Uncalled bet ($0.08) returned to sickman7
sickman7 collected $0.13 from pot
sickman7: doesn't show hand 
*** SUMMARY ***
Total pot $0.13 | Rake $0 
Board [8s 6c 9d]
Seat 1: domitorii (button) folded before Flop (didn't bet)
Seat 2: hc agorist (small blind) folded before Flop
Seat 3: strimmm0 (big blind) folded on the Flop
Seat 4: sickman7 collected ($0.13)
Seat 5: koribut folded before Flop (didn't bet)
Seat 6: stano5 folded before Flop (didn't bet)



PokerStars Zoom Hand #193768065434:  Hold'em No Limit ($0.01/$0.02) - 2018/11/27 0:25:59 CUST [2018/11/26 11:25:59 ET]
Table 'Halley' 6-max Seat #1 is the button
Seat 1: charlesws25 ($4.10 in chips) 
Seat 2: waswaz332 ($2 in chips) 
Seat 3: hc agorist ($1.81 in chips) 
Seat 4: pokerfan3999 ($2.29 in chips) 
Seat 5: Bas90 ($2.16 in chips) 
Seat 6: GinthersRift ($9.29 in chips) 
waswaz332: posts small blind $0.01
hc agorist: posts big blind $0.02
*** HOLE CARDS ***
Dealt to hc agorist [Kd 3c]
pokerfan3999: folds 
Bas90: raises $0.03 to $0.05
GinthersRift: calls $0.05
charlesws25: folds 
waswaz332: folds 
hc agorist: folds 
*** FLOP *** [8h 3h 7h]
Bas90: bets $0.10
GinthersRift: calls $0.10
*** TURN *** [8h 3h 7h] [7c]
Bas90: bets $0.35
GinthersRift: folds 
Uncalled bet ($0.35) returned to Bas90
Bas90 collected $0.32 from pot
Bas90: doesn't show hand 
*** SUMMARY ***
Total pot $0.33 | Rake $0.01 
Board [8h 3h 7h 7c]
Seat 1: charlesws25 (button) folded before Flop (didn't bet)
Seat 2: waswaz332 (small blind) folded before Flop
Seat 3: hc agorist (big blind) folded before Flop
Seat 4: pokerfan3999 folded before Flop (didn't bet)
Seat 5: Bas90 collected ($0.32)
Seat 6: GinthersRift folded on the Turn



PokerStars Zoom Hand #193768080517:  Hold'em No Limit ($0.01/$0.02) - 2018/11/27 0:26:26 CUST [2018/11/26 11:26:26 ET]
Table 'Halley' 6-max Seat #1 is the button
Seat 1: hc agorist ($1.78 in chips) 
Seat 2: Papa_Prey ($3.13 in chips) 
Seat 3: jaasso86 ($3.11 in chips) 
Seat 4: nworkun1 ($3.62 in chips) 
Seat 5: averzia ($2.53 in chips) 
Seat 6: BOB7bobo ($4.26 in chips) 
Papa_Prey: posts small blind $0.01
jaasso86: posts big blind $0.02
*** HOLE CARDS ***
Dealt to hc agorist [Qc 7h]
nworkun1: raises $0.03 to $0.05
averzia: folds 
BOB7bobo: folds 
hc agorist: folds 
Papa_Prey: folds 
jaasso86: calls $0.03
*** FLOP *** [Ad 9s 8d]
jaasso86: checks 
nworkun1: bets $0.04
jaasso86: calls $0.04
*** TURN *** [Ad 9s 8d] [7c]
jaasso86: checks 
nworkun1: checks 
*** RIVER *** [Ad 9s 8d 7c] [3s]
jaasso86: bets $0.09
nworkun1: raises $0.17 to $0.26
jaasso86: calls $0.17
*** SHOW DOWN ***
nworkun1: shows [3h 3c] (three of a kind, Threes)
jaasso86: mucks hand 
nworkun1 collected $0.69 from pot
*** SUMMARY ***
Total pot $0.71 | Rake $0.02 
Board [Ad 9s 8d 7c 3s]
Seat 1: hc agorist (button) folded before Flop (didn't bet)
Seat 2: Papa_Prey (small blind) folded before Flop
Seat 3: jaasso86 (big blind) mucked [3d 7d]
Seat 4: nworkun1 showed [3h 3c] and won ($0.69) with three of a kind, Threes
Seat 5: averzia folded before Flop (didn't bet)
Seat 6: BOB7bobo folded before Flop (didn't bet)



PokerStars Zoom Hand #193768083221:  Hold'em No Limit ($0.01/$0.02) - 2018/11/27 0:26:31 CUST [2018/11/26 11:26:31 ET]
Table 'Halley' 6-max Seat #1 is the button
Seat 1: Kir Paal ($2.01 in chips) 
Seat 2: Poker_Baku99 ($1.96 in chips) 
Seat 3: Kokosya ($2.02 in chips) 
Seat 4: cpatom4 ($1.91 in chips) 
Seat 5: hc agorist ($1.78 in chips) 
Seat 6: fazanis4e ($2.62 in chips) 
Poker_Baku99: posts small blind $0.01
Kokosya: posts big blind $0.02
*** HOLE CARDS ***
Dealt to hc agorist [Ac 8c]
cpatom4: folds 
hc agorist: raises $0.02 to $0.04
fazanis4e: folds 
Kir Paal: folds 
Poker_Baku99: calls $0.03
Kokosya: folds 
*** FLOP *** [Jd Ts 4s]
Poker_Baku99: checks 
hc agorist: bets $0.08
Poker_Baku99: calls $0.08
*** TURN *** [Jd Ts 4s] [5d]
Poker_Baku99: checks 
hc agorist: checks 
*** RIVER *** [Jd Ts 4s 5d] [2s]
Poker_Baku99: bets $0.08
hc agorist: folds 
Uncalled bet ($0.08) returned to Poker_Baku99
Poker_Baku99 collected $0.25 from pot
Poker_Baku99: doesn't show hand 
*** SUMMARY ***
Total pot $0.26 | Rake $0.01 
Board [Jd Ts 4s 5d 2s]
Seat 1: Kir Paal (button) folded before Flop (didn't bet)
Seat 2: Poker_Baku99 (small blind) collected ($0.25)
Seat 3: Kokosya (big blind) folded before Flop
Seat 4: cpatom4 folded before Flop (didn't bet)
Seat 5: hc agorist folded on the River
Seat 6: fazanis4e folded before Flop (didn't bet)



PokerStars Zoom Hand #193768101701:  Hold'em No Limit ($0.01/$0.02) - 2018/11/27 0:27:04 CUST [2018/11/26 11:27:04 ET]
Table 'Halley' 6-max Seat #1 is the button
Seat 1: Pokerphili35 ($1.38 in chips) 
Seat 2: BOB7bobo ($2.37 in chips) 
Seat 3: violero_clas ($2.09 in chips) 
Seat 4: ChrisCreys ($13.70 in chips) 
Seat 5: ambasador777 ($2 in chips) 
Seat 6: hc agorist ($1.66 in chips) 
BOB7bobo: posts small blind $0.01
violero_clas: posts big blind $0.02
*** HOLE CARDS ***
Dealt to hc agorist [8h Qc]
ChrisCreys: raises $0.04 to $0.06
ambasador777: folds 
hc agorist: folds 
Pokerphili35: calls $0.06
BOB7bobo: folds 
violero_clas: calls $0.04
*** FLOP *** [2c 8d 3s]
violero_clas: checks 
ChrisCreys: bets $0.06
Pokerphili35: folds 
violero_clas: calls $0.06
*** TURN *** [2c 8d 3s] [Kh]
violero_clas: checks 
ChrisCreys: bets $0.18
violero_clas: folds 
Uncalled bet ($0.18) returned to ChrisCreys
ChrisCreys collected $0.30 from pot
ChrisCreys: doesn't show hand 
*** SUMMARY ***
Total pot $0.31 | Rake $0.01 
Board [2c 8d 3s Kh]
Seat 1: Pokerphili35 (button) folded on the Flop
Seat 2: BOB7bobo (small blind) folded before Flop
Seat 3: violero_clas (big blind) folded on the Turn
Seat 4: ChrisCreys collected ($0.30)
Seat 5: ambasador777 folded before Flop (didn't bet)
Seat 6: hc agorist folded before Flop (didn't bet)



PokerStars Zoom Hand #193768104425:  Hold'em No Limit ($0.01/$0.02) - 2018/11/27 0:27:09 CUST [2018/11/26 11:27:09 ET]
Table 'Halley' 6-max Seat #1 is the button
Seat 1: Pokersk999 ($3.48 in chips) 
Seat 2: Karel33555 ($1.01 in chips) 
Seat 3: alexps922 ($2.91 in chips) 
Seat 4: imgoingNuts ($2 in chips) 
Seat 5: hc agorist ($1.66 in chips) 
Seat 6: roast73 ($4.35 in chips) 
Karel33555: posts small blind $0.01
alexps922: posts big blind $0.02
*** HOLE CARDS ***
Dealt to hc agorist [4d Qd]
imgoingNuts: folds 
hc agorist: raises $0.02 to $0.04
roast73: calls $0.04
Pokersk999: folds 
Karel33555: calls $0.03
alexps922: folds 
*** FLOP *** [2c Kh Th]
Karel33555: checks 
hc agorist: bets $0.11
roast73: folds 
Karel33555: calls $0.11
*** TURN *** [2c Kh Th] [7h]
Karel33555: checks 
hc agorist: bets $0.26
Karel33555: folds 
Uncalled bet ($0.26) returned to hc agorist
hc agorist collected $0.35 from pot
hc agorist: doesn't show hand 
*** SUMMARY ***
Total pot $0.36 | Rake $0.01 
Board [2c Kh Th 7h]
Seat 1: Pokersk999 (button) folded before Flop (didn't bet)
Seat 2: Karel33555 (small blind) folded on the Turn
Seat 3: alexps922 (big blind) folded before Flop
Seat 4: imgoingNuts folded before Flop (didn't bet)
Seat 5: hc agorist collected ($0.35)
Seat 6: roast73 folded on the Flop



PokerStars Zoom Hand #193768129274:  Hold'em No Limit ($0.01/$0.02) - 2018/11/27 0:27:54 CUST [2018/11/26 11:27:54 ET]
Table 'Halley' 6-max Seat #1 is the button
Seat 1: talaSHOCK ($1.20 in chips) 
Seat 2: Rrripl ($1.70 in chips) 
Seat 3: Fishkarub ($2.13 in chips) 
Seat 4: hc agorist ($1.86 in chips) 
Seat 5: Fillippe M. ($2.13 in chips) 
Seat 6: dawidstr ($2 in chips) 
Rrripl: posts small blind $0.01
Fishkarub: posts big blind $0.02
*** HOLE CARDS ***
Dealt to hc agorist [8c 3s]
hc agorist: folds 
Fillippe M.: raises $0.04 to $0.06
dawidstr: folds 
talaSHOCK: folds 
Rrripl: folds 
Fishkarub: folds 
Uncalled bet ($0.04) returned to Fillippe M.
Fillippe M. collected $0.05 from pot
Fillippe M.: doesn't show hand 
*** SUMMARY ***
Total pot $0.05 | Rake $0 
Seat 1: talaSHOCK (button) folded before Flop (didn't bet)
Seat 2: Rrripl (small blind) folded before Flop
Seat 3: Fishkarub (big blind) folded before Flop
Seat 4: hc agorist folded before Flop (didn't bet)
Seat 5: Fillippe M. collected ($0.05)
Seat 6: dawidstr folded before Flop (didn't bet)



PokerStars Zoom Hand #193768131422:  Hold'em No Limit ($0.01/$0.02) - 2018/11/27 0:27:58 CUST [2018/11/26 11:27:58 ET]
Table 'Halley' 6-max Seat #1 is the button
Seat 1: Flok1TTFU ($1.62 in chips) 
Seat 2: ZeusCMR ($1.90 in chips) 
Seat 3: hc agorist ($1.86 in chips) 
Seat 4: LeonidG29 ($5.57 in chips) 
Seat 5: to1R ($2.53 in chips) 
Seat 6: Lehavorkuta ($2.17 in chips) 
ZeusCMR: posts small blind $0.01
hc agorist: posts big blind $0.02
*** HOLE CARDS ***
Dealt to hc agorist [Qd 7c]
LeonidG29: folds 
to1R: folds 
Lehavorkuta: folds 
Flok1TTFU: folds 
ZeusCMR: raises $0.04 to $0.06
hc agorist: folds 
Uncalled bet ($0.04) returned to ZeusCMR
ZeusCMR collected $0.04 from pot
ZeusCMR: doesn't show hand 
*** SUMMARY ***
Total pot $0.04 | Rake $0 
Seat 1: Flok1TTFU (button) folded before Flop (didn't bet)
Seat 2: ZeusCMR (small blind) collected ($0.04)
Seat 3: hc agorist (big blind) folded before Flop
Seat 4: LeonidG29 folded before Flop (didn't bet)
Seat 5: to1R folded before Flop (didn't bet)
Seat 6: Lehavorkuta folded before Flop (didn't bet)



PokerStars Zoom Hand #193768140366:  Hold'em No Limit ($0.01/$0.02) - 2018/11/27 0:28:14 CUST [2018/11/26 11:28:14 ET]
Table 'Halley' 6-max Seat #1 is the button
Seat 1: hc agorist ($1.83 in chips) 
Seat 2: strimmm0 ($4.10 in chips) 
Seat 3: ambasador777 ($2.03 in chips) 
Seat 4: pianobeast ($1.81 in chips) 
Seat 5: donklimp ($2.24 in chips) 
Seat 6: cacao73 ($4.31 in chips) 
strimmm0: posts small blind $0.01
ambasador777: posts big blind $0.02
*** HOLE CARDS ***
Dealt to hc agorist [2c 8h]
pianobeast: raises $0.04 to $0.06
donklimp: folds 
cacao73: folds 
hc agorist: folds 
strimmm0: folds 
ambasador777: calls $0.04
*** FLOP *** [Kh 7c 4c]
ambasador777: checks 
pianobeast: bets $0.07
ambasador777: folds 
Uncalled bet ($0.07) returned to pianobeast
pianobeast collected $0.13 from pot
pianobeast: doesn't show hand 
*** SUMMARY ***
Total pot $0.13 | Rake $0 
Board [Kh 7c 4c]
Seat 1: hc agorist (button) folded before Flop (didn't bet)
Seat 2: strimmm0 (small blind) folded before Flop
Seat 3: ambasador777 (big blind) folded on the Flop
Seat 4: pianobeast collected ($0.13)
Seat 5: donklimp folded before Flop (didn't bet)
Seat 6: cacao73 folded before Flop (didn't bet)



PokerStars Zoom Hand #193768137541:  Hold'em No Limit ($0.01/$0.02) - 2018/11/27 0:28:09 CUST [2018/11/26 11:28:09 ET]
Table 'Halley' 6-max Seat #1 is the button
Seat 1: charlyu$$30$ ($1.82 in chips) 
Seat 2: hc agorist ($1.84 in chips) 
Seat 3: ZeusCMR ($2 in chips) 
Seat 4: marcelim12 ($2 in chips) 
Seat 5: Arch1689 ($2.02 in chips) 
Seat 6: aqwer909 ($2.90 in chips) 
hc agorist: posts small blind $0.01
ZeusCMR: posts big blind $0.02
*** HOLE CARDS ***
Dealt to hc agorist [8c 3c]
marcelim12: folds 
Arch1689: folds 
aqwer909: raises $0.02 to $0.04
charlyu$$30$: calls $0.04
hc agorist: folds 
ZeusCMR: folds 
*** FLOP *** [As 3h 5c]
aqwer909: bets $0.06
charlyu$$30$: calls $0.06
*** TURN *** [As 3h 5c] [6s]
aqwer909: bets $0.22
charlyu$$30$: calls $0.22
*** RIVER *** [As 3h 5c 6s] [8d]
aqwer909: bets $2.58 and is all-in
charlyu$$30$: folds 
Uncalled bet ($2.58) returned to aqwer909
aqwer909 collected $0.65 from pot
aqwer909: doesn't show hand 
*** SUMMARY ***
Total pot $0.67 | Rake $0.02 
Board [As 3h 5c 6s 8d]
Seat 1: charlyu$$30$ (button) folded on the River
Seat 2: hc agorist (small blind) folded before Flop
Seat 3: ZeusCMR (big blind) folded before Flop
Seat 4: marcelim12 folded before Flop (didn't bet)
Seat 5: Arch1689 folded before Flop (didn't bet)
Seat 6: aqwer909 collected ($0.65)



PokerStars Zoom Hand #193768146467:  Hold'em No Limit ($0.01/$0.02) - 2018/11/27 0:28:25 CUST [2018/11/26 11:28:25 ET]
Table 'Halley' 6-max Seat #1 is the button
Seat 1: koribut ($2 in chips) 
Seat 2: malei977 ($2.13 in chips) 
Seat 3: minami315z ($2.39 in chips) 
Seat 4: hc agorist ($1.83 in chips) 
Seat 5: datuti9 ($0.59 in chips) 
Seat 6: T0M5T3R ($2 in chips) 
malei977: posts small blind $0.01
minami315z: posts big blind $0.02
*** HOLE CARDS ***
Dealt to hc agorist [Tc 7c]
hc agorist: raises $0.02 to $0.04
datuti9: folds 
T0M5T3R: folds 
koribut: folds 
malei977: folds 
minami315z: calls $0.02
*** FLOP *** [5c 4c 9s]
minami315z: checks 
hc agorist: bets $0.07
minami315z: folds 
Uncalled bet ($0.07) returned to hc agorist
hc agorist collected $0.09 from pot
hc agorist: doesn't show hand 
*** SUMMARY ***
Total pot $0.09 | Rake $0 
Board [5c 4c 9s]
Seat 1: koribut (button) folded before Flop (didn't bet)
Seat 2: malei977 (small blind) folded before Flop
Seat 3: minami315z (big blind) folded on the Flop
Seat 4: hc agorist collected ($0.09)
Seat 5: datuti9 folded before Flop (didn't bet)
Seat 6: T0M5T3R folded before Flop (didn't bet)



PokerStars Zoom Hand #193768164250:  Hold'em No Limit ($0.01/$0.02) - 2018/11/27 0:28:57 CUST [2018/11/26 11:28:57 ET]
Table 'Halley' 6-max Seat #1 is the button
Seat 1: hc agorist ($1.88 in chips) 
Seat 2: nawh ij oes ($4.55 in chips) 
Seat 3: swraider ($2.69 in chips) 
Seat 4: Symeo208 ($3.97 in chips) 
Seat 5: David peixe ($3.57 in chips) 
Seat 6: Mammarella56 ($2.32 in chips) 
nawh ij oes: posts small blind $0.01
swraider: posts big blind $0.02
*** HOLE CARDS ***
Dealt to hc agorist [3s Th]
Symeo208: folds 
David peixe: folds 
Mammarella56: folds 
hc agorist: folds 
nawh ij oes: folds 
Uncalled bet ($0.01) returned to swraider
swraider collected $0.02 from pot
swraider: doesn't show hand 
*** SUMMARY ***
Total pot $0.02 | Rake $0 
Seat 1: hc agorist (button) folded before Flop (didn't bet)
Seat 2: nawh ij oes (small blind) folded before Flop
Seat 3: swraider (big blind) collected ($0.02)
Seat 4: Symeo208 folded before Flop (didn't bet)
Seat 5: David peixe folded before Flop (didn't bet)
Seat 6: Mammarella56 folded before Flop (didn't bet)



PokerStars Zoom Hand #193768166951:  Hold'em No Limit ($0.01/$0.02) - 2018/11/27 0:29:02 CUST [2018/11/26 11:29:02 ET]
Table 'Halley' 6-max Seat #1 is the button
Seat 1: degelcamus ($7.26 in chips) 
Seat 2: LaFlour5 ($5.82 in chips) 
Seat 3: hc agorist ($1.88 in chips) 
Seat 4: CocaDurrrr ($2 in chips) 
Seat 5: CdnSensation ($4.60 in chips) 
Seat 6: whitepuma4 ($3.67 in chips) 
LaFlour5: posts small blind $0.01
hc agorist: posts big blind $0.02
*** HOLE CARDS ***
Dealt to hc agorist [Jc Ah]
CocaDurrrr: folds 
CdnSensation: raises $0.04 to $0.06
whitepuma4: calls $0.06
degelcamus: folds 
LaFlour5: folds 
hc agorist: raises $0.19 to $0.25
CdnSensation: calls $0.19
whitepuma4: calls $0.19
*** FLOP *** [Jd 8h Tc]
hc agorist: checks 
CdnSensation: checks 
whitepuma4: checks 
*** TURN *** [Jd 8h Tc] [5s]
hc agorist: bets $0.55
CdnSensation: folds 
whitepuma4: calls $0.55
*** RIVER *** [Jd 8h Tc 5s] [4c]
hc agorist: bets $1.08 and is all-in
whitepuma4: calls $1.08
*** SHOW DOWN ***
hc agorist: shows [Jc Ah] (a pair of Jacks)
whitepuma4: shows [3d 3h] (a pair of Threes)
hc agorist collected $3.88 from pot
*** SUMMARY ***
Total pot $4.02 | Rake $0.14 
Board [Jd 8h Tc 5s 4c]
Seat 1: degelcamus (button) folded before Flop (didn't bet)
Seat 2: LaFlour5 (small blind) folded before Flop
Seat 3: hc agorist (big blind) showed [Jc Ah] and won ($3.88) with a pair of Jacks
Seat 4: CocaDurrrr folded before Flop (didn't bet)
Seat 5: CdnSensation folded on the Turn
Seat 6: whitepuma4 showed [3d 3h] and lost with a pair of Threes



PokerStars Zoom Hand #193768212501:  Hold'em No Limit ($0.01/$0.02) - 2018/11/27 0:30:23 CUST [2018/11/26 11:30:23 ET]
Table 'Halley' 6-max Seat #1 is the button
Seat 1: Drinker111 ($5.18 in chips) 
Seat 2: Coffeatus ($2 in chips) 
Seat 3: ugi-dugi ($2.44 in chips) 
Seat 4: amaposh ($3.44 in chips) 
Seat 5: hc agorist ($3.88 in chips) 
Seat 6: penzkocsi ($2.36 in chips) 
Coffeatus: posts small blind $0.01
ugi-dugi: posts big blind $0.02
*** HOLE CARDS ***
Dealt to hc agorist [2c 3s]
amaposh: folds 
hc agorist: folds 
penzkocsi: folds 
Drinker111: folds 
Coffeatus: folds 
Uncalled bet ($0.01) returned to ugi-dugi
ugi-dugi collected $0.02 from pot
ugi-dugi: doesn't show hand 
*** SUMMARY ***
Total pot $0.02 | Rake $0 
Seat 1: Drinker111 (button) folded before Flop (didn't bet)
Seat 2: Coffeatus (small blind) folded before Flop
Seat 3: ugi-dugi (big blind) collected ($0.02)
Seat 4: amaposh folded before Flop (didn't bet)
Seat 5: hc agorist folded before Flop (didn't bet)
Seat 6: penzkocsi folded before Flop (didn't bet)



PokerStars Zoom Hand #193768215315:  Hold'em No Limit ($0.01/$0.02) - 2018/11/27 0:30:28 CUST [2018/11/26 11:30:28 ET]
Table 'Halley' 6-max Seat #1 is the button
Seat 1: alexps922 ($4.05 in chips) 
Seat 2: hc agorist ($3.88 in chips) 
Seat 3: laugodaw ($2.11 in chips) 
Seat 4: SkyElephant ($2 in chips) 
Seat 5: madrihcosher ($2.06 in chips) 
Seat 6: 1MAPTA ($0.66 in chips) 
hc agorist: posts small blind $0.01
laugodaw: posts big blind $0.02
*** HOLE CARDS ***
Dealt to hc agorist [2h Qc]
SkyElephant: folds 
madrihcosher: folds 
1MAPTA: folds 
alexps922: folds 
hc agorist: folds 
Uncalled bet ($0.01) returned to laugodaw
laugodaw collected $0.02 from pot
laugodaw: doesn't show hand 
*** SUMMARY ***
Total pot $0.02 | Rake $0 
Seat 1: alexps922 (button) folded before Flop (didn't bet)
Seat 2: hc agorist (small blind) folded before Flop
Seat 3: laugodaw (big blind) collected ($0.02)
Seat 4: SkyElephant folded before Flop (didn't bet)
Seat 5: madrihcosher folded before Flop (didn't bet)
Seat 6: 1MAPTA folded before Flop (didn't bet)



PokerStars Zoom Hand #193768209167:  Hold'em No Limit ($0.01/$0.02) - 2018/11/27 0:30:17 CUST [2018/11/26 11:30:17 ET]
Table 'Halley' 6-max Seat #1 is the button
Seat 1: Zhan1975 ($6.85 in chips) 
Seat 2: edduarth ($2.04 in chips) 
Seat 3: solarsyco11 ($1.97 in chips) 
Seat 4: Vajdalf92 ($2.18 in chips) 
Seat 5: DoyaRED ($1.32 in chips) 
Seat 6: hc agorist ($3.88 in chips) 
edduarth: posts small blind $0.01
solarsyco11: posts big blind $0.02
*** HOLE CARDS ***
Dealt to hc agorist [Ks 4d]
Vajdalf92: calls $0.02
DoyaRED: folds 
hc agorist: folds 
Zhan1975: raises $0.06 to $0.08
edduarth: folds 
solarsyco11: folds 
Vajdalf92: calls $0.06
*** FLOP *** [Kc 2s Td]
Vajdalf92: checks 
Zhan1975: bets $0.10
Vajdalf92: folds 
Uncalled bet ($0.10) returned to Zhan1975
Zhan1975 collected $0.18 from pot
Zhan1975: doesn't show hand 
*** SUMMARY ***
Total pot $0.19 | Rake $0.01 
Board [Kc 2s Td]
Seat 1: Zhan1975 (button) collected ($0.18)
Seat 2: edduarth (small blind) folded before Flop
Seat 3: solarsyco11 (big blind) folded before Flop
Seat 4: Vajdalf92 folded on the Flop
Seat 5: DoyaRED folded before Flop (didn't bet)
Seat 6: hc agorist folded before Flop (didn't bet)



PokerStars Zoom Hand #193768222170:  Hold'em No Limit ($0.01/$0.02) - 2018/11/27 0:30:40 CUST [2018/11/26 11:30:40 ET]
Table 'Halley' 6-max Seat #1 is the button
Seat 1: lpk2 ($1.35 in chips) 
Seat 2: DANILZOL ($1.94 in chips) 
Seat 3: felakers ($2.08 in chips) 
Seat 4: hc agorist ($3.87 in chips) 
Seat 5: Scratch_wzp ($2 in chips) 
Seat 6: Shatl555 ($1.10 in chips) 
DANILZOL: posts small blind $0.01
felakers: posts big blind $0.02
*** HOLE CARDS ***
Dealt to hc agorist [Kh Td]
hc agorist: raises $0.02 to $0.04
Scratch_wzp: folds 
Shatl555: calls $0.04
lpk2: folds 
DANILZOL: folds 
felakers: folds 
*** FLOP *** [Th 8s Ts]
hc agorist: bets $0.04
Shatl555: calls $0.04
*** TURN *** [Th 8s Ts] [Jh]
hc agorist: bets $0.14
Shatl555: folds 
Uncalled bet ($0.14) returned to hc agorist
hc agorist collected $0.18 from pot
hc agorist: doesn't show hand 
*** SUMMARY ***
Total pot $0.19 | Rake $0.01 
Board [Th 8s Ts Jh]
Seat 1: lpk2 (button) folded before Flop (didn't bet)
Seat 2: DANILZOL (small blind) folded before Flop
Seat 3: felakers (big blind) folded before Flop
Seat 4: hc agorist collected ($0.18)
Seat 5: Scratch_wzp folded before Flop (didn't bet)
Seat 6: Shatl555 folded on the Turn



PokerStars Zoom Hand #193768252188:  Hold'em No Limit ($0.01/$0.02) - 2018/11/27 0:31:33 CUST [2018/11/26 11:31:33 ET]
Table 'Halley' 6-max Seat #1 is the button
Seat 1: Olga Berezina ($2.15 in chips) 
Seat 2: kilingdude ($2.01 in chips) 
Seat 3: jimmydwilson12 ($2 in chips) 
Seat 4: MiuFuringi ($3.24 in chips) 
Seat 5: Unconform ($3.55 in chips) 
Seat 6: hc agorist ($3.97 in chips) 
kilingdude: posts small blind $0.01
jimmydwilson12: posts big blind $0.02
*** HOLE CARDS ***
Dealt to hc agorist [8d 7h]
MiuFuringi: folds 
Unconform: folds 
hc agorist: raises $0.02 to $0.04
Olga Berezina: folds 
kilingdude: folds 
jimmydwilson12: folds 
Uncalled bet ($0.02) returned to hc agorist
hc agorist collected $0.05 from pot
hc agorist: doesn't show hand 
*** SUMMARY ***
Total pot $0.05 | Rake $0 
Seat 1: Olga Berezina (button) folded before Flop (didn't bet)
Seat 2: kilingdude (small blind) folded before Flop
Seat 3: jimmydwilson12 (big blind) folded before Flop
Seat 4: MiuFuringi folded before Flop (didn't bet)
Seat 5: Unconform folded before Flop (didn't bet)
Seat 6: hc agorist collected ($0.05)



PokerStars Zoom Hand #193768268090:  Hold'em No Limit ($0.01/$0.02) - 2018/11/27 0:32:01 CUST [2018/11/26 11:32:01 ET]
Table 'Halley' 6-max Seat #1 is the button
Seat 1: pianobeast ($2.62 in chips) 
Seat 2: anitisqui ($2.76 in chips) 
Seat 3: MaximGusev ($3.14 in chips) 
Seat 4: Soban89 ($1.89 in chips) 
Seat 5: hc agorist ($3.98 in chips) 
Seat 6: averzia ($2.11 in chips) 
anitisqui: posts small blind $0.01
MaximGusev: posts big blind $0.02
*** HOLE CARDS ***
Dealt to hc agorist [Qc Kc]
Soban89: folds 
hc agorist: raises $0.04 to $0.06
averzia: folds 
pianobeast: folds 
anitisqui: folds 
MaximGusev: folds 
Uncalled bet ($0.04) returned to hc agorist
hc agorist collected $0.05 from pot
hc agorist: doesn't show hand 
*** SUMMARY ***
Total pot $0.05 | Rake $0 
Seat 1: pianobeast (button) folded before Flop (didn't bet)
Seat 2: anitisqui (small blind) folded before Flop
Seat 3: MaximGusev (big blind) folded before Flop
Seat 4: Soban89 folded before Flop (didn't bet)
Seat 5: hc agorist collected ($0.05)
Seat 6: averzia folded before Flop (didn't bet)



PokerStars Zoom Hand #193768259508:  Hold'em No Limit ($0.01/$0.02) - 2018/11/27 0:31:46 CUST [2018/11/26 11:31:46 ET]
Table 'Halley' 6-max Seat #1 is the button
Seat 1: daabr934 ($2.29 in chips) 
Seat 2: erioncrazy ($2 in chips) 
Seat 3: hc agorist ($4 in chips) 
Seat 4: don_energo2 ($2.82 in chips) 
Seat 5: MaximGusev ($3.14 in chips) 
Seat 6: d-potolok ($2.03 in chips) 
erioncrazy: posts small blind $0.01
hc agorist: posts big blind $0.02
*** HOLE CARDS ***
Dealt to hc agorist [4h 2h]
don_energo2: folds 
MaximGusev: folds 
d-potolok: raises $0.03 to $0.05
daabr934: raises $0.03 to $0.08
erioncrazy: folds 
hc agorist: folds 
d-potolok: calls $0.03
*** FLOP *** [6c Kc 7s]
d-potolok: checks 
daabr934: bets $0.09
d-potolok: folds 
Uncalled bet ($0.09) returned to daabr934
daabr934 collected $0.18 from pot
daabr934: doesn't show hand 
*** SUMMARY ***
Total pot $0.19 | Rake $0.01 
Board [6c Kc 7s]
Seat 1: daabr934 (button) collected ($0.18)
Seat 2: erioncrazy (small blind) folded before Flop
Seat 3: hc agorist (big blind) folded before Flop
Seat 4: don_energo2 folded before Flop (didn't bet)
Seat 5: MaximGusev folded before Flop (didn't bet)
Seat 6: d-potolok folded on the Flop



PokerStars Zoom Hand #193768274902:  Hold'em No Limit ($0.01/$0.02) - 2018/11/27 0:32:13 CUST [2018/11/26 11:32:13 ET]
Table 'Halley' 6-max Seat #1 is the button
Seat 1: hc agorist ($4.01 in chips) 
Seat 2: HareKrosh ($2.03 in chips) 
Seat 3: charlesws25 ($6.72 in chips) 
Seat 4: chechoraiser ($2.62 in chips) 
Seat 5: Kyle1998s ($3.59 in chips) 
Seat 6: d2009157 ($3.48 in chips) 
HareKrosh: posts small blind $0.01
charlesws25: posts big blind $0.02
*** HOLE CARDS ***
Dealt to hc agorist [Jc 8c]
chechoraiser: folds 
Kyle1998s: folds 
d2009157: folds 
hc agorist: raises $0.02 to $0.04
HareKrosh: folds 
charlesws25: folds 
Uncalled bet ($0.02) returned to hc agorist
hc agorist collected $0.05 from pot
hc agorist: doesn't show hand 
*** SUMMARY ***
Total pot $0.05 | Rake $0 
Seat 1: hc agorist (button) collected ($0.05)
Seat 2: HareKrosh (small blind) folded before Flop
Seat 3: charlesws25 (big blind) folded before Flop
Seat 4: chechoraiser folded before Flop (didn't bet)
Seat 5: Kyle1998s folded before Flop (didn't bet)
Seat 6: d2009157 folded before Flop (didn't bet)



PokerStars Zoom Hand #193768282676:  Hold'em No Limit ($0.01/$0.02) - 2018/11/27 0:32:27 CUST [2018/11/26 11:32:27 ET]
Table 'Halley' 6-max Seat #1 is the button
Seat 1: Zveryukka ($1.06 in chips) 
Seat 2: hc agorist ($4.04 in chips) 
Seat 3: d2009157 ($2.16 in chips) 
Seat 4: sunnyline 9902 ($1.60 in chips) 
Seat 5: lpk2 ($1.90 in chips) 
Seat 6: azulut ($2.29 in chips) 
hc agorist: posts small blind $0.01
d2009157: posts big blind $0.02
*** HOLE CARDS ***
Dealt to hc agorist [6h 8s]
sunnyline 9902: folds 
lpk2: folds 
azulut: raises $0.03 to $0.05
Zveryukka: folds 
hc agorist: folds 
d2009157: folds 
Uncalled bet ($0.03) returned to azulut
azulut collected $0.05 from pot
azulut: doesn't show hand 
*** SUMMARY ***
Total pot $0.05 | Rake $0 
Seat 1: Zveryukka (button) folded before Flop (didn't bet)
Seat 2: hc agorist (small blind) folded before Flop
Seat 3: d2009157 (big blind) folded before Flop
Seat 4: sunnyline 9902 folded before Flop (didn't bet)
Seat 5: lpk2 folded before Flop (didn't bet)
Seat 6: azulut collected ($0.05)



PokerStars Zoom Hand #193768285447:  Hold'em No Limit ($0.01/$0.02) - 2018/11/27 0:32:32 CUST [2018/11/26 11:32:32 ET]
Table 'Halley' 6-max Seat #1 is the button
Seat 1: Vajdalf92 ($2.02 in chips) 
Seat 2: meniasjo ($3.06 in chips) 
Seat 3: oshoka ($2.23 in chips) 
Seat 4: Arch1689 ($2 in chips) 
Seat 5: T0M5T3R ($2.02 in chips) 
Seat 6: hc agorist ($4.03 in chips) 
meniasjo: posts small blind $0.01
oshoka: posts big blind $0.02
*** HOLE CARDS ***
Dealt to hc agorist [6s 7s]
Arch1689: folds 
T0M5T3R: folds 
hc agorist: raises $0.02 to $0.04
Vajdalf92: folds 
meniasjo: folds 
oshoka: folds 
Uncalled bet ($0.02) returned to hc agorist
hc agorist collected $0.05 from pot
hc agorist: doesn't show hand 
*** SUMMARY ***
Total pot $0.05 | Rake $0 
Seat 1: Vajdalf92 (button) folded before Flop (didn't bet)
Seat 2: meniasjo (small blind) folded before Flop
Seat 3: oshoka (big blind) folded before Flop
Seat 4: Arch1689 folded before Flop (didn't bet)
Seat 5: T0M5T3R folded before Flop (didn't bet)
Seat 6: hc agorist collected ($0.05)



PokerStars Zoom Hand #193768294563:  Hold'em No Limit ($0.01/$0.02) - 2018/11/27 0:32:48 CUST [2018/11/26 11:32:48 ET]
Table 'Halley' 6-max Seat #1 is the button
Seat 1: RocknRolla5 ($2.26 in chips) 
Seat 2: Mooch2729 ($3.01 in chips) 
Seat 3: hc agorist ($4.06 in chips) 
Seat 4: artyrrofe ($0.58 in chips) 
Seat 5: shakal7140 ($1.25 in chips) 
Seat 6: Mr-under-tam ($2.44 in chips) 
Mooch2729: posts small blind $0.01
hc agorist: posts big blind $0.02
*** HOLE CARDS ***
Dealt to hc agorist [6h Tc]
artyrrofe: folds 
shakal7140: calls $0.02
Mr-under-tam: folds 
RocknRolla5: raises $0.06 to $0.08
Mooch2729: folds 
hc agorist: folds 
shakal7140: calls $0.06
*** FLOP *** [7s 8c 5h]
shakal7140: bets $0.06
RocknRolla5: folds 
Uncalled bet ($0.06) returned to shakal7140
shakal7140 collected $0.18 from pot
shakal7140: doesn't show hand 
*** SUMMARY ***
Total pot $0.19 | Rake $0.01 
Board [7s 8c 5h]
Seat 1: RocknRolla5 (button) folded on the Flop
Seat 2: Mooch2729 (small blind) folded before Flop
Seat 3: hc agorist (big blind) folded before Flop
Seat 4: artyrrofe folded before Flop (didn't bet)
Seat 5: shakal7140 collected ($0.18)
Seat 6: Mr-under-tam folded before Flop (didn't bet)



PokerStars Zoom Hand #193768302454:  Hold'em No Limit ($0.01/$0.02) - 2018/11/27 0:33:02 CUST [2018/11/26 11:33:02 ET]
Table 'Halley' 6-max Seat #1 is the button
Seat 1: hc agorist ($4.04 in chips) 
Seat 2: talaSHOCK ($1.12 in chips) 
Seat 3: holywarss ($2.93 in chips) 
Seat 4: David peixe ($2.31 in chips) 
Seat 5: Lyudmila07 ($2.31 in chips) 
Seat 6: strimmm0 ($14.87 in chips) 
talaSHOCK: posts small blind $0.01
holywarss: posts big blind $0.02
*** HOLE CARDS ***
Dealt to hc agorist [Qh Ks]
David peixe: folds 
Lyudmila07: folds 
strimmm0: folds 
hc agorist: raises $0.02 to $0.04
talaSHOCK: calls $0.03
holywarss: folds 
*** FLOP *** [Qc 3d 6s]
talaSHOCK: checks 
hc agorist: bets $0.04
talaSHOCK: calls $0.04
*** TURN *** [Qc 3d 6s] [7s]
talaSHOCK: checks 
hc agorist: bets $0.13
talaSHOCK: calls $0.13
*** RIVER *** [Qc 3d 6s 7s] [3h]
talaSHOCK: checks 
hc agorist: bets $0.32
talaSHOCK: folds 
Uncalled bet ($0.32) returned to hc agorist
hc agorist collected $0.42 from pot
hc agorist: doesn't show hand 
*** SUMMARY ***
Total pot $0.44 | Rake $0.02 
Board [Qc 3d 6s 7s 3h]
Seat 1: hc agorist (button) collected ($0.42)
Seat 2: talaSHOCK (small blind) folded on the River
Seat 3: holywarss (big blind) folded before Flop
Seat 4: David peixe folded before Flop (didn't bet)
Seat 5: Lyudmila07 folded before Flop (didn't bet)
Seat 6: strimmm0 folded before Flop (didn't bet)



PokerStars Zoom Hand #193768328333:  Hold'em No Limit ($0.01/$0.02) - 2018/11/27 0:33:48 CUST [2018/11/26 11:33:48 ET]
Table 'Halley' 6-max Seat #1 is the button
Seat 1: MrMuravey ($0.56 in chips) 
Seat 2: Pauchok 43ru ($2.61 in chips) 
Seat 3: Kokosya ($2 in chips) 
Seat 4: Roflpain ($3.14 in chips) 
Seat 5: hc agorist ($4.25 in chips) 
Seat 6: duki317 ($1.84 in chips) 
Pauchok 43ru: posts small blind $0.01
Kokosya: posts big blind $0.02
*** HOLE CARDS ***
Dealt to hc agorist [Ks Qd]
Roflpain: folds 
hc agorist: raises $0.02 to $0.04
duki317: folds 
MrMuravey: raises $0.52 to $0.56 and is all-in
Pauchok 43ru: folds 
Kokosya: folds 
hc agorist: folds 
Uncalled bet ($0.52) returned to MrMuravey
MrMuravey collected $0.11 from pot
MrMuravey: doesn't show hand 
*** SUMMARY ***
Total pot $0.11 | Rake $0 
Seat 1: MrMuravey (button) collected ($0.11)
Seat 2: Pauchok 43ru (small blind) folded before Flop
Seat 3: Kokosya (big blind) folded before Flop
Seat 4: Roflpain folded before Flop (didn't bet)
Seat 5: hc agorist folded before Flop
Seat 6: duki317 folded before Flop (didn't bet)



PokerStars Zoom Hand #193768336121:  Hold'em No Limit ($0.01/$0.02) - 2018/11/27 0:34:02 CUST [2018/11/26 11:34:02 ET]
Table 'Halley' 6-max Seat #1 is the button
Seat 1: barrgand ($3.06 in chips) 
Seat 2: hc agorist ($4.21 in chips) 
Seat 3: ios-801 ($2 in chips) 
Seat 4: AGT1960 ($3.25 in chips) 
Seat 5: daabr934 ($2.09 in chips) 
Seat 6: Vajdalf92 ($2.10 in chips) 
hc agorist: posts small blind $0.01
ios-801: posts big blind $0.02
*** HOLE CARDS ***
Dealt to hc agorist [4c 5c]
AGT1960: folds 
daabr934: folds 
Vajdalf92: folds 
barrgand: folds 
hc agorist: raises $0.02 to $0.04
ios-801: folds 
Uncalled bet ($0.02) returned to hc agorist
hc agorist collected $0.04 from pot
hc agorist: doesn't show hand 
*** SUMMARY ***
Total pot $0.04 | Rake $0 
Seat 1: barrgand (button) folded before Flop (didn't bet)
Seat 2: hc agorist (small blind) collected ($0.04)
Seat 3: ios-801 (big blind) folded before Flop
Seat 4: AGT1960 folded before Flop (didn't bet)
Seat 5: daabr934 folded before Flop (didn't bet)
Seat 6: Vajdalf92 folded before Flop (didn't bet)



PokerStars Zoom Hand #193768342720:  Hold'em No Limit ($0.01/$0.02) - 2018/11/27 0:34:14 CUST [2018/11/26 11:34:14 ET]
Table 'Halley' 6-max Seat #1 is the button
Seat 1: Variance3k ($2.05 in chips) 
Seat 2: vova270793 ($5.50 in chips) 
Seat 3: David peixe ($3.86 in chips) 
Seat 4: hc agorist ($4.23 in chips) 
Seat 5: Lawrence$lim ($2 in chips) 
Seat 6: anasanto ($4.28 in chips) 
vova270793: posts small blind $0.01
David peixe: posts big blind $0.02
*** HOLE CARDS ***
Dealt to hc agorist [Th Kh]
hc agorist: raises $0.02 to $0.04
Lawrence$lim: folds 
anasanto: folds 
Variance3k: folds 
vova270793: raises $0.12 to $0.16
David peixe: folds 
hc agorist: calls $0.12
*** FLOP *** [3c 7s Ks]
vova270793: bets $0.20
hc agorist: calls $0.20
*** TURN *** [3c 7s Ks] [5d]
vova270793: bets $0.55
hc agorist: calls $0.55
*** RIVER *** [3c 7s Ks 5d] [Ad]
vova270793: checks 
hc agorist: checks 
*** SHOW DOWN ***
vova270793: shows [Qs As] (a pair of Aces)
hc agorist: mucks hand 
vova270793 collected $1.78 from pot
*** SUMMARY ***
Total pot $1.84 | Rake $0.06 
Board [3c 7s Ks 5d Ad]
Seat 1: Variance3k (button) folded before Flop (didn't bet)
Seat 2: vova270793 (small blind) showed [Qs As] and won ($1.78) with a pair of Aces
Seat 3: David peixe (big blind) folded before Flop
Seat 4: hc agorist mucked [Th Kh]
Seat 5: Lawrence$lim folded before Flop (didn't bet)
Seat 6: anasanto folded before Flop (didn't bet)



PokerStars Zoom Hand #193768382091:  Hold'em No Limit ($0.01/$0.02) - 2018/11/27 0:35:24 CUST [2018/11/26 11:35:24 ET]
Table 'Halley' 6-max Seat #1 is the button
Seat 1: SkyElephant ($2.39 in chips) 
Seat 2: Vajdalf92 ($2.52 in chips) 
Seat 3: hc agorist ($3.32 in chips) 
Seat 4: Tczoki ($2.71 in chips) 
Seat 5: Trallalak ($1.99 in chips) 
Seat 6: Lyudmila07 ($3.02 in chips) 
Vajdalf92: posts small blind $0.01
hc agorist: posts big blind $0.02
*** HOLE CARDS ***
Dealt to hc agorist [4s 4d]
Tczoki: raises $0.04 to $0.06
Trallalak: folds 
Lyudmila07: folds 
SkyElephant: folds 
Vajdalf92: folds 
hc agorist: calls $0.04
*** FLOP *** [9s 5d 4c]
hc agorist: checks 
Tczoki: checks 
*** TURN *** [9s 5d 4c] [3c]
hc agorist: checks 
Tczoki: bets $0.08
hc agorist: raises $0.24 to $0.32
Tczoki: folds 
Uncalled bet ($0.24) returned to hc agorist
hc agorist collected $0.28 from pot
hc agorist: doesn't show hand 
*** SUMMARY ***
Total pot $0.29 | Rake $0.01 
Board [9s 5d 4c 3c]
Seat 1: SkyElephant (button) folded before Flop (didn't bet)
Seat 2: Vajdalf92 (small blind) folded before Flop
Seat 3: hc agorist (big blind) collected ($0.28)
Seat 4: Tczoki folded on the Turn
Seat 5: Trallalak folded before Flop (didn't bet)
Seat 6: Lyudmila07 folded before Flop (didn't bet)



PokerStars Zoom Hand #193768406165:  Hold'em No Limit ($0.01/$0.02) - 2018/11/27 0:36:07 CUST [2018/11/26 11:36:07 ET]
Table 'Halley' 6-max Seat #1 is the button
Seat 1: zeppi2106 ($2.43 in chips) 
Seat 2: dori_vedimak ($4.55 in chips) 
Seat 3: madrihcosher ($3.80 in chips) 
Seat 4: stupid_bear1 ($2.53 in chips) 
Seat 5: bbhzzz ($2.46 in chips) 
Seat 6: hc agorist ($3.46 in chips) 
dori_vedimak: posts small blind $0.01
madrihcosher: posts big blind $0.02
*** HOLE CARDS ***
Dealt to hc agorist [Kc 6h]
stupid_bear1: folds 
bbhzzz: folds 
hc agorist: raises $0.02 to $0.04
zeppi2106: calls $0.04
dori_vedimak: folds 
madrihcosher: folds 
*** FLOP *** [6d Kh 2h]
hc agorist: bets $0.04
zeppi2106: calls $0.04
*** TURN *** [6d Kh 2h] [9s]
hc agorist: bets $0.28
zeppi2106: calls $0.28
*** RIVER *** [6d Kh 2h 9s] [2d]
hc agorist: bets $0.54
zeppi2106: calls $0.54
*** SHOW DOWN ***
hc agorist: shows [Kc 6h] (two pair, Kings and Sixes)
zeppi2106: mucks hand 
hc agorist collected $1.77 from pot
*** SUMMARY ***
Total pot $1.83 | Rake $0.06 
Board [6d Kh 2h 9s 2d]
Seat 1: zeppi2106 (button) mucked [3d Kd]
Seat 2: dori_vedimak (small blind) folded before Flop
Seat 3: madrihcosher (big blind) folded before Flop
Seat 4: stupid_bear1 folded before Flop (didn't bet)
Seat 5: bbhzzz folded before Flop (didn't bet)
Seat 6: hc agorist showed [Kc 6h] and won ($1.77) with two pair, Kings and Sixes



PokerStars Zoom Hand #193768433503:  Hold'em No Limit ($0.01/$0.02) - 2018/11/27 0:36:56 CUST [2018/11/26 11:36:56 ET]
Table 'Halley' 6-max Seat #1 is the button
Seat 1: andyvk85 ($4.91 in chips) 
Seat 2: 6opusbI4 ($4.32 in chips) 
Seat 3: tomillo50258 ($1.58 in chips) 
Seat 4: hc agorist ($4.33 in chips) 
Seat 5: charlesws25 ($7.11 in chips) 
Seat 6: xiazhen ($2.05 in chips) 
6opusbI4: posts small blind $0.01
tomillo50258: posts big blind $0.02
*** HOLE CARDS ***
Dealt to hc agorist [4c Kh]
hc agorist: folds 
charlesws25: folds 
xiazhen: raises $0.03 to $0.05
andyvk85: folds 
6opusbI4: folds 
tomillo50258: folds 
Uncalled bet ($0.03) returned to xiazhen
xiazhen collected $0.05 from pot
xiazhen: doesn't show hand 
*** SUMMARY ***
Total pot $0.05 | Rake $0 
Seat 1: andyvk85 (button) folded before Flop (didn't bet)
Seat 2: 6opusbI4 (small blind) folded before Flop
Seat 3: tomillo50258 (big blind) folded before Flop
Seat 4: hc agorist folded before Flop (didn't bet)
Seat 5: charlesws25 folded before Flop (didn't bet)
Seat 6: xiazhen collected ($0.05)



PokerStars Zoom Hand #193768436819:  Hold'em No Limit ($0.01/$0.02) - 2018/11/27 0:37:02 CUST [2018/11/26 11:37:02 ET]
Table 'Halley' 6-max Seat #1 is the button
Seat 1: strimmm0 ($4.51 in chips) 
Seat 2: hc agorist ($4.33 in chips) 
Seat 3: EstebanTTT ($2.09 in chips) 
Seat 4: zeppi2106 ($1.53 in chips) 
Seat 5: LaFlour5 ($4.01 in chips) 
Seat 6: talaSHOCK ($0.85 in chips) 
hc agorist: posts small blind $0.01
EstebanTTT: posts big blind $0.02
*** HOLE CARDS ***
Dealt to hc agorist [2h Tc]
zeppi2106: folds 
LaFlour5: folds 
talaSHOCK: folds 
strimmm0: folds 
hc agorist: folds 
Uncalled bet ($0.01) returned to EstebanTTT
EstebanTTT collected $0.02 from pot
EstebanTTT: doesn't show hand 
*** SUMMARY ***
Total pot $0.02 | Rake $0 
Seat 1: strimmm0 (button) folded before Flop (didn't bet)
Seat 2: hc agorist (small blind) folded before Flop
Seat 3: EstebanTTT (big blind) collected ($0.02)
Seat 4: zeppi2106 folded before Flop (didn't bet)
Seat 5: LaFlour5 folded before Flop (didn't bet)
Seat 6: talaSHOCK folded before Flop (didn't bet)



PokerStars Zoom Hand #193768443521:  Hold'em No Limit ($0.01/$0.02) - 2018/11/27 0:37:14 CUST [2018/11/26 11:37:14 ET]
Table 'Halley' 6-max Seat #1 is the button
Seat 1: hc agorist ($4.32 in chips) 
Seat 2: Schnute1 ($1 in chips) 
Seat 3: Pauchok 43ru ($2.77 in chips) 
Seat 4: effortlessly1 ($4.94 in chips) 
Seat 5: TobishMe ($2 in chips) 
Seat 6: Kokosya ($2.40 in chips) 
Schnute1: posts small blind $0.01
Pauchok 43ru: posts big blind $0.02
*** HOLE CARDS ***
Dealt to hc agorist [5s 9c]
effortlessly1: folds 
TobishMe: folds 
Kokosya: raises $0.04 to $0.06
hc agorist: folds 
Schnute1: folds 
Pauchok 43ru: folds 
Uncalled bet ($0.04) returned to Kokosya
Kokosya collected $0.05 from pot
Kokosya: doesn't show hand 
*** SUMMARY ***
Total pot $0.05 | Rake $0 
Seat 1: hc agorist (button) folded before Flop (didn't bet)
Seat 2: Schnute1 (small blind) folded before Flop
Seat 3: Pauchok 43ru (big blind) folded before Flop
Seat 4: effortlessly1 folded before Flop (didn't bet)
Seat 5: TobishMe folded before Flop (didn't bet)
Seat 6: Kokosya collected ($0.05)



PokerStars Zoom Hand #193768447871:  Hold'em No Limit ($0.01/$0.02) - 2018/11/27 0:37:22 CUST [2018/11/26 11:37:22 ET]
Table 'Halley' 6-max Seat #1 is the button
Seat 1: rolyeah ($2.08 in chips) 
Seat 2: the_n3w3r_guy ($4.06 in chips) 
Seat 3: just8start ($1.11 in chips) 
Seat 4: Energetic71 ($2.04 in chips) 
Seat 5: hc agorist ($4.32 in chips) 
Seat 6: anitisqui ($2 in chips) 
the_n3w3r_guy: posts small blind $0.01
just8start: posts big blind $0.02
*** HOLE CARDS ***
Dealt to hc agorist [Qh 5c]
Energetic71: folds 
hc agorist: folds 
anitisqui: folds 
rolyeah: raises $0.04 to $0.06
the_n3w3r_guy: folds 
just8start: calls $0.04
*** FLOP *** [2s 2h 8s]
just8start: bets $0.04
rolyeah: folds 
Uncalled bet ($0.04) returned to just8start
just8start collected $0.13 from pot
just8start: doesn't show hand 
*** SUMMARY ***
Total pot $0.13 | Rake $0 
Board [2s 2h 8s]
Seat 1: rolyeah (button) folded on the Flop
Seat 2: the_n3w3r_guy (small blind) folded before Flop
Seat 3: just8start (big blind) collected ($0.13)
Seat 4: Energetic71 folded before Flop (didn't bet)
Seat 5: hc agorist folded before Flop (didn't bet)
Seat 6: anitisqui folded before Flop (didn't bet)



PokerStars Zoom Hand #193768451769:  Hold'em No Limit ($0.01/$0.02) - 2018/11/27 0:37:29 CUST [2018/11/26 11:37:29 ET]
Table 'Halley' 6-max Seat #1 is the button
Seat 1: macmac399 ($4.68 in chips) 
Seat 2: Rusherito87 ($2.01 in chips) 
Seat 3: Dax0815 ($4.71 in chips) 
Seat 4: hc agorist ($4.32 in chips) 
Seat 5: DRC0812 ($1.40 in chips) 
Seat 6: virgulino143 ($1.78 in chips) 
Rusherito87: posts small blind $0.01
Dax0815: posts big blind $0.02
*** HOLE CARDS ***
Dealt to hc agorist [Tc Td]
hc agorist: raises $0.04 to $0.06
DRC0812: calls $0.06
virgulino143: calls $0.06
macmac399: folds 
Rusherito87: folds 
Dax0815: folds 
*** FLOP *** [5d Qs Kh]
hc agorist: bets $0.15
DRC0812: folds 
virgulino143: folds 
Uncalled bet ($0.15) returned to hc agorist
hc agorist collected $0.20 from pot
hc agorist: doesn't show hand 
*** SUMMARY ***
Total pot $0.21 | Rake $0.01 
Board [5d Qs Kh]
Seat 1: macmac399 (button) folded before Flop (didn't bet)
Seat 2: Rusherito87 (small blind) folded before Flop
Seat 3: Dax0815 (big blind) folded before Flop
Seat 4: hc agorist collected ($0.20)
Seat 5: DRC0812 folded on the Flop
Seat 6: virgulino143 folded on the Flop



PokerStars Zoom Hand #193768474193:  Hold'em No Limit ($0.01/$0.02) - 2018/11/27 0:38:09 CUST [2018/11/26 11:38:09 ET]
Table 'Halley' 6-max Seat #1 is the button
Seat 1: dropkorp ($2.10 in chips) 
Seat 2: Kokosya ($2.99 in chips) 
Seat 3: felakers ($2.23 in chips) 
Seat 4: mannequino ($2.45 in chips) 
Seat 5: daabr934 ($2.34 in chips) 
Seat 6: hc agorist ($4.46 in chips) 
Kokosya: posts small blind $0.01
felakers: posts big blind $0.02
*** HOLE CARDS ***
Dealt to hc agorist [4d 5d]
mannequino: folds 
daabr934: calls $0.02
hc agorist: raises $0.07 to $0.09
dropkorp: folds 
Kokosya: folds 
felakers: folds 
daabr934: folds 
Uncalled bet ($0.07) returned to hc agorist
hc agorist collected $0.07 from pot
hc agorist: doesn't show hand 
*** SUMMARY ***
Total pot $0.07 | Rake $0 
Seat 1: dropkorp (button) folded before Flop (didn't bet)
Seat 2: Kokosya (small blind) folded before Flop
Seat 3: felakers (big blind) folded before Flop
Seat 4: mannequino folded before Flop (didn't bet)
Seat 5: daabr934 folded before Flop
Seat 6: hc agorist collected ($0.07)



PokerStars Zoom Hand #193768488041:  Hold'em No Limit ($0.01/$0.02) - 2018/11/27 0:38:34 CUST [2018/11/26 11:38:34 ET]
Table 'Halley' 6-max Seat #1 is the button
Seat 1: Flootyn ($2 in chips) 
Seat 2: SKFin ($0.96 in chips) 
Seat 3: StrikeG312 ($2.25 in chips) 
Seat 4: Gollenz ($3.28 in chips) 
Seat 5: hc agorist ($4.51 in chips) 
Seat 6: newworld236 ($3.40 in chips) 
SKFin: posts small blind $0.01
StrikeG312: posts big blind $0.02
*** HOLE CARDS ***
Dealt to hc agorist [9d 3d]
Gollenz: folds 
hc agorist: raises $0.02 to $0.04
newworld236: folds 
Flootyn: folds 
SKFin: folds 
StrikeG312: calls $0.02
*** FLOP *** [Qd 8h 2h]
StrikeG312: checks 
hc agorist: bets $0.03
StrikeG312: calls $0.03
*** TURN *** [Qd 8h 2h] [9h]
StrikeG312: checks 
hc agorist: checks 
*** RIVER *** [Qd 8h 2h 9h] [2c]
StrikeG312: checks 
hc agorist: checks 
*** SHOW DOWN ***
StrikeG312: shows [Ad 7d] (a pair of Deuces)
hc agorist: shows [9d 3d] (two pair, Nines and Deuces)
hc agorist collected $0.14 from pot
*** SUMMARY ***
Total pot $0.15 | Rake $0.01 
Board [Qd 8h 2h 9h 2c]
Seat 1: Flootyn (button) folded before Flop (didn't bet)
Seat 2: SKFin (small blind) folded before Flop
Seat 3: StrikeG312 (big blind) showed [Ad 7d] and lost with a pair of Deuces
Seat 4: Gollenz folded before Flop (didn't bet)
Seat 5: hc agorist showed [9d 3d] and won ($0.14) with two pair, Nines and Deuces
Seat 6: newworld236 folded before Flop (didn't bet)



PokerStars Zoom Hand #193768505864:  Hold'em No Limit ($0.01/$0.02) - 2018/11/27 0:39:06 CUST [2018/11/26 11:39:06 ET]
Table 'Halley' 6-max Seat #1 is the button
Seat 1: taiszi ($4.19 in chips) 
Seat 2: hc agorist ($4.58 in chips) 
Seat 3: elenka757 ($1.11 in chips) 
Seat 4: shmagister ($1.91 in chips) 
Seat 5: felakers ($3.62 in chips) 
Seat 6: mcecanho ($1.72 in chips) 
hc agorist: posts small blind $0.01
elenka757: posts big blind $0.02
*** HOLE CARDS ***
Dealt to hc agorist [9d Js]
shmagister: raises $0.03 to $0.05
felakers: folds 
mcecanho: folds 
taiszi: folds 
hc agorist: folds 
elenka757: folds 
Uncalled bet ($0.03) returned to shmagister
shmagister collected $0.05 from pot
shmagister: doesn't show hand 
*** SUMMARY ***
Total pot $0.05 | Rake $0 
Seat 1: taiszi (button) folded before Flop (didn't bet)
Seat 2: hc agorist (small blind) folded before Flop
Seat 3: elenka757 (big blind) folded before Flop
Seat 4: shmagister collected ($0.05)
Seat 5: felakers folded before Flop (didn't bet)
Seat 6: mcecanho folded before Flop (didn't bet)



PokerStars Zoom Hand #193768508653:  Hold'em No Limit ($0.01/$0.02) - 2018/11/27 0:39:11 CUST [2018/11/26 11:39:11 ET]
Table 'Halley' 6-max Seat #1 is the button
Seat 1: xolnikc69 ($2.16 in chips) 
Seat 2: AAQQQ ($2.27 in chips) 
Seat 3: hc agorist ($4.57 in chips) 
Seat 4: JahoorJa ($2.63 in chips) 
Seat 5: StraightPR0 ($6.57 in chips) 
Seat 6: Denellus ($2 in chips) 
AAQQQ: posts small blind $0.01
hc agorist: posts big blind $0.02
*** HOLE CARDS ***
Dealt to hc agorist [3c 8d]
JahoorJa: calls $0.02
StraightPR0: folds 
Denellus: folds 
xolnikc69: folds 
AAQQQ: folds 
hc agorist: checks 
*** FLOP *** [Kd Js 2c]
hc agorist: checks 
JahoorJa: checks 
*** TURN *** [Kd Js 2c] [4h]
hc agorist: checks 
JahoorJa: checks 
*** RIVER *** [Kd Js 2c 4h] [5d]
hc agorist: checks 
JahoorJa: checks 
*** SHOW DOWN ***
hc agorist: shows [3c 8d] (high card King)
JahoorJa: shows [Qc 6d] (high card King - Queen kicker)
JahoorJa collected $0.05 from pot
*** SUMMARY ***
Total pot $0.05 | Rake $0 
Board [Kd Js 2c 4h 5d]
Seat 1: xolnikc69 (button) folded before Flop (didn't bet)
Seat 2: AAQQQ (small blind) folded before Flop
Seat 3: hc agorist (big blind) showed [3c 8d] and lost with high card King
Seat 4: JahoorJa showed [Qc 6d] and won ($0.05) with high card King
Seat 5: StraightPR0 folded before Flop (didn't bet)
Seat 6: Denellus folded before Flop (didn't bet)



PokerStars Zoom Hand #193768522601:  Hold'em No Limit ($0.01/$0.02) - 2018/11/27 0:39:36 CUST [2018/11/26 11:39:36 ET]
Table 'Halley' 6-max Seat #1 is the button
Seat 1: hc agorist ($4.55 in chips) 
Seat 2: daabr934 ($2.17 in chips) 
Seat 3: asposition ($2.67 in chips) 
Seat 4: pv2903 ($7.97 in chips) 
Seat 5: Oleg1400 ($2.20 in chips) 
Seat 6: Grindatia ($2.61 in chips) 
daabr934: posts small blind $0.01
asposition: posts big blind $0.02
*** HOLE CARDS ***
Dealt to hc agorist [Tc 6h]
pv2903: folds 
Oleg1400: folds 
Grindatia: folds 
hc agorist: raises $0.02 to $0.04
daabr934: calls $0.03
asposition: calls $0.02
*** FLOP *** [9d Jc Kd]
daabr934: checks 
asposition: checks 
hc agorist: checks 
*** TURN *** [9d Jc Kd] [5c]
daabr934: bets $0.06
asposition: calls $0.06
hc agorist: folds 
*** RIVER *** [9d Jc Kd 5c] [Qd]
daabr934: bets $0.08
asposition: calls $0.08
*** SHOW DOWN ***
daabr934: shows [Qh Qc] (three of a kind, Queens)
asposition: mucks hand 
daabr934 collected $0.39 from pot
*** SUMMARY ***
Total pot $0.40 | Rake $0.01 
Board [9d Jc Kd 5c Qd]
Seat 1: hc agorist (button) folded on the Turn
Seat 2: daabr934 (small blind) showed [Qh Qc] and won ($0.39) with three of a kind, Queens
Seat 3: asposition (big blind) mucked [Kh Js]
Seat 4: pv2903 folded before Flop (didn't bet)
Seat 5: Oleg1400 folded before Flop (didn't bet)
Seat 6: Grindatia folded before Flop (didn't bet)



PokerStars Zoom Hand #193768545087:  Hold'em No Limit ($0.01/$0.02) - 2018/11/27 0:40:16 CUST [2018/11/26 11:40:16 ET]
Table 'Halley' 6-max Seat #1 is the button
Seat 1: Samarxx ($2.14 in chips) 
Seat 2: anasanto ($4.93 in chips) 
Seat 3: G-Town49 ($2 in chips) 
Seat 4: SkyElephant ($2 in chips) 
Seat 5: taurusvit ($2.21 in chips) 
Seat 6: hc agorist ($4.51 in chips) 
anasanto: posts small blind $0.01
G-Town49: posts big blind $0.02
*** HOLE CARDS ***
Dealt to hc agorist [Kc Jc]
SkyElephant: folds 
taurusvit: folds 
hc agorist: raises $0.02 to $0.04
Samarxx: folds 
anasanto: raises $0.10 to $0.14
G-Town49: folds 
hc agorist: calls $0.10
*** FLOP *** [5h 9s Ad]
anasanto: bets $0.22
hc agorist: folds 
Uncalled bet ($0.22) returned to anasanto
anasanto collected $0.29 from pot
anasanto: doesn't show hand 
*** SUMMARY ***
Total pot $0.30 | Rake $0.01 
Board [5h 9s Ad]
Seat 1: Samarxx (button) folded before Flop (didn't bet)
Seat 2: anasanto (small blind) collected ($0.29)
Seat 3: G-Town49 (big blind) folded before Flop
Seat 4: SkyElephant folded before Flop (didn't bet)
Seat 5: taurusvit folded before Flop (didn't bet)
Seat 6: hc agorist folded on the Flop



PokerStars Zoom Hand #193768571963:  Hold'em No Limit ($0.01/$0.02) - 2018/11/27 0:41:04 CUST [2018/11/26 11:41:04 ET]
Table 'Halley' 6-max Seat #1 is the button
Seat 1: zura-dzhm ($2.49 in chips) 
Seat 2: gabrielpfm ($2.12 in chips) 
Seat 3: hc agorist ($4.37 in chips) 
Seat 4: Olympiojr ($0.94 in chips) 
Seat 5: Aegeides ($2.15 in chips) 
Seat 6: Grindatia ($2.71 in chips) 
gabrielpfm: posts small blind $0.01
hc agorist: posts big blind $0.02
*** HOLE CARDS ***
Dealt to hc agorist [Td 7c]
Olympiojr: folds 
Aegeides: folds 
Grindatia: folds 
zura-dzhm: folds 
gabrielpfm: folds 
Uncalled bet ($0.01) returned to hc agorist
hc agorist collected $0.02 from pot
hc agorist: doesn't show hand 
*** SUMMARY ***
Total pot $0.02 | Rake $0 
Seat 1: zura-dzhm (button) folded before Flop (didn't bet)
Seat 2: gabrielpfm (small blind) folded before Flop
Seat 3: hc agorist (big blind) collected ($0.02)
Seat 4: Olympiojr folded before Flop (didn't bet)
Seat 5: Aegeides folded before Flop (didn't bet)
Seat 6: Grindatia folded before Flop (didn't bet)



PokerStars Zoom Hand #193768568030:  Hold'em No Limit ($0.01/$0.02) - 2018/11/27 0:40:57 CUST [2018/11/26 11:40:57 ET]
Table 'Halley' 6-max Seat #1 is the button
Seat 1: Papa_Prey ($2 in chips) 
Seat 2: T0M5T3R ($2.60 in chips) 
Seat 3: ard14 ($2.17 in chips) 
Seat 4: NOBLELOCKS ($4.03 in chips) 
Seat 5: hc agorist ($4.37 in chips) 
Seat 6: OljverK ($1.56 in chips) 
T0M5T3R: posts small blind $0.01
ard14: posts big blind $0.02
*** HOLE CARDS ***
Dealt to hc agorist [Jd 7h]
NOBLELOCKS: raises $0.04 to $0.06
hc agorist: folds 
OljverK: calls $0.06
Papa_Prey: folds 
T0M5T3R: folds 
ard14: folds 
*** FLOP *** [Jc 8h Qc]
NOBLELOCKS: bets $0.09
OljverK: raises $0.19 to $0.28
NOBLELOCKS: calls $0.19
*** TURN *** [Jc 8h Qc] [5s]
NOBLELOCKS: checks 
OljverK: bets $0.44
NOBLELOCKS: folds 
Uncalled bet ($0.44) returned to OljverK
OljverK collected $0.69 from pot
OljverK: doesn't show hand 
*** SUMMARY ***
Total pot $0.71 | Rake $0.02 
Board [Jc 8h Qc 5s]
Seat 1: Papa_Prey (button) folded before Flop (didn't bet)
Seat 2: T0M5T3R (small blind) folded before Flop
Seat 3: ard14 (big blind) folded before Flop
Seat 4: NOBLELOCKS folded on the Turn
Seat 5: hc agorist folded before Flop (didn't bet)
Seat 6: OljverK collected ($0.69)



PokerStars Zoom Hand #193768587688:  Hold'em No Limit ($0.01/$0.02) - 2018/11/27 0:41:32 CUST [2018/11/26 11:41:32 ET]
Table 'Halley' 6-max Seat #1 is the button
Seat 1: alexps922 ($3.01 in chips) 
Seat 2: dawavey ($1.71 in chips) 
Seat 3: madrihcosher ($3.78 in chips) 
Seat 4: hc agorist ($4.38 in chips) 
Seat 5: begemot340 ($3.44 in chips) 
Seat 6: Papa_Prey ($2.01 in chips) 
dawavey: posts small blind $0.01
madrihcosher: posts big blind $0.02
*** HOLE CARDS ***
Dealt to hc agorist [8s 8d]
hc agorist: raises $0.02 to $0.04
begemot340: folds 
Papa_Prey: folds 
alexps922: folds 
dawavey: calls $0.03
madrihcosher: folds 
*** FLOP *** [Qc 6c 9s]
dawavey: bets $0.10
hc agorist: folds 
Uncalled bet ($0.10) returned to dawavey
dawavey collected $0.10 from pot
dawavey: doesn't show hand 
*** SUMMARY ***
Total pot $0.10 | Rake $0 
Board [Qc 6c 9s]
Seat 1: alexps922 (button) folded before Flop (didn't bet)
Seat 2: dawavey (small blind) collected ($0.10)
Seat 3: madrihcosher (big blind) folded before Flop
Seat 4: hc agorist folded on the Flop
Seat 5: begemot340 folded before Flop (didn't bet)
Seat 6: Papa_Prey folded before Flop (didn't bet)



PokerStars Zoom Hand #193768606870:  Hold'em No Limit ($0.01/$0.02) - 2018/11/27 0:42:06 CUST [2018/11/26 11:42:06 ET]
Table 'Halley' 6-max Seat #1 is the button
Seat 1: rolyeah ($2.04 in chips) 
Seat 2: hc agorist ($4.34 in chips) 
Seat 3: lucyenriny ($0.93 in chips) 
Seat 4: bbhzzz ($2.10 in chips) 
Seat 5: kuklatank ($2.21 in chips) 
Seat 6: Omuvan ($5.76 in chips) 
hc agorist: posts small blind $0.01
lucyenriny: posts big blind $0.02
*** HOLE CARDS ***
Dealt to hc agorist [9h 9c]
bbhzzz: raises $0.04 to $0.06
kuklatank: folds 
Omuvan: folds 
rolyeah: folds 
hc agorist: calls $0.05
lucyenriny: calls $0.04
*** FLOP *** [Jc Ks 8d]
hc agorist: checks 
lucyenriny: checks 
bbhzzz: checks 
*** TURN *** [Jc Ks 8d] [6c]
hc agorist: checks 
lucyenriny: checks 
bbhzzz: checks 
*** RIVER *** [Jc Ks 8d 6c] [8h]
hc agorist: bets $0.60
lucyenriny: folds 
bbhzzz: folds 
Uncalled bet ($0.60) returned to hc agorist
hc agorist collected $0.17 from pot
hc agorist: doesn't show hand 
*** SUMMARY ***
Total pot $0.18 | Rake $0.01 
Board [Jc Ks 8d 6c 8h]
Seat 1: rolyeah (button) folded before Flop (didn't bet)
Seat 2: hc agorist (small blind) collected ($0.17)
Seat 3: lucyenriny (big blind) folded on the River
Seat 4: bbhzzz folded on the River
Seat 5: kuklatank folded before Flop (didn't bet)
Seat 6: Omuvan folded before Flop (didn't bet)



PokerStars Zoom Hand #193768603528:  Hold'em No Limit ($0.01/$0.02) - 2018/11/27 0:42:00 CUST [2018/11/26 11:42:00 ET]
Table 'Halley' 6-max Seat #1 is the button
Seat 1: duki317 ($2.68 in chips) 
Seat 2: 73X4S ($2.03 in chips) 
Seat 3: T0M5T3R ($2.12 in chips) 
Seat 4: Xenoeus1 ($2.40 in chips) 
Seat 5: nikonova88 ($6.02 in chips) 
Seat 6: hc agorist ($4.34 in chips) 
73X4S: posts small blind $0.01
T0M5T3R: posts big blind $0.02
*** HOLE CARDS ***
Dealt to hc agorist [Qh 3c]
Xenoeus1: folds 
nikonova88: raises $0.04 to $0.06
hc agorist: folds 
duki317: folds 
73X4S: folds 
T0M5T3R: calls $0.04
*** FLOP *** [6s 8d Ks]
T0M5T3R: checks 
nikonova88: bets $0.09
T0M5T3R: raises $0.21 to $0.30
nikonova88: calls $0.21
*** TURN *** [6s 8d Ks] [4s]
T0M5T3R: checks 
nikonova88: checks 
*** RIVER *** [6s 8d Ks 4s] [7d]
T0M5T3R: bets $0.23
nikonova88: calls $0.23
*** SHOW DOWN ***
T0M5T3R: shows [6c 6h] (three of a kind, Sixes)
nikonova88: mucks hand 
T0M5T3R collected $1.15 from pot
*** SUMMARY ***
Total pot $1.19 | Rake $0.04 
Board [6s 8d Ks 4s 7d]
Seat 1: duki317 (button) folded before Flop (didn't bet)
Seat 2: 73X4S (small blind) folded before Flop
Seat 3: T0M5T3R (big blind) showed [6c 6h] and won ($1.15) with three of a kind, Sixes
Seat 4: Xenoeus1 folded before Flop (didn't bet)
Seat 5: nikonova88 mucked [As Kh]
Seat 6: hc agorist folded before Flop (didn't bet)



PokerStars Zoom Hand #193768630316:  Hold'em No Limit ($0.01/$0.02) - 2018/11/27 0:42:48 CUST [2018/11/26 11:42:48 ET]
Table 'Halley' 6-max Seat #1 is the button
Seat 1: hc agorist ($4.45 in chips) 
Seat 2: JBD101 ($2.83 in chips) 
Seat 3: KF Furiak ($3.62 in chips) 
Seat 4: Teckhaus ($2.51 in chips) 
Seat 5: degelcamus ($3.24 in chips) 
Seat 6: grajekTeo ($5.36 in chips) 
JBD101: posts small blind $0.01
KF Furiak: posts big blind $0.02
*** HOLE CARDS ***
Dealt to hc agorist [9c Kd]
Teckhaus: folds 
degelcamus: folds 
grajekTeo: raises $0.04 to $0.06
hc agorist: raises $0.12 to $0.18
JBD101: folds 
KF Furiak: folds 
grajekTeo: calls $0.12
*** FLOP *** [Jc 4d 2h]
grajekTeo: checks 
hc agorist: checks 
*** TURN *** [Jc 4d 2h] [Js]
grajekTeo: bets $0.14
hc agorist: folds 
Uncalled bet ($0.14) returned to grajekTeo
grajekTeo collected $0.38 from pot
grajekTeo: doesn't show hand 
*** SUMMARY ***
Total pot $0.39 | Rake $0.01 
Board [Jc 4d 2h Js]
Seat 1: hc agorist (button) folded on the Turn
Seat 2: JBD101 (small blind) folded before Flop
Seat 3: KF Furiak (big blind) folded before Flop
Seat 4: Teckhaus folded before Flop (didn't bet)
Seat 5: degelcamus folded before Flop (didn't bet)
Seat 6: grajekTeo collected ($0.38)



PokerStars Zoom Hand #193768648302:  Hold'em No Limit ($0.01/$0.02) - 2018/11/27 0:43:20 CUST [2018/11/26 11:43:20 ET]
Table 'Halley' 6-max Seat #1 is the button
Seat 1: nicemitya ($4.40 in chips) 
Seat 2: domosedka4 ($2.17 in chips) 
Seat 3: Vajdalf92 ($2 in chips) 
Seat 4: barrgand ($3.27 in chips) 
Seat 5: hc agorist ($4.27 in chips) 
Seat 6: zhx9001 ($1.34 in chips) 
domosedka4: posts small blind $0.01
Vajdalf92: posts big blind $0.02
*** HOLE CARDS ***
Dealt to hc agorist [Ah 7s]
barrgand: folds 
hc agorist: folds 
zhx9001: folds 
nicemitya: folds 
domosedka4: folds 
Uncalled bet ($0.01) returned to Vajdalf92
Vajdalf92 collected $0.02 from pot
Vajdalf92: doesn't show hand 
*** SUMMARY ***
Total pot $0.02 | Rake $0 
Seat 1: nicemitya (button) folded before Flop (didn't bet)
Seat 2: domosedka4 (small blind) folded before Flop
Seat 3: Vajdalf92 (big blind) collected ($0.02)
Seat 4: barrgand folded before Flop (didn't bet)
Seat 5: hc agorist folded before Flop (didn't bet)
Seat 6: zhx9001 folded before Flop (didn't bet)



PokerStars Zoom Hand #193768651808:  Hold'em No Limit ($0.01/$0.02) - 2018/11/27 0:43:26 CUST [2018/11/26 11:43:26 ET]
Table 'Halley' 6-max Seat #1 is the button
Seat 1: Coffeatus ($2.57 in chips) 
Seat 2: the_n3w3r_guy ($2.57 in chips) 
Seat 3: hc agorist ($4.27 in chips) 
Seat 4: LuckdarkAA ($4.58 in chips) 
Seat 5: StraightPR0 ($2.28 in chips) 
Seat 6: j3fing ($6.24 in chips) 
the_n3w3r_guy: posts small blind $0.01
hc agorist: posts big blind $0.02
*** HOLE CARDS ***
Dealt to hc agorist [2c Jd]
LuckdarkAA: folds 
StraightPR0: raises $0.04 to $0.06
j3fing: folds 
Coffeatus: folds 
the_n3w3r_guy: folds 
hc agorist: folds 
Uncalled bet ($0.04) returned to StraightPR0
StraightPR0 collected $0.05 from pot
StraightPR0: doesn't show hand 
*** SUMMARY ***
Total pot $0.05 | Rake $0 
Seat 1: Coffeatus (button) folded before Flop (didn't bet)
Seat 2: the_n3w3r_guy (small blind) folded before Flop
Seat 3: hc agorist (big blind) folded before Flop
Seat 4: LuckdarkAA folded before Flop (didn't bet)
Seat 5: StraightPR0 collected ($0.05)
Seat 6: j3fing folded before Flop (didn't bet)



PokerStars Zoom Hand #193768655767:  Hold'em No Limit ($0.01/$0.02) - 2018/11/27 0:43:33 CUST [2018/11/26 11:43:33 ET]
Table 'Halley' 6-max Seat #1 is the button
Seat 1: SharkBoy1994 ($3.11 in chips) 
Seat 2: Arch1689 ($2.24 in chips) 
Seat 3: Gollenz ($2.27 in chips) 
Seat 4: begemot340 ($3.29 in chips) 
Seat 5: maliz4 ($1.97 in chips) 
Seat 6: hc agorist ($4.25 in chips) 
Arch1689: posts small blind $0.01
Gollenz: posts big blind $0.02
*** HOLE CARDS ***
Dealt to hc agorist [Jd Kh]
begemot340: folds 
maliz4: raises $0.02 to $0.04
hc agorist: raises $0.10 to $0.14
SharkBoy1994: folds 
Arch1689: folds 
Gollenz: folds 
maliz4: calls $0.10
*** FLOP *** [6h 7s 3c]
maliz4: bets $0.15
hc agorist: folds 
Uncalled bet ($0.15) returned to maliz4
maliz4 collected $0.30 from pot
maliz4: doesn't show hand 
*** SUMMARY ***
Total pot $0.31 | Rake $0.01 
Board [6h 7s 3c]
Seat 1: SharkBoy1994 (button) folded before Flop (didn't bet)
Seat 2: Arch1689 (small blind) folded before Flop
Seat 3: Gollenz (big blind) folded before Flop
Seat 4: begemot340 folded before Flop (didn't bet)
Seat 5: maliz4 collected ($0.30)
Seat 6: hc agorist folded on the Flop



PokerStars Zoom Hand #193768676637:  Hold'em No Limit ($0.01/$0.02) - 2018/11/27 0:44:10 CUST [2018/11/26 11:44:10 ET]
Table 'Halley' 6-max Seat #1 is the button
Seat 1: lisicca ($0.92 in chips) 
Seat 2: Cartman 8703 ($2.18 in chips) 
Seat 3: Pokerphili35 ($1.17 in chips) 
Seat 4: hc agorist ($4.11 in chips) 
Seat 5: nikonova88 ($5.40 in chips) 
Seat 6: JustOnimusha ($1.62 in chips) 
Cartman 8703: posts small blind $0.01
Pokerphili35: posts big blind $0.02
*** HOLE CARDS ***
Dealt to hc agorist [2c 2h]
hc agorist: raises $0.02 to $0.04
nikonova88: folds 
JustOnimusha: folds 
lisicca: folds 
Cartman 8703: folds 
Pokerphili35: raises $0.02 to $0.06
hc agorist: calls $0.02
*** FLOP *** [6s 7d Jh]
Pokerphili35: bets $0.04
hc agorist: calls $0.04
*** TURN *** [6s 7d Jh] [6d]
Pokerphili35: bets $0.10
hc agorist: folds 
Uncalled bet ($0.10) returned to Pokerphili35
Pokerphili35 collected $0.20 from pot
Pokerphili35: doesn't show hand 
*** SUMMARY ***
Total pot $0.21 | Rake $0.01 
Board [6s 7d Jh 6d]
Seat 1: lisicca (button) folded before Flop (didn't bet)
Seat 2: Cartman 8703 (small blind) folded before Flop
Seat 3: Pokerphili35 (big blind) collected ($0.20)
Seat 4: hc agorist folded on the Turn
Seat 5: nikonova88 folded before Flop (didn't bet)
Seat 6: JustOnimusha folded before Flop (didn't bet)



PokerStars Zoom Hand #193768696482:  Hold'em No Limit ($0.01/$0.02) - 2018/11/27 0:44:45 CUST [2018/11/26 11:44:45 ET]
Table 'Halley' 6-max Seat #1 is the button
Seat 1: soylaraja ($2.01 in chips) 
Seat 2: hc agorist ($4.01 in chips) 
Seat 3: Spinno ($2.53 in chips) 
Seat 4: Askercha ($1.34 in chips) 
Seat 5: madrihcosher ($2.06 in chips) 
Seat 6: zequi1998 ($2.51 in chips) 
hc agorist: posts small blind $0.01
Spinno: posts big blind $0.02
*** HOLE CARDS ***
Dealt to hc agorist [Ad Kc]
Askercha: folds 
madrihcosher: folds 
zequi1998: folds 
soylaraja: folds 
hc agorist: raises $0.04 to $0.06
Spinno: folds 
Uncalled bet ($0.04) returned to hc agorist
hc agorist collected $0.04 from pot
hc agorist: doesn't show hand 
*** SUMMARY ***
Total pot $0.04 | Rake $0 
Seat 1: soylaraja (button) folded before Flop (didn't bet)
Seat 2: hc agorist (small blind) collected ($0.04)
Seat 3: Spinno (big blind) folded before Flop
Seat 4: Askercha folded before Flop (didn't bet)
Seat 5: madrihcosher folded before Flop (didn't bet)
Seat 6: zequi1998 folded before Flop (didn't bet)



PokerStars Zoom Hand #193768709083:  Hold'em No Limit ($0.01/$0.02) - 2018/11/27 0:45:07 CUST [2018/11/26 11:45:07 ET]
Table 'Halley' 6-max Seat #1 is the button
Seat 1: hc agorist ($4.03 in chips) 
Seat 2: Rolkomolko ($2 in chips) 
Seat 3: bbil300 ($2.02 in chips) 
Seat 4: pruxaxa ($1 in chips) 
Seat 5: OljverK ($1.97 in chips) 
Seat 6: Kir Paal ($2.26 in chips) 
Rolkomolko: posts small blind $0.01
bbil300: posts big blind $0.02
*** HOLE CARDS ***
Dealt to hc agorist [7s 2h]
pruxaxa: folds 
OljverK: folds 
Kir Paal: folds 
hc agorist: folds 
Rolkomolko: folds 
Uncalled bet ($0.01) returned to bbil300
bbil300 collected $0.02 from pot
bbil300: doesn't show hand 
*** SUMMARY ***
Total pot $0.02 | Rake $0 
Seat 1: hc agorist (button) folded before Flop (didn't bet)
Seat 2: Rolkomolko (small blind) folded before Flop
Seat 3: bbil300 (big blind) collected ($0.02)
Seat 4: pruxaxa folded before Flop (didn't bet)
Seat 5: OljverK folded before Flop (didn't bet)
Seat 6: Kir Paal folded before Flop (didn't bet)



PokerStars Zoom Hand #193768712531:  Hold'em No Limit ($0.01/$0.02) - 2018/11/27 0:45:13 CUST [2018/11/26 11:45:13 ET]
Table 'Halley' 6-max Seat #1 is the button
Seat 1: dawidstr ($3.05 in chips) 
Seat 2: ace _poker7 ($1.97 in chips) 
Seat 3: Artuzinio ($2.16 in chips) 
Seat 4: hc agorist ($4.03 in chips) 
Seat 5: Mizzek ($3.26 in chips) 
Seat 6: chist33 ($0.69 in chips) 
ace _poker7: posts small blind $0.01
Artuzinio: posts big blind $0.02
*** HOLE CARDS ***
Dealt to hc agorist [7d 6c]
hc agorist: folds 
Mizzek: folds 
chist33: folds 
dawidstr: folds 
ace _poker7: raises $0.02 to $0.04
Artuzinio: calls $0.02
*** FLOP *** [2c 4s 9s]
ace _poker7: bets $0.08
Artuzinio: folds 
Uncalled bet ($0.08) returned to ace _poker7
ace _poker7 collected $0.08 from pot
ace _poker7: doesn't show hand 
*** SUMMARY ***
Total pot $0.08 | Rake $0 
Board [2c 4s 9s]
Seat 1: dawidstr (button) folded before Flop (didn't bet)
Seat 2: ace _poker7 (small blind) collected ($0.08)
Seat 3: Artuzinio (big blind) folded on the Flop
Seat 4: hc agorist folded before Flop (didn't bet)
Seat 5: Mizzek folded before Flop (didn't bet)
Seat 6: chist33 folded before Flop (didn't bet)



PokerStars Zoom Hand #193768729597:  Hold'em No Limit ($0.01/$0.02) - 2018/11/27 0:45:43 CUST [2018/11/26 11:45:43 ET]
Table 'Halley' 6-max Seat #1 is the button
Seat 1: markiz655 ($3.12 in chips) 
Seat 2: gabrielpfm ($2.71 in chips) 
Seat 3: hc agorist ($3.97 in chips) 
Seat 4: Cartman 8703 ($2.21 in chips) 
Seat 5: Rolkomolko ($2.50 in chips) 
Seat 6: Forten55 ($4.52 in chips) 
gabrielpfm: posts small blind $0.01
hc agorist: posts big blind $0.02
*** HOLE CARDS ***
Dealt to hc agorist [Qd Ad]
Cartman 8703: folds 
Rolkomolko: folds 
Forten55: folds 
markiz655: folds 
gabrielpfm: raises $0.04 to $0.06
hc agorist: raises $0.12 to $0.18
gabrielpfm: folds 
Uncalled bet ($0.12) returned to hc agorist
hc agorist collected $0.12 from pot
hc agorist: doesn't show hand 
*** SUMMARY ***
Total pot $0.12 | Rake $0 
Seat 1: markiz655 (button) folded before Flop (didn't bet)
Seat 2: gabrielpfm (small blind) folded before Flop
Seat 3: hc agorist (big blind) collected ($0.12)
Seat 4: Cartman 8703 folded before Flop (didn't bet)
Seat 5: Rolkomolko folded before Flop (didn't bet)
Seat 6: Forten55 folded before Flop (didn't bet)



PokerStars Zoom Hand #193768715348:  Hold'em No Limit ($0.01/$0.02) - 2018/11/27 0:45:18 CUST [2018/11/26 11:45:18 ET]
Table 'Halley' 6-max Seat #1 is the button
Seat 1: psychopathko ($1.83 in chips) 
Seat 2: Energetic71 ($3.10 in chips) 
Seat 3: Luke6.1 ($2 in chips) 
Seat 4: SeaWolfff ($5.22 in chips) 
Seat 5: j3fing ($6.21 in chips) 
Seat 6: hc agorist ($4.03 in chips) 
Energetic71: posts small blind $0.01
Luke6.1: posts big blind $0.02
*** HOLE CARDS ***
Dealt to hc agorist [4s As]
SeaWolfff: raises $0.04 to $0.06
j3fing: folds 
hc agorist: calls $0.06
psychopathko: folds 
Energetic71: calls $0.05
Luke6.1: folds 
*** FLOP *** [8s 9h 9d]
Energetic71: checks 
SeaWolfff: bets $0.10
hc agorist: folds 
Energetic71: folds 
Uncalled bet ($0.10) returned to SeaWolfff
SeaWolfff collected $0.19 from pot
SeaWolfff: doesn't show hand 
*** SUMMARY ***
Total pot $0.20 | Rake $0.01 
Board [8s 9h 9d]
Seat 1: psychopathko (button) folded before Flop (didn't bet)
Seat 2: Energetic71 (small blind) folded on the Flop
Seat 3: Luke6.1 (big blind) folded before Flop
Seat 4: SeaWolfff collected ($0.19)
Seat 5: j3fing folded before Flop (didn't bet)
Seat 6: hc agorist folded on the Flop



PokerStars Zoom Hand #193768738020:  Hold'em No Limit ($0.01/$0.02) - 2018/11/27 0:45:58 CUST [2018/11/26 11:45:58 ET]
Table 'Halley' 6-max Seat #1 is the button
Seat 1: hc agorist ($4.03 in chips) 
Seat 2: Jeste Audike ($2.70 in chips) 
Seat 3: chef1926 ($2.20 in chips) 
Seat 4: villian888 ($3.05 in chips) 
Seat 5: Mizzek ($3.28 in chips) 
Seat 6: Pauchok 43ru ($2.08 in chips) 
Jeste Audike: posts small blind $0.01
chef1926: posts big blind $0.02
*** HOLE CARDS ***
Dealt to hc agorist [2h 6h]
villian888: raises $0.04 to $0.06
Mizzek: folds 
Pauchok 43ru: folds 
hc agorist: raises $0.15 to $0.21
Jeste Audike: folds 
chef1926: folds 
villian888: calls $0.15
*** FLOP *** [Kc 5s 5c]
villian888: checks 
hc agorist: bets $0.15
villian888: folds 
Uncalled bet ($0.15) returned to hc agorist
hc agorist collected $0.43 from pot
hc agorist: doesn't show hand 
*** SUMMARY ***
Total pot $0.45 | Rake $0.02 
Board [Kc 5s 5c]
Seat 1: hc agorist (button) collected ($0.43)
Seat 2: Jeste Audike (small blind) folded before Flop
Seat 3: chef1926 (big blind) folded before Flop
Seat 4: villian888 folded on the Flop
Seat 5: Mizzek folded before Flop (didn't bet)
Seat 6: Pauchok 43ru folded before Flop (didn't bet)



PokerStars Zoom Hand #193768756733:  Hold'em No Limit ($0.01/$0.02) - 2018/11/27 0:46:31 CUST [2018/11/26 11:46:31 ET]
Table 'Halley' 6-max Seat #1 is the button
Seat 1: virgulino143 ($1.62 in chips) 
Seat 2: hc agorist ($4.25 in chips) 
Seat 3: Gurosek ($1.12 in chips) 
Seat 4: Bruniin_F ($2.07 in chips) 
Seat 5: bbhzzz ($2 in chips) 
Seat 6: BadBoy-PokStars ($2.03 in chips) 
hc agorist: posts small blind $0.01
Gurosek: posts big blind $0.02
*** HOLE CARDS ***
Dealt to hc agorist [Qs 3c]
Bruniin_F: folds 
bbhzzz: folds 
BadBoy-PokStars: raises $0.02 to $0.04
virgulino143: folds 
hc agorist: folds 
Gurosek: folds 
Uncalled bet ($0.02) returned to BadBoy-PokStars
BadBoy-PokStars collected $0.05 from pot
BadBoy-PokStars: doesn't show hand 
*** SUMMARY ***
Total pot $0.05 | Rake $0 
Seat 1: virgulino143 (button) folded before Flop (didn't bet)
Seat 2: hc agorist (small blind) folded before Flop
Seat 3: Gurosek (big blind) folded before Flop
Seat 4: Bruniin_F folded before Flop (didn't bet)
Seat 5: bbhzzz folded before Flop (didn't bet)
Seat 6: BadBoy-PokStars collected ($0.05)



PokerStars Zoom Hand #193768759548:  Hold'em No Limit ($0.01/$0.02) - 2018/11/27 0:46:36 CUST [2018/11/26 11:46:36 ET]
Table 'Halley' 6-max Seat #1 is the button
Seat 1: the_n3w3r_guy ($2.54 in chips) 
Seat 2: lisicca ($1.04 in chips) 
Seat 3: valera.19189 ($1.47 in chips) 
Seat 4: KF Furiak ($2.44 in chips) 
Seat 5: hc agorist ($4.24 in chips) 
Seat 6: pokerstri508 ($1.49 in chips) 
lisicca: posts small blind $0.01
valera.19189: posts big blind $0.02
*** HOLE CARDS ***
Dealt to hc agorist [Td Tc]
KF Furiak: raises $0.04 to $0.06
hc agorist: calls $0.06
pokerstri508: folds 
the_n3w3r_guy: folds 
lisicca: folds 
valera.19189: folds 
*** FLOP *** [Ah 5h 5c]
KF Furiak: checks 
hc agorist: checks 
*** TURN *** [Ah 5h 5c] [7h]
KF Furiak: bets $0.07
hc agorist: calls $0.07
*** RIVER *** [Ah 5h 5c 7h] [Ts]
KF Furiak: bets $0.20
hc agorist: raises $1 to $1.20
KF Furiak: folds 
Uncalled bet ($1) returned to hc agorist
hc agorist collected $0.67 from pot
hc agorist: doesn't show hand 
*** SUMMARY ***
Total pot $0.69 | Rake $0.02 
Board [Ah 5h 5c 7h Ts]
Seat 1: the_n3w3r_guy (button) folded before Flop (didn't bet)
Seat 2: lisicca (small blind) folded before Flop
Seat 3: valera.19189 (big blind) folded before Flop
Seat 4: KF Furiak folded on the River
Seat 5: hc agorist collected ($0.67)
Seat 6: pokerstri508 folded before Flop (didn't bet)



PokerStars Zoom Hand #193768792633:  Hold'em No Limit ($0.01/$0.02) - 2018/11/27 0:47:34 CUST [2018/11/26 11:47:34 ET]
Table 'Halley' 6-max Seat #1 is the button
Seat 1: wqd4 ($0.78 in chips) 
Seat 2: Roflpain ($3.25 in chips) 
Seat 3: hc agorist ($4.58 in chips) 
Seat 4: mich051260 ($11.02 in chips) 
Seat 5: AllBugay ($2.08 in chips) 
Seat 6: newvou ($1.97 in chips) 
Roflpain: posts small blind $0.01
hc agorist: posts big blind $0.02
*** HOLE CARDS ***
Dealt to hc agorist [5h 4s]
mich051260: raises $0.05 to $0.07
AllBugay: folds 
newvou: calls $0.07
wqd4: folds 
Roflpain: folds 
hc agorist: folds 
*** FLOP *** [7h 8c 3s]
mich051260: bets $0.16
newvou: folds 
Uncalled bet ($0.16) returned to mich051260
mich051260 collected $0.16 from pot
mich051260: doesn't show hand 
*** SUMMARY ***
Total pot $0.17 | Rake $0.01 
Board [7h 8c 3s]
Seat 1: wqd4 (button) folded before Flop (didn't bet)
Seat 2: Roflpain (small blind) folded before Flop
Seat 3: hc agorist (big blind) folded before Flop
Seat 4: mich051260 collected ($0.16)
Seat 5: AllBugay folded before Flop (didn't bet)
Seat 6: newvou folded on the Flop



PokerStars Zoom Hand #193768797719:  Hold'em No Limit ($0.01/$0.02) - 2018/11/27 0:47:43 CUST [2018/11/26 11:47:43 ET]
Table 'Halley' 6-max Seat #1 is the button
Seat 1: penzkocsi ($2 in chips) 
Seat 2: the_n3w3r_guy ($2.53 in chips) 
Seat 3: ANRI11101988 ($1 in chips) 
Seat 4: Drinker111 ($5.41 in chips) 
Seat 5: hc agorist ($4.56 in chips) 
Seat 6: Fixmenem ($2 in chips) 
the_n3w3r_guy: posts small blind $0.01
ANRI11101988: posts big blind $0.02
*** HOLE CARDS ***
Dealt to hc agorist [Tc Qd]
Drinker111: folds 
hc agorist: raises $0.02 to $0.04
Fixmenem: folds 
penzkocsi: folds 
the_n3w3r_guy: folds 
ANRI11101988: folds 
Uncalled bet ($0.02) returned to hc agorist
hc agorist collected $0.05 from pot
hc agorist: doesn't show hand 
*** SUMMARY ***
Total pot $0.05 | Rake $0 
Seat 1: penzkocsi (button) folded before Flop (didn't bet)
Seat 2: the_n3w3r_guy (small blind) folded before Flop
Seat 3: ANRI11101988 (big blind) folded before Flop
Seat 4: Drinker111 folded before Flop (didn't bet)
Seat 5: hc agorist collected ($0.05)
Seat 6: Fixmenem folded before Flop (didn't bet)



PokerStars Zoom Hand #193768806921:  Hold'em No Limit ($0.01/$0.02) - 2018/11/27 0:47:59 CUST [2018/11/26 11:47:59 ET]
Table 'Halley' 6-max Seat #1 is the button
Seat 1: hc agorist ($4.59 in chips) 
Seat 2: Setokhaiba ($2.03 in chips) 
Seat 3: ravemaster-z ($2.38 in chips) 
Seat 4: strimmm0 ($5.07 in chips) 
Seat 5: mariogabriew ($1.41 in chips) 
Seat 6: gaeppakse ($2.03 in chips) 
Setokhaiba: posts small blind $0.01
ravemaster-z: posts big blind $0.02
*** HOLE CARDS ***
Dealt to hc agorist [8d As]
strimmm0: folds 
mariogabriew: raises $0.04 to $0.06
gaeppakse: folds 
hc agorist: raises $0.12 to $0.18
Setokhaiba: folds 
ravemaster-z: folds 
mariogabriew: calls $0.12
*** FLOP *** [Ts 9c Jc]
mariogabriew: bets $0.08
hc agorist: calls $0.08
*** TURN *** [Ts 9c Jc] [Qs]
mariogabriew: checks 
hc agorist: bets $0.40
mariogabriew: folds 
Uncalled bet ($0.40) returned to hc agorist
hc agorist collected $0.53 from pot
hc agorist: doesn't show hand 
*** SUMMARY ***
Total pot $0.55 | Rake $0.02 
Board [Ts 9c Jc Qs]
Seat 1: hc agorist (button) collected ($0.53)
Seat 2: Setokhaiba (small blind) folded before Flop
Seat 3: ravemaster-z (big blind) folded before Flop
Seat 4: strimmm0 folded before Flop (didn't bet)
Seat 5: mariogabriew folded on the Turn
Seat 6: gaeppakse folded before Flop (didn't bet)



PokerStars Zoom Hand #193768846808:  Hold'em No Limit ($0.01/$0.02) - 2018/11/27 0:49:09 CUST [2018/11/26 11:49:09 ET]
Table 'Halley' 6-max Seat #1 is the button
Seat 1: OMOC1945 ($1.31 in chips) 
Seat 2: effortlessly1 ($3.90 in chips) 
Seat 3: m3t1s ($4.62 in chips) 
Seat 4: hc agorist ($4.86 in chips) 
Seat 5: Scratch_wzp ($6.35 in chips) 
Seat 6: Rightful ($2 in chips) 
effortlessly1: posts small blind $0.01
m3t1s: posts big blind $0.02
*** HOLE CARDS ***
Dealt to hc agorist [Ts 6d]
hc agorist: folds 
Scratch_wzp: raises $0.03 to $0.05
Rightful: raises $0.11 to $0.16
OMOC1945: folds 
effortlessly1: folds 
m3t1s: folds 
Scratch_wzp: folds 
Uncalled bet ($0.11) returned to Rightful
Rightful collected $0.13 from pot
Rightful: doesn't show hand 
*** SUMMARY ***
Total pot $0.13 | Rake $0 
Seat 1: OMOC1945 (button) folded before Flop (didn't bet)
Seat 2: effortlessly1 (small blind) folded before Flop
Seat 3: m3t1s (big blind) folded before Flop
Seat 4: hc agorist folded before Flop (didn't bet)
Seat 5: Scratch_wzp folded before Flop
Seat 6: Rightful collected ($0.13)



PokerStars Zoom Hand #193768849687:  Hold'em No Limit ($0.01/$0.02) - 2018/11/27 0:49:14 CUST [2018/11/26 11:49:14 ET]
Table 'Halley' 6-max Seat #1 is the button
Seat 1: Gollenz ($2.55 in chips) 
Seat 2: hc agorist ($4.86 in chips) 
Seat 3: moskita789 ($2.70 in chips) 
Seat 4: mine4sure ($2.60 in chips) 
Seat 5: marta328 ($2.25 in chips) 
Seat 6: villian888 ($2.72 in chips) 
hc agorist: posts small blind $0.01
moskita789: posts big blind $0.02
*** HOLE CARDS ***
Dealt to hc agorist [Qd 4c]
mine4sure: raises $0.02 to $0.04
marta328: folds 
villian888: folds 
Gollenz: folds 
hc agorist: folds 
moskita789: folds 
Uncalled bet ($0.02) returned to mine4sure
mine4sure collected $0.05 from pot
mine4sure: doesn't show hand 
*** SUMMARY ***
Total pot $0.05 | Rake $0 
Seat 1: Gollenz (button) folded before Flop (didn't bet)
Seat 2: hc agorist (small blind) folded before Flop
Seat 3: moskita789 (big blind) folded before Flop
Seat 4: mine4sure collected ($0.05)
Seat 5: marta328 folded before Flop (didn't bet)
Seat 6: villian888 folded before Flop (didn't bet)



PokerStars Zoom Hand #193768838259:  Hold'em No Limit ($0.01/$0.02) - 2018/11/27 0:48:54 CUST [2018/11/26 11:48:54 ET]
Table 'Halley' 6-max Seat #1 is the button
Seat 1: derek373 ($3.60 in chips) 
Seat 2: PavloSyn ($0.95 in chips) 
Seat 3: stupid_bear1 ($1.10 in chips) 
Seat 4: ph@ntom_f12 ($2 in chips) 
Seat 5: glad240 ($0.96 in chips) 
Seat 6: hc agorist ($4.86 in chips) 
PavloSyn: posts small blind $0.01
stupid_bear1: posts big blind $0.02
*** HOLE CARDS ***
Dealt to hc agorist [8d 6h]
ph@ntom_f12: raises $0.04 to $0.06
glad240: folds 
hc agorist: folds 
derek373: folds 
PavloSyn: folds 
stupid_bear1: calls $0.04
*** FLOP *** [Td 2d 9d]
stupid_bear1: checks 
ph@ntom_f12: bets $0.08
stupid_bear1: folds 
Uncalled bet ($0.08) returned to ph@ntom_f12
ph@ntom_f12 collected $0.13 from pot
ph@ntom_f12: doesn't show hand 
*** SUMMARY ***
Total pot $0.13 | Rake $0 
Board [Td 2d 9d]
Seat 1: derek373 (button) folded before Flop (didn't bet)
Seat 2: PavloSyn (small blind) folded before Flop
Seat 3: stupid_bear1 (big blind) folded on the Flop
Seat 4: ph@ntom_f12 collected ($0.13)
Seat 5: glad240 folded before Flop (didn't bet)
Seat 6: hc agorist folded before Flop (didn't bet)



PokerStars Zoom Hand #193768857584:  Hold'em No Limit ($0.01/$0.02) - 2018/11/27 0:49:28 CUST [2018/11/26 11:49:28 ET]
Table 'Halley' 6-max Seat #1 is the button
Seat 1: pkr_str3368 ($2 in chips) 
Seat 2: villian888 ($8.54 in chips) 
Seat 3: Taggwan ($3.08 in chips) 
Seat 4: hc agorist ($4.85 in chips) 
Seat 5: Flojojo11 ($3.67 in chips) 
Seat 6: BadBoy-PokStars ($2 in chips) 
villian888: posts small blind $0.01
Taggwan: posts big blind $0.02
*** HOLE CARDS ***
Dealt to hc agorist [4c 9h]
hc agorist: folds 
Flojojo11: folds 
BadBoy-PokStars: raises $0.02 to $0.04
pkr_str3368: folds 
villian888: folds 
Taggwan: folds 
Uncalled bet ($0.02) returned to BadBoy-PokStars
BadBoy-PokStars collected $0.05 from pot
BadBoy-PokStars: doesn't show hand 
*** SUMMARY ***
Total pot $0.05 | Rake $0 
Seat 1: pkr_str3368 (button) folded before Flop (didn't bet)
Seat 2: villian888 (small blind) folded before Flop
Seat 3: Taggwan (big blind) folded before Flop
Seat 4: hc agorist folded before Flop (didn't bet)
Seat 5: Flojojo11 folded before Flop (didn't bet)
Seat 6: BadBoy-PokStars collected ($0.05)



PokerStars Zoom Hand #193768854709:  Hold'em No Limit ($0.01/$0.02) - 2018/11/27 0:49:23 CUST [2018/11/26 11:49:23 ET]
Table 'Halley' 6-max Seat #1 is the button
Seat 1: melse_youth ($2.15 in chips) 
Seat 2: rolyeah ($2.79 in chips) 
Seat 3: Diff3r3nt ($2.08 in chips) 
Seat 4: takpat ($2.30 in chips) 
Seat 5: hc agorist ($4.85 in chips) 
Seat 6: penzkocsi ($2.02 in chips) 
rolyeah: posts small blind $0.01
Diff3r3nt: posts big blind $0.02
*** HOLE CARDS ***
Dealt to hc agorist [2d 9s]
takpat: folds 
hc agorist: folds 
penzkocsi: raises $0.04 to $0.06
melse_youth: raises $0.12 to $0.18
rolyeah: folds 
Diff3r3nt: folds 
penzkocsi: folds 
Uncalled bet ($0.12) returned to melse_youth
melse_youth collected $0.15 from pot
melse_youth: doesn't show hand 
*** SUMMARY ***
Total pot $0.15 | Rake $0 
Seat 1: melse_youth (button) collected ($0.15)
Seat 2: rolyeah (small blind) folded before Flop
Seat 3: Diff3r3nt (big blind) folded before Flop
Seat 4: takpat folded before Flop (didn't bet)
Seat 5: hc agorist folded before Flop (didn't bet)
Seat 6: penzkocsi folded before Flop



PokerStars Zoom Hand #193768860420:  Hold'em No Limit ($0.01/$0.02) - 2018/11/27 0:49:33 CUST [2018/11/26 11:49:33 ET]
Table 'Halley' 6-max Seat #1 is the button
Seat 1: hc agorist ($4.85 in chips) 
Seat 2: StraightPR0 ($3.37 in chips) 
Seat 3: alexps922 ($3.05 in chips) 
Seat 4: sokolik81 ($2 in chips) 
Seat 5: ZAVODchani22 ($2.08 in chips) 
Seat 6: Genal55 ($2.08 in chips) 
StraightPR0: posts small blind $0.01
alexps922: posts big blind $0.02
*** HOLE CARDS ***
Dealt to hc agorist [Qh 8h]
sokolik81: folds 
ZAVODchani22: raises $0.04 to $0.06
Genal55: folds 
hc agorist: calls $0.06
StraightPR0: folds 
alexps922: folds 
*** FLOP *** [Jc 4h Jh]
ZAVODchani22: bets $0.08
hc agorist: calls $0.08
*** TURN *** [Jc 4h Jh] [6c]
ZAVODchani22: bets $0.16
hc agorist: calls $0.16
*** RIVER *** [Jc 4h Jh 6c] [9s]
ZAVODchani22: checks 
hc agorist: bets $0.28
ZAVODchani22: calls $0.28
*** SHOW DOWN ***
hc agorist: shows [Qh 8h] (a pair of Jacks)
ZAVODchani22: shows [Kd Ks] (two pair, Kings and Jacks)
ZAVODchani22 collected $1.15 from pot
*** SUMMARY ***
Total pot $1.19 | Rake $0.04 
Board [Jc 4h Jh 6c 9s]
Seat 1: hc agorist (button) showed [Qh 8h] and lost with a pair of Jacks
Seat 2: StraightPR0 (small blind) folded before Flop
Seat 3: alexps922 (big blind) folded before Flop
Seat 4: sokolik81 folded before Flop (didn't bet)
Seat 5: ZAVODchani22 showed [Kd Ks] and won ($1.15) with two pair, Kings and Jacks
Seat 6: Genal55 folded before Flop (didn't bet)



PokerStars Zoom Hand #193768889128:  Hold'em No Limit ($0.01/$0.02) - 2018/11/27 0:50:23 CUST [2018/11/26 11:50:23 ET]
Table 'Halley' 6-max Seat #1 is the button
Seat 1: blue52844 ($6.59 in chips) 
Seat 2: serde4nik ($3.04 in chips) 
Seat 3: hc agorist ($4.27 in chips) 
Seat 4: sluks ($2.30 in chips) 
Seat 5: averzia ($2.11 in chips) 
Seat 6: David peixe ($2.66 in chips) 
serde4nik: posts small blind $0.01
hc agorist: posts big blind $0.02
*** HOLE CARDS ***
Dealt to hc agorist [8s 7d]
sluks: folds 
averzia: folds 
David peixe: folds 
blue52844: folds 
serde4nik: folds 
Uncalled bet ($0.01) returned to hc agorist
hc agorist collected $0.02 from pot
hc agorist: doesn't show hand 
*** SUMMARY ***
Total pot $0.02 | Rake $0 
Seat 1: blue52844 (button) folded before Flop (didn't bet)
Seat 2: serde4nik (small blind) folded before Flop
Seat 3: hc agorist (big blind) collected ($0.02)
Seat 4: sluks folded before Flop (didn't bet)
Seat 5: averzia folded before Flop (didn't bet)
Seat 6: David peixe folded before Flop (didn't bet)



PokerStars Zoom Hand #193768894797:  Hold'em No Limit ($0.01/$0.02) - 2018/11/27 0:50:33 CUST [2018/11/26 11:50:33 ET]
Table 'Halley' 6-max Seat #1 is the button
Seat 1: guitboxer ($2.91 in chips) 
Seat 2: daabr934 ($2.95 in chips) 
Seat 3: bbhzzz ($2.85 in chips) 
Seat 4: hc agorist ($4.28 in chips) 
Seat 5: StraightPR0 ($2.56 in chips) 
Seat 6: CEP}I{bIK ($1.84 in chips) 
daabr934: posts small blind $0.01
bbhzzz: posts big blind $0.02
*** HOLE CARDS ***
Dealt to hc agorist [Kh Jd]
hc agorist: raises $0.02 to $0.04
StraightPR0: folds 
CEP}I{bIK: folds 
guitboxer: folds 
daabr934: folds 
bbhzzz: calls $0.02
*** FLOP *** [7h Qc As]
bbhzzz: checks 
hc agorist: bets $0.07
bbhzzz: calls $0.07
*** TURN *** [7h Qc As] [Kd]
bbhzzz: checks 
hc agorist: checks 
*** RIVER *** [7h Qc As Kd] [9d]
bbhzzz: checks 
hc agorist: checks 
*** SHOW DOWN ***
bbhzzz: shows [2d Ah] (a pair of Aces)
hc agorist: mucks hand 
bbhzzz collected $0.22 from pot
*** SUMMARY ***
Total pot $0.23 | Rake $0.01 
Board [7h Qc As Kd 9d]
Seat 1: guitboxer (button) folded before Flop (didn't bet)
Seat 2: daabr934 (small blind) folded before Flop
Seat 3: bbhzzz (big blind) showed [2d Ah] and won ($0.22) with a pair of Aces
Seat 4: hc agorist mucked [Kh Jd]
Seat 5: StraightPR0 folded before Flop (didn't bet)
Seat 6: CEP}I{bIK folded before Flop (didn't bet)



PokerStars Zoom Hand #193768913729:  Hold'em No Limit ($0.01/$0.02) - 2018/11/27 0:51:06 CUST [2018/11/26 11:51:06 ET]
Table 'Halley' 6-max Seat #1 is the button
Seat 1: Mr-under-tam ($2.53 in chips) 
Seat 2: stupid_bear1 ($1.99 in chips) 
Seat 3: flex03041978 ($1.70 in chips) 
Seat 4: winnietoeter ($2.35 in chips) 
Seat 5: Cartman 8703 ($2.34 in chips) 
Seat 6: hc agorist ($4.17 in chips) 
stupid_bear1: posts small blind $0.01
flex03041978: posts big blind $0.02
*** HOLE CARDS ***
Dealt to hc agorist [Ad 6d]
winnietoeter: folds 
Cartman 8703: folds 
hc agorist: raises $0.02 to $0.04
Mr-under-tam: folds 
stupid_bear1: raises $0.08 to $0.12
flex03041978: folds 
hc agorist: calls $0.08
*** FLOP *** [Kh 9c Qh]
stupid_bear1: bets $0.13
hc agorist: folds 
Uncalled bet ($0.13) returned to stupid_bear1
stupid_bear1 collected $0.25 from pot
stupid_bear1: doesn't show hand 
*** SUMMARY ***
Total pot $0.26 | Rake $0.01 
Board [Kh 9c Qh]
Seat 1: Mr-under-tam (button) folded before Flop (didn't bet)
Seat 2: stupid_bear1 (small blind) collected ($0.25)
Seat 3: flex03041978 (big blind) folded before Flop
Seat 4: winnietoeter folded before Flop (didn't bet)
Seat 5: Cartman 8703 folded before Flop (didn't bet)
Seat 6: hc agorist folded on the Flop



PokerStars Zoom Hand #193768926482:  Hold'em No Limit ($0.01/$0.02) - 2018/11/27 0:51:28 CUST [2018/11/26 11:51:28 ET]
Table 'Halley' 6-max Seat #1 is the button
Seat 1: HareKrosh ($1.52 in chips) 
Seat 2: hc agorist ($4.05 in chips) 
Seat 3: giveTHEnutsS ($3.93 in chips) 
Seat 4: m3t1s ($5.48 in chips) 
Seat 5: TheD1nhoR10 ($0.99 in chips) 
Seat 6: SKFin ($1.76 in chips) 
hc agorist: posts small blind $0.01
giveTHEnutsS: posts big blind $0.02
*** HOLE CARDS ***
Dealt to hc agorist [Qh Qc]
m3t1s: folds 
TheD1nhoR10: folds 
SKFin: calls $0.02
HareKrosh: raises $0.13 to $0.15
hc agorist: raises $0.30 to $0.45
giveTHEnutsS: folds 
SKFin: folds 
HareKrosh: folds 
Uncalled bet ($0.30) returned to hc agorist
hc agorist collected $0.34 from pot
hc agorist: doesn't show hand 
*** SUMMARY ***
Total pot $0.34 | Rake $0 
Seat 1: HareKrosh (button) folded before Flop
Seat 2: hc agorist (small blind) collected ($0.34)
Seat 3: giveTHEnutsS (big blind) folded before Flop
Seat 4: m3t1s folded before Flop (didn't bet)
Seat 5: TheD1nhoR10 folded before Flop (didn't bet)
Seat 6: SKFin folded before Flop



PokerStars Zoom Hand #193768943375:  Hold'em No Limit ($0.01/$0.02) - 2018/11/27 0:51:58 CUST [2018/11/26 11:51:58 ET]
Table 'Halley' 6-max Seat #1 is the button
Seat 1: MaexelF ($2.01 in chips) 
Seat 2: tehBlub ($2.01 in chips) 
Seat 3: hc agorist ($4.24 in chips) 
Seat 4: vatteztaR* ($2 in chips) 
Seat 5: donklimp ($2.87 in chips) 
Seat 6: dedmoroz311 ($1.51 in chips) 
tehBlub: posts small blind $0.01
hc agorist: posts big blind $0.02
*** HOLE CARDS ***
Dealt to hc agorist [5d 7s]
vatteztaR*: folds 
donklimp: raises $0.04 to $0.06
dedmoroz311: calls $0.06
MaexelF: calls $0.06
tehBlub: folds 
hc agorist: folds 
*** FLOP *** [Qh Jh 5h]
donklimp: checks 
dedmoroz311: bets $0.10
MaexelF: folds 
donklimp: calls $0.10
*** TURN *** [Qh Jh 5h] [6d]
donklimp: checks 
dedmoroz311: bets $0.14
donklimp: folds 
Uncalled bet ($0.14) returned to dedmoroz311
dedmoroz311 collected $0.40 from pot
dedmoroz311: doesn't show hand 
*** SUMMARY ***
Total pot $0.41 | Rake $0.01 
Board [Qh Jh 5h 6d]
Seat 1: MaexelF (button) folded on the Flop
Seat 2: tehBlub (small blind) folded before Flop
Seat 3: hc agorist (big blind) folded before Flop
Seat 4: vatteztaR* folded before Flop (didn't bet)
Seat 5: donklimp folded on the Turn
Seat 6: dedmoroz311 collected ($0.40)



PokerStars Zoom Hand #193768946789:  Hold'em No Limit ($0.01/$0.02) - 2018/11/27 0:52:04 CUST [2018/11/26 11:52:04 ET]
Table 'Halley' 6-max Seat #1 is the button
Seat 1: Glivera77 ($1.73 in chips) 
Seat 2: degelcamus ($3.81 in chips) 
Seat 3: 06romm22 ($2.92 in chips) 
Seat 4: abatur0 ($0.82 in chips) 
Seat 5: hc agorist ($4.22 in chips) 
Seat 6: barakuda021 ($0.41 in chips) 
degelcamus: posts small blind $0.01
06romm22: posts big blind $0.02
*** HOLE CARDS ***
Dealt to hc agorist [7d 7h]
abatur0: folds 
hc agorist: raises $0.02 to $0.04
barakuda021: folds 
Glivera77: folds 
degelcamus: raises $0.12 to $0.16
06romm22: folds 
hc agorist: calls $0.12
*** FLOP *** [Jh Qd 4h]
degelcamus: bets $0.13
hc agorist: calls $0.13
*** TURN *** [Jh Qd 4h] [2d]
degelcamus: checks 
hc agorist: checks 
*** RIVER *** [Jh Qd 4h 2d] [9s]
degelcamus: checks 
hc agorist: checks 
*** SHOW DOWN ***
degelcamus: shows [Ad Kc] (high card Ace)
hc agorist: shows [7d 7h] (a pair of Sevens)
hc agorist collected $0.58 from pot
*** SUMMARY ***
Total pot $0.60 | Rake $0.02 
Board [Jh Qd 4h 2d 9s]
Seat 1: Glivera77 (button) folded before Flop (didn't bet)
Seat 2: degelcamus (small blind) showed [Ad Kc] and lost with high card Ace
Seat 3: 06romm22 (big blind) folded before Flop
Seat 4: abatur0 folded before Flop (didn't bet)
Seat 5: hc agorist showed [7d 7h] and won ($0.58) with a pair of Sevens
Seat 6: barakuda021 folded before Flop (didn't bet)



PokerStars Zoom Hand #193768981680:  Hold'em No Limit ($0.01/$0.02) - 2018/11/27 0:53:05 CUST [2018/11/26 11:53:05 ET]
Table 'Halley' 6-max Seat #1 is the button
Seat 1: sukisurova ($3.19 in chips) 
Seat 2: Rrripl ($1.10 in chips) 
Seat 3: Makogonov868 ($1.39 in chips) 
Seat 4: Roflpain ($3.24 in chips) 
Seat 5: don_energo2 ($2.59 in chips) 
Seat 6: hc agorist ($4.51 in chips) 
Rrripl: posts small blind $0.01
Makogonov868: posts big blind $0.02
*** HOLE CARDS ***
Dealt to hc agorist [Ac Th]
Roflpain: folds 
don_energo2: folds 
hc agorist: raises $0.04 to $0.06
sukisurova: folds 
Rrripl: folds 
Makogonov868: folds 
Uncalled bet ($0.04) returned to hc agorist
hc agorist collected $0.05 from pot
hc agorist: doesn't show hand 
*** SUMMARY ***
Total pot $0.05 | Rake $0 
Seat 1: sukisurova (button) folded before Flop (didn't bet)
Seat 2: Rrripl (small blind) folded before Flop
Seat 3: Makogonov868 (big blind) folded before Flop
Seat 4: Roflpain folded before Flop (didn't bet)
Seat 5: don_energo2 folded before Flop (didn't bet)
Seat 6: hc agorist collected ($0.05)



PokerStars Zoom Hand #193768995508:  Hold'em No Limit ($0.01/$0.02) - 2018/11/27 0:53:29 CUST [2018/11/26 11:53:29 ET]
Table 'Halley' 6-max Seat #1 is the button
Seat 1: hc agorist ($4.54 in chips) 
Seat 2: Akutagawa ($2 in chips) 
Seat 3: Overdose93 ($2 in chips) 
Seat 4: Teckhaus ($2 in chips) 
Seat 5: SILK207 ($3.44 in chips) 
Seat 6: Kala77 ($2.24 in chips) 
Akutagawa: posts small blind $0.01
Overdose93: posts big blind $0.02
*** HOLE CARDS ***
Dealt to hc agorist [Ts Kd]
Teckhaus: folds 
SILK207: raises $0.04 to $0.06
Kala77: folds 
hc agorist: calls $0.06
Akutagawa: folds 
Overdose93: folds 
*** FLOP *** [4c Ah Ad]
SILK207: checks 
hc agorist: checks 
*** TURN *** [4c Ah Ad] [5d]
SILK207: bets $0.06
hc agorist: calls $0.06
*** RIVER *** [4c Ah Ad 5d] [8d]
SILK207: checks 
hc agorist: bets $0.46
SILK207: folds 
Uncalled bet ($0.46) returned to hc agorist
hc agorist collected $0.26 from pot
hc agorist: doesn't show hand 
*** SUMMARY ***
Total pot $0.27 | Rake $0.01 
Board [4c Ah Ad 5d 8d]
Seat 1: hc agorist (button) collected ($0.26)
Seat 2: Akutagawa (small blind) folded before Flop
Seat 3: Overdose93 (big blind) folded before Flop
Seat 4: Teckhaus folded before Flop (didn't bet)
Seat 5: SILK207 folded on the River
Seat 6: Kala77 folded before Flop (didn't bet)



PokerStars Zoom Hand #193769023524:  Hold'em No Limit ($0.01/$0.02) - 2018/11/27 0:54:18 CUST [2018/11/26 11:54:18 ET]
Table 'Halley' 6-max Seat #1 is the button
Seat 1: malei977 ($2.14 in chips) 
Seat 2: GRizlik14 ($2.02 in chips) 
Seat 3: MSchmitz555 ($3.17 in chips) 
Seat 4: hc agorist ($4.67 in chips) 
Seat 5: 3Iver's3 ($2.19 in chips) 
Seat 6: Rus. Pioneer ($2.02 in chips) 
GRizlik14: posts small blind $0.01
MSchmitz555: posts big blind $0.02
*** HOLE CARDS ***
Dealt to hc agorist [5c 4c]
hc agorist: raises $0.04 to $0.06
3Iver's3: folds 
Rus. Pioneer: folds 
malei977: folds 
GRizlik14: folds 
MSchmitz555: calls $0.04
*** FLOP *** [Ad Kc Ts]
MSchmitz555: checks 
hc agorist: bets $0.10
MSchmitz555: folds 
Uncalled bet ($0.10) returned to hc agorist
hc agorist collected $0.13 from pot
hc agorist: doesn't show hand 
*** SUMMARY ***
Total pot $0.13 | Rake $0 
Board [Ad Kc Ts]
Seat 1: malei977 (button) folded before Flop (didn't bet)
Seat 2: GRizlik14 (small blind) folded before Flop
Seat 3: MSchmitz555 (big blind) folded on the Flop
Seat 4: hc agorist collected ($0.13)
Seat 5: 3Iver's3 folded before Flop (didn't bet)
Seat 6: Rus. Pioneer folded before Flop (didn't bet)



PokerStars Zoom Hand #193769020634:  Hold'em No Limit ($0.01/$0.02) - 2018/11/27 0:54:13 CUST [2018/11/26 11:54:13 ET]
Table 'Halley' 6-max Seat #1 is the button
Seat 1: craw005 ($1.97 in chips) 
Seat 2: hc agorist ($4.68 in chips) 
Seat 3: guitboxer ($5.01 in chips) 
Seat 4: AGT1960 ($3.65 in chips) 
Seat 5: Williwacker9 ($2.21 in chips) 
Seat 6: _Arslan_AK ($2.23 in chips) 
hc agorist: posts small blind $0.01
guitboxer: posts big blind $0.02
*** HOLE CARDS ***
Dealt to hc agorist [8d 2c]
AGT1960: raises $0.02 to $0.04
Williwacker9: folds 
_Arslan_AK: calls $0.04
craw005: calls $0.04
hc agorist: folds 
guitboxer: calls $0.02
*** FLOP *** [6s 5d 9s]
guitboxer: checks 
AGT1960: checks 
_Arslan_AK: bets $0.16
craw005: folds 
guitboxer: folds 
AGT1960: folds 
Uncalled bet ($0.16) returned to _Arslan_AK
_Arslan_AK collected $0.16 from pot
_Arslan_AK: doesn't show hand 
*** SUMMARY ***
Total pot $0.17 | Rake $0.01 
Board [6s 5d 9s]
Seat 1: craw005 (button) folded on the Flop
Seat 2: hc agorist (small blind) folded before Flop
Seat 3: guitboxer (big blind) folded on the Flop
Seat 4: AGT1960 folded on the Flop
Seat 5: Williwacker9 folded before Flop (didn't bet)
Seat 6: _Arslan_AK collected ($0.16)



PokerStars Zoom Hand #193769035486:  Hold'em No Limit ($0.01/$0.02) - 2018/11/27 0:54:39 CUST [2018/11/26 11:54:39 ET]
Table 'Halley' 6-max Seat #1 is the button
Seat 1: HomosapieN55 ($2.17 in chips) 
Seat 2: markiz655 ($2.27 in chips) 
Seat 3: COLTZLI ($1.60 in chips) 
Seat 4: easylavandos ($2.04 in chips) 
Seat 5: hc agorist ($4.74 in chips) 
Seat 6: averzia ($2 in chips) 
markiz655: posts small blind $0.01
COLTZLI: posts big blind $0.02
*** HOLE CARDS ***
Dealt to hc agorist [3h Tc]
easylavandos: folds 
hc agorist: folds 
averzia: folds 
HomosapieN55: folds 
markiz655: folds 
Uncalled bet ($0.01) returned to COLTZLI
COLTZLI collected $0.02 from pot
COLTZLI: doesn't show hand 
*** SUMMARY ***
Total pot $0.02 | Rake $0 
Seat 1: HomosapieN55 (button) folded before Flop (didn't bet)
Seat 2: markiz655 (small blind) folded before Flop
Seat 3: COLTZLI (big blind) collected ($0.02)
Seat 4: easylavandos folded before Flop (didn't bet)
Seat 5: hc agorist folded before Flop (didn't bet)
Seat 6: averzia folded before Flop (didn't bet)



PokerStars Zoom Hand #193769038340:  Hold'em No Limit ($0.01/$0.02) - 2018/11/27 0:54:44 CUST [2018/11/26 11:54:44 ET]
Table 'Halley' 6-max Seat #1 is the button
Seat 1: akurat111 ($1.78 in chips) 
Seat 2: sinster_ca85 ($4.60 in chips) 
Seat 3: pocketfetish ($5.81 in chips) 
Seat 4: hc agorist ($4.74 in chips) 
Seat 5: dawavey ($1.11 in chips) 
Seat 6: Bynek21 ($2.60 in chips) 
sinster_ca85: posts small blind $0.01
pocketfetish: posts big blind $0.02
*** HOLE CARDS ***
Dealt to hc agorist [5d 6d]
hc agorist: raises $0.04 to $0.06
dawavey: folds 
Bynek21: folds 
akurat111: raises $0.10 to $0.16
sinster_ca85: folds 
pocketfetish: folds 
hc agorist: folds 
Uncalled bet ($0.10) returned to akurat111
akurat111 collected $0.15 from pot
akurat111: doesn't show hand 
*** SUMMARY ***
Total pot $0.15 | Rake $0 
Seat 1: akurat111 (button) collected ($0.15)
Seat 2: sinster_ca85 (small blind) folded before Flop
Seat 3: pocketfetish (big blind) folded before Flop
Seat 4: hc agorist folded before Flop
Seat 5: dawavey folded before Flop (didn't bet)
Seat 6: Bynek21 folded before Flop (didn't bet)



PokerStars Zoom Hand #193769048605:  Hold'em No Limit ($0.01/$0.02) - 2018/11/27 0:55:02 CUST [2018/11/26 11:55:02 ET]
Table 'Halley' 6-max Seat #1 is the button
Seat 1: rostis22 ($2.12 in chips) 
Seat 2: Rhatree ($2.05 in chips) 
Seat 3: hc agorist ($4.68 in chips) 
Seat 4: nonsensever ($9.55 in chips) 
Seat 5: SKFin ($1.96 in chips) 
Seat 6: bliznec828 ($2.41 in chips) 
Rhatree: posts small blind $0.01
hc agorist: posts big blind $0.02
*** HOLE CARDS ***
Dealt to hc agorist [6c 6s]
nonsensever: raises $0.03 to $0.05
SKFin: folds 
bliznec828: folds 
rostis22: folds 
Rhatree: calls $0.04
hc agorist: calls $0.03
*** FLOP *** [4s 8h 9c]
Rhatree: checks 
hc agorist: checks 
nonsensever: checks 
*** TURN *** [4s 8h 9c] [7d]
Rhatree: bets $0.05
hc agorist: calls $0.05
nonsensever: folds 
*** RIVER *** [4s 8h 9c 7d] [Jd]
Rhatree: bets $0.08
hc agorist: folds 
Uncalled bet ($0.08) returned to Rhatree
Rhatree collected $0.24 from pot
Rhatree: doesn't show hand 
*** SUMMARY ***
Total pot $0.25 | Rake $0.01 
Board [4s 8h 9c 7d Jd]
Seat 1: rostis22 (button) folded before Flop (didn't bet)
Seat 2: Rhatree (small blind) collected ($0.24)
Seat 3: hc agorist (big blind) folded on the River
Seat 4: nonsensever folded on the Turn
Seat 5: SKFin folded before Flop (didn't bet)
Seat 6: bliznec828 folded before Flop (didn't bet)



PokerStars Zoom Hand #193769073736:  Hold'em No Limit ($0.01/$0.02) - 2018/11/27 0:55:54 CUST [2018/11/26 11:55:54 ET]
Table 'Halley' 6-max Seat #1 is the button
Seat 1: hc agorist ($4.58 in chips) 
Seat 2: COURT JES264 ($4.33 in chips) 
Seat 3: Rightful ($2.60 in chips) 
Seat 4: zergmiky ($2.14 in chips) 
Seat 5: f44444 ($2.13 in chips) 
Seat 6: Nikich_ua ($2 in chips) 
COURT JES264: posts small blind $0.01
Rightful: posts big blind $0.02
*** HOLE CARDS ***
Dealt to hc agorist [6s 3d]
zergmiky: raises $0.04 to $0.06
f44444: folds 
Nikich_ua: folds 
hc agorist: folds 
COURT JES264: folds 
Rightful: raises $0.12 to $0.18
zergmiky: raises $0.55 to $0.73
Rightful: calls $0.55
*** FLOP *** [4h 8c Jh]
Rightful: checks 
zergmiky: bets $1.41 and is all-in
Rightful: calls $1.41
*** TURN *** [4h 8c Jh] [Jc]
*** RIVER *** [4h 8c Jh Jc] [Tc]
*** SHOW DOWN ***
Rightful: shows [Qc Qd] (two pair, Queens and Jacks)
zergmiky: shows [Ks Kc] (two pair, Kings and Jacks)
zergmiky collected $4.14 from pot
*** SUMMARY ***
Total pot $4.29 | Rake $0.15 
Board [4h 8c Jh Jc Tc]
Seat 1: hc agorist (button) folded before Flop (didn't bet)
Seat 2: COURT JES264 (small blind) folded before Flop
Seat 3: Rightful (big blind) showed [Qc Qd] and lost with two pair, Queens and Jacks
Seat 4: zergmiky showed [Ks Kc] and won ($4.14) with two pair, Kings and Jacks
Seat 5: f44444 folded before Flop (didn't bet)
Seat 6: Nikich_ua folded before Flop (didn't bet)



PokerStars Zoom Hand #193769076482:  Hold'em No Limit ($0.01/$0.02) - 2018/11/27 0:56:00 CUST [2018/11/26 11:56:00 ET]
Table 'Halley' 6-max Seat #1 is the button
Seat 1: cpatom4 ($2.14 in chips) 
Seat 2: gaeppakse ($2 in chips) 
Seat 3: GetAtMeKid ($1 in chips) 
Seat 4: hc agorist ($4.58 in chips) 
Seat 5: bbil300 ($2.46 in chips) 
Seat 6: AGT1960 ($4.27 in chips) 
gaeppakse: posts small blind $0.01
GetAtMeKid: posts big blind $0.02
*** HOLE CARDS ***
Dealt to hc agorist [9s Ks]
hc agorist: raises $0.04 to $0.06
bbil300: folds 
AGT1960: calls $0.06
cpatom4: folds 
gaeppakse: folds 
GetAtMeKid: folds 
*** FLOP *** [3c 6s 7d]
hc agorist: bets $0.05
AGT1960: calls $0.05
*** TURN *** [3c 6s 7d] [8c]
hc agorist: checks 
AGT1960: bets $0.18
hc agorist: calls $0.18
*** RIVER *** [3c 6s 7d 8c] [9c]
hc agorist: checks 
AGT1960: bets $0.39
hc agorist: folds 
Uncalled bet ($0.39) returned to AGT1960
AGT1960 collected $0.59 from pot
AGT1960: doesn't show hand 
*** SUMMARY ***
Total pot $0.61 | Rake $0.02 
Board [3c 6s 7d 8c 9c]
Seat 1: cpatom4 (button) folded before Flop (didn't bet)
Seat 2: gaeppakse (small blind) folded before Flop
Seat 3: GetAtMeKid (big blind) folded before Flop
Seat 4: hc agorist folded on the River
Seat 5: bbil300 folded before Flop (didn't bet)
Seat 6: AGT1960 collected ($0.59)



PokerStars Zoom Hand #193769119617:  Hold'em No Limit ($0.01/$0.02) - 2018/11/27 0:57:32 CUST [2018/11/26 11:57:32 ET]
Table 'Halley' 6-max Seat #1 is the button
Seat 1: Kokosya ($3.08 in chips) 
Seat 2: SASHA030683 ($1.85 in chips) 
Seat 3: Lady Laine ($0.82 in chips) 
Seat 4: JBD101 ($3.29 in chips) 
Seat 5: pneto ($7.15 in chips) 
Seat 6: hc agorist ($4.28 in chips) 
SASHA030683: posts small blind $0.01
Lady Laine: posts big blind $0.02
*** HOLE CARDS ***
Dealt to hc agorist [Ts 9s]
JBD101: folds 
pneto: folds 
hc agorist: raises $0.02 to $0.04
Kokosya: folds 
SASHA030683: folds 
Lady Laine: calls $0.02
*** FLOP *** [Qh 9h 8c]
Lady Laine: bets $0.05
hc agorist: calls $0.05
*** TURN *** [Qh 9h 8c] [3s]
Lady Laine: bets $0.09
hc agorist: calls $0.09
*** RIVER *** [Qh 9h 8c 3s] [Tc]
Lady Laine: bets $0.18
hc agorist: calls $0.18
*** SHOW DOWN ***
Lady Laine: shows [Qs Ac] (a pair of Queens)
hc agorist: shows [Ts 9s] (two pair, Tens and Nines)
hc agorist collected $0.70 from pot
*** SUMMARY ***
Total pot $0.73 | Rake $0.03 
Board [Qh 9h 8c 3s Tc]
Seat 1: Kokosya (button) folded before Flop (didn't bet)
Seat 2: SASHA030683 (small blind) folded before Flop
Seat 3: Lady Laine (big blind) showed [Qs Ac] and lost with a pair of Queens
Seat 4: JBD101 folded before Flop (didn't bet)
Seat 5: pneto folded before Flop (didn't bet)
Seat 6: hc agorist showed [Ts 9s] and won ($0.70) with two pair, Tens and Nines



PokerStars Zoom Hand #193769133295:  Hold'em No Limit ($0.01/$0.02) - 2018/11/27 0:58:01 CUST [2018/11/26 11:58:01 ET]
Table 'Halley' 6-max Seat #1 is the button
Seat 1: clewric ($1.50 in chips) 
Seat 2: grajekTeo ($5.42 in chips) 
Seat 3: hc agorist ($4.62 in chips) 
Seat 4: sinster_ca85 ($4.81 in chips) 
Seat 5: aEROplan-JR ($13.69 in chips) 
Seat 6: Maverick_JPR ($2.04 in chips) 
grajekTeo: posts small blind $0.01
hc agorist: posts big blind $0.02
*** HOLE CARDS ***
Dealt to hc agorist [Ad Jc]
sinster_ca85: folds 
aEROplan-JR: folds 
Maverick_JPR: folds 
clewric: folds 
grajekTeo: raises $0.03 to $0.05
hc agorist: raises $0.10 to $0.15
grajekTeo: folds 
Uncalled bet ($0.10) returned to hc agorist
hc agorist collected $0.10 from pot
hc agorist: doesn't show hand 
*** SUMMARY ***
Total pot $0.10 | Rake $0 
Seat 1: clewric (button) folded before Flop (didn't bet)
Seat 2: grajekTeo (small blind) folded before Flop
Seat 3: hc agorist (big blind) collected ($0.10)
Seat 4: sinster_ca85 folded before Flop (didn't bet)
Seat 5: aEROplan-JR folded before Flop (didn't bet)
Seat 6: Maverick_JPR folded before Flop (didn't bet)



PokerStars Zoom Hand #193769117279:  Hold'em No Limit ($0.01/$0.02) - 2018/11/27 0:57:27 CUST [2018/11/26 11:57:27 ET]
Table 'Halley' 6-max Seat #1 is the button
Seat 1: penzkocsi ($2.09 in chips) 
Seat 2: hc agorist ($4.29 in chips) 
Seat 3: strimmm0 ($5.55 in chips) 
Seat 4: lisicca ($0.42 in chips) 
Seat 5: cpatom4 ($2.26 in chips) 
Seat 6: SKFin ($3.07 in chips) 
hc agorist: posts small blind $0.01
strimmm0: posts big blind $0.02
*** HOLE CARDS ***
Dealt to hc agorist [Qs 3h]
lisicca: calls $0.02
cpatom4: folds 
SKFin: calls $0.02
penzkocsi: folds 
hc agorist: folds 
strimmm0: checks 
*** FLOP *** [Tc 7d 9d]
strimmm0: checks 
lisicca: bets $0.02
SKFin: raises $0.06 to $0.08
strimmm0: folds 
lisicca: calls $0.06
*** TURN *** [Tc 7d 9d] [Jd]
lisicca: bets $0.32 and is all-in
SKFin: folds 
Uncalled bet ($0.32) returned to lisicca
lisicca collected $0.22 from pot
lisicca: doesn't show hand 
*** SUMMARY ***
Total pot $0.23 | Rake $0.01 
Board [Tc 7d 9d Jd]
Seat 1: penzkocsi (button) folded before Flop (didn't bet)
Seat 2: hc agorist (small blind) folded before Flop
Seat 3: strimmm0 (big blind) folded on the Flop
Seat 4: lisicca collected ($0.22)
Seat 5: cpatom4 folded before Flop (didn't bet)
Seat 6: SKFin folded on the Turn



PokerStars Zoom Hand #193769142309:  Hold'em No Limit ($0.01/$0.02) - 2018/11/27 0:58:20 CUST [2018/11/26 11:58:20 ET]
Table 'Halley' 6-max Seat #1 is the button
Seat 1: osiileaz ($5.14 in chips) 
Seat 2: P.Cogito ($2.95 in chips) 
Seat 3: Olga Berezina ($2 in chips) 
Seat 4: JBD101 ($3.20 in chips) 
Seat 5: Woolfman23 ($3.63 in chips) 
Seat 6: hc agorist ($4.67 in chips) 
P.Cogito: posts small blind $0.01
Olga Berezina: posts big blind $0.02
*** HOLE CARDS ***
Dealt to hc agorist [Ac 7c]
JBD101: folds 
Woolfman23: raises $0.04 to $0.06
hc agorist: raises $0.12 to $0.18
osiileaz: folds 
P.Cogito: folds 
Olga Berezina: folds 
Woolfman23: folds 
Uncalled bet ($0.12) returned to hc agorist
hc agorist collected $0.15 from pot
hc agorist: doesn't show hand 
*** SUMMARY ***
Total pot $0.15 | Rake $0 
Seat 1: osiileaz (button) folded before Flop (didn't bet)
Seat 2: P.Cogito (small blind) folded before Flop
Seat 3: Olga Berezina (big blind) folded before Flop
Seat 4: JBD101 folded before Flop (didn't bet)
Seat 5: Woolfman23 folded before Flop
Seat 6: hc agorist collected ($0.15)



PokerStars Zoom Hand #193769157134:  Hold'em No Limit ($0.01/$0.02) - 2018/11/27 0:58:52 CUST [2018/11/26 11:58:52 ET]
Table 'Halley' 6-max Seat #1 is the button
Seat 1: hc agorist ($4.75 in chips) 
Seat 2: SKFin ($2.90 in chips) 
Seat 3: RUZZZZZZZZ ($3.96 in chips) 
Seat 4: domosedka4 ($1.83 in chips) 
Seat 5: srw34 ($1.93 in chips) 
Seat 6: guitboxer ($5.84 in chips) 
SKFin: posts small blind $0.01
RUZZZZZZZZ: posts big blind $0.02
*** HOLE CARDS ***
Dealt to hc agorist [9d As]
domosedka4: folds 
srw34: raises $0.02 to $0.04
guitboxer: folds 
hc agorist: raises $0.11 to $0.15
SKFin: folds 
RUZZZZZZZZ: folds 
srw34: folds 
Uncalled bet ($0.11) returned to hc agorist
hc agorist collected $0.11 from pot
hc agorist: doesn't show hand 
*** SUMMARY ***
Total pot $0.11 | Rake $0 
Seat 1: hc agorist (button) collected ($0.11)
Seat 2: SKFin (small blind) folded before Flop
Seat 3: RUZZZZZZZZ (big blind) folded before Flop
Seat 4: domosedka4 folded before Flop (didn't bet)
Seat 5: srw34 folded before Flop
Seat 6: guitboxer folded before Flop (didn't bet)



PokerStars Zoom Hand #193769155272:  Hold'em No Limit ($0.01/$0.02) - 2018/11/27 0:58:48 CUST [2018/11/26 11:58:48 ET]
Table 'Halley' 6-max Seat #1 is the button
Seat 1: rr-emco7 ($0.77 in chips) 
Seat 2: hc agorist ($4.76 in chips) 
Seat 3: Vajdalf92 ($2.09 in chips) 
Seat 4: zhx9001 ($2.16 in chips) 
Seat 5: Doktor Yes ($2.97 in chips) 
Seat 6: Kir Paal ($2.63 in chips) 
hc agorist: posts small blind $0.01
Vajdalf92: posts big blind $0.02
*** HOLE CARDS ***
Dealt to hc agorist [3d 5c]
zhx9001: folds 
Doktor Yes: calls $0.02
Kir Paal: raises $0.06 to $0.08
rr-emco7: folds 
hc agorist: folds 
Vajdalf92: folds 
Doktor Yes: calls $0.06
*** FLOP *** [7d Qc 4d]
Doktor Yes: checks 
Kir Paal: bets $0.15
Doktor Yes: folds 
Uncalled bet ($0.15) returned to Kir Paal
Kir Paal collected $0.18 from pot
Kir Paal: doesn't show hand 
*** SUMMARY ***
Total pot $0.19 | Rake $0.01 
Board [7d Qc 4d]
Seat 1: rr-emco7 (button) folded before Flop (didn't bet)
Seat 2: hc agorist (small blind) folded before Flop
Seat 3: Vajdalf92 (big blind) folded before Flop
Seat 4: zhx9001 folded before Flop (didn't bet)
Seat 5: Doktor Yes folded on the Flop
Seat 6: Kir Paal collected ($0.18)



PokerStars Zoom Hand #193769165638:  Hold'em No Limit ($0.01/$0.02) - 2018/11/27 0:59:10 CUST [2018/11/26 11:59:10 ET]
Table 'Halley' 6-max Seat #1 is the button
Seat 1: PsychoticBR ($3.06 in chips) 
Seat 2: Kokosya ($2.01 in chips) 
Seat 3: qk rodriguez ($2.11 in chips) 
Seat 4: Glok112i ($1.51 in chips) 
Seat 5: hc agorist ($4.82 in chips) 
Seat 6: Bruniin_F ($2.94 in chips) 
Kokosya: posts small blind $0.01
qk rodriguez: posts big blind $0.02
*** HOLE CARDS ***
Dealt to hc agorist [3d 6h]
Glok112i: folds 
hc agorist: folds 
Bruniin_F: raises $0.04 to $0.06
PsychoticBR: folds 
Kokosya: folds 
qk rodriguez: folds 
Uncalled bet ($0.04) returned to Bruniin_F
Bruniin_F collected $0.05 from pot
Bruniin_F: doesn't show hand 
*** SUMMARY ***
Total pot $0.05 | Rake $0 
Seat 1: PsychoticBR (button) folded before Flop (didn't bet)
Seat 2: Kokosya (small blind) folded before Flop
Seat 3: qk rodriguez (big blind) folded before Flop
Seat 4: Glok112i folded before Flop (didn't bet)
Seat 5: hc agorist folded before Flop (didn't bet)
Seat 6: Bruniin_F collected ($0.05)



PokerStars Zoom Hand #193769168067:  Hold'em No Limit ($0.01/$0.02) - 2018/11/27 0:59:15 CUST [2018/11/26 11:59:15 ET]
Table 'Halley' 6-max Seat #1 is the button
Seat 1: minami315z ($3.73 in chips) 
Seat 2: No_C0mm3nT ($1.42 in chips) 
Seat 3: AASkinnyJohnAA ($1.88 in chips) 
Seat 4: lucky_4it ($2.02 in chips) 
Seat 5: hc agorist ($4.82 in chips) 
Seat 6: CEP}I{bIK ($1.97 in chips) 
No_C0mm3nT: posts small blind $0.01
AASkinnyJohnAA: posts big blind $0.02
*** HOLE CARDS ***
Dealt to hc agorist [6c 2s]
lucky_4it: folds 
hc agorist: folds 
CEP}I{bIK: raises $0.02 to $0.04
minami315z: raises $0.08 to $0.12
No_C0mm3nT: folds 
AASkinnyJohnAA: folds 
CEP}I{bIK: calls $0.08
*** FLOP *** [9s Ts Jd]
CEP}I{bIK: checks 
minami315z: bets $0.13
CEP}I{bIK: calls $0.13
*** TURN *** [9s Ts Jd] [Qc]
CEP}I{bIK: checks 
minami315z: checks 
*** RIVER *** [9s Ts Jd Qc] [7s]
CEP}I{bIK: bets $0.37
minami315z: folds 
Uncalled bet ($0.37) returned to CEP}I{bIK
CEP}I{bIK collected $0.51 from pot
CEP}I{bIK: doesn't show hand 
*** SUMMARY ***
Total pot $0.53 | Rake $0.02 
Board [9s Ts Jd Qc 7s]
Seat 1: minami315z (button) folded on the River
Seat 2: No_C0mm3nT (small blind) folded before Flop
Seat 3: AASkinnyJohnAA (big blind) folded before Flop
Seat 4: lucky_4it folded before Flop (didn't bet)
Seat 5: hc agorist folded before Flop (didn't bet)
Seat 6: CEP}I{bIK collected ($0.51)



PokerStars Zoom Hand #193769170404:  Hold'em No Limit ($0.01/$0.02) - 2018/11/27 0:59:20 CUST [2018/11/26 11:59:20 ET]
Table 'Halley' 6-max Seat #1 is the button
Seat 1: Shuler 17 ($2.04 in chips) 
Seat 2: bbhzzz ($2.06 in chips) 
Seat 3: Gamer577 ($2.46 in chips) 
Seat 4: simple s0o ($2.26 in chips) 
Seat 5: StrikeG312 ($2.52 in chips) 
Seat 6: hc agorist ($4.82 in chips) 
bbhzzz: posts small blind $0.01
Gamer577: posts big blind $0.02
*** HOLE CARDS ***
Dealt to hc agorist [9d Th]
simple s0o: folds 
StrikeG312: folds 
hc agorist: raises $0.04 to $0.06
Shuler 17: calls $0.06
bbhzzz: folds 
Gamer577: folds 
*** FLOP *** [5d 8d 2s]
hc agorist: bets $0.05
Shuler 17: calls $0.05
*** TURN *** [5d 8d 2s] [Td]
hc agorist: checks 
Shuler 17: checks 
*** RIVER *** [5d 8d 2s Td] [Tc]
hc agorist: bets $0.36
Shuler 17: folds 
Uncalled bet ($0.36) returned to hc agorist
hc agorist collected $0.24 from pot
hc agorist: doesn't show hand 
*** SUMMARY ***
Total pot $0.25 | Rake $0.01 
Board [5d 8d 2s Td Tc]
Seat 1: Shuler 17 (button) folded on the River
Seat 2: bbhzzz (small blind) folded before Flop
Seat 3: Gamer577 (big blind) folded before Flop
Seat 4: simple s0o folded before Flop (didn't bet)
Seat 5: StrikeG312 folded before Flop (didn't bet)
Seat 6: hc agorist collected ($0.24)



PokerStars Zoom Hand #193769185568:  Hold'em No Limit ($0.01/$0.02) - 2018/11/27 0:59:52 CUST [2018/11/26 11:59:52 ET]
Table 'Halley' 6-max Seat #1 is the button
Seat 1: Mart1sha ($0.97 in chips) 
Seat 2: David peixe ($4.36 in chips) 
Seat 3: hc agorist ($4.95 in chips) 
Seat 4: shakal7140 ($1.03 in chips) 
Seat 5: RIMMM867 ($0.79 in chips) 
Seat 6: piownu ($2.03 in chips) 
David peixe: posts small blind $0.01
hc agorist: posts big blind $0.02
*** HOLE CARDS ***
Dealt to hc agorist [4c Qc]
shakal7140: calls $0.02
RIMMM867: folds 
piownu: folds 
Mart1sha: folds 
David peixe: raises $0.06 to $0.08
hc agorist: folds 
shakal7140: calls $0.06
*** FLOP *** [Qd Js 6s]
David peixe: checks 
shakal7140: bets $0.08
David peixe: folds 
Uncalled bet ($0.08) returned to shakal7140
shakal7140 collected $0.17 from pot
shakal7140: doesn't show hand 
*** SUMMARY ***
Total pot $0.18 | Rake $0.01 
Board [Qd Js 6s]
Seat 1: Mart1sha (button) folded before Flop (didn't bet)
Seat 2: David peixe (small blind) folded on the Flop
Seat 3: hc agorist (big blind) folded before Flop
Seat 4: shakal7140 collected ($0.17)
Seat 5: RIMMM867 folded before Flop (didn't bet)
Seat 6: piownu folded before Flop (didn't bet)



PokerStars Zoom Hand #193769190228:  Hold'em No Limit ($0.01/$0.02) - 2018/11/27 1:00:02 CUST [2018/11/26 12:00:02 ET]
Table 'Halley' 6-max Seat #1 is the button
Seat 1: hc agorist ($4.93 in chips) 
Seat 2: Sochizoiy ($2.56 in chips) 
Seat 3: ravemaster-z ($2.14 in chips) 
Seat 4: Flootyn ($2.54 in chips) 
Seat 5: bliznec828 ($2.41 in chips) 
Seat 6: 3Iver's3 ($3.39 in chips) 
Sochizoiy: posts small blind $0.01
ravemaster-z: posts big blind $0.02
*** HOLE CARDS ***
Dealt to hc agorist [3c Jc]
Flootyn: folds 
bliznec828: folds 
3Iver's3: folds 
hc agorist: raises $0.02 to $0.04
Sochizoiy: folds 
ravemaster-z: folds 
Uncalled bet ($0.02) returned to hc agorist
hc agorist collected $0.05 from pot
hc agorist: doesn't show hand 
*** SUMMARY ***
Total pot $0.05 | Rake $0 
Seat 1: hc agorist (button) collected ($0.05)
Seat 2: Sochizoiy (small blind) folded before Flop
Seat 3: ravemaster-z (big blind) folded before Flop
Seat 4: Flootyn folded before Flop (didn't bet)
Seat 5: bliznec828 folded before Flop (didn't bet)
Seat 6: 3Iver's3 folded before Flop (didn't bet)



PokerStars Zoom Hand #193769198168:  Hold'em No Limit ($0.01/$0.02) - 2018/11/27 1:00:18 CUST [2018/11/26 12:00:18 ET]
Table 'Halley' 6-max Seat #1 is the button
Seat 1: ForHistory ($2 in chips) 
Seat 2: hc agorist ($4.96 in chips) 
Seat 3: undertom ($2.77 in chips) 
Seat 4: hsvdote ($2.28 in chips) 
Seat 5: marta328 ($2.18 in chips) 
Seat 6: dynia1993 ($0.86 in chips) 
hc agorist: posts small blind $0.01
undertom: posts big blind $0.02
*** HOLE CARDS ***
Dealt to hc agorist [Ah Ad]
hsvdote: raises $0.03 to $0.05
marta328: folds 
dynia1993: calls $0.05
ForHistory: folds 
hc agorist: raises $0.20 to $0.25
undertom: folds 
hsvdote: folds 
dynia1993: folds 
Uncalled bet ($0.20) returned to hc agorist
hc agorist collected $0.17 from pot
hc agorist: doesn't show hand 
*** SUMMARY ***
Total pot $0.17 | Rake $0 
Seat 1: ForHistory (button) folded before Flop (didn't bet)
Seat 2: hc agorist (small blind) collected ($0.17)
Seat 3: undertom (big blind) folded before Flop
Seat 4: hsvdote folded before Flop
Seat 5: marta328 folded before Flop (didn't bet)
Seat 6: dynia1993 folded before Flop



PokerStars Zoom Hand #193769214534:  Hold'em No Limit ($0.01/$0.02) - 2018/11/27 1:00:51 CUST [2018/11/26 12:00:51 ET]
Table 'Halley' 6-max Seat #1 is the button
Seat 1: Coffeatus ($2.23 in chips) 
Seat 2: m@xim25 ($2 in chips) 
Seat 3: craven7777 ($3.99 in chips) 
Seat 4: hc agorist ($5.08 in chips) 
Seat 5: shveg77 ($2.31 in chips) 
Seat 6: CheekyEchos ($2.05 in chips) 
m@xim25: posts small blind $0.01
craven7777: posts big blind $0.02
*** HOLE CARDS ***
Dealt to hc agorist [Ks 4s]
hc agorist: raises $0.02 to $0.04
shveg77: folds 
CheekyEchos: raises $0.11 to $0.15
Coffeatus: folds 
m@xim25: folds 
craven7777: folds 
hc agorist: folds 
Uncalled bet ($0.11) returned to CheekyEchos
CheekyEchos collected $0.11 from pot
CheekyEchos: doesn't show hand 
*** SUMMARY ***
Total pot $0.11 | Rake $0 
Seat 1: Coffeatus (button) folded before Flop (didn't bet)
Seat 2: m@xim25 (small blind) folded before Flop
Seat 3: craven7777 (big blind) folded before Flop
Seat 4: hc agorist folded before Flop
Seat 5: shveg77 folded before Flop (didn't bet)
Seat 6: CheekyEchos collected ($0.11)



PokerStars Zoom Hand #193769224382:  Hold'em No Limit ($0.01/$0.02) - 2018/11/27 1:01:10 CUST [2018/11/26 12:01:10 ET]
Table 'Halley' 6-max Seat #1 is the button
Seat 1: Flootyn ($2.12 in chips) 
Seat 2: ZeusCMR ($2.03 in chips) 
Seat 3: BadBoy-PokStars ($2 in chips) 
Seat 4: hc agorist ($5.04 in chips) 
Seat 5: Flok1TTFU ($1.90 in chips) 
Seat 6: Elmisantropo ($1.53 in chips) 
ZeusCMR: posts small blind $0.01
BadBoy-PokStars: posts big blind $0.02
*** HOLE CARDS ***
Dealt to hc agorist [Tc 6h]
hc agorist: folds 
Flok1TTFU: folds 
Elmisantropo: folds 
Flootyn: raises $0.03 to $0.05
ZeusCMR: raises $0.05 to $0.10
BadBoy-PokStars: folds 
Flootyn: calls $0.05
*** FLOP *** [5c 2d Kd]
ZeusCMR: bets $0.11
Flootyn: folds 
Uncalled bet ($0.11) returned to ZeusCMR
ZeusCMR collected $0.21 from pot
ZeusCMR: doesn't show hand 
*** SUMMARY ***
Total pot $0.22 | Rake $0.01 
Board [5c 2d Kd]
Seat 1: Flootyn (button) folded on the Flop
Seat 2: ZeusCMR (small blind) collected ($0.21)
Seat 3: BadBoy-PokStars (big blind) folded before Flop
Seat 4: hc agorist folded before Flop (didn't bet)
Seat 5: Flok1TTFU folded before Flop (didn't bet)
Seat 6: Elmisantropo folded before Flop (didn't bet)



PokerStars Zoom Hand #193769226561:  Hold'em No Limit ($0.01/$0.02) - 2018/11/27 1:01:14 CUST [2018/11/26 12:01:14 ET]
Table 'Halley' 6-max Seat #1 is the button
Seat 1: muxaxo212 ($2.86 in chips) 
Seat 2: TheD1nhoR10 ($1.17 in chips) 
Seat 3: serde4nik ($2.15 in chips) 
Seat 4: craven7777 ($3.97 in chips) 
Seat 5: hc agorist ($5.04 in chips) 
Seat 6: ak47@222 ($2.72 in chips) 
TheD1nhoR10: posts small blind $0.01
serde4nik: posts big blind $0.02
*** HOLE CARDS ***
Dealt to hc agorist [Jc Jd]
craven7777: raises $0.04 to $0.06
hc agorist: calls $0.06
ak47@222: folds 
muxaxo212: folds 
TheD1nhoR10: folds 
serde4nik: calls $0.04
*** FLOP *** [2h 9s Qc]
serde4nik: checks 
craven7777: bets $0.10
hc agorist: calls $0.10
serde4nik: calls $0.10
*** TURN *** [2h 9s Qc] [Ac]
serde4nik: checks 
craven7777: checks 
hc agorist: checks 
*** RIVER *** [2h 9s Qc Ac] [Ks]
serde4nik: checks 
craven7777: checks 
hc agorist: checks 
*** SHOW DOWN ***
serde4nik: shows [Ah 9h] (two pair, Aces and Nines)
craven7777: mucks hand 
hc agorist: mucks hand 
serde4nik collected $0.47 from pot
*** SUMMARY ***
Total pot $0.49 | Rake $0.02 
Board [2h 9s Qc Ac Ks]
Seat 1: muxaxo212 (button) folded before Flop (didn't bet)
Seat 2: TheD1nhoR10 (small blind) folded before Flop
Seat 3: serde4nik (big blind) showed [Ah 9h] and won ($0.47) with two pair, Aces and Nines
Seat 4: craven7777 mucked [6c 6s]
Seat 5: hc agorist mucked [Jc Jd]
Seat 6: ak47@222 folded before Flop (didn't bet)



PokerStars Zoom Hand #193769266142:  Hold'em No Limit ($0.01/$0.02) - 2018/11/27 1:02:25 CUST [2018/11/26 12:02:25 ET]
Table 'Halley' 6-max Seat #1 is the button
Seat 1: abatur0 ($0.92 in chips) 
Seat 2: Hans Gross ($1.84 in chips) 
Seat 3: hc agorist ($4.88 in chips) 
Seat 4: Buxbunny94 ($2.45 in chips) 
Seat 5: ak47@222 ($2.65 in chips) 
Seat 6: stupid_bear1 ($3.01 in chips) 
Hans Gross: posts small blind $0.01
hc agorist: posts big blind $0.02
*** HOLE CARDS ***
Dealt to hc agorist [3c Ah]
Buxbunny94: folds 
ak47@222: folds 
stupid_bear1: folds 
abatur0: folds 
Hans Gross: folds 
Uncalled bet ($0.01) returned to hc agorist
hc agorist collected $0.02 from pot
hc agorist: doesn't show hand 
*** SUMMARY ***
Total pot $0.02 | Rake $0 
Seat 1: abatur0 (button) folded before Flop (didn't bet)
Seat 2: Hans Gross (small blind) folded before Flop
Seat 3: hc agorist (big blind) collected ($0.02)
Seat 4: Buxbunny94 folded before Flop (didn't bet)
Seat 5: ak47@222 folded before Flop (didn't bet)
Seat 6: stupid_bear1 folded before Flop (didn't bet)



PokerStars Zoom Hand #193769271774:  Hold'em No Limit ($0.01/$0.02) - 2018/11/27 1:02:34 CUST [2018/11/26 12:02:34 ET]
Table 'Halley' 6-max Seat #1 is the button
Seat 1: hc agorist ($4.89 in chips) 
Seat 2: octopus62 ($1.25 in chips) 
Seat 3: gaeppakse ($4.07 in chips) 
Seat 4: SharkBoy1994 ($2.63 in chips) 
Seat 5: TellsSohn ($1.98 in chips) 
Seat 6: d2009157 ($2.32 in chips) 
octopus62: posts small blind $0.01
gaeppakse: posts big blind $0.02
*** HOLE CARDS ***
Dealt to hc agorist [4c Td]
SharkBoy1994: folds 
TellsSohn: folds 
d2009157: folds 
hc agorist: folds 
octopus62: folds 
Uncalled bet ($0.01) returned to gaeppakse
gaeppakse collected $0.02 from pot
gaeppakse: doesn't show hand 
*** SUMMARY ***
Total pot $0.02 | Rake $0 
Seat 1: hc agorist (button) folded before Flop (didn't bet)
Seat 2: octopus62 (small blind) folded before Flop
Seat 3: gaeppakse (big blind) collected ($0.02)
Seat 4: SharkBoy1994 folded before Flop (didn't bet)
Seat 5: TellsSohn folded before Flop (didn't bet)
Seat 6: d2009157 folded before Flop (didn't bet)



PokerStars Zoom Hand #193769275671:  Hold'em No Limit ($0.01/$0.02) - 2018/11/27 1:02:41 CUST [2018/11/26 12:02:41 ET]
Table 'Halley' 6-max Seat #1 is the button
Seat 1: Pauchok 43ru ($2.41 in chips) 
Seat 2: hc agorist ($4.89 in chips) 
Seat 3: Cartman 8703 ($3.17 in chips) 
Seat 4: fawltyfelix ($5.30 in chips) 
Seat 5: Michel Mill ($2.07 in chips) 
Seat 6: sorokinpv36 ($2.63 in chips) 
hc agorist: posts small blind $0.01
Cartman 8703: posts big blind $0.02
*** HOLE CARDS ***
Dealt to hc agorist [7h 4d]
fawltyfelix: folds 
Michel Mill: folds 
sorokinpv36: folds 
Pauchok 43ru: folds 
hc agorist: folds 
Uncalled bet ($0.01) returned to Cartman 8703
Cartman 8703 collected $0.02 from pot
Cartman 8703: doesn't show hand 
*** SUMMARY ***
Total pot $0.02 | Rake $0 
Seat 1: Pauchok 43ru (button) folded before Flop (didn't bet)
Seat 2: hc agorist (small blind) folded before Flop
Seat 3: Cartman 8703 (big blind) collected ($0.02)
Seat 4: fawltyfelix folded before Flop (didn't bet)
Seat 5: Michel Mill folded before Flop (didn't bet)
Seat 6: sorokinpv36 folded before Flop (didn't bet)



PokerStars Zoom Hand #193769284749:  Hold'em No Limit ($0.01/$0.02) - 2018/11/27 1:02:57 CUST [2018/11/26 12:02:57 ET]
Table 'Halley' 6-max Seat #1 is the button
Seat 1: nicemitya ($3.05 in chips) 
Seat 2: booshrut ($2.06 in chips) 
Seat 3: QuichesLeRoy ($2.57 in chips) 
Seat 4: maksiDzik ($2.01 in chips) 
Seat 5: hc agorist ($4.88 in chips) 
Seat 6: Taggwan ($3.06 in chips) 
booshrut: posts small blind $0.01
QuichesLeRoy: posts big blind $0.02
*** HOLE CARDS ***
Dealt to hc agorist [Ac Td]
maksiDzik: folds 
hc agorist: raises $0.04 to $0.06
Taggwan: folds 
nicemitya: folds 
booshrut: folds 
QuichesLeRoy: folds 
Uncalled bet ($0.04) returned to hc agorist
hc agorist collected $0.05 from pot
hc agorist: doesn't show hand 
*** SUMMARY ***
Total pot $0.05 | Rake $0 
Seat 1: nicemitya (button) folded before Flop (didn't bet)
Seat 2: booshrut (small blind) folded before Flop
Seat 3: QuichesLeRoy (big blind) folded before Flop
Seat 4: maksiDzik folded before Flop (didn't bet)
Seat 5: hc agorist collected ($0.05)
Seat 6: Taggwan folded before Flop (didn't bet)



PokerStars Zoom Hand #193769298986:  Hold'em No Limit ($0.01/$0.02) - 2018/11/27 1:03:22 CUST [2018/11/26 12:03:22 ET]
Table 'Halley' 6-max Seat #1 is the button
Seat 1: beniboy89 ($5.53 in chips) 
Seat 2: Williwacker9 ($2 in chips) 
Seat 3: BenGurionn ($2.28 in chips) 
Seat 4: hc agorist ($4.87 in chips) 
Seat 5: AllBugay ($1.73 in chips) 
Seat 6: EstebanTTT ($2 in chips) 
Williwacker9: posts small blind $0.01
BenGurionn: posts big blind $0.02
*** HOLE CARDS ***
Dealt to hc agorist [Tc 4c]
hc agorist: raises $0.02 to $0.04
AllBugay: folds 
EstebanTTT: folds 
beniboy89: folds 
Williwacker9: folds 
BenGurionn: folds 
Uncalled bet ($0.02) returned to hc agorist
hc agorist collected $0.05 from pot
hc agorist: doesn't show hand 
*** SUMMARY ***
Total pot $0.05 | Rake $0 
Seat 1: beniboy89 (button) folded before Flop (didn't bet)
Seat 2: Williwacker9 (small blind) folded before Flop
Seat 3: BenGurionn (big blind) folded before Flop
Seat 4: hc agorist collected ($0.05)
Seat 5: AllBugay folded before Flop (didn't bet)
Seat 6: EstebanTTT folded before Flop (didn't bet)



PokerStars Zoom Hand #193769280916:  Hold'em No Limit ($0.01/$0.02) - 2018/11/27 1:02:50 CUST [2018/11/26 12:02:50 ET]
Table 'Halley' 6-max Seat #1 is the button
Seat 1: stupid_bear1 ($0.88 in chips) 
Seat 2: 6tukatuka ($3.41 in chips) 
Seat 3: hjose0220 ($2.71 in chips) 
Seat 4: Lawrence$lim ($2.86 in chips) 
Seat 5: ChrisCreys ($10.71 in chips) 
Seat 6: hc agorist ($4.88 in chips) 
6tukatuka: posts small blind $0.01
hjose0220: posts big blind $0.02
*** HOLE CARDS ***
Dealt to hc agorist [8s Jc]
Lawrence$lim: raises $0.04 to $0.06
ChrisCreys: calls $0.06
hc agorist: folds 
stupid_bear1: calls $0.06
6tukatuka: calls $0.05
hjose0220: calls $0.04
*** FLOP *** [Td Js 2s]
6tukatuka: checks 
hjose0220: checks 
Lawrence$lim: checks 
ChrisCreys: bets $0.10
stupid_bear1: folds 
6tukatuka: folds 
hjose0220: calls $0.10
Lawrence$lim: calls $0.10
*** TURN *** [Td Js 2s] [8h]
hjose0220: bets $0.60
Lawrence$lim: folds 
ChrisCreys: calls $0.60
*** RIVER *** [Td Js 2s 8h] [Ac]
hjose0220: bets $1.95 and is all-in
ChrisCreys: folds 
Uncalled bet ($1.95) returned to hjose0220
hjose0220 collected $1.74 from pot
hjose0220: doesn't show hand 
*** SUMMARY ***
Total pot $1.80 | Rake $0.06 
Board [Td Js 2s 8h Ac]
Seat 1: stupid_bear1 (button) folded on the Flop
Seat 2: 6tukatuka (small blind) folded on the Flop
Seat 3: hjose0220 (big blind) collected ($1.74)
Seat 4: Lawrence$lim folded on the Turn
Seat 5: ChrisCreys folded on the River
Seat 6: hc agorist folded before Flop (didn't bet)



PokerStars Zoom Hand #193769292614:  Hold'em No Limit ($0.01/$0.02) - 2018/11/27 1:03:11 CUST [2018/11/26 12:03:11 ET]
Table 'Halley' 6-max Seat #1 is the button
Seat 1: HomosapieN55 ($2.16 in chips) 
Seat 2: Monetaty ($2.09 in chips) 
Seat 3: gonih ($1.86 in chips) 
Seat 4: hc agorist ($4.91 in chips) 
Seat 5: shveg77 ($1.29 in chips) 
Seat 6: jorik521 ($2.08 in chips) 
Monetaty: posts small blind $0.01
gonih: posts big blind $0.02
*** HOLE CARDS ***
Dealt to hc agorist [9h Js]
hc agorist: raises $0.02 to $0.04
shveg77: raises $0.12 to $0.16
jorik521: calls $0.16
HomosapieN55: folds 
Monetaty: folds 
gonih: folds 
hc agorist: folds 
*** FLOP *** [3s 5h 8h]
shveg77: bets $0.29
jorik521: calls $0.29
*** TURN *** [3s 5h 8h] [Kd]
shveg77: bets $0.68
jorik521: folds 
Uncalled bet ($0.68) returned to shveg77
shveg77 collected $0.94 from pot
shveg77: doesn't show hand 
*** SUMMARY ***
Total pot $0.97 | Rake $0.03 
Board [3s 5h 8h Kd]
Seat 1: HomosapieN55 (button) folded before Flop (didn't bet)
Seat 2: Monetaty (small blind) folded before Flop
Seat 3: gonih (big blind) folded before Flop
Seat 4: hc agorist folded before Flop
Seat 5: shveg77 collected ($0.94)
Seat 6: jorik521 folded on the Turn



PokerStars Zoom Hand #193769319192:  Hold'em No Limit ($0.01/$0.02) - 2018/11/27 1:03:57 CUST [2018/11/26 12:03:57 ET]
Table 'Halley' 6-max Seat #1 is the button
Seat 1: sousaleandro ($2.20 in chips) 
Seat 2: hc agorist ($4.88 in chips) 
Seat 3: bybaleh52 ($2.39 in chips) 
Seat 4: simple s0o ($2 in chips) 
Seat 5: treffer99 ($1.27 in chips) 
Seat 6: 7Mun ($2.01 in chips) 
hc agorist: posts small blind $0.01
bybaleh52: posts big blind $0.02
*** HOLE CARDS ***
Dealt to hc agorist [Kd 3c]
simple s0o: folds 
treffer99: folds 
7Mun: folds 
sousaleandro: raises $0.04 to $0.06
hc agorist: folds 
bybaleh52: folds 
Uncalled bet ($0.04) returned to sousaleandro
sousaleandro collected $0.05 from pot
sousaleandro: doesn't show hand 
*** SUMMARY ***
Total pot $0.05 | Rake $0 
Seat 1: sousaleandro (button) collected ($0.05)
Seat 2: hc agorist (small blind) folded before Flop
Seat 3: bybaleh52 (big blind) folded before Flop
Seat 4: simple s0o folded before Flop (didn't bet)
Seat 5: treffer99 folded before Flop (didn't bet)
Seat 6: 7Mun folded before Flop (didn't bet)



PokerStars Zoom Hand #193769314556:  Hold'em No Limit ($0.01/$0.02) - 2018/11/27 1:03:49 CUST [2018/11/26 12:03:49 ET]
Table 'Halley' 6-max Seat #1 is the button
Seat 1: hc agorist ($4.88 in chips) 
Seat 2: hjose0220 ($2.42 in chips) 
Seat 3: Mizzek ($2 in chips) 
Seat 4: Unconform ($3.49 in chips) 
Seat 5: daabr934 ($2.23 in chips) 
Seat 6: ravemaster-z ($1.16 in chips) 
hjose0220: posts small blind $0.01
Mizzek: posts big blind $0.02
*** HOLE CARDS ***
Dealt to hc agorist [2d 4h]
Unconform: folds 
daabr934 has timed out
daabr934: folds 
ravemaster-z: folds 
hc agorist: folds 
hjose0220: raises $0.02 to $0.04
Mizzek: calls $0.02
*** FLOP *** [Qh 8d Qs]
hjose0220: checks 
Mizzek: bets $0.04
hjose0220: folds 
Uncalled bet ($0.04) returned to Mizzek
Mizzek collected $0.08 from pot
Mizzek: doesn't show hand 
*** SUMMARY ***
Total pot $0.08 | Rake $0 
Board [Qh 8d Qs]
Seat 1: hc agorist (button) folded before Flop (didn't bet)
Seat 2: hjose0220 (small blind) folded on the Flop
Seat 3: Mizzek (big blind) collected ($0.08)
Seat 4: Unconform folded before Flop (didn't bet)
Seat 5: daabr934 folded before Flop (didn't bet)
Seat 6: ravemaster-z folded before Flop (didn't bet)



PokerStars Zoom Hand #193769309351:  Hold'em No Limit ($0.01/$0.02) - 2018/11/27 1:03:40 CUST [2018/11/26 12:03:40 ET]
Table 'Halley' 6-max Seat #1 is the button
Seat 1: craven7777 ($2.30 in chips) 
Seat 2: Alexarulit ($3.10 in chips) 
Seat 3: hc agorist ($4.90 in chips) 
Seat 4: anasanto ($4.25 in chips) 
Seat 5: younggodd23 ($2 in chips) 
Seat 6: VelosNM ($2.09 in chips) 
Alexarulit: posts small blind $0.01
hc agorist: posts big blind $0.02
*** HOLE CARDS ***
Dealt to hc agorist [3h 7c]
anasanto: folds 
younggodd23: folds 
VelosNM: raises $0.03 to $0.05
craven7777: folds 
Alexarulit: raises $0.15 to $0.20
hc agorist: folds 
VelosNM: raises $0.42 to $0.62
Alexarulit: raises $2.48 to $3.10 and is all-in
VelosNM: calls $1.47 and is all-in
Uncalled bet ($1.01) returned to Alexarulit
*** FLOP *** [2h Tc Jc]
*** TURN *** [2h Tc Jc] [8h]
*** RIVER *** [2h Tc Jc 8h] [6d]
*** SHOW DOWN ***
Alexarulit: shows [Kh Ac] (high card Ace)
VelosNM: shows [Ks Kd] (a pair of Kings)
VelosNM collected $4.05 from pot
*** SUMMARY ***
Total pot $4.20 | Rake $0.15 
Board [2h Tc Jc 8h 6d]
Seat 1: craven7777 (button) folded before Flop (didn't bet)
Seat 2: Alexarulit (small blind) showed [Kh Ac] and lost with high card Ace
Seat 3: hc agorist (big blind) folded before Flop
Seat 4: anasanto folded before Flop (didn't bet)
Seat 5: younggodd23 folded before Flop (didn't bet)
Seat 6: VelosNM showed [Ks Kd] and won ($4.05) with a pair of Kings



PokerStars Zoom Hand #193769322529:  Hold'em No Limit ($0.01/$0.02) - 2018/11/27 1:04:03 CUST [2018/11/26 12:04:03 ET]
Table 'Halley' 6-max Seat #1 is the button
Seat 1: SVG7777 ($5.17 in chips) 
Seat 2: gosha - pank ($1.23 in chips) 
Seat 3: CAI+23-7copa ($2 in chips) 
Seat 4: Bragaallin ($2 in chips) 
Seat 5: leuzi5 ($1.32 in chips) 
Seat 6: hc agorist ($4.87 in chips) 
gosha - pank: posts small blind $0.01
CAI+23-7copa: posts big blind $0.02
*** HOLE CARDS ***
Dealt to hc agorist [9d Tc]
Bragaallin: raises $0.04 to $0.06
leuzi5: folds 
hc agorist: raises $0.12 to $0.18
SVG7777: folds 
gosha - pank: folds 
CAI+23-7copa: folds 
Bragaallin: calls $0.12
*** FLOP *** [Qc Qh Td]
Bragaallin: checks 
hc agorist: checks 
*** TURN *** [Qc Qh Td] [Kd]
Bragaallin: checks 
hc agorist: checks 
*** RIVER *** [Qc Qh Td Kd] [2s]
Bragaallin: checks 
hc agorist: bets $0.20
Bragaallin: calls $0.20
*** SHOW DOWN ***
hc agorist: shows [9d Tc] (two pair, Queens and Tens)
Bragaallin: shows [As Kc] (two pair, Kings and Queens)
Bragaallin collected $0.76 from pot
*** SUMMARY ***
Total pot $0.79 | Rake $0.03 
Board [Qc Qh Td Kd 2s]
Seat 1: SVG7777 (button) folded before Flop (didn't bet)
Seat 2: gosha - pank (small blind) folded before Flop
Seat 3: CAI+23-7copa (big blind) folded before Flop
Seat 4: Bragaallin showed [As Kc] and won ($0.76) with two pair, Kings and Queens
Seat 5: leuzi5 folded before Flop (didn't bet)
Seat 6: hc agorist showed [9d Tc] and lost with two pair, Queens and Tens



PokerStars Zoom Hand #193769356087:  Hold'em No Limit ($0.01/$0.02) - 2018/11/27 1:05:01 CUST [2018/11/26 12:05:01 ET]
Table 'Halley' 6-max Seat #1 is the button
Seat 1: EduardL ($2.70 in chips) 
Seat 2: fawltyfelix ($5.15 in chips) 
Seat 3: batek_1 ($2.48 in chips) 
Seat 4: m3t1s ($5.38 in chips) 
Seat 5: hc agorist ($4.49 in chips) 
Seat 6: srw34 ($2.73 in chips) 
fawltyfelix: posts small blind $0.01
batek_1: posts big blind $0.02
*** HOLE CARDS ***
Dealt to hc agorist [8c Ac]
m3t1s: raises $0.04 to $0.06
hc agorist: raises $0.12 to $0.18
srw34: folds 
EduardL: folds 
fawltyfelix: folds 
batek_1: folds 
m3t1s: folds 
Uncalled bet ($0.12) returned to hc agorist
hc agorist collected $0.15 from pot
hc agorist: doesn't show hand 
*** SUMMARY ***
Total pot $0.15 | Rake $0 
Seat 1: EduardL (button) folded before Flop (didn't bet)
Seat 2: fawltyfelix (small blind) folded before Flop
Seat 3: batek_1 (big blind) folded before Flop
Seat 4: m3t1s folded before Flop
Seat 5: hc agorist collected ($0.15)
Seat 6: srw34 folded before Flop (didn't bet)



PokerStars Zoom Hand #193769368202:  Hold'em No Limit ($0.01/$0.02) - 2018/11/27 1:05:22 CUST [2018/11/26 12:05:22 ET]
Table 'Halley' 6-max Seat #1 is the button
Seat 1: fawltyfelix ($5.14 in chips) 
Seat 2: Fillippe M. ($2.34 in chips) 
Seat 3: Cartman 8703 ($5.52 in chips) 
Seat 4: hc agorist ($4.58 in chips) 
Seat 5: Pokersk999 ($2.39 in chips) 
Seat 6: younggodd23 ($3.61 in chips) 
Fillippe M.: posts small blind $0.01
Cartman 8703: posts big blind $0.02
*** HOLE CARDS ***
Dealt to hc agorist [9d Qh]
hc agorist: folds 
Pokersk999: folds 
younggodd23: raises $0.03 to $0.05
fawltyfelix: raises $0.13 to $0.18
Fillippe M.: folds 
Cartman 8703: folds 
younggodd23: folds 
Uncalled bet ($0.13) returned to fawltyfelix
fawltyfelix collected $0.13 from pot
fawltyfelix: doesn't show hand 
*** SUMMARY ***
Total pot $0.13 | Rake $0 
Seat 1: fawltyfelix (button) collected ($0.13)
Seat 2: Fillippe M. (small blind) folded before Flop
Seat 3: Cartman 8703 (big blind) folded before Flop
Seat 4: hc agorist folded before Flop (didn't bet)
Seat 5: Pokersk999 folded before Flop (didn't bet)
Seat 6: younggodd23 folded before Flop



PokerStars Zoom Hand #193769371137:  Hold'em No Limit ($0.01/$0.02) - 2018/11/27 1:05:27 CUST [2018/11/26 12:05:27 ET]
Table 'Halley' 6-max Seat #1 is the button
Seat 1: hc agorist ($4.58 in chips) 
Seat 2: 5tr2te9 ($2.20 in chips) 
Seat 3: ard14 ($3.45 in chips) 
Seat 4: SharkBoy1994 ($2.66 in chips) 
Seat 5: andeee74 ($2.05 in chips) 
Seat 6: veksy ($2.26 in chips) 
5tr2te9: posts small blind $0.01
ard14: posts big blind $0.02
*** HOLE CARDS ***
Dealt to hc agorist [Jh 9h]
SharkBoy1994: folds 
andeee74: folds 
veksy: folds 
hc agorist: raises $0.02 to $0.04
5tr2te9: folds 
ard14: calls $0.02
*** FLOP *** [Th 6h Ks]
ard14: checks 
hc agorist: bets $0.07
ard14: folds 
Uncalled bet ($0.07) returned to hc agorist
hc agorist collected $0.09 from pot
hc agorist: doesn't show hand 
*** SUMMARY ***
Total pot $0.09 | Rake $0 
Board [Th 6h Ks]
Seat 1: hc agorist (button) collected ($0.09)
Seat 2: 5tr2te9 (small blind) folded before Flop
Seat 3: ard14 (big blind) folded on the Flop
Seat 4: SharkBoy1994 folded before Flop (didn't bet)
Seat 5: andeee74 folded before Flop (didn't bet)
Seat 6: veksy folded before Flop (didn't bet)



PokerStars Zoom Hand #193769392614:  Hold'em No Limit ($0.01/$0.02) - 2018/11/27 1:06:04 CUST [2018/11/26 12:06:04 ET]
Table 'Halley' 6-max Seat #1 is the button
Seat 1: strimmm0 ($16.27 in chips) 
Seat 2: Dorogoi57 ($3.47 in chips) 
Seat 3: hc agorist ($4.63 in chips) 
Seat 4: vagasstar ($2.33 in chips) 
Seat 5: abatur0 ($1.97 in chips) 
Seat 6: LaCasa15 ($2.29 in chips) 
Dorogoi57: posts small blind $0.01
hc agorist: posts big blind $0.02
*** HOLE CARDS ***
Dealt to hc agorist [2h Jh]
vagasstar: folds 
abatur0: folds 
LaCasa15: raises $0.04 to $0.06
strimmm0: folds 
Dorogoi57: folds 
hc agorist: raises $0.13 to $0.19
LaCasa15: folds 
Uncalled bet ($0.13) returned to hc agorist
hc agorist collected $0.13 from pot
hc agorist: doesn't show hand 
*** SUMMARY ***
Total pot $0.13 | Rake $0 
Seat 1: strimmm0 (button) folded before Flop (didn't bet)
Seat 2: Dorogoi57 (small blind) folded before Flop
Seat 3: hc agorist (big blind) collected ($0.13)
Seat 4: vagasstar folded before Flop (didn't bet)
Seat 5: abatur0 folded before Flop (didn't bet)
Seat 6: LaCasa15 folded before Flop



PokerStars Zoom Hand #193769404248:  Hold'em No Limit ($0.01/$0.02) - 2018/11/27 1:06:24 CUST [2018/11/26 12:06:24 ET]
Table 'Halley' 6-max Seat #1 is the button
Seat 1: gaeppakse ($2.06 in chips) 
Seat 2: hc agorist ($4.70 in chips) 
Seat 3: juanpocket09 ($2.41 in chips) 
Seat 4: Grindatia ($2 in chips) 
Seat 5: Cartman 8703 ($2 in chips) 
Seat 6: wqd4 ($0.75 in chips) 
hc agorist: posts small blind $0.01
juanpocket09: posts big blind $0.02
*** HOLE CARDS ***
Dealt to hc agorist [6c 9s]
Grindatia: folds 
Cartman 8703: folds 
wqd4: folds 
gaeppakse: folds 
hc agorist: folds 
Uncalled bet ($0.01) returned to juanpocket09
juanpocket09 collected $0.02 from pot
juanpocket09: doesn't show hand 
*** SUMMARY ***
Total pot $0.02 | Rake $0 
Seat 1: gaeppakse (button) folded before Flop (didn't bet)
Seat 2: hc agorist (small blind) folded before Flop
Seat 3: juanpocket09 (big blind) collected ($0.02)
Seat 4: Grindatia folded before Flop (didn't bet)
Seat 5: Cartman 8703 folded before Flop (didn't bet)
Seat 6: wqd4 folded before Flop (didn't bet)



PokerStars Zoom Hand #193769406543:  Hold'em No Limit ($0.01/$0.02) - 2018/11/27 1:06:28 CUST [2018/11/26 12:06:28 ET]
Table 'Halley' 6-max Seat #1 is the button
Seat 1: 73X4S ($2.33 in chips) 
Seat 2: Logrus99 ($1.54 in chips) 
Seat 3: Medved219 ($2 in chips) 
Seat 4: mitias13 ($3.54 in chips) 
Seat 5: TheD1nhoR10 ($0.72 in chips) 
Seat 6: hc agorist ($4.69 in chips) 
Logrus99: posts small blind $0.01
Medved219: posts big blind $0.02
*** HOLE CARDS ***
Dealt to hc agorist [Td 6d]
mitias13: folds 
TheD1nhoR10: folds 
hc agorist: raises $0.02 to $0.04
73X4S: folds 
Logrus99: raises $0.10 to $0.14
Medved219: folds 
hc agorist: raises $0.22 to $0.36
Logrus99: folds 
Uncalled bet ($0.22) returned to hc agorist
hc agorist collected $0.30 from pot
hc agorist: doesn't show hand 
*** SUMMARY ***
Total pot $0.30 | Rake $0 
Seat 1: 73X4S (button) folded before Flop (didn't bet)
Seat 2: Logrus99 (small blind) folded before Flop
Seat 3: Medved219 (big blind) folded before Flop
Seat 4: mitias13 folded before Flop (didn't bet)
Seat 5: TheD1nhoR10 folded before Flop (didn't bet)
Seat 6: hc agorist collected ($0.30)



PokerStars Zoom Hand #193769422336:  Hold'em No Limit ($0.01/$0.02) - 2018/11/27 1:06:55 CUST [2018/11/26 12:06:55 ET]
Table 'Halley' 6-max Seat #1 is the button
Seat 1: 3Iver's3 ($3.69 in chips) 
Seat 2: aleksvp ($2.45 in chips) 
Seat 3: Askercha ($2.09 in chips) 
Seat 4: qk rodriguez ($3.04 in chips) 
Seat 5: hc agorist ($4.85 in chips) 
Seat 6: demisom ($1.25 in chips) 
aleksvp: posts small blind $0.01
Askercha: posts big blind $0.02
*** HOLE CARDS ***
Dealt to hc agorist [Js 9c]
qk rodriguez: folds 
hc agorist: folds 
demisom: folds 
3Iver's3: folds 
aleksvp: folds 
Uncalled bet ($0.01) returned to Askercha
Askercha collected $0.02 from pot
Askercha: doesn't show hand 
*** SUMMARY ***
Total pot $0.02 | Rake $0 
Seat 1: 3Iver's3 (button) folded before Flop (didn't bet)
Seat 2: aleksvp (small blind) folded before Flop
Seat 3: Askercha (big blind) collected ($0.02)
Seat 4: qk rodriguez folded before Flop (didn't bet)
Seat 5: hc agorist folded before Flop (didn't bet)
Seat 6: demisom folded before Flop (didn't bet)



PokerStars Zoom Hand #193769425280:  Hold'em No Limit ($0.01/$0.02) - 2018/11/27 1:07:00 CUST [2018/11/26 12:07:00 ET]
Table 'Halley' 6-max Seat #1 is the button
Seat 1: Alexarulit ($2.07 in chips) 
Seat 2: hc agorist ($4.85 in chips) 
Seat 3: j3fing ($7.35 in chips) 
Seat 4: XMrMojoRisinX ($2 in chips) 
Seat 5: oshoka ($4.08 in chips) 
Seat 6: minami315z ($4.35 in chips) 
hc agorist: posts small blind $0.01
j3fing: posts big blind $0.02
*** HOLE CARDS ***
Dealt to hc agorist [7d 6c]
XMrMojoRisinX: folds 
oshoka: folds 
minami315z: folds 
Alexarulit: folds 
hc agorist: folds 
Uncalled bet ($0.01) returned to j3fing
j3fing collected $0.02 from pot
j3fing: doesn't show hand 
*** SUMMARY ***
Total pot $0.02 | Rake $0 
Seat 1: Alexarulit (button) folded before Flop (didn't bet)
Seat 2: hc agorist (small blind) folded before Flop
Seat 3: j3fing (big blind) collected ($0.02)
Seat 4: XMrMojoRisinX folded before Flop (didn't bet)
Seat 5: oshoka folded before Flop (didn't bet)
Seat 6: minami315z folded before Flop (didn't bet)



PokerStars Zoom Hand #193769431179:  Hold'em No Limit ($0.01/$0.02) - 2018/11/27 1:07:10 CUST [2018/11/26 12:07:10 ET]
Table 'Halley' 6-max Seat #1 is the button
Seat 1: hc agorist ($4.84 in chips) 
Seat 2: pneto ($8.05 in chips) 
Seat 3: Arch1689 ($2 in chips) 
Seat 4: batiatus72 ($0.43 in chips) 
Seat 5: juni0rZ ($2.14 in chips) 
Seat 6: Danilloo93 ($2 in chips) 
pneto: posts small blind $0.01
Arch1689: posts big blind $0.02
*** HOLE CARDS ***
Dealt to hc agorist [7c Jd]
batiatus72: raises $0.02 to $0.04
juni0rZ: folds 
Danilloo93: folds 
hc agorist: folds 
pneto: folds 
Arch1689: folds 
Uncalled bet ($0.02) returned to batiatus72
batiatus72 collected $0.05 from pot
batiatus72: doesn't show hand 
*** SUMMARY ***
Total pot $0.05 | Rake $0 
Seat 1: hc agorist (button) folded before Flop (didn't bet)
Seat 2: pneto (small blind) folded before Flop
Seat 3: Arch1689 (big blind) folded before Flop
Seat 4: batiatus72 collected ($0.05)
Seat 5: juni0rZ folded before Flop (didn't bet)
Seat 6: Danilloo93 folded before Flop (didn't bet)



PokerStars Zoom Hand #193769435148:  Hold'em No Limit ($0.01/$0.02) - 2018/11/27 1:07:17 CUST [2018/11/26 12:07:17 ET]
Table 'Halley' 6-max Seat #1 is the button
Seat 1: GrafVolskiu ($2.02 in chips) 
Seat 2: Rrripl ($1.47 in chips) 
Seat 3: hc agorist ($4.84 in chips) 
Seat 4: Tolsty1981 ($1.08 in chips) 
Seat 5: Will silvaa ($0.58 in chips) 
Seat 6: gian1894 ($1.70 in chips) 
Rrripl: posts small blind $0.01
hc agorist: posts big blind $0.02
*** HOLE CARDS ***
Dealt to hc agorist [2s 4s]
Tolsty1981: folds 
Will silvaa: raises $0.02 to $0.04
gian1894: folds 
GrafVolskiu: folds 
Rrripl: folds 
hc agorist: folds 
Uncalled bet ($0.02) returned to Will silvaa
Will silvaa collected $0.05 from pot
Will silvaa: doesn't show hand 
*** SUMMARY ***
Total pot $0.05 | Rake $0 
Seat 1: GrafVolskiu (button) folded before Flop (didn't bet)
Seat 2: Rrripl (small blind) folded before Flop
Seat 3: hc agorist (big blind) folded before Flop
Seat 4: Tolsty1981 folded before Flop (didn't bet)
Seat 5: Will silvaa collected ($0.05)
Seat 6: gian1894 folded before Flop (didn't bet)



PokerStars Zoom Hand #193769428250:  Hold'em No Limit ($0.01/$0.02) - 2018/11/27 1:07:05 CUST [2018/11/26 12:07:05 ET]
Table 'Halley' 6-max Seat #1 is the button
Seat 1: romanromanro ($3.85 in chips) 
Seat 2: Michel Mill ($2.15 in chips) 
Seat 3: andeee74 ($2.34 in chips) 
Seat 4: >>LVV80<< ($2.06 in chips) 
Seat 5: daabr934 ($2 in chips) 
Seat 6: hc agorist ($4.84 in chips) 
Michel Mill: posts small blind $0.01
andeee74: posts big blind $0.02
*** HOLE CARDS ***
Dealt to hc agorist [9h 3d]
>>LVV80<<: raises $0.04 to $0.06
daabr934: folds 
hc agorist: folds 
romanromanro: folds 
Michel Mill: raises $0.18 to $0.24
andeee74: folds 
>>LVV80<<: folds 
Uncalled bet ($0.18) returned to Michel Mill
Michel Mill collected $0.14 from pot
Michel Mill: doesn't show hand 
*** SUMMARY ***
Total pot $0.14 | Rake $0 
Seat 1: romanromanro (button) folded before Flop (didn't bet)
Seat 2: Michel Mill (small blind) collected ($0.14)
Seat 3: andeee74 (big blind) folded before Flop
Seat 4: >>LVV80<< folded before Flop
Seat 5: daabr934 folded before Flop (didn't bet)
Seat 6: hc agorist folded before Flop (didn't bet)



PokerStars Zoom Hand #193769443430:  Hold'em No Limit ($0.01/$0.02) - 2018/11/27 1:07:31 CUST [2018/11/26 12:07:31 ET]
Table 'Halley' 6-max Seat #1 is the button
Seat 1: CAI+23-7copa ($2.15 in chips) 
Seat 2: Sergey_Bolos ($2 in chips) 
Seat 3: StraightPR0 ($3.50 in chips) 
Seat 4: 2Sheds ($2.08 in chips) 
Seat 5: hc agorist ($4.82 in chips) 
Seat 6: ak47@222 ($2.39 in chips) 
Sergey_Bolos: posts small blind $0.01
StraightPR0: posts big blind $0.02
*** HOLE CARDS ***
Dealt to hc agorist [3h Ts]
2Sheds: folds 
hc agorist: folds 
ak47@222: folds 
CAI+23-7copa: raises $0.03 to $0.05
Sergey_Bolos: folds 
StraightPR0: calls $0.03
*** FLOP *** [3s 9d 9h]
StraightPR0: checks 
CAI+23-7copa: checks 
*** TURN *** [3s 9d 9h] [9s]
StraightPR0: bets $0.07
CAI+23-7copa: calls $0.07
*** RIVER *** [3s 9d 9h 9s] [6h]
StraightPR0: checks 
CAI+23-7copa: checks 
*** SHOW DOWN ***
StraightPR0: shows [Jh As] (three of a kind, Nines)
CAI+23-7copa: mucks hand 
StraightPR0 collected $0.24 from pot
*** SUMMARY ***
Total pot $0.25 | Rake $0.01 
Board [3s 9d 9h 9s 6h]
Seat 1: CAI+23-7copa (button) mucked [Qh Td]
Seat 2: Sergey_Bolos (small blind) folded before Flop
Seat 3: StraightPR0 (big blind) showed [Jh As] and won ($0.24) with three of a kind, Nines
Seat 4: 2Sheds folded before Flop (didn't bet)
Seat 5: hc agorist folded before Flop (didn't bet)
Seat 6: ak47@222 folded before Flop (didn't bet)



PokerStars Zoom Hand #193769448166:  Hold'em No Limit ($0.01/$0.02) - 2018/11/27 1:07:39 CUST [2018/11/26 12:07:39 ET]
Table 'Halley' 6-max Seat #1 is the button
Seat 1: akurat111 ($1.89 in chips) 
Seat 2: Smikuli ($2.08 in chips) 
Seat 3: gabgordula ($2.75 in chips) 
Seat 4: hc agorist ($4.82 in chips) 
Seat 5: Lawrence$lim ($2.73 in chips) 
Seat 6: Astrogeolog ($2.02 in chips) 
Smikuli: posts small blind $0.01
gabgordula: posts big blind $0.02
*** HOLE CARDS ***
Dealt to hc agorist [Ks 5s]
hc agorist: raises $0.02 to $0.04
Lawrence$lim: folds 
Astrogeolog: folds 
akurat111: folds 
Smikuli: calls $0.03
gabgordula: calls $0.02
*** FLOP *** [Qs 7h 9h]
Smikuli: checks 
gabgordula: bets $0.06
hc agorist: folds 
Smikuli: calls $0.06
*** TURN *** [Qs 7h 9h] [Ah]
Smikuli: checks 
gabgordula: checks 
*** RIVER *** [Qs 7h 9h Ah] [8c]
Smikuli: bets $0.16
gabgordula: calls $0.16
*** SHOW DOWN ***
Smikuli: shows [Js Kc] (high card Ace)
gabgordula: shows [Qd As] (two pair, Aces and Queens)
gabgordula collected $0.54 from pot
*** SUMMARY ***
Total pot $0.56 | Rake $0.02 
Board [Qs 7h 9h Ah 8c]
Seat 1: akurat111 (button) folded before Flop (didn't bet)
Seat 2: Smikuli (small blind) showed [Js Kc] and lost with high card Ace
Seat 3: gabgordula (big blind) showed [Qd As] and won ($0.54) with two pair, Aces and Queens
Seat 4: hc agorist folded on the Flop
Seat 5: Lawrence$lim folded before Flop (didn't bet)
Seat 6: Astrogeolog folded before Flop (didn't bet)



PokerStars Zoom Hand #193769466164:  Hold'em No Limit ($0.01/$0.02) - 2018/11/27 1:08:10 CUST [2018/11/26 12:08:10 ET]
Table 'Halley' 6-max Seat #1 is the button
Seat 1: 3n!$h! ($2.81 in chips) 
Seat 2: Terlingen11 ($5.04 in chips) 
Seat 3: gabrielpfm ($3.09 in chips) 
Seat 4: MaesterVeyer ($2.54 in chips) 
Seat 5: sorokinpv36 ($2.09 in chips) 
Seat 6: hc agorist ($4.78 in chips) 
Terlingen11: posts small blind $0.01
gabrielpfm: posts big blind $0.02
*** HOLE CARDS ***
Dealt to hc agorist [Th 2h]
MaesterVeyer: folds 
sorokinpv36: raises $0.03 to $0.05
hc agorist: folds 
3n!$h!: calls $0.05
Terlingen11: folds 
gabrielpfm: calls $0.03
*** FLOP *** [5h Qd As]
gabrielpfm: checks 
sorokinpv36: checks 
3n!$h!: bets $0.06
gabrielpfm: folds 
sorokinpv36: folds 
Uncalled bet ($0.06) returned to 3n!$h!
3n!$h! collected $0.15 from pot
3n!$h!: doesn't show hand 
*** SUMMARY ***
Total pot $0.16 | Rake $0.01 
Board [5h Qd As]
Seat 1: 3n!$h! (button) collected ($0.15)
Seat 2: Terlingen11 (small blind) folded before Flop
Seat 3: gabrielpfm (big blind) folded on the Flop
Seat 4: MaesterVeyer folded before Flop (didn't bet)
Seat 5: sorokinpv36 folded on the Flop
Seat 6: hc agorist folded before Flop (didn't bet)



PokerStars Zoom Hand #193769472648:  Hold'em No Limit ($0.01/$0.02) - 2018/11/27 1:08:21 CUST [2018/11/26 12:08:21 ET]
Table 'Halley' 6-max Seat #1 is the button
Seat 1: smogikas696 ($4.68 in chips) 
Seat 2: Monetaty ($1.94 in chips) 
Seat 3: hc agorist ($4.78 in chips) 
Seat 4: HoudiniH95 ($3.99 in chips) 
Seat 5: 3akhar ($0.91 in chips) 
Seat 6: bodialimon ($2.03 in chips) 
Monetaty: posts small blind $0.01
hc agorist: posts big blind $0.02
*** HOLE CARDS ***
Dealt to hc agorist [Qh Th]
HoudiniH95: folds 
3akhar: calls $0.02
bodialimon: folds 
smogikas696: raises $0.06 to $0.08
Monetaty: folds 
hc agorist: calls $0.06
3akhar: folds 
*** FLOP *** [5h Qs 2s]
hc agorist: checks 
smogikas696: bets $0.08
hc agorist: calls $0.08
*** TURN *** [5h Qs 2s] [Qc]
hc agorist: checks 
smogikas696: checks 
*** RIVER *** [5h Qs 2s Qc] [Ks]
hc agorist: bets $0.28
smogikas696: folds 
Uncalled bet ($0.28) returned to hc agorist
hc agorist collected $0.34 from pot
hc agorist: doesn't show hand 
*** SUMMARY ***
Total pot $0.35 | Rake $0.01 
Board [5h Qs 2s Qc Ks]
Seat 1: smogikas696 (button) folded on the River
Seat 2: Monetaty (small blind) folded before Flop
Seat 3: hc agorist (big blind) collected ($0.34)
Seat 4: HoudiniH95 folded before Flop (didn't bet)
Seat 5: 3akhar folded before Flop
Seat 6: bodialimon folded before Flop (didn't bet)



PokerStars Zoom Hand #193769502364:  Hold'em No Limit ($0.01/$0.02) - 2018/11/27 1:09:12 CUST [2018/11/26 12:09:12 ET]
Table 'Halley' 6-max Seat #1 is the button
Seat 1: hc agorist ($4.96 in chips) 
Seat 2: 6tukatuka ($4.02 in chips) 
Seat 3: swraider ($2.01 in chips) 
Seat 4: don_energo2 ($2.32 in chips) 
Seat 5: Damian36215 ($2.03 in chips) 
Seat 6: Ketsudan ($2.09 in chips) 
6tukatuka: posts small blind $0.01
swraider: posts big blind $0.02
*** HOLE CARDS ***
Dealt to hc agorist [4s 9h]
don_energo2: folds 
Damian36215: folds 
Ketsudan: folds 
hc agorist: folds 
6tukatuka: raises $0.02 to $0.04
swraider: folds 
Uncalled bet ($0.02) returned to 6tukatuka
6tukatuka collected $0.04 from pot
6tukatuka: doesn't show hand 
*** SUMMARY ***
Total pot $0.04 | Rake $0 
Seat 1: hc agorist (button) folded before Flop (didn't bet)
Seat 2: 6tukatuka (small blind) collected ($0.04)
Seat 3: swraider (big blind) folded before Flop
Seat 4: don_energo2 folded before Flop (didn't bet)
Seat 5: Damian36215 folded before Flop (didn't bet)
Seat 6: Ketsudan folded before Flop (didn't bet)



PokerStars Zoom Hand #193769505204:  Hold'em No Limit ($0.01/$0.02) - 2018/11/27 1:09:17 CUST [2018/11/26 12:09:17 ET]
Table 'Halley' 6-max Seat #1 is the button
Seat 1: zsolo480 ($1 in chips) 
Seat 2: Taggwan ($3.41 in chips) 
Seat 3: ard14 ($3.41 in chips) 
Seat 4: hc agorist ($4.96 in chips) 
Seat 5: Oleg1985 ($2.23 in chips) 
Seat 6: Jaap69golf ($2.19 in chips) 
Taggwan: posts small blind $0.01
ard14: posts big blind $0.02
*** HOLE CARDS ***
Dealt to hc agorist [Th Kc]
hc agorist: raises $0.02 to $0.04
Oleg1985: calls $0.04
Jaap69golf: folds 
zsolo480: folds 
Taggwan: folds 
ard14: folds 
*** FLOP *** [3h 4h Js]
hc agorist: bets $0.04
Oleg1985: folds 
Uncalled bet ($0.04) returned to hc agorist
hc agorist collected $0.11 from pot
hc agorist: doesn't show hand 
*** SUMMARY ***
Total pot $0.11 | Rake $0 
Board [3h 4h Js]
Seat 1: zsolo480 (button) folded before Flop (didn't bet)
Seat 2: Taggwan (small blind) folded before Flop
Seat 3: ard14 (big blind) folded before Flop
Seat 4: hc agorist collected ($0.11)
Seat 5: Oleg1985 folded on the Flop
Seat 6: Jaap69golf folded before Flop (didn't bet)



PokerStars Zoom Hand #193769530151:  Hold'em No Limit ($0.01/$0.02) - 2018/11/27 1:09:48 CUST [2018/11/26 12:09:48 ET]
Table 'Halley' 6-max Seat #1 is the button
Seat 1: Dorogoi57 ($2 in chips) 
Seat 2: bobisolo ($1.37 in chips) 
Seat 3: xiangsbae ($2.05 in chips) 
Seat 4: hc agorist ($5.02 in chips) 
Seat 5: Williwacker9 ($2.66 in chips) 
Seat 6: Losimas(LT) ($2 in chips) 
bobisolo: posts small blind $0.01
xiangsbae: posts big blind $0.02
*** HOLE CARDS ***
Dealt to hc agorist [8s 6s]
hc agorist: raises $0.02 to $0.04
Williwacker9: folds 
Losimas(LT): folds 
Dorogoi57: folds 
bobisolo: folds 
xiangsbae: folds 
Uncalled bet ($0.02) returned to hc agorist
hc agorist collected $0.05 from pot
hc agorist: doesn't show hand 
*** SUMMARY ***
Total pot $0.05 | Rake $0 
Seat 1: Dorogoi57 (button) folded before Flop (didn't bet)
Seat 2: bobisolo (small blind) folded before Flop
Seat 3: xiangsbae (big blind) folded before Flop
Seat 4: hc agorist collected ($0.05)
Seat 5: Williwacker9 folded before Flop (didn't bet)
Seat 6: Losimas(LT) folded before Flop (didn't bet)



PokerStars Zoom Hand #193769537156:  Hold'em No Limit ($0.01/$0.02) - 2018/11/27 1:10:00 CUST [2018/11/26 12:10:00 ET]
Table 'Halley' 6-max Seat #1 is the button
Seat 1: madrihcosher ($4.30 in chips) 
Seat 2: Burvinik ($1.22 in chips) 
Seat 3: eRaRoMaRiO ($2.03 in chips) 
Seat 4: Mesnuj ($2.24 in chips) 
Seat 5: hc agorist ($5.05 in chips) 
Seat 6: Lifecards7 ($10.49 in chips) 
Burvinik: posts small blind $0.01
eRaRoMaRiO: posts big blind $0.02
*** HOLE CARDS ***
Dealt to hc agorist [8h 7d]
Mesnuj: folds 
hc agorist: folds 
Lifecards7: raises $0.04 to $0.06
madrihcosher: folds 
Burvinik: folds 
eRaRoMaRiO: folds 
Uncalled bet ($0.04) returned to Lifecards7
Lifecards7 collected $0.05 from pot
Lifecards7: doesn't show hand 
*** SUMMARY ***
Total pot $0.05 | Rake $0 
Seat 1: madrihcosher (button) folded before Flop (didn't bet)
Seat 2: Burvinik (small blind) folded before Flop
Seat 3: eRaRoMaRiO (big blind) folded before Flop
Seat 4: Mesnuj folded before Flop (didn't bet)
Seat 5: hc agorist folded before Flop (didn't bet)
Seat 6: Lifecards7 collected ($0.05)



PokerStars Zoom Hand #193769549504:  Hold'em No Limit ($0.01/$0.02) - 2018/11/27 1:10:21 CUST [2018/11/26 12:10:21 ET]
Table 'Halley' 6-max Seat #1 is the button
Seat 1: Unconform ($2.36 in chips) 
Seat 2: Roflpain ($6.59 in chips) 
Seat 3: P@P@FrIt@ ($2.61 in chips) 
Seat 4: hc agorist ($5.05 in chips) 
Seat 5: ret7 ($2.10 in chips) 
Seat 6: Arch1689 ($2.23 in chips) 
Roflpain: posts small blind $0.01
P@P@FrIt@: posts big blind $0.02
*** HOLE CARDS ***
Dealt to hc agorist [6h 8s]
hc agorist: folds 
ret7: folds 
Arch1689: folds 
Unconform: folds 
Roflpain: folds 
Uncalled bet ($0.01) returned to P@P@FrIt@
P@P@FrIt@ collected $0.02 from pot
P@P@FrIt@: doesn't show hand 
*** SUMMARY ***
Total pot $0.02 | Rake $0 
Seat 1: Unconform (button) folded before Flop (didn't bet)
Seat 2: Roflpain (small blind) folded before Flop
Seat 3: P@P@FrIt@ (big blind) collected ($0.02)
Seat 4: hc agorist folded before Flop (didn't bet)
Seat 5: ret7 folded before Flop (didn't bet)
Seat 6: Arch1689 folded before Flop (didn't bet)



PokerStars Zoom Hand #193769539518:  Hold'em No Limit ($0.01/$0.02) - 2018/11/27 1:10:04 CUST [2018/11/26 12:10:04 ET]
Table 'Halley' 6-max Seat #1 is the button
Seat 1: hc agorist ($5.05 in chips) 
Seat 2: Versal Cupe ($5.29 in chips) 
Seat 3: andeee74 ($2.05 in chips) 
Seat 4: berlinsw ($2 in chips) 
Seat 5: maferna ($2 in chips) 
Seat 6: plotarxis ($2.06 in chips) 
Versal Cupe: posts small blind $0.01
andeee74: posts big blind $0.02
*** HOLE CARDS ***
Dealt to hc agorist [2c As]
berlinsw: folds 
maferna: folds 
plotarxis: raises $0.03 to $0.05
hc agorist: folds 
Versal Cupe: calls $0.04
andeee74: folds 
*** FLOP *** [Kd 4d Jh]
Versal Cupe: checks 
plotarxis: checks 
*** TURN *** [Kd 4d Jh] [Jd]
Versal Cupe: checks 
plotarxis: bets $0.08
Versal Cupe: calls $0.08
*** RIVER *** [Kd 4d Jh Jd] [2s]
Versal Cupe: checks 
plotarxis: bets $0.16
Versal Cupe: folds 
Uncalled bet ($0.16) returned to plotarxis
plotarxis collected $0.27 from pot
plotarxis: doesn't show hand 
*** SUMMARY ***
Total pot $0.28 | Rake $0.01 
Board [Kd 4d Jh Jd 2s]
Seat 1: hc agorist (button) folded before Flop (didn't bet)
Seat 2: Versal Cupe (small blind) folded on the River
Seat 3: andeee74 (big blind) folded before Flop
Seat 4: berlinsw folded before Flop (didn't bet)
Seat 5: maferna folded before Flop (didn't bet)
Seat 6: plotarxis collected ($0.27)



PokerStars Zoom Hand #193769527182:  Hold'em No Limit ($0.01/$0.02) - 2018/11/27 1:09:43 CUST [2018/11/26 12:09:43 ET]
Table 'Halley' 6-max Seat #1 is the button
Seat 1: macmac399 ($3.37 in chips) 
Seat 2: hc agorist ($5.03 in chips) 
Seat 3: Mesnuj ($2.27 in chips) 
Seat 4: dawidstr ($2.06 in chips) 
Seat 5: d2009157 ($1.86 in chips) 
Seat 6: Oleg1985 ($2.01 in chips) 
hc agorist: posts small blind $0.01
Mesnuj: posts big blind $0.02
*** HOLE CARDS ***
Dealt to hc agorist [9d 7s]
dawidstr: folds 
d2009157: folds 
Oleg1985: raises $0.04 to $0.06
macmac399: calls $0.06
hc agorist: folds 
Mesnuj: folds 
*** FLOP *** [2s Kc 5s]
Oleg1985: bets $0.08
macmac399: calls $0.08
*** TURN *** [2s Kc 5s] [3h]
Oleg1985: bets $0.20
macmac399: folds 
Uncalled bet ($0.20) returned to Oleg1985
Oleg1985 collected $0.30 from pot
Oleg1985: doesn't show hand 
*** SUMMARY ***
Total pot $0.31 | Rake $0.01 
Board [2s Kc 5s 3h]
Seat 1: macmac399 (button) folded on the Turn
Seat 2: hc agorist (small blind) folded before Flop
Seat 3: Mesnuj (big blind) folded before Flop
Seat 4: dawidstr folded before Flop (didn't bet)
Seat 5: d2009157 folded before Flop (didn't bet)
Seat 6: Oleg1985 collected ($0.30)



PokerStars Zoom Hand #193769553480:  Hold'em No Limit ($0.01/$0.02) - 2018/11/27 1:10:28 CUST [2018/11/26 12:10:28 ET]
Table 'Halley' 6-max Seat #1 is the button
Seat 1: ravemaster-z ($2.40 in chips) 
Seat 2: LaCasa15 ($3.39 in chips) 
Seat 3: hc agorist ($5.05 in chips) 
Seat 4: lponcec2 ($2.74 in chips) 
Seat 5: m@xim25 ($4.29 in chips) 
Seat 6: $ RaFaelliTo ($2.03 in chips) 
LaCasa15: posts small blind $0.01
hc agorist: posts big blind $0.02
*** HOLE CARDS ***
Dealt to hc agorist [5s 4d]
lponcec2: folds 
m@xim25: folds 
$ RaFaelliTo: folds 
ravemaster-z: folds 
LaCasa15: folds 
Uncalled bet ($0.01) returned to hc agorist
hc agorist collected $0.02 from pot
hc agorist: doesn't show hand 
*** SUMMARY ***
Total pot $0.02 | Rake $0 
Seat 1: ravemaster-z (button) folded before Flop (didn't bet)
Seat 2: LaCasa15 (small blind) folded before Flop
Seat 3: hc agorist (big blind) collected ($0.02)
Seat 4: lponcec2 folded before Flop (didn't bet)
Seat 5: m@xim25 folded before Flop (didn't bet)
Seat 6: $ RaFaelliTo folded before Flop (didn't bet)



PokerStars Zoom Hand #193769545347:  Hold'em No Limit ($0.01/$0.02) - 2018/11/27 1:10:14 CUST [2018/11/26 12:10:14 ET]
Table 'Halley' 6-max Seat #1 is the button
Seat 1: effortlessly1 ($6.04 in chips) 
Seat 2: T0M5T3R ($2.49 in chips) 
Seat 3: Fishersin ($2.65 in chips) 
Seat 4: LightningImpact ($3.55 in chips) 
Seat 5: crazy_jun ($2.28 in chips) 
Seat 6: hc agorist ($5.05 in chips) 
T0M5T3R: posts small blind $0.01
Fishersin: posts big blind $0.02
*** HOLE CARDS ***
Dealt to hc agorist [3h Jc]
LightningImpact: folds 
crazy_jun: folds 
hc agorist: folds 
effortlessly1: raises $0.04 to $0.06
T0M5T3R: folds 
Fishersin: calls $0.04
*** FLOP *** [6c 2h 7s]
Fishersin: checks 
effortlessly1: checks 
*** TURN *** [6c 2h 7s] [Ts]
Fishersin: checks 
effortlessly1: bets $0.09
Fishersin: folds 
Uncalled bet ($0.09) returned to effortlessly1
effortlessly1 collected $0.13 from pot
effortlessly1: doesn't show hand 
*** SUMMARY ***
Total pot $0.13 | Rake $0 
Board [6c 2h 7s Ts]
Seat 1: effortlessly1 (button) collected ($0.13)
Seat 2: T0M5T3R (small blind) folded before Flop
Seat 3: Fishersin (big blind) folded on the Turn
Seat 4: LightningImpact folded before Flop (didn't bet)
Seat 5: crazy_jun folded before Flop (didn't bet)
Seat 6: hc agorist folded before Flop (didn't bet)



PokerStars Zoom Hand #193769560573:  Hold'em No Limit ($0.01/$0.02) - 2018/11/27 1:10:40 CUST [2018/11/26 12:10:40 ET]
Table 'Halley' 6-max Seat #1 is the button
Seat 1: Mesia198 ($8.08 in chips) 
Seat 2: Bratwurst25 ($2.64 in chips) 
Seat 3: mag8574 ($1.88 in chips) 
Seat 4: hc agorist ($5.06 in chips) 
Seat 5: Pauchok 43ru ($2.96 in chips) 
Seat 6: Andrey Kuz50 ($1.20 in chips) 
Bratwurst25: posts small blind $0.01
mag8574: posts big blind $0.02
*** HOLE CARDS ***
Dealt to hc agorist [2h 6d]
hc agorist: folds 
Pauchok 43ru: folds 
Andrey Kuz50: folds 
Mesia198: calls $0.02
Bratwurst25: calls $0.01
mag8574: checks 
*** FLOP *** [8c 3h 5d]
Bratwurst25: bets $0.06
mag8574: folds 
Mesia198: folds 
Uncalled bet ($0.06) returned to Bratwurst25
Bratwurst25 collected $0.06 from pot
Bratwurst25: doesn't show hand 
*** SUMMARY ***
Total pot $0.06 | Rake $0 
Board [8c 3h 5d]
Seat 1: Mesia198 (button) folded on the Flop
Seat 2: Bratwurst25 (small blind) collected ($0.06)
Seat 3: mag8574 (big blind) folded on the Flop
Seat 4: hc agorist folded before Flop (didn't bet)
Seat 5: Pauchok 43ru folded before Flop (didn't bet)
Seat 6: Andrey Kuz50 folded before Flop (didn't bet)



PokerStars Zoom Hand #193769569422:  Hold'em No Limit ($0.01/$0.02) - 2018/11/27 1:10:55 CUST [2018/11/26 12:10:55 ET]
Table 'Halley' 6-max Seat #1 is the button
Seat 1: EstebanTTT ($2.19 in chips) 
Seat 2: hc agorist ($5.05 in chips) 
Seat 3: DudMeister ($6.92 in chips) 
Seat 4: oshoka ($4.86 in chips) 
Seat 5: Fishersin ($2.58 in chips) 
Seat 6: Vajdalf92 ($3.10 in chips) 
hc agorist: posts small blind $0.01
DudMeister: posts big blind $0.02
*** HOLE CARDS ***
Dealt to hc agorist [8d Qs]
oshoka: folds 
Fishersin: folds 
Vajdalf92: folds 
EstebanTTT: raises $0.04 to $0.06
hc agorist: folds 
DudMeister: folds 
Uncalled bet ($0.04) returned to EstebanTTT
EstebanTTT collected $0.05 from pot
EstebanTTT: doesn't show hand 
*** SUMMARY ***
Total pot $0.05 | Rake $0 
Seat 1: EstebanTTT (button) collected ($0.05)
Seat 2: hc agorist (small blind) folded before Flop
Seat 3: DudMeister (big blind) folded before Flop
Seat 4: oshoka folded before Flop (didn't bet)
Seat 5: Fishersin folded before Flop (didn't bet)
Seat 6: Vajdalf92 folded before Flop (didn't bet)



PokerStars Zoom Hand #193769566465:  Hold'em No Limit ($0.01/$0.02) - 2018/11/27 1:10:50 CUST [2018/11/26 12:10:50 ET]
Table 'Halley' 6-max Seat #1 is the button
Seat 1: PastaShaman ($2.94 in chips) 
Seat 2: codpencil ($2.84 in chips) 
Seat 3: stradywary ($2.03 in chips) 
Seat 4: zsolo480 ($0.92 in chips) 
Seat 5: hc agorist ($5.05 in chips) 
Seat 6: COURT JES264 ($5.16 in chips) 
codpencil: posts small blind $0.01
stradywary: posts big blind $0.02
*** HOLE CARDS ***
Dealt to hc agorist [3d 9s]
zsolo480: folds 
hc agorist: folds 
COURT JES264: folds 
PastaShaman: folds 
codpencil: folds 
Uncalled bet ($0.01) returned to stradywary
stradywary collected $0.02 from pot
stradywary: doesn't show hand 
*** SUMMARY ***
Total pot $0.02 | Rake $0 
Seat 1: PastaShaman (button) folded before Flop (didn't bet)
Seat 2: codpencil (small blind) folded before Flop
Seat 3: stradywary (big blind) collected ($0.02)
Seat 4: zsolo480 folded before Flop (didn't bet)
Seat 5: hc agorist folded before Flop (didn't bet)
Seat 6: COURT JES264 folded before Flop (didn't bet)



PokerStars Zoom Hand #193769563474:  Hold'em No Limit ($0.01/$0.02) - 2018/11/27 1:10:45 CUST [2018/11/26 12:10:45 ET]
Table 'Halley' 6-max Seat #1 is the button
Seat 1: Bobbele1967 ($1.98 in chips) 
Seat 2: hc agorist ($5.06 in chips) 
Seat 3: giveTHEnutsS ($3.80 in chips) 
Seat 4: Williwacker9 ($2.19 in chips) 
Seat 5: SevaShindler ($1.08 in chips) 
Seat 6: maxbreak147 ($2.01 in chips) 
hc agorist: posts small blind $0.01
giveTHEnutsS: posts big blind $0.02
*** HOLE CARDS ***
Dealt to hc agorist [Ks 5d]
Williwacker9: folds 
SevaShindler: folds 
maxbreak147: folds 
Bobbele1967: raises $0.04 to $0.06
hc agorist: folds 
giveTHEnutsS: calls $0.04
*** FLOP *** [4s Qs 3h]
giveTHEnutsS: checks 
Bobbele1967: bets $0.07
giveTHEnutsS: folds 
Uncalled bet ($0.07) returned to Bobbele1967
Bobbele1967 collected $0.13 from pot
Bobbele1967: doesn't show hand 
*** SUMMARY ***
Total pot $0.13 | Rake $0 
Board [4s Qs 3h]
Seat 1: Bobbele1967 (button) collected ($0.13)
Seat 2: hc agorist (small blind) folded before Flop
Seat 3: giveTHEnutsS (big blind) folded on the Flop
Seat 4: Williwacker9 folded before Flop (didn't bet)
Seat 5: SevaShindler folded before Flop (didn't bet)
Seat 6: maxbreak147 folded before Flop (didn't bet)



PokerStars Zoom Hand #193769574712:  Hold'em No Limit ($0.01/$0.02) - 2018/11/27 1:11:04 CUST [2018/11/26 12:11:04 ET]
Table 'Halley' 6-max Seat #1 is the button
Seat 1: MaMoHT1988 ($1.95 in chips) 
Seat 2: IMVV310 ($2.18 in chips) 
Seat 3: hc agorist ($5.04 in chips) 
Seat 4: bodialimon ($2.10 in chips) 
Seat 5: Medved219 ($2.10 in chips) 
Seat 6: SanDmitri4 ($2.62 in chips) 
IMVV310: posts small blind $0.01
hc agorist: posts big blind $0.02
*** HOLE CARDS ***
Dealt to hc agorist [Kd Ac]
bodialimon: folds 
Medved219: raises $0.03 to $0.05
SanDmitri4: folds 
MaMoHT1988: folds 
IMVV310: folds 
hc agorist: raises $0.11 to $0.16
Medved219: folds 
Uncalled bet ($0.11) returned to hc agorist
hc agorist collected $0.11 from pot
hc agorist: doesn't show hand 
*** SUMMARY ***
Total pot $0.11 | Rake $0 
Seat 1: MaMoHT1988 (button) folded before Flop (didn't bet)
Seat 2: IMVV310 (small blind) folded before Flop
Seat 3: hc agorist (big blind) collected ($0.11)
Seat 4: bodialimon folded before Flop (didn't bet)
Seat 5: Medved219 folded before Flop
Seat 6: SanDmitri4 folded before Flop (didn't bet)



PokerStars Zoom Hand #193769587050:  Hold'em No Limit ($0.01/$0.02) - 2018/11/27 1:11:25 CUST [2018/11/26 12:11:25 ET]
Table 'Halley' 6-max Seat #1 is the button
Seat 1: hc agorist ($5.10 in chips) 
Seat 2: Rus. Pioneer ($2.77 in chips) 
Seat 3: mcecanho ($3.84 in chips) 
Seat 4: Taggwan ($4.25 in chips) 
Seat 5: Andr1y ($1.20 in chips) 
Seat 6: Alexey3693 ($2.23 in chips) 
Rus. Pioneer: posts small blind $0.01
mcecanho: posts big blind $0.02
*** HOLE CARDS ***
Dealt to hc agorist [3s Kh]
Taggwan: folds 
Andr1y: folds 
Alexey3693: folds 
hc agorist: folds 
Rus. Pioneer: folds 
Uncalled bet ($0.01) returned to mcecanho
mcecanho collected $0.02 from pot
mcecanho: doesn't show hand 
*** SUMMARY ***
Total pot $0.02 | Rake $0 
Seat 1: hc agorist (button) folded before Flop (didn't bet)
Seat 2: Rus. Pioneer (small blind) folded before Flop
Seat 3: mcecanho (big blind) collected ($0.02)
Seat 4: Taggwan folded before Flop (didn't bet)
Seat 5: Andr1y folded before Flop (didn't bet)
Seat 6: Alexey3693 folded before Flop (didn't bet)



PokerStars Zoom Hand #193769589980:  Hold'em No Limit ($0.01/$0.02) - 2018/11/27 1:11:30 CUST [2018/11/26 12:11:30 ET]
Table 'Halley' 6-max Seat #1 is the button
Seat 1: juni0rZ ($2.41 in chips) 
Seat 2: mag8574 ($1.64 in chips) 
Seat 3: j3fing ($4.78 in chips) 
Seat 4: P.Cogito ($2.18 in chips) 
Seat 5: yukon Ronald ($2.08 in chips) 
Seat 6: hc agorist ($5.10 in chips) 
mag8574: posts small blind $0.01
j3fing: posts big blind $0.02
*** HOLE CARDS ***
Dealt to hc agorist [3d 6d]
P.Cogito: folds 
yukon Ronald: calls $0.02
hc agorist: raises $0.07 to $0.09
juni0rZ: folds 
mag8574: folds 
j3fing: folds 
yukon Ronald: folds 
Uncalled bet ($0.07) returned to hc agorist
hc agorist collected $0.07 from pot
hc agorist: doesn't show hand 
*** SUMMARY ***
Total pot $0.07 | Rake $0 
Seat 1: juni0rZ (button) folded before Flop (didn't bet)
Seat 2: mag8574 (small blind) folded before Flop
Seat 3: j3fing (big blind) folded before Flop
Seat 4: P.Cogito folded before Flop (didn't bet)
Seat 5: yukon Ronald folded before Flop
Seat 6: hc agorist collected ($0.07)



PokerStars Zoom Hand #193769607171:  Hold'em No Limit ($0.01/$0.02) - 2018/11/27 1:11:59 CUST [2018/11/26 12:11:59 ET]
Table 'Halley' 6-max Seat #1 is the button
Seat 1: MikeStarsAAAA ($3.11 in chips) 
Seat 2: sks133335 ($2.20 in chips) 
Seat 3: gonih ($0.88 in chips) 
Seat 4: hc agorist ($5.15 in chips) 
Seat 5: LuckdarkAA ($4.17 in chips) 
Seat 6: MaMoHT1988 ($2 in chips) 
sks133335: posts small blind $0.01
gonih: posts big blind $0.02
*** HOLE CARDS ***
Dealt to hc agorist [Qh 2c]
hc agorist: folds 
LuckdarkAA: folds 
MaMoHT1988: folds 
MikeStarsAAAA: raises $0.04 to $0.06
sks133335: folds 
gonih: folds 
Uncalled bet ($0.04) returned to MikeStarsAAAA
MikeStarsAAAA collected $0.05 from pot
MikeStarsAAAA: doesn't show hand 
*** SUMMARY ***
Total pot $0.05 | Rake $0 
Seat 1: MikeStarsAAAA (button) collected ($0.05)
Seat 2: sks133335 (small blind) folded before Flop
Seat 3: gonih (big blind) folded before Flop
Seat 4: hc agorist folded before Flop (didn't bet)
Seat 5: LuckdarkAA folded before Flop (didn't bet)
Seat 6: MaMoHT1988 folded before Flop (didn't bet)



PokerStars Zoom Hand #193769610130:  Hold'em No Limit ($0.01/$0.02) - 2018/11/27 1:12:04 CUST [2018/11/26 12:12:04 ET]
Table 'Halley' 6-max Seat #1 is the button
Seat 1: hc agorist ($5.15 in chips) 
Seat 2: batek_1 ($1.75 in chips) 
Seat 3: Mediasinres ($3.15 in chips) 
Seat 4: strimmm0 ($5.75 in chips) 
Seat 5: San4ezzz63 ($2.03 in chips) 
Seat 6: QuichesLeRoy ($2 in chips) 
batek_1: posts small blind $0.01
Mediasinres: posts big blind $0.02
*** HOLE CARDS ***
Dealt to hc agorist [3c 5c]
strimmm0: folds 
San4ezzz63: raises $0.04 to $0.06
QuichesLeRoy: calls $0.06
hc agorist: raises $0.21 to $0.27
batek_1: folds 
Mediasinres: folds 
San4ezzz63: calls $0.21
QuichesLeRoy: folds 
*** FLOP *** [Jc 6c Jd]
San4ezzz63: checks 
hc agorist: bets $0.21
San4ezzz63: calls $0.21
*** TURN *** [Jc 6c Jd] [Tc]
San4ezzz63: checks 
hc agorist: bets $0.48
San4ezzz63: calls $0.48
*** RIVER *** [Jc 6c Jd Tc] [7s]
San4ezzz63: bets $1.07 and is all-in
hc agorist: calls $1.07
*** SHOW DOWN ***
San4ezzz63: shows [Js As] (three of a kind, Jacks)
hc agorist: shows [3c 5c] (a flush, Jack high)
hc agorist collected $4 from pot
*** SUMMARY ***
Total pot $4.15 | Rake $0.15 
Board [Jc 6c Jd Tc 7s]
Seat 1: hc agorist (button) showed [3c 5c] and won ($4) with a flush, Jack high
Seat 2: batek_1 (small blind) folded before Flop
Seat 3: Mediasinres (big blind) folded before Flop
Seat 4: strimmm0 folded before Flop (didn't bet)
Seat 5: San4ezzz63 showed [Js As] and lost with three of a kind, Jacks
Seat 6: QuichesLeRoy folded before Flop



PokerStars Zoom Hand #193769641876:  Hold'em No Limit ($0.01/$0.02) - 2018/11/27 1:12:58 CUST [2018/11/26 12:12:58 ET]
Table 'Halley' 6-max Seat #1 is the button
Seat 1: glagla87 ($2 in chips) 
Seat 2: hc agorist ($7.12 in chips) 
Seat 3: Rus. Pioneer ($2.76 in chips) 
Seat 4: los_genos ($2.26 in chips) 
Seat 5: mmoozzgg007 ($2 in chips) 
Seat 6: kuna7777 ($0.97 in chips) 
hc agorist: posts small blind $0.01
Rus. Pioneer: posts big blind $0.02
*** HOLE CARDS ***
Dealt to hc agorist [Qs 8h]
los_genos: folds 
mmoozzgg007: folds 
kuna7777: raises $0.02 to $0.04
glagla87: folds 
hc agorist: folds 
Rus. Pioneer: folds 
Uncalled bet ($0.02) returned to kuna7777
kuna7777 collected $0.05 from pot
kuna7777: doesn't show hand 
*** SUMMARY ***
Total pot $0.05 | Rake $0 
Seat 1: glagla87 (button) folded before Flop (didn't bet)
Seat 2: hc agorist (small blind) folded before Flop
Seat 3: Rus. Pioneer (big blind) folded before Flop
Seat 4: los_genos folded before Flop (didn't bet)
Seat 5: mmoozzgg007 folded before Flop (didn't bet)
Seat 6: kuna7777 collected ($0.05)



PokerStars Zoom Hand #193769650745:  Hold'em No Limit ($0.01/$0.02) - 2018/11/27 1:13:13 CUST [2018/11/26 12:13:13 ET]
Table 'Halley' 6-max Seat #1 is the button
Seat 1: zergmiky ($3.01 in chips) 
Seat 2: Henk_M ($1.23 in chips) 
Seat 3: hc agorist ($7.11 in chips) 
Seat 4: rauladrian88 ($1.49 in chips) 
Seat 5: stupid_bear1 ($0.35 in chips) 
Seat 6: GreyKeeperRu ($1.75 in chips) 
Henk_M: posts small blind $0.01
hc agorist: posts big blind $0.02
*** HOLE CARDS ***
Dealt to hc agorist [2c Ts]
rauladrian88: folds 
stupid_bear1: folds 
GreyKeeperRu: folds 
zergmiky: folds 
Henk_M: folds 
Uncalled bet ($0.01) returned to hc agorist
hc agorist collected $0.02 from pot
hc agorist: doesn't show hand 
*** SUMMARY ***
Total pot $0.02 | Rake $0 
Seat 1: zergmiky (button) folded before Flop (didn't bet)
Seat 2: Henk_M (small blind) folded before Flop
Seat 3: hc agorist (big blind) collected ($0.02)
Seat 4: rauladrian88 folded before Flop (didn't bet)
Seat 5: stupid_bear1 folded before Flop (didn't bet)
Seat 6: GreyKeeperRu folded before Flop (didn't bet)



PokerStars Zoom Hand #193769661305:  Hold'em No Limit ($0.01/$0.02) - 2018/11/27 1:13:31 CUST [2018/11/26 12:13:31 ET]
Table 'Halley' 6-max Seat #1 is the button
Seat 1: Losimas(LT) ($2.90 in chips) 
Seat 2: Danilloo93 ($4.40 in chips) 
Seat 3: COURT JES264 ($3.74 in chips) 
Seat 4: Flauschefloc ($1.92 in chips) 
Seat 5: hc agorist ($7.12 in chips) 
Seat 6: vagasstar ($2.93 in chips) 
Danilloo93: posts small blind $0.01
COURT JES264: posts big blind $0.02
*** HOLE CARDS ***
Dealt to hc agorist [Jh 7s]
Flauschefloc: folds 
hc agorist: folds 
vagasstar: raises $0.04 to $0.06
Losimas(LT): folds 
Danilloo93: folds 
COURT JES264: folds 
Uncalled bet ($0.04) returned to vagasstar
vagasstar collected $0.05 from pot
vagasstar: doesn't show hand 
*** SUMMARY ***
Total pot $0.05 | Rake $0 
Seat 1: Losimas(LT) (button) folded before Flop (didn't bet)
Seat 2: Danilloo93 (small blind) folded before Flop
Seat 3: COURT JES264 (big blind) folded before Flop
Seat 4: Flauschefloc folded before Flop (didn't bet)
Seat 5: hc agorist folded before Flop (didn't bet)
Seat 6: vagasstar collected ($0.05)



PokerStars Zoom Hand #193769664898:  Hold'em No Limit ($0.01/$0.02) - 2018/11/27 1:13:37 CUST [2018/11/26 12:13:37 ET]
Table 'Halley' 6-max Seat #1 is the button
Seat 1: hc agorist ($7.12 in chips) 
Seat 2: Kala77 ($2.25 in chips) 
Seat 3: pkr_str3368 ($2.21 in chips) 
Seat 4: serde4nik ($2.99 in chips) 
Seat 5: KF Furiak ($0.46 in chips) 
Seat 6: bulugo333 ($2 in chips) 
Kala77: posts small blind $0.01
pkr_str3368: posts big blind $0.02
*** HOLE CARDS ***
Dealt to hc agorist [5c 4h]
serde4nik: raises $0.03 to $0.05
KF Furiak: calls $0.05
bulugo333: folds 
hc agorist: folds 
Kala77: folds 
pkr_str3368: folds 
*** FLOP *** [2c 4c Kc]
serde4nik: checks 
KF Furiak: bets $0.07
serde4nik: folds 
Uncalled bet ($0.07) returned to KF Furiak
KF Furiak collected $0.13 from pot
KF Furiak: doesn't show hand 
*** SUMMARY ***
Total pot $0.13 | Rake $0 
Board [2c 4c Kc]
Seat 1: hc agorist (button) folded before Flop (didn't bet)
Seat 2: Kala77 (small blind) folded before Flop
Seat 3: pkr_str3368 (big blind) folded before Flop
Seat 4: serde4nik folded on the Flop
Seat 5: KF Furiak collected ($0.13)
Seat 6: bulugo333 folded before Flop (didn't bet)



PokerStars Zoom Hand #193769654824:  Hold'em No Limit ($0.01/$0.02) - 2018/11/27 1:13:20 CUST [2018/11/26 12:13:20 ET]
Table 'Halley' 6-max Seat #1 is the button
Seat 1: SVG7777 ($3.35 in chips) 
Seat 2: ravemaster-z ($3.32 in chips) 
Seat 3: >>LVV80<< ($2 in chips) 
Seat 4: COURT JES264 ($4.98 in chips) 
Seat 5: craven7777 ($5.49 in chips) 
Seat 6: hc agorist ($7.12 in chips) 
ravemaster-z: posts small blind $0.01
>>LVV80<<: posts big blind $0.02
*** HOLE CARDS ***
Dealt to hc agorist [3d Jc]
COURT JES264: folds 
craven7777: folds 
hc agorist: folds 
SVG7777: raises $0.02 to $0.04
ravemaster-z: folds 
>>LVV80<<: calls $0.02
*** FLOP *** [9h 3c Kd]
>>LVV80<<: checks 
SVG7777: bets $0.05
>>LVV80<<: calls $0.05
*** TURN *** [9h 3c Kd] [9s]
>>LVV80<<: checks 
SVG7777: checks 
*** RIVER *** [9h 3c Kd 9s] [Th]
>>LVV80<<: checks 
SVG7777: checks 
*** SHOW DOWN ***
>>LVV80<<: shows [5d 3h] (two pair, Nines and Threes)
SVG7777: shows [6h 6s] (two pair, Nines and Sixes)
SVG7777 collected $0.18 from pot
*** SUMMARY ***
Total pot $0.19 | Rake $0.01 
Board [9h 3c Kd 9s Th]
Seat 1: SVG7777 (button) showed [6h 6s] and won ($0.18) with two pair, Nines and Sixes
Seat 2: ravemaster-z (small blind) folded before Flop
Seat 3: >>LVV80<< (big blind) showed [5d 3h] and lost with two pair, Nines and Threes
Seat 4: COURT JES264 folded before Flop (didn't bet)
Seat 5: craven7777 folded before Flop (didn't bet)
Seat 6: hc agorist folded before Flop (didn't bet)



PokerStars Zoom Hand #193769669121:  Hold'em No Limit ($0.01/$0.02) - 2018/11/27 1:13:44 CUST [2018/11/26 12:13:44 ET]
Table 'Halley' 6-max Seat #1 is the button
Seat 1: buca7a ($3.44 in chips) 
Seat 2: snowwboarder ($1.57 in chips) 
Seat 3: SRERAF ($2.12 in chips) 
Seat 4: hc agorist ($7.12 in chips) 
Seat 5: EL PAV*14 ($3.04 in chips) 
Seat 6: Williwacker9 ($2 in chips) 
snowwboarder: posts small blind $0.01
SRERAF: posts big blind $0.02
*** HOLE CARDS ***
Dealt to hc agorist [6c 9h]
hc agorist: folds 
EL PAV*14: folds 
Williwacker9: folds 
buca7a: raises $0.04 to $0.06
snowwboarder: folds 
SRERAF: folds 
Uncalled bet ($0.04) returned to buca7a
buca7a collected $0.05 from pot
buca7a: doesn't show hand 
*** SUMMARY ***
Total pot $0.05 | Rake $0 
Seat 1: buca7a (button) collected ($0.05)
Seat 2: snowwboarder (small blind) folded before Flop
Seat 3: SRERAF (big blind) folded before Flop
Seat 4: hc agorist folded before Flop (didn't bet)
Seat 5: EL PAV*14 folded before Flop (didn't bet)
Seat 6: Williwacker9 folded before Flop (didn't bet)



PokerStars Zoom Hand #193769672050:  Hold'em No Limit ($0.01/$0.02) - 2018/11/27 1:13:49 CUST [2018/11/26 12:13:49 ET]
Table 'Halley' 6-max Seat #1 is the button
Seat 1: GDGHD ($4.85 in chips) 
Seat 2: sepik200 ($3.15 in chips) 
Seat 3: Pauchok 43ru ($1.62 in chips) 
Seat 4: villian888 ($2.19 in chips) 
Seat 5: Darius INC. ($2.28 in chips) 
Seat 6: hc agorist ($7.12 in chips) 
sepik200: posts small blind $0.01
Pauchok 43ru: posts big blind $0.02
*** HOLE CARDS ***
Dealt to hc agorist [Js 8d]
villian888: folds 
Darius INC.: folds 
hc agorist: raises $0.02 to $0.04
GDGHD: folds 
sepik200: folds 
Pauchok 43ru: folds 
Uncalled bet ($0.02) returned to hc agorist
hc agorist collected $0.05 from pot
hc agorist: doesn't show hand 
*** SUMMARY ***
Total pot $0.05 | Rake $0 
Seat 1: GDGHD (button) folded before Flop (didn't bet)
Seat 2: sepik200 (small blind) folded before Flop
Seat 3: Pauchok 43ru (big blind) folded before Flop
Seat 4: villian888 folded before Flop (didn't bet)
Seat 5: Darius INC. folded before Flop (didn't bet)
Seat 6: hc agorist collected ($0.05)



PokerStars Zoom Hand #193769681487:  Hold'em No Limit ($0.01/$0.02) - 2018/11/27 1:14:05 CUST [2018/11/26 12:14:05 ET]
Table 'Halley' 6-max Seat #1 is the button
Seat 1: dawidstr ($2.44 in chips) 
Seat 2: P.Cogito ($2.10 in chips) 
Seat 3: hc agorist ($7.15 in chips) 
Seat 4: simple s0o ($2.64 in chips) 
Seat 5: AAQQQ ($2 in chips) 
Seat 6: TheD1nhoR10 ($0.37 in chips) 
P.Cogito: posts small blind $0.01
hc agorist: posts big blind $0.02
*** HOLE CARDS ***
Dealt to hc agorist [9h Qd]
simple s0o: folds 
AAQQQ: folds 
TheD1nhoR10: folds 
dawidstr: raises $0.04 to $0.06
P.Cogito: folds 
hc agorist: raises $0.13 to $0.19
dawidstr: folds 
Uncalled bet ($0.13) returned to hc agorist
hc agorist collected $0.13 from pot
hc agorist: doesn't show hand 
*** SUMMARY ***
Total pot $0.13 | Rake $0 
Seat 1: dawidstr (button) folded before Flop
Seat 2: P.Cogito (small blind) folded before Flop
Seat 3: hc agorist (big blind) collected ($0.13)
Seat 4: simple s0o folded before Flop (didn't bet)
Seat 5: AAQQQ folded before Flop (didn't bet)
Seat 6: TheD1nhoR10 folded before Flop (didn't bet)



PokerStars Zoom Hand #193769703468:  Hold'em No Limit ($0.01/$0.02) - 2018/11/27 1:14:42 CUST [2018/11/26 12:14:42 ET]
Table 'Halley' 6-max Seat #1 is the button
Seat 1: Omuvan ($4.59 in chips) 
Seat 2: HoudiniH95 ($3.36 in chips) 
Seat 3: skendroshen ($2 in chips) 
Seat 4: Ruffian505 ($0.78 in chips) 
Seat 5: hc agorist ($7.21 in chips) 
Seat 6: pokerfan3999 ($3.86 in chips) 
HoudiniH95: posts small blind $0.01
skendroshen: posts big blind $0.02
*** HOLE CARDS ***
Dealt to hc agorist [Ad 8c]
Ruffian505: folds 
hc agorist: folds 
pokerfan3999: raises $0.04 to $0.06
Omuvan: folds 
HoudiniH95: folds 
skendroshen: folds 
Uncalled bet ($0.04) returned to pokerfan3999
pokerfan3999 collected $0.05 from pot
pokerfan3999: doesn't show hand 
*** SUMMARY ***
Total pot $0.05 | Rake $0 
Seat 1: Omuvan (button) folded before Flop (didn't bet)
Seat 2: HoudiniH95 (small blind) folded before Flop
Seat 3: skendroshen (big blind) folded before Flop
Seat 4: Ruffian505 folded before Flop (didn't bet)
Seat 5: hc agorist folded before Flop (didn't bet)
Seat 6: pokerfan3999 collected ($0.05)



PokerStars Zoom Hand #193769700463:  Hold'em No Limit ($0.01/$0.02) - 2018/11/27 1:14:37 CUST [2018/11/26 12:14:37 ET]
Table 'Halley' 6-max Seat #1 is the button
Seat 1: Glivera77 ($1.69 in chips) 
Seat 2: hc agorist ($7.22 in chips) 
Seat 3: MiuFuringi ($3.64 in chips) 
Seat 4: FanT1One ($2.25 in chips) 
Seat 5: bybaleh52 ($3.17 in chips) 
Seat 6: gaeppakse ($2 in chips) 
hc agorist: posts small blind $0.01
MiuFuringi: posts big blind $0.02
*** HOLE CARDS ***
Dealt to hc agorist [7d 6s]
FanT1One: folds 
bybaleh52: folds 
gaeppakse: folds 
Glivera77: raises $0.03 to $0.05
hc agorist: folds 
MiuFuringi: calls $0.03
*** FLOP *** [Js 2c Jh]
MiuFuringi: checks 
Glivera77: checks 
*** TURN *** [Js 2c Jh] [Ac]
MiuFuringi: checks 
Glivera77: bets $0.05
MiuFuringi: folds 
Uncalled bet ($0.05) returned to Glivera77
Glivera77 collected $0.11 from pot
Glivera77: doesn't show hand 
*** SUMMARY ***
Total pot $0.11 | Rake $0 
Board [Js 2c Jh Ac]
Seat 1: Glivera77 (button) collected ($0.11)
Seat 2: hc agorist (small blind) folded before Flop
Seat 3: MiuFuringi (big blind) folded on the Turn
Seat 4: FanT1One folded before Flop (didn't bet)
Seat 5: bybaleh52 folded before Flop (didn't bet)
Seat 6: gaeppakse folded before Flop (didn't bet)



PokerStars Zoom Hand #193769706994:  Hold'em No Limit ($0.01/$0.02) - 2018/11/27 1:14:48 CUST [2018/11/26 12:14:48 ET]
Table 'Halley' 6-max Seat #1 is the button
Seat 1: hc agorist ($7.21 in chips) 
Seat 2: Rooos21 ($2.35 in chips) 
Seat 3: Darek.bl ($2 in chips) 
Seat 4: lucyenriny ($1.38 in chips) 
Seat 5: Andrey Kuz50 ($0.79 in chips) 
Seat 6: Bobbele1967 ($1.98 in chips) 
Rooos21: posts small blind $0.01
Darek.bl: posts big blind $0.02
*** HOLE CARDS ***
Dealt to hc agorist [6c 5c]
lucyenriny: calls $0.02
Andrey Kuz50: raises $0.08 to $0.10
Bobbele1967: folds 
hc agorist: folds 
Rooos21: folds 
Darek.bl: folds 
lucyenriny: calls $0.08
*** FLOP *** [Ah Kd 4s]
lucyenriny: bets $0.02
Andrey Kuz50: calls $0.02
*** TURN *** [Ah Kd 4s] [4d]
lucyenriny: bets $0.02
Andrey Kuz50: calls $0.02
*** RIVER *** [Ah Kd 4s 4d] [9d]
lucyenriny: bets $0.02
Andrey Kuz50: calls $0.02
*** SHOW DOWN ***
lucyenriny: shows [Kh Qc] (two pair, Kings and Fours)
Andrey Kuz50: mucks hand 
lucyenriny collected $0.34 from pot
*** SUMMARY ***
Total pot $0.35 | Rake $0.01 
Board [Ah Kd 4s 4d 9d]
Seat 1: hc agorist (button) folded before Flop (didn't bet)
Seat 2: Rooos21 (small blind) folded before Flop
Seat 3: Darek.bl (big blind) folded before Flop
Seat 4: lucyenriny showed [Kh Qc] and won ($0.34) with two pair, Kings and Fours
Seat 5: Andrey Kuz50 mucked [7h 7c]
Seat 6: Bobbele1967 folded before Flop (didn't bet)



PokerStars Zoom Hand #193769717159:  Hold'em No Limit ($0.01/$0.02) - 2018/11/27 1:15:05 CUST [2018/11/26 12:15:05 ET]
Table 'Halley' 6-max Seat #1 is the button
Seat 1: Forten55 ($2.58 in chips) 
Seat 2: NaumiPar ($4.38 in chips) 
Seat 3: hc agorist ($7.21 in chips) 
Seat 4: bodialimon ($2.58 in chips) 
Seat 5: simple s0o ($7.62 in chips) 
Seat 6: Niphet ($2.01 in chips) 
NaumiPar: posts small blind $0.01
hc agorist: posts big blind $0.02
*** HOLE CARDS ***
Dealt to hc agorist [Kc 3h]
bodialimon: folds 
simple s0o: raises $0.04 to $0.06
Niphet: folds 
Forten55: calls $0.06
NaumiPar: folds 
hc agorist: folds 
*** FLOP *** [6h Qc 5h]
simple s0o: checks 
Forten55: checks 
*** TURN *** [6h Qc 5h] [Qs]
simple s0o: checks 
Forten55: checks 
*** RIVER *** [6h Qc 5h Qs] [4d]
simple s0o: bets $0.06
Forten55: folds 
Uncalled bet ($0.06) returned to simple s0o
simple s0o collected $0.14 from pot
simple s0o: doesn't show hand 
*** SUMMARY ***
Total pot $0.15 | Rake $0.01 
Board [6h Qc 5h Qs 4d]
Seat 1: Forten55 (button) folded on the River
Seat 2: NaumiPar (small blind) folded before Flop
Seat 3: hc agorist (big blind) folded before Flop
Seat 4: bodialimon folded before Flop (didn't bet)
Seat 5: simple s0o collected ($0.14)
Seat 6: Niphet folded before Flop (didn't bet)



PokerStars Zoom Hand #193769720732:  Hold'em No Limit ($0.01/$0.02) - 2018/11/27 1:15:11 CUST [2018/11/26 12:15:11 ET]
Table 'Halley' 6-max Seat #1 is the button
Seat 1: sousaleandro ($2 in chips) 
Seat 2: solarsyco11 ($3.76 in chips) 
Seat 3: COURT JES264 ($4.65 in chips) 
Seat 4: Qwkl ($2.03 in chips) 
Seat 5: Oleg1985 ($2.68 in chips) 
Seat 6: hc agorist ($7.19 in chips) 
solarsyco11: posts small blind $0.01
COURT JES264: posts big blind $0.02
*** HOLE CARDS ***
Dealt to hc agorist [Ks Qs]
Qwkl: folds 
Oleg1985: raises $0.04 to $0.06
hc agorist: raises $0.12 to $0.18
sousaleandro: folds 
solarsyco11: folds 
COURT JES264: calls $0.16
Oleg1985: calls $0.12
*** FLOP *** [7c 3h 3s]
COURT JES264: checks 
Oleg1985: checks 
hc agorist: checks 
*** TURN *** [7c 3h 3s] [7s]
COURT JES264: checks 
Oleg1985: checks 
hc agorist: bets $0.24
COURT JES264: folds 
Oleg1985: calls $0.24
*** RIVER *** [7c 3h 3s 7s] [5d]
Oleg1985: checks 
hc agorist: bets $0.44
Oleg1985: calls $0.44
*** SHOW DOWN ***
hc agorist: shows [Ks Qs] (two pair, Sevens and Threes)
Oleg1985: shows [Ah Qd] (two pair, Sevens and Threes - Ace kicker)
Oleg1985 collected $1.84 from pot
*** SUMMARY ***
Total pot $1.91 | Rake $0.07 
Board [7c 3h 3s 7s 5d]
Seat 1: sousaleandro (button) folded before Flop (didn't bet)
Seat 2: solarsyco11 (small blind) folded before Flop
Seat 3: COURT JES264 (big blind) folded on the Turn
Seat 4: Qwkl folded before Flop (didn't bet)
Seat 5: Oleg1985 showed [Ah Qd] and won ($1.84) with two pair, Sevens and Threes
Seat 6: hc agorist showed [Ks Qs] and lost with two pair, Sevens and Threes



PokerStars Zoom Hand #193769757571:  Hold'em No Limit ($0.01/$0.02) - 2018/11/27 1:16:13 CUST [2018/11/26 12:16:13 ET]
Table 'Halley' 6-max Seat #1 is the button
Seat 1: >>LVV80<< ($2.12 in chips) 
Seat 2: hc agorist ($6.33 in chips) 
Seat 3: 3Iver's3 ($3.95 in chips) 
Seat 4: Vajdalf92 ($3.56 in chips) 
Seat 5: Mesnuj ($2.18 in chips) 
Seat 6: blue52844 ($2.78 in chips) 
hc agorist: posts small blind $0.01
3Iver's3: posts big blind $0.02
*** HOLE CARDS ***
Dealt to hc agorist [4c 8d]
Vajdalf92: folds 
Mesnuj: folds 
blue52844: raises $0.04 to $0.06
>>LVV80<<: folds 
hc agorist: folds 
3Iver's3: folds 
Uncalled bet ($0.04) returned to blue52844
blue52844 collected $0.05 from pot
blue52844: doesn't show hand 
*** SUMMARY ***
Total pot $0.05 | Rake $0 
Seat 1: >>LVV80<< (button) folded before Flop (didn't bet)
Seat 2: hc agorist (small blind) folded before Flop
Seat 3: 3Iver's3 (big blind) folded before Flop
Seat 4: Vajdalf92 folded before Flop (didn't bet)
Seat 5: Mesnuj folded before Flop (didn't bet)
Seat 6: blue52844 collected ($0.05)



PokerStars Zoom Hand #193769765841:  Hold'em No Limit ($0.01/$0.02) - 2018/11/27 1:16:27 CUST [2018/11/26 12:16:27 ET]
Table 'Halley' 6-max Seat #1 is the button
Seat 1: piterstone ($2.86 in chips) 
Seat 2: Bratwurst25 ($1.57 in chips) 
Seat 3: Damian36215 ($2.22 in chips) 
Seat 4: hc agorist ($6.32 in chips) 
Seat 5: Alexarulit ($2.06 in chips) 
Seat 6: pokerfan3999 ($3.75 in chips) 
Bratwurst25: posts small blind $0.01
Damian36215: posts big blind $0.02
*** HOLE CARDS ***
Dealt to hc agorist [Ac 2c]
hc agorist: raises $0.04 to $0.06
Alexarulit: folds 
pokerfan3999: folds 
piterstone: folds 
Bratwurst25: folds 
Damian36215: folds 
Uncalled bet ($0.04) returned to hc agorist
hc agorist collected $0.05 from pot
hc agorist: doesn't show hand 
*** SUMMARY ***
Total pot $0.05 | Rake $0 
Seat 1: piterstone (button) folded before Flop (didn't bet)
Seat 2: Bratwurst25 (small blind) folded before Flop
Seat 3: Damian36215 (big blind) folded before Flop
Seat 4: hc agorist collected ($0.05)
Seat 5: Alexarulit folded before Flop (didn't bet)
Seat 6: pokerfan3999 folded before Flop (didn't bet)



PokerStars Zoom Hand #193769761081:  Hold'em No Limit ($0.01/$0.02) - 2018/11/27 1:16:19 CUST [2018/11/26 12:16:19 ET]
Table 'Halley' 6-max Seat #1 is the button
Seat 1: tdo208 ($3.98 in chips) 
Seat 2: SanDmitri4 ($3.37 in chips) 
Seat 3: meniasjo ($4.30 in chips) 
Seat 4: 73X4S ($6.85 in chips) 
Seat 5: hc agorist ($6.32 in chips) 
Seat 6: marta328 ($2 in chips) 
SanDmitri4: posts small blind $0.01
meniasjo: posts big blind $0.02
*** HOLE CARDS ***
Dealt to hc agorist [2s 8d]
73X4S: folds 
hc agorist: folds 
marta328: folds 
tdo208: raises $0.04 to $0.06
SanDmitri4: folds 
meniasjo: calls $0.04
*** FLOP *** [4d 9c 7d]
meniasjo: checks 
tdo208: checks 
*** TURN *** [4d 9c 7d] [Th]
meniasjo: bets $0.10
tdo208: folds 
Uncalled bet ($0.10) returned to meniasjo
meniasjo collected $0.13 from pot
meniasjo: doesn't show hand 
*** SUMMARY ***
Total pot $0.13 | Rake $0 
Board [4d 9c 7d Th]
Seat 1: tdo208 (button) folded on the Turn
Seat 2: SanDmitri4 (small blind) folded before Flop
Seat 3: meniasjo (big blind) collected ($0.13)
Seat 4: 73X4S folded before Flop (didn't bet)
Seat 5: hc agorist folded before Flop (didn't bet)
Seat 6: marta328 folded before Flop (didn't bet)



PokerStars Zoom Hand #193769780660:  Hold'em No Limit ($0.01/$0.02) - 2018/11/27 1:16:52 CUST [2018/11/26 12:16:52 ET]
Table 'Halley' 6-max Seat #1 is the button
Seat 1: vonvon59640 ($3.39 in chips) 
Seat 2: BigNezbowski ($0.56 in chips) 
Seat 3: hc agorist ($6.35 in chips) 
Seat 4: simple s0o ($7.50 in chips) 
Seat 5: cacao73 ($3.08 in chips) 
Seat 6: affgust ($2.17 in chips) 
BigNezbowski: posts small blind $0.01
hc agorist: posts big blind $0.02
*** HOLE CARDS ***
Dealt to hc agorist [6h As]
simple s0o: folds 
cacao73: folds 
affgust: folds 
vonvon59640: folds 
BigNezbowski: folds 
Uncalled bet ($0.01) returned to hc agorist
hc agorist collected $0.02 from pot
hc agorist: doesn't show hand 
*** SUMMARY ***
Total pot $0.02 | Rake $0 
Seat 1: vonvon59640 (button) folded before Flop (didn't bet)
Seat 2: BigNezbowski (small blind) folded before Flop
Seat 3: hc agorist (big blind) collected ($0.02)
Seat 4: simple s0o folded before Flop (didn't bet)
Seat 5: cacao73 folded before Flop (didn't bet)
Seat 6: affgust folded before Flop (didn't bet)



PokerStars Zoom Hand #193769777676:  Hold'em No Limit ($0.01/$0.02) - 2018/11/27 1:16:47 CUST [2018/11/26 12:16:47 ET]
Table 'Halley' 6-max Seat #1 is the button
Seat 1: Maverick_JPR ($3.57 in chips) 
Seat 2: SanDmitri4 ($2 in chips) 
Seat 3: mag8574 ($3.03 in chips) 
Seat 4: Unconform ($2.16 in chips) 
Seat 5: hc agorist ($6.35 in chips) 
Seat 6: batiatus72 ($1.53 in chips) 
SanDmitri4: posts small blind $0.01
mag8574: posts big blind $0.02
*** HOLE CARDS ***
Dealt to hc agorist [5s 2c]
Unconform: folds 
hc agorist: folds 
batiatus72: folds 
Maverick_JPR: raises $0.05 to $0.07
SanDmitri4: folds 
mag8574: folds 
Uncalled bet ($0.05) returned to Maverick_JPR
Maverick_JPR collected $0.05 from pot
Maverick_JPR: doesn't show hand 
*** SUMMARY ***
Total pot $0.05 | Rake $0 
Seat 1: Maverick_JPR (button) collected ($0.05)
Seat 2: SanDmitri4 (small blind) folded before Flop
Seat 3: mag8574 (big blind) folded before Flop
Seat 4: Unconform folded before Flop (didn't bet)
Seat 5: hc agorist folded before Flop (didn't bet)
Seat 6: batiatus72 folded before Flop (didn't bet)



PokerStars Zoom Hand #193769787134:  Hold'em No Limit ($0.01/$0.02) - 2018/11/27 1:17:03 CUST [2018/11/26 12:17:03 ET]
Table 'Halley' 6-max Seat #1 is the button
Seat 1: hc agorist ($6.36 in chips) 
Seat 2: Spinno ($2.01 in chips) 
Seat 3: Rus. Pioneer ($4.45 in chips) 
Seat 4: Qwkl ($2.11 in chips) 
Seat 5: DAMASCO23 ($2.43 in chips) 
Seat 6: WingedAng3l ($2.24 in chips) 
Spinno: posts small blind $0.01
Rus. Pioneer: posts big blind $0.02
*** HOLE CARDS ***
Dealt to hc agorist [Qc Jc]
Qwkl: folds 
DAMASCO23: folds 
WingedAng3l: folds 
hc agorist: raises $0.04 to $0.06
Spinno: folds 
Rus. Pioneer: calls $0.04
*** FLOP *** [7d Th Qh]
Rus. Pioneer: checks 
hc agorist: bets $0.10
Rus. Pioneer: calls $0.10
*** TURN *** [7d Th Qh] [5c]
Rus. Pioneer: checks 
hc agorist: bets $0.24
Rus. Pioneer: folds 
Uncalled bet ($0.24) returned to hc agorist
hc agorist collected $0.32 from pot
hc agorist: doesn't show hand 
*** SUMMARY ***
Total pot $0.33 | Rake $0.01 
Board [7d Th Qh 5c]
Seat 1: hc agorist (button) collected ($0.32)
Seat 2: Spinno (small blind) folded before Flop
Seat 3: Rus. Pioneer (big blind) folded on the Turn
Seat 4: Qwkl folded before Flop (didn't bet)
Seat 5: DAMASCO23 folded before Flop (didn't bet)
Seat 6: WingedAng3l folded before Flop (didn't bet)



PokerStars Zoom Hand #193769807706:  Hold'em No Limit ($0.01/$0.02) - 2018/11/27 1:17:38 CUST [2018/11/26 12:17:38 ET]
Table 'Halley' 6-max Seat #1 is the button
Seat 1: Tuxui y)l(ac ($2.43 in chips) 
Seat 2: hc agorist ($6.52 in chips) 
Seat 3: stradywary ($2.09 in chips) 
Seat 4: NaumiPar ($3.42 in chips) 
Seat 5: Rus. Pioneer ($4.29 in chips) 
Seat 6: booktable ($2.15 in chips) 
hc agorist: posts small blind $0.01
stradywary: posts big blind $0.02
*** HOLE CARDS ***
Dealt to hc agorist [3s 5s]
NaumiPar: folds 
Rus. Pioneer: folds 
booktable: raises $0.02 to $0.04
Tuxui y)l(ac: folds 
hc agorist: raises $0.10 to $0.14
stradywary: folds 
booktable: folds 
Uncalled bet ($0.10) returned to hc agorist
hc agorist collected $0.10 from pot
hc agorist: doesn't show hand 
*** SUMMARY ***
Total pot $0.10 | Rake $0 
Seat 1: Tuxui y)l(ac (button) folded before Flop (didn't bet)
Seat 2: hc agorist (small blind) collected ($0.10)
Seat 3: stradywary (big blind) folded before Flop
Seat 4: NaumiPar folded before Flop (didn't bet)
Seat 5: Rus. Pioneer folded before Flop (didn't bet)
Seat 6: booktable folded before Flop



PokerStars Zoom Hand #193769805392:  Hold'em No Limit ($0.01/$0.02) - 2018/11/27 1:17:34 CUST [2018/11/26 12:17:34 ET]
Table 'Halley' 6-max Seat #1 is the button
Seat 1: wackonut ($4.04 in chips) 
Seat 2: stradywary ($2 in chips) 
Seat 3: Symeo208 ($2.55 in chips) 
Seat 4: hc agorist ($6.52 in chips) 
Seat 5: booktable ($2 in chips) 
Seat 6: Qwkl ($2 in chips) 
stradywary: posts small blind $0.01
Symeo208: posts big blind $0.02
*** HOLE CARDS ***
Dealt to hc agorist [8c Qd]
hc agorist: folds 
booktable: folds 
Qwkl: folds 
wackonut: raises $0.04 to $0.06
stradywary: folds 
Symeo208: raises $0.14 to $0.20
wackonut: folds 
Uncalled bet ($0.14) returned to Symeo208
Symeo208 collected $0.13 from pot
Symeo208: doesn't show hand 
*** SUMMARY ***
Total pot $0.13 | Rake $0 
Seat 1: wackonut (button) folded before Flop
Seat 2: stradywary (small blind) folded before Flop
Seat 3: Symeo208 (big blind) collected ($0.13)
Seat 4: hc agorist folded before Flop (didn't bet)
Seat 5: booktable folded before Flop (didn't bet)
Seat 6: Qwkl folded before Flop (didn't bet)



PokerStars Zoom Hand #193769821357:  Hold'em No Limit ($0.01/$0.02) - 2018/11/27 1:18:01 CUST [2018/11/26 12:18:01 ET]
Table 'Halley' 6-max Seat #1 is the button
Seat 1: Danilloo93 ($5.34 in chips) 
Seat 2: TheD1nhoR10 ($0.17 in chips) 
Seat 3: averzia ($2 in chips) 
Seat 4: hc agorist ($6.58 in chips) 
Seat 5: pv2903 ($5.12 in chips) 
Seat 6: csarruda ($2.02 in chips) 
TheD1nhoR10: posts small blind $0.01
averzia: posts big blind $0.02
*** HOLE CARDS ***
Dealt to hc agorist [Jd 2c]
hc agorist: folds 
pv2903: folds 
csarruda: folds 
Danilloo93: folds 
TheD1nhoR10: folds 
Uncalled bet ($0.01) returned to averzia
averzia collected $0.02 from pot
averzia: doesn't show hand 
*** SUMMARY ***
Total pot $0.02 | Rake $0 
Seat 1: Danilloo93 (button) folded before Flop (didn't bet)
Seat 2: TheD1nhoR10 (small blind) folded before Flop
Seat 3: averzia (big blind) collected ($0.02)
Seat 4: hc agorist folded before Flop (didn't bet)
Seat 5: pv2903 folded before Flop (didn't bet)
Seat 6: csarruda folded before Flop (didn't bet)



PokerStars Zoom Hand #193769818339:  Hold'em No Limit ($0.01/$0.02) - 2018/11/27 1:17:56 CUST [2018/11/26 12:17:56 ET]
Table 'Halley' 6-max Seat #1 is the button
Seat 1: crazy_jun ($2.01 in chips) 
Seat 2: sergeyf132 ($1.95 in chips) 
Seat 3: demon7521 ($2 in chips) 
Seat 4: strimmm0 ($15.95 in chips) 
Seat 5: Unconform ($2.23 in chips) 
Seat 6: hc agorist ($6.58 in chips) 
sergeyf132: posts small blind $0.01
demon7521: posts big blind $0.02
*** HOLE CARDS ***
Dealt to hc agorist [Qh 2c]
strimmm0: folds 
Unconform: folds 
hc agorist: folds 
crazy_jun: raises $0.03 to $0.05
sergeyf132: folds 
demon7521: folds 
Uncalled bet ($0.03) returned to crazy_jun
crazy_jun collected $0.05 from pot
crazy_jun: doesn't show hand 
*** SUMMARY ***
Total pot $0.05 | Rake $0 
Seat 1: crazy_jun (button) collected ($0.05)
Seat 2: sergeyf132 (small blind) folded before Flop
Seat 3: demon7521 (big blind) folded before Flop
Seat 4: strimmm0 folded before Flop (didn't bet)
Seat 5: Unconform folded before Flop (didn't bet)
Seat 6: hc agorist folded before Flop (didn't bet)



PokerStars Zoom Hand #193769823689:  Hold'em No Limit ($0.01/$0.02) - 2018/11/27 1:18:05 CUST [2018/11/26 12:18:05 ET]
Table 'Halley' 6-max Seat #1 is the button
Seat 1: hc agorist ($6.58 in chips) 
Seat 2: QQTob ($2 in chips) 
Seat 3: GreyKeeperRu ($2 in chips) 
Seat 4: melse_youth ($2.21 in chips) 
Seat 5: stasondel ($2 in chips) 
Seat 6: bova53 ($5.59 in chips) 
QQTob: posts small blind $0.01
GreyKeeperRu: posts big blind $0.02
*** HOLE CARDS ***
Dealt to hc agorist [As 6h]
melse_youth: folds 
stasondel: folds 
bova53: raises $0.02 to $0.04
hc agorist: raises $0.11 to $0.15
QQTob: folds 
GreyKeeperRu: folds 
bova53: calls $0.11
*** FLOP *** [6s 7h Js]
bova53: bets $0.02
hc agorist: raises $0.14 to $0.16
bova53: calls $0.14
*** TURN *** [6s 7h Js] [5s]
bova53: checks 
hc agorist: checks 
*** RIVER *** [6s 7h Js 5s] [Ad]
bova53: checks 
hc agorist: bets $0.43
bova53: calls $0.43
*** SHOW DOWN ***
hc agorist: shows [As 6h] (two pair, Aces and Sixes)
bova53: mucks hand 
hc agorist collected $1.46 from pot
*** SUMMARY ***
Total pot $1.51 | Rake $0.05 
Board [6s 7h Js 5s Ad]
Seat 1: hc agorist (button) showed [As 6h] and won ($1.46) with two pair, Aces and Sixes
Seat 2: QQTob (small blind) folded before Flop
Seat 3: GreyKeeperRu (big blind) folded before Flop
Seat 4: melse_youth folded before Flop (didn't bet)
Seat 5: stasondel folded before Flop (didn't bet)
Seat 6: bova53 mucked [9s Jh]



PokerStars Zoom Hand #193769859838:  Hold'em No Limit ($0.01/$0.02) - 2018/11/27 1:19:06 CUST [2018/11/26 12:19:06 ET]
Table 'Halley' 6-max Seat #1 is the button
Seat 1: Mizepa ($2.01 in chips) 
Seat 2: hc agorist ($7.30 in chips) 
Seat 3: fomik33 ($2.03 in chips) 
Seat 4: Machina65 ($2.46 in chips) 
Seat 5: fazanis4e ($2 in chips) 
Seat 6: QuichesLeRoy ($2.12 in chips) 
hc agorist: posts small blind $0.01
fomik33: posts big blind $0.02
*** HOLE CARDS ***
Dealt to hc agorist [2s 8h]
Machina65: folds 
fazanis4e: folds 
QuichesLeRoy: folds 
Mizepa: folds 
hc agorist: folds 
Uncalled bet ($0.01) returned to fomik33
fomik33 collected $0.02 from pot
fomik33: doesn't show hand 
*** SUMMARY ***
Total pot $0.02 | Rake $0 
Seat 1: Mizepa (button) folded before Flop (didn't bet)
Seat 2: hc agorist (small blind) folded before Flop
Seat 3: fomik33 (big blind) collected ($0.02)
Seat 4: Machina65 folded before Flop (didn't bet)
Seat 5: fazanis4e folded before Flop (didn't bet)
Seat 6: QuichesLeRoy folded before Flop (didn't bet)



PokerStars Zoom Hand #193769867045:  Hold'em No Limit ($0.01/$0.02) - 2018/11/27 1:19:18 CUST [2018/11/26 12:19:18 ET]
Table 'Halley' 6-max Seat #1 is the button
Seat 1: Kir Paal ($2.15 in chips) 
Seat 2: B3rni ($2 in chips) 
Seat 3: hc agorist ($7.29 in chips) 
Seat 4: wackonut ($4.02 in chips) 
Seat 5: DENCYD ($2 in chips) 
Seat 6: hansterdam61 ($2.13 in chips) 
B3rni: posts small blind $0.01
hc agorist: posts big blind $0.02
*** HOLE CARDS ***
Dealt to hc agorist [4h Ts]
wackonut: folds 
DENCYD: folds 
hansterdam61: folds 
Kir Paal: folds 
B3rni: folds 
Uncalled bet ($0.01) returned to hc agorist
hc agorist collected $0.02 from pot
hc agorist: doesn't show hand 
*** SUMMARY ***
Total pot $0.02 | Rake $0 
Seat 1: Kir Paal (button) folded before Flop (didn't bet)
Seat 2: B3rni (small blind) folded before Flop
Seat 3: hc agorist (big blind) collected ($0.02)
Seat 4: wackonut folded before Flop (didn't bet)
Seat 5: DENCYD folded before Flop (didn't bet)
Seat 6: hansterdam61 folded before Flop (didn't bet)



PokerStars Zoom Hand #193769873566:  Hold'em No Limit ($0.01/$0.02) - 2018/11/27 1:19:29 CUST [2018/11/26 12:19:29 ET]
Table 'Halley' 6-max Seat #1 is the button
Seat 1: suuutt ($2.04 in chips) 
Seat 2: pianobeast ($3.56 in chips) 
Seat 3: Mizzek ($2.92 in chips) 
Seat 4: Jaap69golf ($4.30 in chips) 
Seat 5: fazanis4e ($2.67 in chips) 
Seat 6: hc agorist ($7.30 in chips) 
pianobeast: posts small blind $0.01
Mizzek: posts big blind $0.02
*** HOLE CARDS ***
Dealt to hc agorist [2h 9s]
Jaap69golf: raises $0.04 to $0.06
fazanis4e: folds 
hc agorist: folds 
suuutt: folds 
pianobeast: folds 
Mizzek: folds 
Uncalled bet ($0.04) returned to Jaap69golf
Jaap69golf collected $0.05 from pot
Jaap69golf: doesn't show hand 
*** SUMMARY ***
Total pot $0.05 | Rake $0 
Seat 1: suuutt (button) folded before Flop (didn't bet)
Seat 2: pianobeast (small blind) folded before Flop
Seat 3: Mizzek (big blind) folded before Flop
Seat 4: Jaap69golf collected ($0.05)
Seat 5: fazanis4e folded before Flop (didn't bet)
Seat 6: hc agorist folded before Flop (didn't bet)



PokerStars Zoom Hand #193769880749:  Hold'em No Limit ($0.01/$0.02) - 2018/11/27 1:19:41 CUST [2018/11/26 12:19:41 ET]
Table 'Halley' 6-max Seat #1 is the button
Seat 1: hc agorist ($7.30 in chips) 
Seat 2: ravemaster-z ($2.36 in chips) 
Seat 3: Mediasinres ($2.44 in chips) 
Seat 4: mjrobin ($1.96 in chips) 
Seat 5: valera.19189 ($3.93 in chips) 
Seat 6: Monetaty ($2.25 in chips) 
ravemaster-z: posts small blind $0.01
Mediasinres: posts big blind $0.02
*** HOLE CARDS ***
Dealt to hc agorist [Ah 2h]
mjrobin: folds 
valera.19189: folds 
Monetaty: folds 
hc agorist: raises $0.04 to $0.06
ravemaster-z: folds 
Mediasinres: folds 
Uncalled bet ($0.04) returned to hc agorist
hc agorist collected $0.05 from pot
hc agorist: doesn't show hand 
*** SUMMARY ***
Total pot $0.05 | Rake $0 
Seat 1: hc agorist (button) collected ($0.05)
Seat 2: ravemaster-z (small blind) folded before Flop
Seat 3: Mediasinres (big blind) folded before Flop
Seat 4: mjrobin folded before Flop (didn't bet)
Seat 5: valera.19189 folded before Flop (didn't bet)
Seat 6: Monetaty folded before Flop (didn't bet)



PokerStars Zoom Hand #193769875979:  Hold'em No Limit ($0.01/$0.02) - 2018/11/27 1:19:33 CUST [2018/11/26 12:19:33 ET]
Table 'Halley' 6-max Seat #1 is the button
Seat 1: Bruniin_F ($2 in chips) 
Seat 2: LuckdarkAA ($5.49 in chips) 
Seat 3: glagla87 ($2.37 in chips) 
Seat 4: Lawrence$lim ($2.19 in chips) 
Seat 5: xzOLOtx ($2.90 in chips) 
Seat 6: hc agorist ($7.30 in chips) 
LuckdarkAA: posts small blind $0.01
glagla87: posts big blind $0.02
*** HOLE CARDS ***
Dealt to hc agorist [Qs 4d]
Lawrence$lim: folds 
xzOLOtx: raises $0.04 to $0.06
hc agorist: folds 
Bruniin_F: folds 
LuckdarkAA: calls $0.05
glagla87: folds 
*** FLOP *** [7s 3c 6h]
LuckdarkAA: checks 
xzOLOtx: checks 
*** TURN *** [7s 3c 6h] [Qh]
LuckdarkAA: bets $0.07
xzOLOtx: calls $0.07
*** RIVER *** [7s 3c 6h Qh] [Ks]
LuckdarkAA: checks 
xzOLOtx: bets $0.11
LuckdarkAA: folds 
Uncalled bet ($0.11) returned to xzOLOtx
xzOLOtx collected $0.27 from pot
xzOLOtx: doesn't show hand 
*** SUMMARY ***
Total pot $0.28 | Rake $0.01 
Board [7s 3c 6h Qh Ks]
Seat 1: Bruniin_F (button) folded before Flop (didn't bet)
Seat 2: LuckdarkAA (small blind) folded on the River
Seat 3: glagla87 (big blind) folded before Flop
Seat 4: Lawrence$lim folded before Flop (didn't bet)
Seat 5: xzOLOtx collected ($0.27)
Seat 6: hc agorist folded before Flop (didn't bet)



PokerStars Zoom Hand #193769889715:  Hold'em No Limit ($0.01/$0.02) - 2018/11/27 1:19:56 CUST [2018/11/26 12:19:56 ET]
Table 'Halley' 6-max Seat #1 is the button
Seat 1: Darek.bl ($3.77 in chips) 
Seat 2: Pokersk999 ($2 in chips) 
Seat 3: 59sem ($0.66 in chips) 
Seat 4: simon32.ru ($2.05 in chips) 
Seat 5: hc agorist ($7.33 in chips) 
Seat 6: dan/rej ($6.93 in chips) 
Pokersk999: posts small blind $0.01
59sem: posts big blind $0.02
*** HOLE CARDS ***
Dealt to hc agorist [Qd Js]
simon32.ru: folds 
hc agorist: raises $0.04 to $0.06
dan/rej: folds 
Darek.bl: calls $0.06
Pokersk999: calls $0.05
59sem: folds 
*** FLOP *** [3h 2h Jc]
Pokersk999: checks 
hc agorist: bets $0.07
Darek.bl: folds 
Pokersk999: folds 
Uncalled bet ($0.07) returned to hc agorist
hc agorist collected $0.19 from pot
hc agorist: doesn't show hand 
*** SUMMARY ***
Total pot $0.20 | Rake $0.01 
Board [3h 2h Jc]
Seat 1: Darek.bl (button) folded on the Flop
Seat 2: Pokersk999 (small blind) folded on the Flop
Seat 3: 59sem (big blind) folded before Flop
Seat 4: simon32.ru folded before Flop (didn't bet)
Seat 5: hc agorist collected ($0.19)
Seat 6: dan/rej folded before Flop (didn't bet)



PokerStars Zoom Hand #193769907714:  Hold'em No Limit ($0.01/$0.02) - 2018/11/27 1:20:26 CUST [2018/11/26 12:20:26 ET]
Table 'Halley' 6-max Seat #1 is the button
Seat 1: Masticlox ($2.34 in chips) 
Seat 2: hc agorist ($7.46 in chips) 
Seat 3: NOBLELOCKS ($5.14 in chips) 
Seat 4: JustOnimusha ($1.58 in chips) 
Seat 5: buca7a ($4.94 in chips) 
Seat 6: darkoldmaker ($2.14 in chips) 
hc agorist: posts small blind $0.01
NOBLELOCKS: posts big blind $0.02
*** HOLE CARDS ***
Dealt to hc agorist [7d Jc]
JustOnimusha: folds 
buca7a: raises $0.04 to $0.06
darkoldmaker: folds 
Masticlox: folds 
hc agorist: folds 
NOBLELOCKS: calls $0.04
*** FLOP *** [6s 3h 9d]
NOBLELOCKS: checks 
buca7a: checks 
*** TURN *** [6s 3h 9d] [Qh]
NOBLELOCKS: checks 
buca7a: checks 
*** RIVER *** [6s 3h 9d Qh] [6d]
NOBLELOCKS: bets $0.04
buca7a: calls $0.04
*** SHOW DOWN ***
NOBLELOCKS: shows [Td 5d] (a pair of Sixes)
buca7a: shows [5c Ac] (a pair of Sixes - Ace kicker)
buca7a collected $0.20 from pot
*** SUMMARY ***
Total pot $0.21 | Rake $0.01 
Board [6s 3h 9d Qh 6d]
Seat 1: Masticlox (button) folded before Flop (didn't bet)
Seat 2: hc agorist (small blind) folded before Flop
Seat 3: NOBLELOCKS (big blind) showed [Td 5d] and lost with a pair of Sixes
Seat 4: JustOnimusha folded before Flop (didn't bet)
Seat 5: buca7a showed [5c Ac] and won ($0.20) with a pair of Sixes
Seat 6: darkoldmaker folded before Flop (didn't bet)



PokerStars Zoom Hand #193769914289:  Hold'em No Limit ($0.01/$0.02) - 2018/11/27 1:20:37 CUST [2018/11/26 12:20:37 ET]
Table 'Halley' 6-max Seat #1 is the button
Seat 1: Rightful ($3.27 in chips) 
Seat 2: m@xim25 ($13.89 in chips) 
Seat 3: hc agorist ($7.45 in chips) 
Seat 4: Lawrence$lim ($2.64 in chips) 
Seat 5: BadBoy-PokStars ($2.03 in chips) 
Seat 6: Project TB ($2.03 in chips) 
m@xim25: posts small blind $0.01
hc agorist: posts big blind $0.02
*** HOLE CARDS ***
Dealt to hc agorist [Ks Kc]
Lawrence$lim: folds 
BadBoy-PokStars: folds 
Project TB: raises $0.04 to $0.06
Rightful: raises $0.12 to $0.18
m@xim25: folds 
hc agorist: raises $0.30 to $0.48
Project TB: folds 
Rightful: calls $0.30
*** FLOP *** [Ts As Ad]
hc agorist: checks 
Rightful: checks 
*** TURN *** [Ts As Ad] [9c]
hc agorist: checks 
Rightful: checks 
*** RIVER *** [Ts As Ad 9c] [7s]
hc agorist: bets $0.54
Rightful: folds 
Uncalled bet ($0.54) returned to hc agorist
hc agorist collected $0.99 from pot
hc agorist: doesn't show hand 
*** SUMMARY ***
Total pot $1.03 | Rake $0.04 
Board [Ts As Ad 9c 7s]
Seat 1: Rightful (button) folded on the River
Seat 2: m@xim25 (small blind) folded before Flop
Seat 3: hc agorist (big blind) collected ($0.99)
Seat 4: Lawrence$lim folded before Flop (didn't bet)
Seat 5: BadBoy-PokStars folded before Flop (didn't bet)
Seat 6: Project TB folded before Flop



PokerStars Zoom Hand #193769943153:  Hold'em No Limit ($0.01/$0.02) - 2018/11/27 1:21:25 CUST [2018/11/26 12:21:25 ET]
Table 'Halley' 6-max Seat #1 is the button
Seat 1: elionspecter ($2 in chips) 
Seat 2: Magelan4813 ($1.59 in chips) 
Seat 3: nikonova88 ($4.36 in chips) 
Seat 4: Bot35 ($4.10 in chips) 
Seat 5: PalineQ ($1.95 in chips) 
Seat 6: hc agorist ($7.96 in chips) 
Magelan4813: posts small blind $0.01
nikonova88: posts big blind $0.02
*** HOLE CARDS ***
Dealt to hc agorist [9s Qh]
Bot35: folds 
PalineQ: folds 
hc agorist: raises $0.02 to $0.04
elionspecter: folds 
Magelan4813: folds 
nikonova88: folds 
Uncalled bet ($0.02) returned to hc agorist
hc agorist collected $0.05 from pot
hc agorist: doesn't show hand 
*** SUMMARY ***
Total pot $0.05 | Rake $0 
Seat 1: elionspecter (button) folded before Flop (didn't bet)
Seat 2: Magelan4813 (small blind) folded before Flop
Seat 3: nikonova88 (big blind) folded before Flop
Seat 4: Bot35 folded before Flop (didn't bet)
Seat 5: PalineQ folded before Flop (didn't bet)
Seat 6: hc agorist collected ($0.05)



PokerStars Zoom Hand #193769950829:  Hold'em No Limit ($0.01/$0.02) - 2018/11/27 1:21:38 CUST [2018/11/26 12:21:38 ET]
Table 'Halley' 6-max Seat #1 is the button
Seat 1: hc agorist ($7.99 in chips) 
Seat 2: felipedj ($2.31 in chips) 
Seat 3: marta328 ($2.10 in chips) 
Seat 4: Project TB ($2.17 in chips) 
Seat 5: elle3007 ($2.81 in chips) 
Seat 6: Rusherito87 ($2.44 in chips) 
felipedj: posts small blind $0.01
marta328: posts big blind $0.02
*** HOLE CARDS ***
Dealt to hc agorist [Jh 4c]
Project TB: folds 
elle3007: folds 
Rusherito87: folds 
hc agorist: folds 
felipedj: folds 
Uncalled bet ($0.01) returned to marta328
marta328 collected $0.02 from pot
marta328: doesn't show hand 
*** SUMMARY ***
Total pot $0.02 | Rake $0 
Seat 1: hc agorist (button) folded before Flop (didn't bet)
Seat 2: felipedj (small blind) folded before Flop
Seat 3: marta328 (big blind) collected ($0.02)
Seat 4: Project TB folded before Flop (didn't bet)
Seat 5: elle3007 folded before Flop (didn't bet)
Seat 6: Rusherito87 folded before Flop (didn't bet)



PokerStars Zoom Hand #193769954453:  Hold'em No Limit ($0.01/$0.02) - 2018/11/27 1:21:44 CUST [2018/11/26 12:21:44 ET]
Table 'Halley' 6-max Seat #1 is the button
Seat 1: Elmisantropo ($1.79 in chips) 
Seat 2: RAIN_ACID ($3.55 in chips) 
Seat 3: >>LVV80<< ($2.18 in chips) 
Seat 4: Mesnuj ($4.86 in chips) 
Seat 5: hc agorist ($7.99 in chips) 
Seat 6: LightningImpact ($5.76 in chips) 
RAIN_ACID: posts small blind $0.01
>>LVV80<<: posts big blind $0.02
*** HOLE CARDS ***
Dealt to hc agorist [Tc 9c]
Mesnuj: folds 
hc agorist: raises $0.04 to $0.06
LightningImpact: folds 
Elmisantropo: folds 
RAIN_ACID: folds 
>>LVV80<<: folds 
Uncalled bet ($0.04) returned to hc agorist
hc agorist collected $0.05 from pot
hc agorist: doesn't show hand 
*** SUMMARY ***
Total pot $0.05 | Rake $0 
Seat 1: Elmisantropo (button) folded before Flop (didn't bet)
Seat 2: RAIN_ACID (small blind) folded before Flop
Seat 3: >>LVV80<< (big blind) folded before Flop
Seat 4: Mesnuj folded before Flop (didn't bet)
Seat 5: hc agorist collected ($0.05)
Seat 6: LightningImpact folded before Flop (didn't bet)



PokerStars Zoom Hand #193769966339:  Hold'em No Limit ($0.01/$0.02) - 2018/11/27 1:22:04 CUST [2018/11/26 12:22:04 ET]
Table 'Halley' 6-max Seat #1 is the button
Seat 1: HoudiniH95 ($4.12 in chips) 
Seat 2: grv17 ($5.82 in chips) 
Seat 3: Kiizu ($3.83 in chips) 
Seat 4: hc agorist ($8.02 in chips) 
Seat 5: SAVITAR99 ($2.13 in chips) 
Seat 6: meniasjo ($6.47 in chips) 
grv17: posts small blind $0.01
Kiizu: posts big blind $0.02
*** HOLE CARDS ***
Dealt to hc agorist [Js 3s]
hc agorist: folds 
SAVITAR99: folds 
meniasjo: folds 
HoudiniH95: raises $0.04 to $0.06
grv17: folds 
Kiizu: folds 
Uncalled bet ($0.04) returned to HoudiniH95
HoudiniH95 collected $0.05 from pot
HoudiniH95: doesn't show hand 
*** SUMMARY ***
Total pot $0.05 | Rake $0 
Seat 1: HoudiniH95 (button) collected ($0.05)
Seat 2: grv17 (small blind) folded before Flop
Seat 3: Kiizu (big blind) folded before Flop
Seat 4: hc agorist folded before Flop (didn't bet)
Seat 5: SAVITAR99 folded before Flop (didn't bet)
Seat 6: meniasjo folded before Flop (didn't bet)



PokerStars Zoom Hand #193769969984:  Hold'em No Limit ($0.01/$0.02) - 2018/11/27 1:22:10 CUST [2018/11/26 12:22:10 ET]
Table 'Halley' 6-max Seat #1 is the button
Seat 1: SRERAF ($2.03 in chips) 
Seat 2: DiLe††an†e ($0.88 in chips) 
Seat 3: hc agorist ($8.02 in chips) 
Seat 4: azulut ($2 in chips) 
Seat 5: ChaossTheory ($2.71 in chips) 
Seat 6: Heliodabest ($4.61 in chips) 
DiLe††an†e: posts small blind $0.01
hc agorist: posts big blind $0.02
*** HOLE CARDS ***
Dealt to hc agorist [8s Ac]
azulut: folds 
ChaossTheory: folds 
Heliodabest: calls $0.02
SRERAF: raises $0.06 to $0.08
DiLe††an†e: folds 
hc agorist: folds 
Heliodabest: folds 
Uncalled bet ($0.06) returned to SRERAF
SRERAF collected $0.07 from pot
SRERAF: doesn't show hand 
*** SUMMARY ***
Total pot $0.07 | Rake $0 
Seat 1: SRERAF (button) collected ($0.07)
Seat 2: DiLe††an†e (small blind) folded before Flop
Seat 3: hc agorist (big blind) folded before Flop
Seat 4: azulut folded before Flop (didn't bet)
Seat 5: ChaossTheory folded before Flop (didn't bet)
Seat 6: Heliodabest folded before Flop



