PokerStars Zoom Hand #193393857282:  Hold'em No Limit ($0.01/$0.02) - 2018/11/17 0:57:29 CUST [2018/11/16 11:57:29 ET]
Table 'Halley' 6-max Seat #1 is the button
Seat 1: max.m.7deiL ($2.07 in chips) 
Seat 2: Marco0o12 ($2.35 in chips) 
Seat 3: hc agorist ($1.60 in chips) 
Seat 4: xiazhen ($2.92 in chips) 
Seat 5: VreditelL ($2 in chips) 
Seat 6: gnomNa5copok ($1.36 in chips) 
Marco0o12: posts small blind $0.01
hc agorist: posts big blind $0.02
*** HOLE CARDS ***
Dealt to hc agorist [Jd Td]
xiazhen: folds 
VreditelL: folds 
gnomNa5copok: folds 
max.m.7deiL: raises $0.02 to $0.04
Marco0o12: folds 
hc agorist: calls $0.02
*** FLOP *** [9d 2h 8d]
hc agorist: checks 
max.m.7deiL: bets $0.04
hc agorist: raises $0.20 to $0.24
max.m.7deiL: calls $0.20
*** TURN *** [9d 2h 8d] [Ac]
hc agorist: bets $0.38
max.m.7deiL: folds 
Uncalled bet ($0.38) returned to hc agorist
hc agorist collected $0.55 from pot
hc agorist: doesn't show hand 
*** SUMMARY ***
Total pot $0.57 | Rake $0.02 
Board [9d 2h 8d Ac]
Seat 1: max.m.7deiL (button) folded on the Turn
Seat 2: Marco0o12 (small blind) folded before Flop
Seat 3: hc agorist (big blind) collected ($0.55)
Seat 4: xiazhen folded before Flop (didn't bet)
Seat 5: VreditelL folded before Flop (didn't bet)
Seat 6: gnomNa5copok folded before Flop (didn't bet)



PokerStars Zoom Hand #193393878417:  Hold'em No Limit ($0.01/$0.02) - 2018/11/17 0:58:14 CUST [2018/11/16 11:58:14 ET]
Table 'Halley' 6-max Seat #1 is the button
Seat 1: Funmaker007 ($6.66 in chips) 
Seat 2: nathaniel158 ($3.55 in chips) 
Seat 3: WolfV1 ($2 in chips) 
Seat 4: Danilloo93 ($2.37 in chips) 
Seat 5: hc agorist ($2 in chips) 
Seat 6: mag8574 ($2.24 in chips) 
nathaniel158: posts small blind $0.01
WolfV1: posts big blind $0.02
*** HOLE CARDS ***
Dealt to hc agorist [7c 7h]
Danilloo93: folds 
hc agorist: raises $0.02 to $0.04
mag8574: calls $0.04
Funmaker007: folds 
nathaniel158: folds 
WolfV1: calls $0.02
*** FLOP *** [Ks Ac 8c]
WolfV1: checks 
hc agorist: bets $0.05
mag8574: folds 
WolfV1: folds 
Uncalled bet ($0.05) returned to hc agorist
hc agorist collected $0.13 from pot
hc agorist: doesn't show hand 
*** SUMMARY ***
Total pot $0.13 | Rake $0 
Board [Ks Ac 8c]
Seat 1: Funmaker007 (button) folded before Flop (didn't bet)
Seat 2: nathaniel158 (small blind) folded before Flop
Seat 3: WolfV1 (big blind) folded on the Flop
Seat 4: Danilloo93 folded before Flop (didn't bet)
Seat 5: hc agorist collected ($0.13)
Seat 6: mag8574 folded on the Flop



PokerStars Zoom Hand #193393891763:  Hold'em No Limit ($0.01/$0.02) - 2018/11/17 0:58:42 CUST [2018/11/16 11:58:42 ET]
Table 'Halley' 6-max Seat #1 is the button
Seat 1: hc agorist ($2.08 in chips) 
Seat 2: aleksvp ($2.02 in chips) 
Seat 3: polnareff85 ($1.87 in chips) 
Seat 4: Rechtse back ($5.71 in chips) 
Seat 5: Qwkl ($2.24 in chips) 
Seat 6: Rapitsu ($1.56 in chips) 
aleksvp: posts small blind $0.01
polnareff85: posts big blind $0.02
*** HOLE CARDS ***
Dealt to hc agorist [9h Td]
Rechtse back: raises $0.04 to $0.06
Qwkl: calls $0.06
Rapitsu: folds 
hc agorist: folds 
aleksvp: folds 
polnareff85: folds 
*** FLOP *** [Ah 2c Qh]
Rechtse back: bets $0.11
Qwkl: folds 
Uncalled bet ($0.11) returned to Rechtse back
Rechtse back collected $0.14 from pot
Rechtse back: doesn't show hand 
*** SUMMARY ***
Total pot $0.15 | Rake $0.01 
Board [Ah 2c Qh]
Seat 1: hc agorist (button) folded before Flop (didn't bet)
Seat 2: aleksvp (small blind) folded before Flop
Seat 3: polnareff85 (big blind) folded before Flop
Seat 4: Rechtse back collected ($0.14)
Seat 5: Qwkl folded on the Flop
Seat 6: Rapitsu folded before Flop (didn't bet)



PokerStars Zoom Hand #193393894642:  Hold'em No Limit ($0.01/$0.02) - 2018/11/17 0:58:48 CUST [2018/11/16 11:58:48 ET]
Table 'Halley' 6-max Seat #1 is the button
Seat 1: jowijojo ($2.38 in chips) 
Seat 2: anorectal ($5.94 in chips) 
Seat 3: ASplayer9119 ($2.51 in chips) 
Seat 4: Bankomat$404 ($1.64 in chips) 
Seat 5: armandeke ($2.18 in chips) 
Seat 6: hc agorist ($2.08 in chips) 
anorectal: posts small blind $0.01
ASplayer9119: posts big blind $0.02
*** HOLE CARDS ***
Dealt to hc agorist [Jd Jc]
Bankomat$404: folds 
armandeke: folds 
hc agorist: raises $0.04 to $0.06
jowijojo: folds 
anorectal: folds 
ASplayer9119: folds 
Uncalled bet ($0.04) returned to hc agorist
hc agorist collected $0.05 from pot
hc agorist: doesn't show hand 
*** SUMMARY ***
Total pot $0.05 | Rake $0 
Seat 1: jowijojo (button) folded before Flop (didn't bet)
Seat 2: anorectal (small blind) folded before Flop
Seat 3: ASplayer9119 (big blind) folded before Flop
Seat 4: Bankomat$404 folded before Flop (didn't bet)
Seat 5: armandeke folded before Flop (didn't bet)
Seat 6: hc agorist collected ($0.05)



PokerStars Zoom Hand #193393889379:  Hold'em No Limit ($0.01/$0.02) - 2018/11/17 0:58:37 CUST [2018/11/16 11:58:37 ET]
Table 'Halley' 6-max Seat #1 is the button
Seat 1: lastfox ($2.59 in chips) 
Seat 2: hc agorist ($2.09 in chips) 
Seat 3: Aliencoxy ($4.12 in chips) 
Seat 4: 4andha ($2.71 in chips) 
Seat 5: RocknRolla5 ($2.11 in chips) 
Seat 6: Marco0o12 ($2.40 in chips) 
hc agorist: posts small blind $0.01
Aliencoxy: posts big blind $0.02
*** HOLE CARDS ***
Dealt to hc agorist [8s 3c]
4andha: folds 
RocknRolla5: folds 
Marco0o12: folds 
lastfox: raises $0.03 to $0.05
hc agorist: folds 
Aliencoxy: calls $0.03
*** FLOP *** [6h 2c Jc]
Aliencoxy: checks 
lastfox: bets $0.06
Aliencoxy: calls $0.06
*** TURN *** [6h 2c Jc] [Js]
Aliencoxy: bets $0.12
lastfox: folds 
Uncalled bet ($0.12) returned to Aliencoxy
Aliencoxy collected $0.22 from pot
Aliencoxy: doesn't show hand 
*** SUMMARY ***
Total pot $0.23 | Rake $0.01 
Board [6h 2c Jc Js]
Seat 1: lastfox (button) folded on the Turn
Seat 2: hc agorist (small blind) folded before Flop
Seat 3: Aliencoxy (big blind) collected ($0.22)
Seat 4: 4andha folded before Flop (didn't bet)
Seat 5: RocknRolla5 folded before Flop (didn't bet)
Seat 6: Marco0o12 folded before Flop (didn't bet)



PokerStars Zoom Hand #193393901791:  Hold'em No Limit ($0.01/$0.02) - 2018/11/17 0:59:03 CUST [2018/11/16 11:59:03 ET]
Table 'Halley' 6-max Seat #1 is the button
Seat 1: PPYPP ($2.02 in chips) 
Seat 2: benizel ($2 in chips) 
Seat 3: hc agorist ($2.11 in chips) 
Seat 4: PRrey ($4.60 in chips) 
Seat 5: straiki ($4.89 in chips) 
Seat 6: boris_198020 ($1.86 in chips) 
benizel: posts small blind $0.01
hc agorist: posts big blind $0.02
*** HOLE CARDS ***
Dealt to hc agorist [7d Jc]
PRrey: folds 
straiki: folds 
boris_198020: raises $0.02 to $0.04
PPYPP: folds 
benizel: folds 
hc agorist: folds 
Uncalled bet ($0.02) returned to boris_198020
boris_198020 collected $0.05 from pot
boris_198020: doesn't show hand 
*** SUMMARY ***
Total pot $0.05 | Rake $0 
Seat 1: PPYPP (button) folded before Flop (didn't bet)
Seat 2: benizel (small blind) folded before Flop
Seat 3: hc agorist (big blind) folded before Flop
Seat 4: PRrey folded before Flop (didn't bet)
Seat 5: straiki folded before Flop (didn't bet)
Seat 6: boris_198020 collected ($0.05)



PokerStars Zoom Hand #193393905958:  Hold'em No Limit ($0.01/$0.02) - 2018/11/17 0:59:12 CUST [2018/11/16 11:59:12 ET]
Table 'Halley' 6-max Seat #1 is the button
Seat 1: Enlassombras ($2.59 in chips) 
Seat 2: Burij14 ($2.29 in chips) 
Seat 3: helolele ($3.05 in chips) 
Seat 4: 1nnuendo ($8.30 in chips) 
Seat 5: hc agorist ($2.09 in chips) 
Seat 6: atlokki ($1.24 in chips) 
Burij14: posts small blind $0.01
helolele: posts big blind $0.02
*** HOLE CARDS ***
Dealt to hc agorist [8c Td]
1nnuendo: folds 
hc agorist: folds 
atlokki: folds 
Enlassombras: folds 
Burij14: folds 
Uncalled bet ($0.01) returned to helolele
helolele collected $0.02 from pot
helolele: doesn't show hand 
*** SUMMARY ***
Total pot $0.02 | Rake $0 
Seat 1: Enlassombras (button) folded before Flop (didn't bet)
Seat 2: Burij14 (small blind) folded before Flop
Seat 3: helolele (big blind) collected ($0.02)
Seat 4: 1nnuendo folded before Flop (didn't bet)
Seat 5: hc agorist folded before Flop (didn't bet)
Seat 6: atlokki folded before Flop (didn't bet)



PokerStars Zoom Hand #193393908767:  Hold'em No Limit ($0.01/$0.02) - 2018/11/17 0:59:18 CUST [2018/11/16 11:59:18 ET]
Table 'Halley' 6-max Seat #1 is the button
Seat 1: hc agorist ($2.09 in chips) 
Seat 2: miro180 ($2.10 in chips) 
Seat 3: lpda773 ($2 in chips) 
Seat 4: pyrosteam ($3.15 in chips) 
Seat 5: kugelmeer ($2.75 in chips) 
Seat 6: Keltu :D ($2.82 in chips) 
miro180: posts small blind $0.01
lpda773: posts big blind $0.02
*** HOLE CARDS ***
Dealt to hc agorist [7s 6d]
pyrosteam: folds 
kugelmeer: folds 
Keltu :D: folds 
hc agorist: raises $0.02 to $0.04
miro180: calls $0.03
lpda773: calls $0.02
*** FLOP *** [Kc 3h Qh]
miro180: checks 
lpda773: checks 
hc agorist: checks 
*** TURN *** [Kc 3h Qh] [5d]
miro180: bets $0.02
lpda773: calls $0.02
hc agorist: folds 
*** RIVER *** [Kc 3h Qh 5d] [Td]
miro180: checks 
lpda773: checks 
*** SHOW DOWN ***
miro180: shows [Ac 3d] (a pair of Threes)
lpda773: shows [9c Tc] (a pair of Tens)
lpda773 collected $0.15 from pot
*** SUMMARY ***
Total pot $0.16 | Rake $0.01 
Board [Kc 3h Qh 5d Td]
Seat 1: hc agorist (button) folded on the Turn
Seat 2: miro180 (small blind) showed [Ac 3d] and lost with a pair of Threes
Seat 3: lpda773 (big blind) showed [9c Tc] and won ($0.15) with a pair of Tens
Seat 4: pyrosteam folded before Flop (didn't bet)
Seat 5: kugelmeer folded before Flop (didn't bet)
Seat 6: Keltu :D folded before Flop (didn't bet)



PokerStars Zoom Hand #193393920922:  Hold'em No Limit ($0.01/$0.02) - 2018/11/17 0:59:44 CUST [2018/11/16 11:59:44 ET]
Table 'Halley' 6-max Seat #1 is the button
Seat 1: olcham7 ($2 in chips) 
Seat 2: hc agorist ($2.05 in chips) 
Seat 3: GRizlik14 ($2.39 in chips) 
Seat 4: pkeJdlpHf56 ($1.93 in chips) 
Seat 5: VreditelL ($2 in chips) 
Seat 6: babiloniaxxx ($2.09 in chips) 
hc agorist: posts small blind $0.01
GRizlik14: posts big blind $0.02
*** HOLE CARDS ***
Dealt to hc agorist [Jc Ac]
pkeJdlpHf56: folds 
VreditelL: folds 
babiloniaxxx: raises $0.04 to $0.06
olcham7: folds 
hc agorist: calls $0.05
GRizlik14: calls $0.04
*** FLOP *** [8d 8h 9h]
hc agorist: checks 
GRizlik14: checks 
babiloniaxxx: bets $0.06
hc agorist: calls $0.06
GRizlik14: folds 
*** TURN *** [8d 8h 9h] [Td]
hc agorist: checks 
babiloniaxxx: bets $0.15
hc agorist: calls $0.15
*** RIVER *** [8d 8h 9h Td] [4h]
hc agorist: checks 
babiloniaxxx: checks 
*** SHOW DOWN ***
hc agorist: shows [Jc Ac] (a pair of Eights)
babiloniaxxx: shows [Ad Qh] (a pair of Eights - Ace+Queen kicker)
babiloniaxxx collected $0.58 from pot
*** SUMMARY ***
Total pot $0.60 | Rake $0.02 
Board [8d 8h 9h Td 4h]
Seat 1: olcham7 (button) folded before Flop (didn't bet)
Seat 2: hc agorist (small blind) showed [Jc Ac] and lost with a pair of Eights
Seat 3: GRizlik14 (big blind) folded on the Flop
Seat 4: pkeJdlpHf56 folded before Flop (didn't bet)
Seat 5: VreditelL folded before Flop (didn't bet)
Seat 6: babiloniaxxx showed [Ad Qh] and won ($0.58) with a pair of Eights



PokerStars Zoom Hand #193393955394:  Hold'em No Limit ($0.01/$0.02) - 2018/11/17 1:00:54 CUST [2018/11/16 12:00:54 ET]
Table 'Halley' 6-max Seat #1 is the button
Seat 1: SonTNkts ($1.88 in chips) 
Seat 2: DrMoZzz ($4.08 in chips) 
Seat 3: SkyElephant ($2.17 in chips) 
Seat 4: hc agorist ($1.78 in chips) 
Seat 5: orangos ($1.24 in chips) 
Seat 6: HHEG ($2.66 in chips) 
DrMoZzz: posts small blind $0.01
SkyElephant: posts big blind $0.02
*** HOLE CARDS ***
Dealt to hc agorist [2h 6h]
hc agorist: folds 
orangos: folds 
HHEG: folds 
SonTNkts: folds 
DrMoZzz: folds 
Uncalled bet ($0.01) returned to SkyElephant
SkyElephant collected $0.02 from pot
SkyElephant: doesn't show hand 
*** SUMMARY ***
Total pot $0.02 | Rake $0 
Seat 1: SonTNkts (button) folded before Flop (didn't bet)
Seat 2: DrMoZzz (small blind) folded before Flop
Seat 3: SkyElephant (big blind) collected ($0.02)
Seat 4: hc agorist folded before Flop (didn't bet)
Seat 5: orangos folded before Flop (didn't bet)
Seat 6: HHEG folded before Flop (didn't bet)



PokerStars Zoom Hand #193393952808:  Hold'em No Limit ($0.01/$0.02) - 2018/11/17 1:00:49 CUST [2018/11/16 12:00:49 ET]
Table 'Halley' 6-max Seat #1 is the button
Seat 1: babiloniaxxx ($2.40 in chips) 
Seat 2: nathaniel158 ($2.49 in chips) 
Seat 3: hapkin777 ($2 in chips) 
Seat 4: MOU77Y ($2 in chips) 
Seat 5: lll MAXV lll ($2.18 in chips) 
Seat 6: hc agorist ($1.78 in chips) 
nathaniel158: posts small blind $0.01
hapkin777: posts big blind $0.02
*** HOLE CARDS ***
Dealt to hc agorist [7d 3h]
MOU77Y: folds 
lll MAXV lll: raises $0.03 to $0.05
hc agorist: folds 
babiloniaxxx: folds 
nathaniel158: folds 
hapkin777: folds 
Uncalled bet ($0.03) returned to lll MAXV lll
lll MAXV lll collected $0.05 from pot
lll MAXV lll: doesn't show hand 
*** SUMMARY ***
Total pot $0.05 | Rake $0 
Seat 1: babiloniaxxx (button) folded before Flop (didn't bet)
Seat 2: nathaniel158 (small blind) folded before Flop
Seat 3: hapkin777 (big blind) folded before Flop
Seat 4: MOU77Y folded before Flop (didn't bet)
Seat 5: lll MAXV lll collected ($0.05)
Seat 6: hc agorist folded before Flop (didn't bet)



PokerStars Zoom Hand #193393957944:  Hold'em No Limit ($0.01/$0.02) - 2018/11/17 1:00:59 CUST [2018/11/16 12:00:59 ET]
Table 'Halley' 6-max Seat #1 is the button
Seat 1: vais8 ($1.49 in chips) 
Seat 2: Snegul ($0.75 in chips) 
Seat 3: hc agorist ($1.78 in chips) 
Seat 4: twerskoi13 ($2.86 in chips) 
Seat 5: mag8574 ($2.53 in chips) 
Seat 6: matioks ($1.87 in chips) 
Snegul: posts small blind $0.01
hc agorist: posts big blind $0.02
*** HOLE CARDS ***
Dealt to hc agorist [Qh Kd]
twerskoi13: folds 
mag8574: raises $0.04 to $0.06
matioks: folds 
vais8: folds 
Snegul: folds 
hc agorist: calls $0.04
*** FLOP *** [2h 3c 3h]
hc agorist: checks 
mag8574: bets $0.06
hc agorist: calls $0.06
*** TURN *** [2h 3c 3h] [Kh]
hc agorist: checks 
mag8574: checks 
*** RIVER *** [2h 3c 3h Kh] [8h]
hc agorist: bets $0.34
mag8574: folds 
Uncalled bet ($0.34) returned to hc agorist
hc agorist collected $0.24 from pot
hc agorist: doesn't show hand 
*** SUMMARY ***
Total pot $0.25 | Rake $0.01 
Board [2h 3c 3h Kh 8h]
Seat 1: vais8 (button) folded before Flop (didn't bet)
Seat 2: Snegul (small blind) folded before Flop
Seat 3: hc agorist (big blind) collected ($0.24)
Seat 4: twerskoi13 folded before Flop (didn't bet)
Seat 5: mag8574 folded on the River
Seat 6: matioks folded before Flop (didn't bet)



PokerStars Zoom Hand #193393976710:  Hold'em No Limit ($0.01/$0.02) - 2018/11/17 1:01:33 CUST [2018/11/16 12:01:33 ET]
Table 'Halley' 6-max Seat #1 is the button
Seat 1: verrocchio82 ($1.47 in chips) 
Seat 2: d-potolok ($2 in chips) 
Seat 3: Uinuva ($5.79 in chips) 
Seat 4: hc agorist ($1.90 in chips) 
Seat 5: R2D2-DK ($4.92 in chips) 
Seat 6: lll MAXV lll ($2.18 in chips) 
d-potolok: posts small blind $0.01
Uinuva: posts big blind $0.02
*** HOLE CARDS ***
Dealt to hc agorist [4s 7c]
hc agorist: folds 
R2D2-DK: folds 
lll MAXV lll: folds 
verrocchio82: raises $0.05 to $0.07
d-potolok: folds 
Uinuva: folds 
Uncalled bet ($0.05) returned to verrocchio82
verrocchio82 collected $0.05 from pot
verrocchio82: doesn't show hand 
*** SUMMARY ***
Total pot $0.05 | Rake $0 
Seat 1: verrocchio82 (button) collected ($0.05)
Seat 2: d-potolok (small blind) folded before Flop
Seat 3: Uinuva (big blind) folded before Flop
Seat 4: hc agorist folded before Flop (didn't bet)
Seat 5: R2D2-DK folded before Flop (didn't bet)
Seat 6: lll MAXV lll folded before Flop (didn't bet)



PokerStars Zoom Hand #193393979478:  Hold'em No Limit ($0.01/$0.02) - 2018/11/17 1:01:38 CUST [2018/11/16 12:01:38 ET]
Table 'Halley' 6-max Seat #1 is the button
Seat 1: hc agorist ($1.90 in chips) 
Seat 2: k0maruk ($1.98 in chips) 
Seat 3: aldair68 ($3.66 in chips) 
Seat 4: fidelis17 ($2 in chips) 
Seat 5: batke1984 ($1.33 in chips) 
Seat 6: Pokerboy1203 ($0.90 in chips) 
k0maruk: posts small blind $0.01
aldair68: posts big blind $0.02
*** HOLE CARDS ***
Dealt to hc agorist [8c 7d]
fidelis17: folds 
batke1984: folds 
Pokerboy1203: calls $0.02
hc agorist: raises $0.06 to $0.08
k0maruk: folds 
aldair68: folds 
Pokerboy1203: calls $0.06
*** FLOP *** [6s 9c Qc]
Pokerboy1203: checks 
hc agorist: bets $0.06
Pokerboy1203: raises $0.15 to $0.21
hc agorist: calls $0.15
*** TURN *** [6s 9c Qc] [4c]
Pokerboy1203: bets $0.61 and is all-in
hc agorist: calls $0.61
*** RIVER *** [6s 9c Qc 4c] [3c]
*** SHOW DOWN ***
Pokerboy1203: shows [9d Qd] (two pair, Queens and Nines)
hc agorist: shows [8c 7d] (a flush, Queen high)
hc agorist collected $1.77 from pot
*** SUMMARY ***
Total pot $1.83 | Rake $0.06 
Board [6s 9c Qc 4c 3c]
Seat 1: hc agorist (button) showed [8c 7d] and won ($1.77) with a flush, Queen high
Seat 2: k0maruk (small blind) folded before Flop
Seat 3: aldair68 (big blind) folded before Flop
Seat 4: fidelis17 folded before Flop (didn't bet)
Seat 5: batke1984 folded before Flop (didn't bet)
Seat 6: Pokerboy1203 showed [9d Qd] and lost with two pair, Queens and Nines



PokerStars Zoom Hand #193394013294:  Hold'em No Limit ($0.01/$0.02) - 2018/11/17 1:02:38 CUST [2018/11/16 12:02:38 ET]
Table 'Halley' 6-max Seat #1 is the button
Seat 1: engelen563 ($2.22 in chips) 
Seat 2: hc agorist ($2.77 in chips) 
Seat 3: Shliabik ($3.14 in chips) 
Seat 4: Zeemaz ($0.48 in chips) 
Seat 5: reini1100 ($1.98 in chips) 
Seat 6: 3omigo ($4.16 in chips) 
hc agorist: posts small blind $0.01
Shliabik: posts big blind $0.02
*** HOLE CARDS ***
Dealt to hc agorist [3c 7s]
Zeemaz: folds 
reini1100: folds 
3omigo: folds 
engelen563: raises $0.02 to $0.04
hc agorist: folds 
Shliabik: calls $0.02
*** FLOP *** [6s Th 4d]
Shliabik: checks 
engelen563: bets $0.03
Shliabik: folds 
Uncalled bet ($0.03) returned to engelen563
engelen563 collected $0.09 from pot
engelen563: doesn't show hand 
*** SUMMARY ***
Total pot $0.09 | Rake $0 
Board [6s Th 4d]
Seat 1: engelen563 (button) collected ($0.09)
Seat 2: hc agorist (small blind) folded before Flop
Seat 3: Shliabik (big blind) folded on the Flop
Seat 4: Zeemaz folded before Flop (didn't bet)
Seat 5: reini1100 folded before Flop (didn't bet)
Seat 6: 3omigo folded before Flop (didn't bet)



PokerStars Zoom Hand #193394008526:  Hold'em No Limit ($0.01/$0.02) - 2018/11/17 1:02:30 CUST [2018/11/16 12:02:30 ET]
Table 'Halley' 6-max Seat #1 is the button
Seat 1: Jgrochovskii ($2.65 in chips) 
Seat 2: marian_rr ($1.06 in chips) 
Seat 3: Korsett84 ($2 in chips) 
Seat 4: artri3 ($1.74 in chips) 
Seat 5: hc agorist ($2.77 in chips) 
Seat 6: Dorogoi57 ($3.71 in chips) 
marian_rr: posts small blind $0.01
Korsett84: posts big blind $0.02
*** HOLE CARDS ***
Dealt to hc agorist [8d 4s]
artri3: raises $0.02 to $0.04
hc agorist: folds 
Dorogoi57: folds 
Jgrochovskii: folds 
marian_rr: folds 
Korsett84: raises $0.02 to $0.06
artri3: calls $0.02
*** FLOP *** [Ah Ts Js]
Korsett84: bets $0.07
artri3: calls $0.07
*** TURN *** [Ah Ts Js] [Qd]
Korsett84: bets $0.14
artri3: folds 
Uncalled bet ($0.14) returned to Korsett84
Korsett84 collected $0.26 from pot
Korsett84: doesn't show hand 
*** SUMMARY ***
Total pot $0.27 | Rake $0.01 
Board [Ah Ts Js Qd]
Seat 1: Jgrochovskii (button) folded before Flop (didn't bet)
Seat 2: marian_rr (small blind) folded before Flop
Seat 3: Korsett84 (big blind) collected ($0.26)
Seat 4: artri3 folded on the Turn
Seat 5: hc agorist folded before Flop (didn't bet)
Seat 6: Dorogoi57 folded before Flop (didn't bet)



PokerStars Zoom Hand #193394016680:  Hold'em No Limit ($0.01/$0.02) - 2018/11/17 1:02:44 CUST [2018/11/16 12:02:44 ET]
Table 'Halley' 6-max Seat #1 is the button
Seat 1: qk rodriguez ($2.07 in chips) 
Seat 2: Salmonplnk23 ($2.31 in chips) 
Seat 3: ignacio971 ($2.30 in chips) 
Seat 4: Oberon63 ($1.71 in chips) 
Seat 5: Urban_Slug ($2 in chips) 
Seat 6: hc agorist ($2.76 in chips) 
Salmonplnk23: posts small blind $0.01
ignacio971: posts big blind $0.02
*** HOLE CARDS ***
Dealt to hc agorist [Jh 7h]
Oberon63: folds 
Urban_Slug: folds 
hc agorist: raises $0.04 to $0.06
qk rodriguez: folds 
Salmonplnk23: folds 
ignacio971: folds 
Uncalled bet ($0.04) returned to hc agorist
hc agorist collected $0.05 from pot
hc agorist: doesn't show hand 
*** SUMMARY ***
Total pot $0.05 | Rake $0 
Seat 1: qk rodriguez (button) folded before Flop (didn't bet)
Seat 2: Salmonplnk23 (small blind) folded before Flop
Seat 3: ignacio971 (big blind) folded before Flop
Seat 4: Oberon63 folded before Flop (didn't bet)
Seat 5: Urban_Slug folded before Flop (didn't bet)
Seat 6: hc agorist collected ($0.05)



PokerStars Zoom Hand #193394028455:  Hold'em No Limit ($0.01/$0.02) - 2018/11/17 1:03:05 CUST [2018/11/16 12:03:05 ET]
Table 'Halley' 6-max Seat #1 is the button
Seat 1: 7santey7 ($2.48 in chips) 
Seat 2: SirCornflake ($2 in chips) 
Seat 3: Tomirlan8 ($2.11 in chips) 
Seat 4: motoi8motoi ($2.44 in chips) 
Seat 5: hc agorist ($2.79 in chips) 
Seat 6: oposs153 ($2.03 in chips) 
SirCornflake: posts small blind $0.01
Tomirlan8: posts big blind $0.02
*** HOLE CARDS ***
Dealt to hc agorist [7d Ah]
motoi8motoi: folds 
hc agorist: raises $0.02 to $0.04
oposs153: folds 
7santey7: folds 
SirCornflake: folds 
Tomirlan8: raises $0.14 to $0.18
hc agorist: folds 
Uncalled bet ($0.14) returned to Tomirlan8
Tomirlan8 collected $0.09 from pot
Tomirlan8: doesn't show hand 
*** SUMMARY ***
Total pot $0.09 | Rake $0 
Seat 1: 7santey7 (button) folded before Flop (didn't bet)
Seat 2: SirCornflake (small blind) folded before Flop
Seat 3: Tomirlan8 (big blind) collected ($0.09)
Seat 4: motoi8motoi folded before Flop (didn't bet)
Seat 5: hc agorist folded before Flop
Seat 6: oposs153 folded before Flop (didn't bet)



PokerStars Zoom Hand #193394042553:  Hold'em No Limit ($0.01/$0.02) - 2018/11/17 1:03:29 CUST [2018/11/16 12:03:29 ET]
Table 'Halley' 6-max Seat #1 is the button
Seat 1: AngelBear82 ($2 in chips) 
Seat 2: Fixmenem ($2.11 in chips) 
Seat 3: hc agorist ($2.75 in chips) 
Seat 4: dyak909 ($2.71 in chips) 
Seat 5: Shliabik ($3.05 in chips) 
Seat 6: chala-man999 ($2.62 in chips) 
Fixmenem: posts small blind $0.01
hc agorist: posts big blind $0.02
*** HOLE CARDS ***
Dealt to hc agorist [Jc Ac]
dyak909: folds 
Shliabik: folds 
chala-man999: folds 
AngelBear82: folds 
Fixmenem: raises $0.03 to $0.05
hc agorist: calls $0.03
*** FLOP *** [6h 6s 8d]
Fixmenem: bets $0.05
hc agorist: calls $0.05
*** TURN *** [6h 6s 8d] [Td]
Fixmenem: bets $0.12
hc agorist: calls $0.12
*** RIVER *** [6h 6s 8d Td] [9s]
Fixmenem: checks 
hc agorist: bets $0.32
Fixmenem: folds 
Uncalled bet ($0.32) returned to hc agorist
hc agorist collected $0.42 from pot
hc agorist: doesn't show hand 
*** SUMMARY ***
Total pot $0.44 | Rake $0.02 
Board [6h 6s 8d Td 9s]
Seat 1: AngelBear82 (button) folded before Flop (didn't bet)
Seat 2: Fixmenem (small blind) folded on the River
Seat 3: hc agorist (big blind) collected ($0.42)
Seat 4: dyak909 folded before Flop (didn't bet)
Seat 5: Shliabik folded before Flop (didn't bet)
Seat 6: chala-man999 folded before Flop (didn't bet)



PokerStars Zoom Hand #193394091768:  Hold'em No Limit ($0.01/$0.02) - 2018/11/17 1:04:54 CUST [2018/11/16 12:04:54 ET]
Table 'Halley' 6-max Seat #1 is the button
Seat 1: Rechtse back ($6.21 in chips) 
Seat 2: lll MAXV lll ($2.28 in chips) 
Seat 3: oposs153 ($2 in chips) 
Seat 4: Quadko228 ($2.10 in chips) 
Seat 5: zenitowec777 ($2.41 in chips) 
Seat 6: hc agorist ($2.95 in chips) 
lll MAXV lll: posts small blind $0.01
oposs153: posts big blind $0.02
*** HOLE CARDS ***
Dealt to hc agorist [9d 7c]
Quadko228: folds 
zenitowec777: calls $0.02
hc agorist: calls $0.02
Rechtse back: folds 
lll MAXV lll: folds 
oposs153: checks 
*** FLOP *** [Ks Th Qc]
oposs153: checks 
zenitowec777: checks 
hc agorist: checks 
*** TURN *** [Ks Th Qc] [Kd]
oposs153: checks 
zenitowec777: checks 
hc agorist: bets $0.05
oposs153: folds 
zenitowec777: folds 
Uncalled bet ($0.05) returned to hc agorist
hc agorist collected $0.07 from pot
hc agorist: doesn't show hand 
*** SUMMARY ***
Total pot $0.07 | Rake $0 
Board [Ks Th Qc Kd]
Seat 1: Rechtse back (button) folded before Flop (didn't bet)
Seat 2: lll MAXV lll (small blind) folded before Flop
Seat 3: oposs153 (big blind) folded on the Turn
Seat 4: Quadko228 folded before Flop (didn't bet)
Seat 5: zenitowec777 folded on the Turn
Seat 6: hc agorist collected ($0.07)



PokerStars Zoom Hand #193394123996:  Hold'em No Limit ($0.01/$0.02) - 2018/11/17 1:05:49 CUST [2018/11/16 12:05:49 ET]
Table 'Halley' 6-max Seat #1 is the button
Seat 1: msu.fedos ($2.23 in chips) 
Seat 2: polnareff85 ($2.14 in chips) 
Seat 3: Paulocius ($1.17 in chips) 
Seat 4: hc agorist ($3 in chips) 
Seat 5: RocknRolla5 ($2.38 in chips) 
Seat 6: ariana51130 ($3.47 in chips) 
polnareff85: posts small blind $0.01
Paulocius: posts big blind $0.02
*** HOLE CARDS ***
Dealt to hc agorist [4c 7s]
hc agorist: folds 
RocknRolla5: folds 
ariana51130: folds 
msu.fedos: folds 
polnareff85: folds 
Uncalled bet ($0.01) returned to Paulocius
Paulocius collected $0.02 from pot
Paulocius: doesn't show hand 
*** SUMMARY ***
Total pot $0.02 | Rake $0 
Seat 1: msu.fedos (button) folded before Flop (didn't bet)
Seat 2: polnareff85 (small blind) folded before Flop
Seat 3: Paulocius (big blind) collected ($0.02)
Seat 4: hc agorist folded before Flop (didn't bet)
Seat 5: RocknRolla5 folded before Flop (didn't bet)
Seat 6: ariana51130 folded before Flop (didn't bet)



PokerStars Zoom Hand #193394127501:  Hold'em No Limit ($0.01/$0.02) - 2018/11/17 1:05:55 CUST [2018/11/16 12:05:55 ET]
Table 'Halley' 6-max Seat #1 is the button
Seat 1: Crowy21 ($2 in chips) 
Seat 2: hc agorist ($3 in chips) 
Seat 3: SanDmitri4 ($2.19 in chips) 
Seat 4: HyrymaN ($3.43 in chips) 
Seat 5: sztuciec ($2.15 in chips) 
Seat 6: bradeda ($2.38 in chips) 
hc agorist: posts small blind $0.01
SanDmitri4: posts big blind $0.02
*** HOLE CARDS ***
Dealt to hc agorist [5c As]
HyrymaN: raises $0.04 to $0.06
sztuciec: folds 
bradeda: folds 
Crowy21: folds 
hc agorist: folds 
SanDmitri4: folds 
Uncalled bet ($0.04) returned to HyrymaN
HyrymaN collected $0.05 from pot
HyrymaN: doesn't show hand 
*** SUMMARY ***
Total pot $0.05 | Rake $0 
Seat 1: Crowy21 (button) folded before Flop (didn't bet)
Seat 2: hc agorist (small blind) folded before Flop
Seat 3: SanDmitri4 (big blind) folded before Flop
Seat 4: HyrymaN collected ($0.05)
Seat 5: sztuciec folded before Flop (didn't bet)
Seat 6: bradeda folded before Flop (didn't bet)



PokerStars Zoom Hand #193394135523:  Hold'em No Limit ($0.01/$0.02) - 2018/11/17 1:06:09 CUST [2018/11/16 12:06:09 ET]
Table 'Halley' 6-max Seat #1 is the button
Seat 1: hc agorist ($2.99 in chips) 
Seat 2: positivefind ($3.59 in chips) 
Seat 3: Bloodypowers ($2.03 in chips) 
Seat 4: sne>I<ana ($1.34 in chips) 
Seat 5: NeverSTisLT ($2.32 in chips) 
Seat 6: Higginson66 ($2.27 in chips) 
positivefind: posts small blind $0.01
Bloodypowers: posts big blind $0.02
*** HOLE CARDS ***
Dealt to hc agorist [Qh Td]
sne>I<ana: folds 
NeverSTisLT: folds 
Higginson66: folds 
hc agorist: raises $0.02 to $0.04
positivefind: raises $0.12 to $0.16
Bloodypowers: folds 
hc agorist: folds 
Uncalled bet ($0.12) returned to positivefind
positivefind collected $0.10 from pot
positivefind: doesn't show hand 
*** SUMMARY ***
Total pot $0.10 | Rake $0 
Seat 1: hc agorist (button) folded before Flop
Seat 2: positivefind (small blind) collected ($0.10)
Seat 3: Bloodypowers (big blind) folded before Flop
Seat 4: sne>I<ana folded before Flop (didn't bet)
Seat 5: NeverSTisLT folded before Flop (didn't bet)
Seat 6: Higginson66 folded before Flop (didn't bet)



PokerStars Zoom Hand #193394146004:  Hold'em No Limit ($0.01/$0.02) - 2018/11/17 1:06:27 CUST [2018/11/16 12:06:27 ET]
Table 'Halley' 6-max Seat #1 is the button
Seat 1: rus22lan22 ($3.23 in chips) 
Seat 2: metz_fitness ($2.36 in chips) 
Seat 3: hc agorist ($2.95 in chips) 
Seat 4: ten_dima_81 ($2.66 in chips) 
Seat 5: Nikeim ($4.55 in chips) 
Seat 6: Savavlad97 ($2.04 in chips) 
metz_fitness: posts small blind $0.01
hc agorist: posts big blind $0.02
*** HOLE CARDS ***
Dealt to hc agorist [3s 7s]
ten_dima_81: folds 
Nikeim: folds 
Savavlad97: raises $0.03 to $0.05
rus22lan22: folds 
metz_fitness: folds 
hc agorist: folds 
Uncalled bet ($0.03) returned to Savavlad97
Savavlad97 collected $0.05 from pot
Savavlad97: doesn't show hand 
*** SUMMARY ***
Total pot $0.05 | Rake $0 
Seat 1: rus22lan22 (button) folded before Flop (didn't bet)
Seat 2: metz_fitness (small blind) folded before Flop
Seat 3: hc agorist (big blind) folded before Flop
Seat 4: ten_dima_81 folded before Flop (didn't bet)
Seat 5: Nikeim folded before Flop (didn't bet)
Seat 6: Savavlad97 collected ($0.05)



PokerStars Zoom Hand #193394156954:  Hold'em No Limit ($0.01/$0.02) - 2018/11/17 1:06:46 CUST [2018/11/16 12:06:46 ET]
Table 'Halley' 6-max Seat #1 is the button
Seat 1: S.A.JU.REZAK ($2.53 in chips) 
Seat 2: hc agorist ($2.93 in chips) 
Seat 3: batke1984 ($1.02 in chips) 
Seat 4: 21samuel ($1.45 in chips) 
Seat 5: Spartak733777 ($1.96 in chips) 
Seat 6: khalatov ($2.05 in chips) 
hc agorist: posts small blind $0.01
batke1984: posts big blind $0.02
*** HOLE CARDS ***
Dealt to hc agorist [2d 4c]
21samuel: folds 
Spartak733777: folds 
khalatov: folds 
S.A.JU.REZAK: folds 
hc agorist: folds 
Uncalled bet ($0.01) returned to batke1984
batke1984 collected $0.02 from pot
batke1984: doesn't show hand 
*** SUMMARY ***
Total pot $0.02 | Rake $0 
Seat 1: S.A.JU.REZAK (button) folded before Flop (didn't bet)
Seat 2: hc agorist (small blind) folded before Flop
Seat 3: batke1984 (big blind) collected ($0.02)
Seat 4: 21samuel folded before Flop (didn't bet)
Seat 5: Spartak733777 folded before Flop (didn't bet)
Seat 6: khalatov folded before Flop (didn't bet)



PokerStars Zoom Hand #193394153503:  Hold'em No Limit ($0.01/$0.02) - 2018/11/17 1:06:40 CUST [2018/11/16 12:06:40 ET]
Table 'Halley' 6-max Seat #1 is the button
Seat 1: mi$tralx ($2.19 in chips) 
Seat 2: babiloniaxxx ($3.94 in chips) 
Seat 3: SonTNkts ($3.25 in chips) 
Seat 4: LuM3r--O ($7.67 in chips) 
Seat 5: mietek198977 ($1.42 in chips) 
Seat 6: hc agorist ($2.93 in chips) 
babiloniaxxx: posts small blind $0.01
SonTNkts: posts big blind $0.02
*** HOLE CARDS ***
Dealt to hc agorist [8c Kc]
LuM3r--O: folds 
mietek198977: folds 
hc agorist: folds 
mi$tralx: folds 
babiloniaxxx: raises $0.04 to $0.06
SonTNkts: folds 
Uncalled bet ($0.04) returned to babiloniaxxx
babiloniaxxx collected $0.04 from pot
babiloniaxxx: doesn't show hand 
*** SUMMARY ***
Total pot $0.04 | Rake $0 
Seat 1: mi$tralx (button) folded before Flop (didn't bet)
Seat 2: babiloniaxxx (small blind) collected ($0.04)
Seat 3: SonTNkts (big blind) folded before Flop
Seat 4: LuM3r--O folded before Flop (didn't bet)
Seat 5: mietek198977 folded before Flop (didn't bet)
Seat 6: hc agorist folded before Flop (didn't bet)



PokerStars Zoom Hand #193394159869:  Hold'em No Limit ($0.01/$0.02) - 2018/11/17 1:06:51 CUST [2018/11/16 12:06:51 ET]
Table 'Halley' 6-max Seat #1 is the button
Seat 1: hc agorist ($2.92 in chips) 
Seat 2: 27magneto27 ($2.10 in chips) 
Seat 3: geminihotty ($0.64 in chips) 
Seat 4: max.m.7deiL ($2.06 in chips) 
Seat 5: AnNik1961 ($2.23 in chips) 
Seat 6: pellion ($5.11 in chips) 
27magneto27: posts small blind $0.01
geminihotty: posts big blind $0.02
*** HOLE CARDS ***
Dealt to hc agorist [Js 4s]
max.m.7deiL: folds 
AnNik1961: folds 
pellion: raises $0.06 to $0.08
hc agorist: folds 
27magneto27: folds 
geminihotty: folds 
Uncalled bet ($0.06) returned to pellion
pellion collected $0.05 from pot
pellion: doesn't show hand 
*** SUMMARY ***
Total pot $0.05 | Rake $0 
Seat 1: hc agorist (button) folded before Flop (didn't bet)
Seat 2: 27magneto27 (small blind) folded before Flop
Seat 3: geminihotty (big blind) folded before Flop
Seat 4: max.m.7deiL folded before Flop (didn't bet)
Seat 5: AnNik1961 folded before Flop (didn't bet)
Seat 6: pellion collected ($0.05)



PokerStars Zoom Hand #193394169115:  Hold'em No Limit ($0.01/$0.02) - 2018/11/17 1:07:07 CUST [2018/11/16 12:07:07 ET]
Table 'Halley' 6-max Seat #1 is the button
Seat 1: JORKER22 ($4.62 in chips) 
Seat 2: Qwkl ($2.98 in chips) 
Seat 3: LimitlessLV ($2.09 in chips) 
Seat 4: helolele ($3.31 in chips) 
Seat 5: Rainmaker1978 ($2.05 in chips) 
Seat 6: hc agorist ($2.92 in chips) 
Qwkl: posts small blind $0.01
LimitlessLV: posts big blind $0.02
*** HOLE CARDS ***
Dealt to hc agorist [2h 5d]
helolele: raises $0.03 to $0.05
Rainmaker1978: folds 
hc agorist: folds 
JORKER22: folds 
Qwkl: folds 
LimitlessLV: folds 
Uncalled bet ($0.03) returned to helolele
helolele collected $0.05 from pot
helolele: doesn't show hand 
*** SUMMARY ***
Total pot $0.05 | Rake $0 
Seat 1: JORKER22 (button) folded before Flop (didn't bet)
Seat 2: Qwkl (small blind) folded before Flop
Seat 3: LimitlessLV (big blind) folded before Flop
Seat 4: helolele collected ($0.05)
Seat 5: Rainmaker1978 folded before Flop (didn't bet)
Seat 6: hc agorist folded before Flop (didn't bet)



PokerStars Zoom Hand #193394166193:  Hold'em No Limit ($0.01/$0.02) - 2018/11/17 1:07:02 CUST [2018/11/16 12:07:02 ET]
Table 'Halley' 6-max Seat #1 is the button
Seat 1: Dyakill ($3.81 in chips) 
Seat 2: cedricvde ($2.45 in chips) 
Seat 3: Toecloth ($2.84 in chips) 
Seat 4: Enlassombras ($2.99 in chips) 
Seat 5: hc agorist ($2.92 in chips) 
Seat 6: AnNik1961 ($2.21 in chips) 
cedricvde: posts small blind $0.01
Toecloth: posts big blind $0.02
*** HOLE CARDS ***
Dealt to hc agorist [4d 5h]
Enlassombras: folds 
hc agorist: folds 
AnNik1961: folds 
Dyakill: folds 
cedricvde: raises $0.03 to $0.05
Toecloth: calls $0.03
*** FLOP *** [As 8c Kc]
cedricvde: bets $0.05
Toecloth: folds 
Uncalled bet ($0.05) returned to cedricvde
cedricvde collected $0.10 from pot
cedricvde: doesn't show hand 
*** SUMMARY ***
Total pot $0.10 | Rake $0 
Board [As 8c Kc]
Seat 1: Dyakill (button) folded before Flop (didn't bet)
Seat 2: cedricvde (small blind) collected ($0.10)
Seat 3: Toecloth (big blind) folded on the Flop
Seat 4: Enlassombras folded before Flop (didn't bet)
Seat 5: hc agorist folded before Flop (didn't bet)
Seat 6: AnNik1961 folded before Flop (didn't bet)



PokerStars Zoom Hand #193394172668:  Hold'em No Limit ($0.01/$0.02) - 2018/11/17 1:07:13 CUST [2018/11/16 12:07:13 ET]
Table 'Halley' 6-max Seat #1 is the button
Seat 1: Barra West ($6.61 in chips) 
Seat 2: Dorogoi57 ($3.88 in chips) 
Seat 3: laoban888 ($2 in chips) 
Seat 4: hc agorist ($2.92 in chips) 
Seat 5: Lawrence$lim ($2 in chips) 
Seat 6: Martik322 ($2.50 in chips) 
Dorogoi57: posts small blind $0.01
laoban888: posts big blind $0.02
*** HOLE CARDS ***
Dealt to hc agorist [5s Th]
hc agorist: folds 
Lawrence$lim: raises $0.04 to $0.06
Martik322: folds 
Barra West: folds 
Dorogoi57: folds 
laoban888: calls $0.04
*** FLOP *** [Ac Qh Td]
laoban888: checks 
Lawrence$lim: bets $0.09
laoban888: folds 
Uncalled bet ($0.09) returned to Lawrence$lim
Lawrence$lim collected $0.13 from pot
Lawrence$lim: doesn't show hand 
*** SUMMARY ***
Total pot $0.13 | Rake $0 
Board [Ac Qh Td]
Seat 1: Barra West (button) folded before Flop (didn't bet)
Seat 2: Dorogoi57 (small blind) folded before Flop
Seat 3: laoban888 (big blind) folded on the Flop
Seat 4: hc agorist folded before Flop (didn't bet)
Seat 5: Lawrence$lim collected ($0.13)
Seat 6: Martik322 folded before Flop (didn't bet)



PokerStars Zoom Hand #193394175553:  Hold'em No Limit ($0.01/$0.02) - 2018/11/17 1:07:18 CUST [2018/11/16 12:07:18 ET]
Table 'Halley' 6-max Seat #1 is the button
Seat 1: Golum 123149 ($2.14 in chips) 
Seat 2: xiazhen ($2.08 in chips) 
Seat 3: hc agorist ($2.92 in chips) 
Seat 4: Wild Sttar ($2.34 in chips) 
Seat 5: Melamory77 ($0.42 in chips) 
Seat 6: lastfox ($2.03 in chips) 
xiazhen: posts small blind $0.01
hc agorist: posts big blind $0.02
*** HOLE CARDS ***
Dealt to hc agorist [7s 2s]
Wild Sttar: folds 
Melamory77: folds 
lastfox: raises $0.03 to $0.05
Golum 123149: folds 
xiazhen: folds 
hc agorist: folds 
Uncalled bet ($0.03) returned to lastfox
lastfox collected $0.05 from pot
lastfox: doesn't show hand 
*** SUMMARY ***
Total pot $0.05 | Rake $0 
Seat 1: Golum 123149 (button) folded before Flop (didn't bet)
Seat 2: xiazhen (small blind) folded before Flop
Seat 3: hc agorist (big blind) folded before Flop
Seat 4: Wild Sttar folded before Flop (didn't bet)
Seat 5: Melamory77 folded before Flop (didn't bet)
Seat 6: lastfox collected ($0.05)



PokerStars Zoom Hand #193394179573:  Hold'em No Limit ($0.01/$0.02) - 2018/11/17 1:07:25 CUST [2018/11/16 12:07:25 ET]
Table 'Halley' 6-max Seat #1 is the button
Seat 1: hc agorist ($2.90 in chips) 
Seat 2: jowijojo ($2.74 in chips) 
Seat 3: Bodri88 ($7.87 in chips) 
Seat 4: Renky91 ($2.93 in chips) 
Seat 5: joedaum ($1.63 in chips) 
Seat 6: WiNNeRdn ($2 in chips) 
jowijojo: posts small blind $0.01
Bodri88: posts big blind $0.02
*** HOLE CARDS ***
Dealt to hc agorist [9c 6h]
Renky91: folds 
joedaum: folds 
WiNNeRdn: folds 
hc agorist: raises $0.02 to $0.04
jowijojo: folds 
Bodri88: calls $0.02
*** FLOP *** [3d Tc 9d]
Bodri88: checks 
hc agorist: checks 
*** TURN *** [3d Tc 9d] [Qh]
Bodri88: bets $0.07
hc agorist: calls $0.07
*** RIVER *** [3d Tc 9d Qh] [7d]
Bodri88: bets $0.17
hc agorist: calls $0.17
*** SHOW DOWN ***
Bodri88: shows [Js Kc] (a straight, Nine to King)
hc agorist: mucks hand 
Bodri88 collected $0.55 from pot
*** SUMMARY ***
Total pot $0.57 | Rake $0.02 
Board [3d Tc 9d Qh 7d]
Seat 1: hc agorist (button) mucked [9c 6h]
Seat 2: jowijojo (small blind) folded before Flop
Seat 3: Bodri88 (big blind) showed [Js Kc] and won ($0.55) with a straight, Nine to King
Seat 4: Renky91 folded before Flop (didn't bet)
Seat 5: joedaum folded before Flop (didn't bet)
Seat 6: WiNNeRdn folded before Flop (didn't bet)



PokerStars Zoom Hand #193394202186:  Hold'em No Limit ($0.01/$0.02) - 2018/11/17 1:08:04 CUST [2018/11/16 12:08:04 ET]
Table 'Halley' 6-max Seat #1 is the button
Seat 1: cardplayerrr ($1.14 in chips) 
Seat 2: Barra West ($6.47 in chips) 
Seat 3: serg888803 ($1 in chips) 
Seat 4: ZePokerArt ($2.20 in chips) 
Seat 5: hc agorist ($2.62 in chips) 
Seat 6: nana7733104 ($2 in chips) 
Barra West: posts small blind $0.01
serg888803: posts big blind $0.02
*** HOLE CARDS ***
Dealt to hc agorist [6h 2s]
ZePokerArt: folds 
hc agorist: folds 
nana7733104: folds 
cardplayerrr: folds 
Barra West: folds 
Uncalled bet ($0.01) returned to serg888803
serg888803 collected $0.02 from pot
serg888803: doesn't show hand 
*** SUMMARY ***
Total pot $0.02 | Rake $0 
Seat 1: cardplayerrr (button) folded before Flop (didn't bet)
Seat 2: Barra West (small blind) folded before Flop
Seat 3: serg888803 (big blind) collected ($0.02)
Seat 4: ZePokerArt folded before Flop (didn't bet)
Seat 5: hc agorist folded before Flop (didn't bet)
Seat 6: nana7733104 folded before Flop (didn't bet)



PokerStars Zoom Hand #193394205182:  Hold'em No Limit ($0.01/$0.02) - 2018/11/17 1:08:09 CUST [2018/11/16 12:08:09 ET]
Table 'Halley' 6-max Seat #1 is the button
Seat 1: S.A.JU.REZAK ($3.03 in chips) 
Seat 2: vladimir690 ($1.14 in chips) 
Seat 3: aleksvp ($2 in chips) 
Seat 4: 27magneto27 ($2.91 in chips) 
Seat 5: hc agorist ($2.62 in chips) 
Seat 6: Troy668 ($4.09 in chips) 
vladimir690: posts small blind $0.01
aleksvp: posts big blind $0.02
*** HOLE CARDS ***
Dealt to hc agorist [Js Kd]
27magneto27: folds 
hc agorist: raises $0.04 to $0.06
Troy668: folds 
S.A.JU.REZAK: folds 
vladimir690: folds 
aleksvp: folds 
Uncalled bet ($0.04) returned to hc agorist
hc agorist collected $0.05 from pot
hc agorist: doesn't show hand 
*** SUMMARY ***
Total pot $0.05 | Rake $0 
Seat 1: S.A.JU.REZAK (button) folded before Flop (didn't bet)
Seat 2: vladimir690 (small blind) folded before Flop
Seat 3: aleksvp (big blind) folded before Flop
Seat 4: 27magneto27 folded before Flop (didn't bet)
Seat 5: hc agorist collected ($0.05)
Seat 6: Troy668 folded before Flop (didn't bet)



PokerStars Zoom Hand #193394218521:  Hold'em No Limit ($0.01/$0.02) - 2018/11/17 1:08:32 CUST [2018/11/16 12:08:32 ET]
Table 'Halley' 6-max Seat #1 is the button
Seat 1: orangos ($1.91 in chips) 
Seat 2: ios-801 ($2.01 in chips) 
Seat 3: 1anXIce ($1.64 in chips) 
Seat 4: hc agorist ($2.65 in chips) 
Seat 5: oposs153 ($2.41 in chips) 
Seat 6: reini1100 ($1.97 in chips) 
ios-801: posts small blind $0.01
1anXIce: posts big blind $0.02
*** HOLE CARDS ***
Dealt to hc agorist [5h 8c]
hc agorist: folds 
oposs153: folds 
reini1100: folds 
orangos: folds 
ios-801: folds 
Uncalled bet ($0.01) returned to 1anXIce
1anXIce collected $0.02 from pot
1anXIce: doesn't show hand 
*** SUMMARY ***
Total pot $0.02 | Rake $0 
Seat 1: orangos (button) folded before Flop (didn't bet)
Seat 2: ios-801 (small blind) folded before Flop
Seat 3: 1anXIce (big blind) collected ($0.02)
Seat 4: hc agorist folded before Flop (didn't bet)
Seat 5: oposs153 folded before Flop (didn't bet)
Seat 6: reini1100 folded before Flop (didn't bet)



PokerStars Zoom Hand #193394221385:  Hold'em No Limit ($0.01/$0.02) - 2018/11/17 1:08:37 CUST [2018/11/16 12:08:37 ET]
Table 'Halley' 6-max Seat #1 is the button
Seat 1: Innerwuss ($2 in chips) 
Seat 2: hc agorist ($2.65 in chips) 
Seat 3: Mr. Jay12345 ($1.86 in chips) 
Seat 4: MuXaHuKK ($2.04 in chips) 
Seat 5: JORKER22 ($5.21 in chips) 
Seat 6: RNSAMAD ($1.20 in chips) 
hc agorist: posts small blind $0.01
Mr. Jay12345: posts big blind $0.02
*** HOLE CARDS ***
Dealt to hc agorist [2c Tc]
MuXaHuKK: folds 
JORKER22: folds 
RNSAMAD: folds 
Innerwuss: raises $0.02 to $0.04
hc agorist: folds 
Mr. Jay12345: raises $0.30 to $0.34
Innerwuss: raises $1.66 to $2 and is all-in
Mr. Jay12345: folds 
Uncalled bet ($1.66) returned to Innerwuss
Innerwuss collected $0.69 from pot
Innerwuss: doesn't show hand 
*** SUMMARY ***
Total pot $0.69 | Rake $0 
Seat 1: Innerwuss (button) collected ($0.69)
Seat 2: hc agorist (small blind) folded before Flop
Seat 3: Mr. Jay12345 (big blind) folded before Flop
Seat 4: MuXaHuKK folded before Flop (didn't bet)
Seat 5: JORKER22 folded before Flop (didn't bet)
Seat 6: RNSAMAD folded before Flop (didn't bet)



PokerStars Zoom Hand #193394227675:  Hold'em No Limit ($0.01/$0.02) - 2018/11/17 1:08:48 CUST [2018/11/16 12:08:48 ET]
Table 'Halley' 6-max Seat #1 is the button
Seat 1: Urban_Slug ($2 in chips) 
Seat 2: nathaniel158 ($2.04 in chips) 
Seat 3: VladKot ($2.11 in chips) 
Seat 4: Simkooo ($2.02 in chips) 
Seat 5: olcham7 ($2.02 in chips) 
Seat 6: hc agorist ($2.64 in chips) 
nathaniel158: posts small blind $0.01
VladKot: posts big blind $0.02
*** HOLE CARDS ***
Dealt to hc agorist [6s Qs]
Simkooo: folds 
olcham7: raises $0.04 to $0.06
hc agorist: raises $0.12 to $0.18
Urban_Slug: folds 
nathaniel158: folds 
VladKot: folds 
olcham7: calls $0.12
*** FLOP *** [7h 8c 2h]
olcham7: checks 
hc agorist: bets $0.14
olcham7: calls $0.14
*** TURN *** [7h 8c 2h] [5c]
olcham7: checks 
hc agorist: bets $0.56
olcham7: calls $0.56
*** RIVER *** [7h 8c 2h 5c] [6c]
olcham7: checks 
hc agorist: checks 
*** SHOW DOWN ***
olcham7: shows [Js Jc] (a pair of Jacks)
hc agorist: mucks hand 
olcham7 collected $1.73 from pot
*** SUMMARY ***
Total pot $1.79 | Rake $0.06 
Board [7h 8c 2h 5c 6c]
Seat 1: Urban_Slug (button) folded before Flop (didn't bet)
Seat 2: nathaniel158 (small blind) folded before Flop
Seat 3: VladKot (big blind) folded before Flop
Seat 4: Simkooo folded before Flop (didn't bet)
Seat 5: olcham7 showed [Js Jc] and won ($1.73) with a pair of Jacks
Seat 6: hc agorist mucked [6s Qs]



PokerStars Zoom Hand #193394252703:  Hold'em No Limit ($0.01/$0.02) - 2018/11/17 1:09:31 CUST [2018/11/16 12:09:31 ET]
Table 'Halley' 6-max Seat #1 is the button
Seat 1: Quadko228 ($2.15 in chips) 
Seat 2: MOU77Y ($2.40 in chips) 
Seat 3: hc agorist ($1.76 in chips) 
Seat 4: ignacio971 ($2 in chips) 
Seat 5: pianobeast ($2.12 in chips) 
Seat 6: 69Nails ($2.81 in chips) 
MOU77Y: posts small blind $0.01
hc agorist: posts big blind $0.02
*** HOLE CARDS ***
Dealt to hc agorist [Qs Js]
ignacio971: folds 
pianobeast: folds 
69Nails: folds 
Quadko228: raises $0.04 to $0.06
MOU77Y: folds 
hc agorist: calls $0.04
*** FLOP *** [3c 8s 5d]
hc agorist: checks 
Quadko228: bets $0.07
hc agorist: calls $0.07
*** TURN *** [3c 8s 5d] [Qc]
hc agorist: checks 
Quadko228: checks 
*** RIVER *** [3c 8s 5d Qc] [3h]
hc agorist: bets $0.22
Quadko228: folds 
Uncalled bet ($0.22) returned to hc agorist
hc agorist collected $0.26 from pot
hc agorist: doesn't show hand 
*** SUMMARY ***
Total pot $0.27 | Rake $0.01 
Board [3c 8s 5d Qc 3h]
Seat 1: Quadko228 (button) folded on the River
Seat 2: MOU77Y (small blind) folded before Flop
Seat 3: hc agorist (big blind) collected ($0.26)
Seat 4: ignacio971 folded before Flop (didn't bet)
Seat 5: pianobeast folded before Flop (didn't bet)
Seat 6: 69Nails folded before Flop (didn't bet)



PokerStars Zoom Hand #193394278080:  Hold'em No Limit ($0.01/$0.02) - 2018/11/17 1:10:15 CUST [2018/11/16 12:10:15 ET]
Table 'Halley' 6-max Seat #1 is the button
Seat 1: don_energo2 ($2 in chips) 
Seat 2: hc agorist ($1.89 in chips) 
Seat 3: xiazhen ($2 in chips) 
Seat 4: JecK [24RUS] ($1.20 in chips) 
Seat 5: lesly aleks ($2.01 in chips) 
Seat 6: aldair68 ($2.02 in chips) 
hc agorist: posts small blind $0.01
xiazhen: posts big blind $0.02
*** HOLE CARDS ***
Dealt to hc agorist [8d Kh]
JecK [24RUS]: folds 
lesly aleks: folds 
aldair68: raises $0.03 to $0.05
don_energo2: folds 
hc agorist: folds 
xiazhen: calls $0.03
*** FLOP *** [Td 7h 3h]
xiazhen: checks 
aldair68: bets $0.04
xiazhen: folds 
Uncalled bet ($0.04) returned to aldair68
aldair68 collected $0.11 from pot
aldair68: doesn't show hand 
*** SUMMARY ***
Total pot $0.11 | Rake $0 
Board [Td 7h 3h]
Seat 1: don_energo2 (button) folded before Flop (didn't bet)
Seat 2: hc agorist (small blind) folded before Flop
Seat 3: xiazhen (big blind) folded on the Flop
Seat 4: JecK [24RUS] folded before Flop (didn't bet)
Seat 5: lesly aleks folded before Flop (didn't bet)
Seat 6: aldair68 collected ($0.11)



PokerStars Zoom Hand #193394284316:  Hold'em No Limit ($0.01/$0.02) - 2018/11/17 1:10:26 CUST [2018/11/16 12:10:26 ET]
Table 'Halley' 6-max Seat #1 is the button
Seat 1: benizel ($2.21 in chips) 
Seat 2: pellion ($6.43 in chips) 
Seat 3: Toecloth ($3.16 in chips) 
Seat 4: hc agorist ($1.88 in chips) 
Seat 5: VreditelL ($2.14 in chips) 
Seat 6: elvis_genius ($3.69 in chips) 
pellion: posts small blind $0.01
Toecloth: posts big blind $0.02
*** HOLE CARDS ***
Dealt to hc agorist [7d Qs]
hc agorist: folds 
VreditelL: raises $0.04 to $0.06
elvis_genius: folds 
benizel: folds 
pellion: folds 
Toecloth: folds 
Uncalled bet ($0.04) returned to VreditelL
VreditelL collected $0.05 from pot
VreditelL: doesn't show hand 
*** SUMMARY ***
Total pot $0.05 | Rake $0 
Seat 1: benizel (button) folded before Flop (didn't bet)
Seat 2: pellion (small blind) folded before Flop
Seat 3: Toecloth (big blind) folded before Flop
Seat 4: hc agorist folded before Flop (didn't bet)
Seat 5: VreditelL collected ($0.05)
Seat 6: elvis_genius folded before Flop (didn't bet)



PokerStars Zoom Hand #193394287309:  Hold'em No Limit ($0.01/$0.02) - 2018/11/17 1:10:31 CUST [2018/11/16 12:10:31 ET]
Table 'Halley' 6-max Seat #1 is the button
Seat 1: hc agorist ($1.88 in chips) 
Seat 2: Satheman ($2 in chips) 
Seat 3: polnareff85 ($2.32 in chips) 
Seat 4: argoha2010 ($2.25 in chips) 
Seat 5: Funmaker007 ($6.37 in chips) 
Seat 6: LimitlessLV ($2.44 in chips) 
Satheman: posts small blind $0.01
polnareff85: posts big blind $0.02
*** HOLE CARDS ***
Dealt to hc agorist [4h 6s]
argoha2010: folds 
Funmaker007: raises $0.04 to $0.06
LimitlessLV: folds 
hc agorist: folds 
Satheman: folds 
polnareff85: calls $0.04
*** FLOP *** [5s Js Ks]
polnareff85: checks 
Funmaker007: checks 
*** TURN *** [5s Js Ks] [9s]
polnareff85: bets $0.04
Funmaker007: folds 
Uncalled bet ($0.04) returned to polnareff85
polnareff85 collected $0.13 from pot
polnareff85: doesn't show hand 
*** SUMMARY ***
Total pot $0.13 | Rake $0 
Board [5s Js Ks 9s]
Seat 1: hc agorist (button) folded before Flop (didn't bet)
Seat 2: Satheman (small blind) folded before Flop
Seat 3: polnareff85 (big blind) collected ($0.13)
Seat 4: argoha2010 folded before Flop (didn't bet)
Seat 5: Funmaker007 folded on the Turn
Seat 6: LimitlessLV folded before Flop (didn't bet)



PokerStars Zoom Hand #193394299580:  Hold'em No Limit ($0.01/$0.02) - 2018/11/17 1:10:52 CUST [2018/11/16 12:10:52 ET]
Table 'Halley' 6-max Seat #1 is the button
Seat 1: Dimoni797979 ($2.28 in chips) 
Seat 2: pyrosteam ($4.46 in chips) 
Seat 3: TheSnake168 ($2 in chips) 
Seat 4: kyoubaku ($2.02 in chips) 
Seat 5: hc agorist ($1.86 in chips) 
Seat 6: takpat ($0.22 in chips) 
pyrosteam: posts small blind $0.01
TheSnake168: posts big blind $0.02
*** HOLE CARDS ***
Dealt to hc agorist [2c Td]
kyoubaku: folds 
hc agorist: folds 
takpat: raises $0.04 to $0.06
Dimoni797979: folds 
pyrosteam: folds 
TheSnake168: folds 
Uncalled bet ($0.04) returned to takpat
takpat collected $0.05 from pot
takpat: doesn't show hand 
*** SUMMARY ***
Total pot $0.05 | Rake $0 
Seat 1: Dimoni797979 (button) folded before Flop (didn't bet)
Seat 2: pyrosteam (small blind) folded before Flop
Seat 3: TheSnake168 (big blind) folded before Flop
Seat 4: kyoubaku folded before Flop (didn't bet)
Seat 5: hc agorist folded before Flop (didn't bet)
Seat 6: takpat collected ($0.05)



PokerStars Zoom Hand #193394302432:  Hold'em No Limit ($0.01/$0.02) - 2018/11/17 1:10:57 CUST [2018/11/16 12:10:57 ET]
Table 'Halley' 6-max Seat #1 is the button
Seat 1: qk rodriguez ($2 in chips) 
Seat 2: orangos ($1.21 in chips) 
Seat 3: plasencia345 ($1.67 in chips) 
Seat 4: Mr.hao001981 ($0.76 in chips) 
Seat 5: carloscrum ($1.99 in chips) 
Seat 6: hc agorist ($1.86 in chips) 
orangos: posts small blind $0.01
plasencia345: posts big blind $0.02
*** HOLE CARDS ***
Dealt to hc agorist [Qs As]
Mr.hao001981: folds 
carloscrum: folds 
hc agorist: raises $0.04 to $0.06
qk rodriguez: folds 
orangos: folds 
plasencia345: folds 
Uncalled bet ($0.04) returned to hc agorist
hc agorist collected $0.05 from pot
hc agorist: doesn't show hand 
*** SUMMARY ***
Total pot $0.05 | Rake $0 
Seat 1: qk rodriguez (button) folded before Flop (didn't bet)
Seat 2: orangos (small blind) folded before Flop
Seat 3: plasencia345 (big blind) folded before Flop
Seat 4: Mr.hao001981 folded before Flop (didn't bet)
Seat 5: carloscrum folded before Flop (didn't bet)
Seat 6: hc agorist collected ($0.05)



PokerStars Zoom Hand #193394290885:  Hold'em No Limit ($0.01/$0.02) - 2018/11/17 1:10:37 CUST [2018/11/16 12:10:37 ET]
Table 'Halley' 6-max Seat #1 is the button
Seat 1: boris_198020 ($1.60 in chips) 
Seat 2: Rpet43 ($1.64 in chips) 
Seat 3: hc agorist ($1.88 in chips) 
Seat 4: Nutsit72 ($1.86 in chips) 
Seat 5: 27magneto27 ($2.46 in chips) 
Seat 6: VladKot ($2.09 in chips) 
Rpet43: posts small blind $0.01
hc agorist: posts big blind $0.02
*** HOLE CARDS ***
Dealt to hc agorist [6d 4s]
Nutsit72: raises $0.06 to $0.08
27magneto27: folds 
VladKot: folds 
boris_198020: folds 
Rpet43: folds 
hc agorist: folds 
Uncalled bet ($0.06) returned to Nutsit72
Nutsit72 collected $0.05 from pot
Nutsit72: doesn't show hand 
*** SUMMARY ***
Total pot $0.05 | Rake $0 
Seat 1: boris_198020 (button) folded before Flop (didn't bet)
Seat 2: Rpet43 (small blind) folded before Flop
Seat 3: hc agorist (big blind) folded before Flop
Seat 4: Nutsit72 collected ($0.05)
Seat 5: 27magneto27 folded before Flop (didn't bet)
Seat 6: VladKot folded before Flop (didn't bet)



PokerStars Zoom Hand #193394311092:  Hold'em No Limit ($0.01/$0.02) - 2018/11/17 1:11:12 CUST [2018/11/16 12:11:12 ET]
Table 'Halley' 6-max Seat #1 is the button
Seat 1: zcrtdbx ($2.94 in chips) 
Seat 2: donova ($1.42 in chips) 
Seat 3: piterstone ($2.81 in chips) 
Seat 4: hd8500 ($0.90 in chips) 
Seat 5: hc agorist ($1.89 in chips) 
Seat 6: bLoNdiNkek ($4.35 in chips) 
donova: posts small blind $0.01
piterstone: posts big blind $0.02
*** HOLE CARDS ***
Dealt to hc agorist [6c 8h]
hd8500: folds 
hc agorist: folds 
bLoNdiNkek: folds 
zcrtdbx: raises $0.04 to $0.06
donova: folds 
piterstone: folds 
Uncalled bet ($0.04) returned to zcrtdbx
zcrtdbx collected $0.05 from pot
zcrtdbx: doesn't show hand 
*** SUMMARY ***
Total pot $0.05 | Rake $0 
Seat 1: zcrtdbx (button) collected ($0.05)
Seat 2: donova (small blind) folded before Flop
Seat 3: piterstone (big blind) folded before Flop
Seat 4: hd8500 folded before Flop (didn't bet)
Seat 5: hc agorist folded before Flop (didn't bet)
Seat 6: bLoNdiNkek folded before Flop (didn't bet)



PokerStars Zoom Hand #193394317481:  Hold'em No Limit ($0.01/$0.02) - 2018/11/17 1:11:23 CUST [2018/11/16 12:11:23 ET]
Table 'Halley' 6-max Seat #1 is the button
Seat 1: OkadaVictor ($3.01 in chips) 
Seat 2: hc agorist ($1.89 in chips) 
Seat 3: msu.fedos ($3.40 in chips) 
Seat 4: SVG7777 ($0.63 in chips) 
Seat 5: d-potolok ($2.21 in chips) 
Seat 6: ariana51130 ($6.31 in chips) 
hc agorist: posts small blind $0.01
msu.fedos: posts big blind $0.02
*** HOLE CARDS ***
Dealt to hc agorist [4d Ks]
SVG7777: folds 
d-potolok: folds 
ariana51130: folds 
OkadaVictor: raises $0.04 to $0.06
hc agorist: folds 
msu.fedos: folds 
Uncalled bet ($0.04) returned to OkadaVictor
OkadaVictor collected $0.05 from pot
OkadaVictor: doesn't show hand 
*** SUMMARY ***
Total pot $0.05 | Rake $0 
Seat 1: OkadaVictor (button) collected ($0.05)
Seat 2: hc agorist (small blind) folded before Flop
Seat 3: msu.fedos (big blind) folded before Flop
Seat 4: SVG7777 folded before Flop (didn't bet)
Seat 5: d-potolok folded before Flop (didn't bet)
Seat 6: ariana51130 folded before Flop (didn't bet)



PokerStars Zoom Hand #193394314021:  Hold'em No Limit ($0.01/$0.02) - 2018/11/17 1:11:17 CUST [2018/11/16 12:11:17 ET]
Table 'Halley' 6-max Seat #1 is the button
Seat 1: hc agorist ($1.89 in chips) 
Seat 2: mgrothe0815 ($2 in chips) 
Seat 3: Petrov$kij ($2.45 in chips) 
Seat 4: gnomNa5copok ($1.70 in chips) 
Seat 5: Rino2609 ($2.43 in chips) 
Seat 6: dunnir ($2.83 in chips) 
mgrothe0815: posts small blind $0.01
Petrov$kij: posts big blind $0.02
*** HOLE CARDS ***
Dealt to hc agorist [2h 8h]
gnomNa5copok: folds 
Rino2609: folds 
dunnir: folds 
hc agorist: folds 
mgrothe0815: raises $0.04 to $0.06
Petrov$kij: calls $0.04
*** FLOP *** [4c 9c 3c]
mgrothe0815: checks 
Petrov$kij: checks 
*** TURN *** [4c 9c 3c] [2s]
mgrothe0815: bets $0.06
Petrov$kij: folds 
Uncalled bet ($0.06) returned to mgrothe0815
mgrothe0815 collected $0.12 from pot
mgrothe0815: doesn't show hand 
*** SUMMARY ***
Total pot $0.12 | Rake $0 
Board [4c 9c 3c 2s]
Seat 1: hc agorist (button) folded before Flop (didn't bet)
Seat 2: mgrothe0815 (small blind) collected ($0.12)
Seat 3: Petrov$kij (big blind) folded on the Turn
Seat 4: gnomNa5copok folded before Flop (didn't bet)
Seat 5: Rino2609 folded before Flop (didn't bet)
Seat 6: dunnir folded before Flop (didn't bet)



PokerStars Zoom Hand #193394320305:  Hold'em No Limit ($0.01/$0.02) - 2018/11/17 1:11:28 CUST [2018/11/16 12:11:28 ET]
Table 'Halley' 6-max Seat #1 is the button
Seat 1: max.m.7deiL ($2.26 in chips) 
Seat 2: krosallt ($2.88 in chips) 
Seat 3: elvis_genius ($3.69 in chips) 
Seat 4: ForHistory ($2.40 in chips) 
Seat 5: 4cBLizZy ($3.47 in chips) 
Seat 6: hc agorist ($1.88 in chips) 
krosallt: posts small blind $0.01
elvis_genius: posts big blind $0.02
*** HOLE CARDS ***
Dealt to hc agorist [7h Qc]
ForHistory: folds 
4cBLizZy: folds 
hc agorist: raises $0.02 to $0.04
max.m.7deiL: folds 
krosallt: folds 
elvis_genius: calls $0.02
*** FLOP *** [6c 7c 8c]
elvis_genius: checks 
hc agorist: bets $0.03
elvis_genius: raises $0.08 to $0.11
hc agorist: calls $0.08
*** TURN *** [6c 7c 8c] [3s]
elvis_genius: bets $0.22
hc agorist: calls $0.22
*** RIVER *** [6c 7c 8c 3s] [9s]
elvis_genius: checks 
hc agorist: bets $1.51 and is all-in
elvis_genius: folds 
Uncalled bet ($1.51) returned to hc agorist
hc agorist collected $0.72 from pot
hc agorist: doesn't show hand 
*** SUMMARY ***
Total pot $0.75 | Rake $0.03 
Board [6c 7c 8c 3s 9s]
Seat 1: max.m.7deiL (button) folded before Flop (didn't bet)
Seat 2: krosallt (small blind) folded before Flop
Seat 3: elvis_genius (big blind) folded on the River
Seat 4: ForHistory folded before Flop (didn't bet)
Seat 5: 4cBLizZy folded before Flop (didn't bet)
Seat 6: hc agorist collected ($0.72)



PokerStars Zoom Hand #193394354827:  Hold'em No Limit ($0.01/$0.02) - 2018/11/17 1:12:28 CUST [2018/11/16 12:12:28 ET]
Table 'Halley' 6-max Seat #1 is the button
Seat 1: d-potolok ($2.02 in chips) 
Seat 2: ziorrr ($3.08 in chips) 
Seat 3: hc agorist ($2.23 in chips) 
Seat 4: dyak909 ($2.74 in chips) 
Seat 5: juancho0007 ($5.85 in chips) 
Seat 6: alexps922 ($2.30 in chips) 
ziorrr: posts small blind $0.01
hc agorist: posts big blind $0.02
*** HOLE CARDS ***
Dealt to hc agorist [7h Jd]
dyak909: folds 
juancho0007: folds 
alexps922: raises $0.03 to $0.05
d-potolok: folds 
ziorrr: folds 
hc agorist: folds 
Uncalled bet ($0.03) returned to alexps922
alexps922 collected $0.05 from pot
alexps922: doesn't show hand 
*** SUMMARY ***
Total pot $0.05 | Rake $0 
Seat 1: d-potolok (button) folded before Flop (didn't bet)
Seat 2: ziorrr (small blind) folded before Flop
Seat 3: hc agorist (big blind) folded before Flop
Seat 4: dyak909 folded before Flop (didn't bet)
Seat 5: juancho0007 folded before Flop (didn't bet)
Seat 6: alexps922 collected ($0.05)



PokerStars Zoom Hand #193394351974:  Hold'em No Limit ($0.01/$0.02) - 2018/11/17 1:12:23 CUST [2018/11/16 12:12:23 ET]
Table 'Halley' 6-max Seat #1 is the button
Seat 1: MuXaHuKK ($2.27 in chips) 
Seat 2: pellion ($6.18 in chips) 
Seat 3: kazyunok ($1.94 in chips) 
Seat 4: reini1100 ($1.92 in chips) 
Seat 5: hc agorist ($2.23 in chips) 
Seat 6: Gleb Budakva ($2 in chips) 
pellion: posts small blind $0.01
kazyunok: posts big blind $0.02
*** HOLE CARDS ***
Dealt to hc agorist [3c 9c]
reini1100: folds 
hc agorist: folds 
Gleb Budakva: raises $0.04 to $0.06
MuXaHuKK: folds 
pellion: folds 
kazyunok: raises $0.13 to $0.19
Gleb Budakva: calls $0.13
*** FLOP *** [9s 7s Ts]
kazyunok: bets $0.18
Gleb Budakva: raises $1.63 to $1.81 and is all-in
kazyunok: folds 
Uncalled bet ($1.63) returned to Gleb Budakva
Gleb Budakva collected $0.72 from pot
Gleb Budakva: doesn't show hand 
*** SUMMARY ***
Total pot $0.75 | Rake $0.03 
Board [9s 7s Ts]
Seat 1: MuXaHuKK (button) folded before Flop (didn't bet)
Seat 2: pellion (small blind) folded before Flop
Seat 3: kazyunok (big blind) folded on the Flop
Seat 4: reini1100 folded before Flop (didn't bet)
Seat 5: hc agorist folded before Flop (didn't bet)
Seat 6: Gleb Budakva collected ($0.72)



PokerStars Zoom Hand #193394361185:  Hold'em No Limit ($0.01/$0.02) - 2018/11/17 1:12:39 CUST [2018/11/16 12:12:39 ET]
Table 'Halley' 6-max Seat #1 is the button
Seat 1: hc agorist ($2.21 in chips) 
Seat 2: zcrtdbx ($3.72 in chips) 
Seat 3: pkeJdlpHf56 ($1.89 in chips) 
Seat 4: carloscrum ($1.85 in chips) 
Seat 5: RA1010 ($2.19 in chips) 
Seat 6: LdnOnDTrack ($2.75 in chips) 
zcrtdbx: posts small blind $0.01
pkeJdlpHf56: posts big blind $0.02
*** HOLE CARDS ***
Dealt to hc agorist [Qs 7s]
carloscrum: folds 
RA1010: folds 
LdnOnDTrack: raises $0.03 to $0.05
hc agorist: raises $0.11 to $0.16
zcrtdbx: folds 
pkeJdlpHf56: folds 
LdnOnDTrack: folds 
Uncalled bet ($0.11) returned to hc agorist
hc agorist collected $0.13 from pot
hc agorist: doesn't show hand 
*** SUMMARY ***
Total pot $0.13 | Rake $0 
Seat 1: hc agorist (button) collected ($0.13)
Seat 2: zcrtdbx (small blind) folded before Flop
Seat 3: pkeJdlpHf56 (big blind) folded before Flop
Seat 4: carloscrum folded before Flop (didn't bet)
Seat 5: RA1010 folded before Flop (didn't bet)
Seat 6: LdnOnDTrack folded before Flop



PokerStars Zoom Hand #193394377028:  Hold'em No Limit ($0.01/$0.02) - 2018/11/17 1:13:06 CUST [2018/11/16 12:13:06 ET]
Table 'Halley' 6-max Seat #1 is the button
Seat 1: zequi1998 ($2.93 in chips) 
Seat 2: hc agorist ($2.29 in chips) 
Seat 3: mi$tralx ($2 in chips) 
Seat 4: Nimblyigo ($3.37 in chips) 
Seat 5: deltanueve ($2.05 in chips) 
Seat 6: batke1984 ($0.52 in chips) 
hc agorist: posts small blind $0.01
mi$tralx: posts big blind $0.02
*** HOLE CARDS ***
Dealt to hc agorist [Jh Kh]
Nimblyigo: folds 
deltanueve: folds 
batke1984: folds 
zequi1998: folds 
hc agorist: raises $0.04 to $0.06
mi$tralx: folds 
Uncalled bet ($0.04) returned to hc agorist
hc agorist collected $0.04 from pot
hc agorist: doesn't show hand 
*** SUMMARY ***
Total pot $0.04 | Rake $0 
Seat 1: zequi1998 (button) folded before Flop (didn't bet)
Seat 2: hc agorist (small blind) collected ($0.04)
Seat 3: mi$tralx (big blind) folded before Flop
Seat 4: Nimblyigo folded before Flop (didn't bet)
Seat 5: deltanueve folded before Flop (didn't bet)
Seat 6: batke1984 folded before Flop (didn't bet)



PokerStars Zoom Hand #193394386194:  Hold'em No Limit ($0.01/$0.02) - 2018/11/17 1:13:22 CUST [2018/11/16 12:13:22 ET]
Table 'Halley' 6-max Seat #1 is the button
Seat 1: Urban_Slug ($2 in chips) 
Seat 2: d1amondhaze ($3.80 in chips) 
Seat 3: appleeric201 ($1 in chips) 
Seat 4: hc agorist ($2.31 in chips) 
Seat 5: Bodri88 ($7.70 in chips) 
Seat 6: Eveyor ($2.18 in chips) 
d1amondhaze: posts small blind $0.01
appleeric201: posts big blind $0.02
*** HOLE CARDS ***
Dealt to hc agorist [Ac 7d]
hc agorist: folds 
Bodri88: raises $0.04 to $0.06
Eveyor: folds 
Urban_Slug: raises $0.12 to $0.18
d1amondhaze: folds 
appleeric201: folds 
Bodri88: calls $0.12
*** FLOP *** [Qd 4h Qs]
Bodri88: checks 
Urban_Slug: bets $0.13
Bodri88: calls $0.13
*** TURN *** [Qd 4h Qs] [Js]
Bodri88: checks 
Urban_Slug: checks 
*** RIVER *** [Qd 4h Qs Js] [5s]
Bodri88: checks 
Urban_Slug: bets $0.33
Bodri88: folds 
Uncalled bet ($0.33) returned to Urban_Slug
Urban_Slug collected $0.63 from pot
Urban_Slug: doesn't show hand 
*** SUMMARY ***
Total pot $0.65 | Rake $0.02 
Board [Qd 4h Qs Js 5s]
Seat 1: Urban_Slug (button) collected ($0.63)
Seat 2: d1amondhaze (small blind) folded before Flop
Seat 3: appleeric201 (big blind) folded before Flop
Seat 4: hc agorist folded before Flop (didn't bet)
Seat 5: Bodri88 folded on the River
Seat 6: Eveyor folded before Flop (didn't bet)



PokerStars Zoom Hand #193394389113:  Hold'em No Limit ($0.01/$0.02) - 2018/11/17 1:13:27 CUST [2018/11/16 12:13:27 ET]
Table 'Halley' 6-max Seat #1 is the button
Seat 1: DespoSep ($9.21 in chips) 
Seat 2: MrWhite670 ($1.82 in chips) 
Seat 3: PBG123 ($4.82 in chips) 
Seat 4: vlend ($2.26 in chips) 
Seat 5: zcrtdbx ($3.65 in chips) 
Seat 6: hc agorist ($2.31 in chips) 
MrWhite670: posts small blind $0.01
PBG123: posts big blind $0.02
*** HOLE CARDS ***
Dealt to hc agorist [Qc Th]
vlend has timed out
vlend: folds 
zcrtdbx: folds 
hc agorist: raises $0.04 to $0.06
DespoSep: folds 
MrWhite670: folds 
PBG123: folds 
Uncalled bet ($0.04) returned to hc agorist
hc agorist collected $0.05 from pot
hc agorist: doesn't show hand 
*** SUMMARY ***
Total pot $0.05 | Rake $0 
Seat 1: DespoSep (button) folded before Flop (didn't bet)
Seat 2: MrWhite670 (small blind) folded before Flop
Seat 3: PBG123 (big blind) folded before Flop
Seat 4: vlend folded before Flop (didn't bet)
Seat 5: zcrtdbx folded before Flop (didn't bet)
Seat 6: hc agorist collected ($0.05)



PokerStars Zoom Hand #193394409905:  Hold'em No Limit ($0.01/$0.02) - 2018/11/17 1:14:03 CUST [2018/11/16 12:14:03 ET]
Table 'Halley' 6-max Seat #1 is the button
Seat 1: Wild Sttar ($2.10 in chips) 
Seat 2: pkeJdlpHf56 ($1.97 in chips) 
Seat 3: hc agorist ($2.34 in chips) 
Seat 4: devilz1978 ($1.22 in chips) 
Seat 5: SPACECASH 9 ($1.97 in chips) 
Seat 6: MiVidaLoca33 ($2.09 in chips) 
pkeJdlpHf56: posts small blind $0.01
hc agorist: posts big blind $0.02
*** HOLE CARDS ***
Dealt to hc agorist [5c 9c]
devilz1978: folds 
SPACECASH 9: folds 
MiVidaLoca33: raises $0.03 to $0.05
Wild Sttar: folds 
pkeJdlpHf56: folds 
hc agorist: calls $0.03
*** FLOP *** [3s Td Jc]
hc agorist: checks 
MiVidaLoca33: bets $0.05
hc agorist: folds 
Uncalled bet ($0.05) returned to MiVidaLoca33
MiVidaLoca33 collected $0.11 from pot
MiVidaLoca33: doesn't show hand 
*** SUMMARY ***
Total pot $0.11 | Rake $0 
Board [3s Td Jc]
Seat 1: Wild Sttar (button) folded before Flop (didn't bet)
Seat 2: pkeJdlpHf56 (small blind) folded before Flop
Seat 3: hc agorist (big blind) folded on the Flop
Seat 4: devilz1978 folded before Flop (didn't bet)
Seat 5: SPACECASH 9 folded before Flop (didn't bet)
Seat 6: MiVidaLoca33 collected ($0.11)



PokerStars Zoom Hand #193394422634:  Hold'em No Limit ($0.01/$0.02) - 2018/11/17 1:14:25 CUST [2018/11/16 12:14:25 ET]
Table 'Halley' 6-max Seat #1 is the button
Seat 1: hc agorist ($2.29 in chips) 
Seat 2: DotaRipper ($1.51 in chips) 
Seat 3: WiNNeRdn ($2.20 in chips) 
Seat 4: gary01407 ($0.97 in chips) 
Seat 5: SersemTT ($5.59 in chips) 
Seat 6: Nick555111 ($1.29 in chips) 
DotaRipper: posts small blind $0.01
WiNNeRdn: posts big blind $0.02
*** HOLE CARDS ***
Dealt to hc agorist [Td Qh]
gary01407: folds 
SersemTT: folds 
Nick555111: folds 
hc agorist: raises $0.04 to $0.06
DotaRipper: folds 
WiNNeRdn: folds 
Uncalled bet ($0.04) returned to hc agorist
hc agorist collected $0.05 from pot
hc agorist: doesn't show hand 
*** SUMMARY ***
Total pot $0.05 | Rake $0 
Seat 1: hc agorist (button) collected ($0.05)
Seat 2: DotaRipper (small blind) folded before Flop
Seat 3: WiNNeRdn (big blind) folded before Flop
Seat 4: gary01407 folded before Flop (didn't bet)
Seat 5: SersemTT folded before Flop (didn't bet)
Seat 6: Nick555111 folded before Flop (didn't bet)



PokerStars Zoom Hand #193394427950:  Hold'em No Limit ($0.01/$0.02) - 2018/11/17 1:14:34 CUST [2018/11/16 12:14:34 ET]
Table 'Halley' 6-max Seat #1 is the button
Seat 1: shogi17 ($5.51 in chips) 
Seat 2: briefmaso ($2.56 in chips) 
Seat 3: nullnullnull ($1.95 in chips) 
Seat 4: hc agorist ($2.32 in chips) 
Seat 5: ZKM10 ($1.39 in chips) 
Seat 6: Lazeras97 ($1.71 in chips) 
briefmaso: posts small blind $0.01
nullnullnull: posts big blind $0.02
*** HOLE CARDS ***
Dealt to hc agorist [5s 3d]
hc agorist: folds 
ZKM10: folds 
Lazeras97 has timed out
Lazeras97: folds 
shogi17: folds 
briefmaso: folds 
Uncalled bet ($0.01) returned to nullnullnull
nullnullnull collected $0.02 from pot
nullnullnull: doesn't show hand 
*** SUMMARY ***
Total pot $0.02 | Rake $0 
Seat 1: shogi17 (button) folded before Flop (didn't bet)
Seat 2: briefmaso (small blind) folded before Flop
Seat 3: nullnullnull (big blind) collected ($0.02)
Seat 4: hc agorist folded before Flop (didn't bet)
Seat 5: ZKM10 folded before Flop (didn't bet)
Seat 6: Lazeras97 folded before Flop (didn't bet)



PokerStars Zoom Hand #193394436706:  Hold'em No Limit ($0.01/$0.02) - 2018/11/17 1:14:49 CUST [2018/11/16 12:14:49 ET]
Table 'Halley' 6-max Seat #1 is the button
Seat 1: aleksvp ($3.50 in chips) 
Seat 2: MPATHEO ($4.10 in chips) 
Seat 3: I Shaadzz I ($2.23 in chips) 
Seat 4: Lifecards7 ($2.12 in chips) 
Seat 5: hc agorist ($2.31 in chips) 
Seat 6: Simkooo ($2.41 in chips) 
MPATHEO: posts small blind $0.01
I Shaadzz I: posts big blind $0.02
*** HOLE CARDS ***
Dealt to hc agorist [7s 6d]
Lifecards7: folds 
hc agorist: folds 
Simkooo: folds 
aleksvp: folds 
MPATHEO: raises $0.03 to $0.05
I Shaadzz I: folds 
Uncalled bet ($0.03) returned to MPATHEO
MPATHEO collected $0.04 from pot
MPATHEO: doesn't show hand 
*** SUMMARY ***
Total pot $0.04 | Rake $0 
Seat 1: aleksvp (button) folded before Flop (didn't bet)
Seat 2: MPATHEO (small blind) collected ($0.04)
Seat 3: I Shaadzz I (big blind) folded before Flop
Seat 4: Lifecards7 folded before Flop (didn't bet)
Seat 5: hc agorist folded before Flop (didn't bet)
Seat 6: Simkooo folded before Flop (didn't bet)



PokerStars Zoom Hand #193394433764:  Hold'em No Limit ($0.01/$0.02) - 2018/11/17 1:14:44 CUST [2018/11/16 12:14:44 ET]
Table 'Halley' 6-max Seat #1 is the button
Seat 1: REIDMYCARDS ($2.72 in chips) 
Seat 2: Wild Sttar ($5.86 in chips) 
Seat 3: ASplayer9119 ($2.54 in chips) 
Seat 4: hc agorist ($2.31 in chips) 
Seat 5: VreditelL ($2 in chips) 
Seat 6: LunatikoSj ($2.28 in chips) 
Wild Sttar: posts small blind $0.01
ASplayer9119: posts big blind $0.02
*** HOLE CARDS ***
Dealt to hc agorist [5c Js]
hc agorist: folds 
VreditelL: folds 
LunatikoSj: folds 
REIDMYCARDS: folds 
Wild Sttar: raises $0.04 to $0.06
ASplayer9119: raises $0.12 to $0.18
Wild Sttar: folds 
Uncalled bet ($0.12) returned to ASplayer9119
ASplayer9119 collected $0.12 from pot
ASplayer9119: doesn't show hand 
*** SUMMARY ***
Total pot $0.12 | Rake $0 
Seat 1: REIDMYCARDS (button) folded before Flop (didn't bet)
Seat 2: Wild Sttar (small blind) folded before Flop
Seat 3: ASplayer9119 (big blind) collected ($0.12)
Seat 4: hc agorist folded before Flop (didn't bet)
Seat 5: VreditelL folded before Flop (didn't bet)
Seat 6: LunatikoSj folded before Flop (didn't bet)



PokerStars Zoom Hand #193394430870:  Hold'em No Limit ($0.01/$0.02) - 2018/11/17 1:14:39 CUST [2018/11/16 12:14:39 ET]
Table 'Halley' 6-max Seat #1 is the button
Seat 1: d4nya7 ($0.94 in chips) 
Seat 2: hc agorist ($2.32 in chips) 
Seat 3: t$unami cr ($1.64 in chips) 
Seat 4: Mokkelo ($2 in chips) 
Seat 5: SanDmitri4 ($2.20 in chips) 
Seat 6: miro180 ($1.51 in chips) 
hc agorist: posts small blind $0.01
t$unami cr: posts big blind $0.02
*** HOLE CARDS ***
Dealt to hc agorist [5h Kd]
Mokkelo: folds 
SanDmitri4: folds 
miro180: calls $0.02
d4nya7: calls $0.02
hc agorist: folds 
t$unami cr: checks 
*** FLOP *** [9c 2s Ac]
t$unami cr: checks 
miro180: bets $0.04
d4nya7: calls $0.04
t$unami cr: folds 
*** TURN *** [9c 2s Ac] [8c]
miro180: bets $0.02
d4nya7: raises $0.04 to $0.06
miro180: calls $0.04
*** RIVER *** [9c 2s Ac 8c] [Qc]
miro180: checks 
d4nya7: bets $0.16
miro180: folds 
Uncalled bet ($0.16) returned to d4nya7
d4nya7 collected $0.26 from pot
d4nya7: doesn't show hand 
*** SUMMARY ***
Total pot $0.27 | Rake $0.01 
Board [9c 2s Ac 8c Qc]
Seat 1: d4nya7 (button) collected ($0.26)
Seat 2: hc agorist (small blind) folded before Flop
Seat 3: t$unami cr (big blind) folded on the Flop
Seat 4: Mokkelo folded before Flop (didn't bet)
Seat 5: SanDmitri4 folded before Flop (didn't bet)
Seat 6: miro180 folded on the River



PokerStars Zoom Hand #193394440677:  Hold'em No Limit ($0.01/$0.02) - 2018/11/17 1:14:56 CUST [2018/11/16 12:14:56 ET]
Table 'Halley' 6-max Seat #1 is the button
Seat 1: 3omigo ($2 in chips) 
Seat 2: kampfrobby ($4.04 in chips) 
Seat 3: hc agorist ($2.31 in chips) 
Seat 4: Bence Fekete ($8.99 in chips) 
Seat 5: actionMoon ($2 in chips) 
Seat 6: Alter7777 ($2.15 in chips) 
kampfrobby: posts small blind $0.01
hc agorist: posts big blind $0.02
*** HOLE CARDS ***
Dealt to hc agorist [5d 5s]
Bence Fekete: folds 
actionMoon: folds 
Alter7777: folds 
3omigo: raises $0.02 to $0.04
kampfrobby: raises $0.08 to $0.12
hc agorist: raises $0.10 to $0.22
3omigo: raises $1.78 to $2 and is all-in
kampfrobby: folds 
hc agorist: folds 
Uncalled bet ($1.78) returned to 3omigo
3omigo collected $0.56 from pot
3omigo: doesn't show hand 
*** SUMMARY ***
Total pot $0.56 | Rake $0 
Seat 1: 3omigo (button) collected ($0.56)
Seat 2: kampfrobby (small blind) folded before Flop
Seat 3: hc agorist (big blind) folded before Flop
Seat 4: Bence Fekete folded before Flop (didn't bet)
Seat 5: actionMoon folded before Flop (didn't bet)
Seat 6: Alter7777 folded before Flop (didn't bet)



PokerStars Zoom Hand #193394467019:  Hold'em No Limit ($0.01/$0.02) - 2018/11/17 1:15:41 CUST [2018/11/16 12:15:41 ET]
Table 'Halley' 6-max Seat #1 is the button
Seat 1: batke1984 ($0.55 in chips) 
Seat 2: Korsett84 ($2 in chips) 
Seat 3: Wild Sttar ($5.80 in chips) 
Seat 4: kugelmeer ($2.06 in chips) 
Seat 5: Setokhaiba ($2 in chips) 
Seat 6: hc agorist ($2.09 in chips) 
Korsett84: posts small blind $0.01
Wild Sttar: posts big blind $0.02
*** HOLE CARDS ***
Dealt to hc agorist [Jc Ac]
kugelmeer: folds 
Setokhaiba: folds 
hc agorist: raises $0.04 to $0.06
batke1984: folds 
Korsett84: calls $0.05
Wild Sttar: calls $0.04
*** FLOP *** [4c 6d 6h]
Korsett84: checks 
Wild Sttar: checks 
hc agorist: bets $0.06
Korsett84: calls $0.06
Wild Sttar: folds 
*** TURN *** [4c 6d 6h] [7d]
Korsett84: bets $0.15
hc agorist: folds 
Uncalled bet ($0.15) returned to Korsett84
Korsett84 collected $0.29 from pot
Korsett84: doesn't show hand 
*** SUMMARY ***
Total pot $0.30 | Rake $0.01 
Board [4c 6d 6h 7d]
Seat 1: batke1984 (button) folded before Flop (didn't bet)
Seat 2: Korsett84 (small blind) collected ($0.29)
Seat 3: Wild Sttar (big blind) folded on the Flop
Seat 4: kugelmeer folded before Flop (didn't bet)
Seat 5: Setokhaiba folded before Flop (didn't bet)
Seat 6: hc agorist folded on the Turn



PokerStars Zoom Hand #193394493502:  Hold'em No Limit ($0.01/$0.02) - 2018/11/17 1:16:26 CUST [2018/11/16 12:16:26 ET]
Table 'Halley' 6-max Seat #1 is the button
Seat 1: hc agorist ($1.97 in chips) 
Seat 2: pandurka ($1.07 in chips) 
Seat 3: pianobeast ($2.69 in chips) 
Seat 4: slowplaymax ($3.81 in chips) 
Seat 5: ASplayer9119 ($2.65 in chips) 
Seat 6: artpoker77 ($1.05 in chips) 
pandurka: posts small blind $0.01
pianobeast: posts big blind $0.02
*** HOLE CARDS ***
Dealt to hc agorist [Jc 3h]
slowplaymax: folds 
ASplayer9119: folds 
artpoker77: folds 
hc agorist: folds 
pandurka: folds 
Uncalled bet ($0.01) returned to pianobeast
pianobeast collected $0.02 from pot
pianobeast: doesn't show hand 
*** SUMMARY ***
Total pot $0.02 | Rake $0 
Seat 1: hc agorist (button) folded before Flop (didn't bet)
Seat 2: pandurka (small blind) folded before Flop
Seat 3: pianobeast (big blind) collected ($0.02)
Seat 4: slowplaymax folded before Flop (didn't bet)
Seat 5: ASplayer9119 folded before Flop (didn't bet)
Seat 6: artpoker77 folded before Flop (didn't bet)



PokerStars Zoom Hand #193394499336:  Hold'em No Limit ($0.01/$0.02) - 2018/11/17 1:16:36 CUST [2018/11/16 12:16:36 ET]
Table 'Halley' 6-max Seat #1 is the button
Seat 1: Jeannette111 ($1.75 in chips) 
Seat 2: alextinct865 ($2.54 in chips) 
Seat 3: SpawnNVV ($3.25 in chips) 
Seat 4: profi444 ($3.22 in chips) 
Seat 5: hoyosuk513 ($2.40 in chips) 
Seat 6: hc agorist ($1.96 in chips) 
alextinct865: posts small blind $0.01
SpawnNVV: posts big blind $0.02
*** HOLE CARDS ***
Dealt to hc agorist [2h 4c]
profi444: folds 
hoyosuk513: folds 
hc agorist: folds 
Jeannette111: folds 
alextinct865: folds 
Uncalled bet ($0.01) returned to SpawnNVV
SpawnNVV collected $0.02 from pot
SpawnNVV: doesn't show hand 
*** SUMMARY ***
Total pot $0.02 | Rake $0 
Seat 1: Jeannette111 (button) folded before Flop (didn't bet)
Seat 2: alextinct865 (small blind) folded before Flop
Seat 3: SpawnNVV (big blind) collected ($0.02)
Seat 4: profi444 folded before Flop (didn't bet)
Seat 5: hoyosuk513 folded before Flop (didn't bet)
Seat 6: hc agorist folded before Flop (didn't bet)



PokerStars Zoom Hand #193394496382:  Hold'em No Limit ($0.01/$0.02) - 2018/11/17 1:16:31 CUST [2018/11/16 12:16:31 ET]
Table 'Halley' 6-max Seat #1 is the button
Seat 1: Laian A. Sior ($0.83 in chips) 
Seat 2: hc agorist ($1.97 in chips) 
Seat 3: SersemTT ($5.84 in chips) 
Seat 4: juancho0007 ($3.24 in chips) 
Seat 5: 69Nails ($4.01 in chips) 
Seat 6: I Shaadzz I ($2.30 in chips) 
hc agorist: posts small blind $0.01
SersemTT: posts big blind $0.02
*** HOLE CARDS ***
Dealt to hc agorist [As 2d]
juancho0007: folds 
69Nails: folds 
I Shaadzz I: folds 
Laian A. Sior: raises $0.02 to $0.04
hc agorist: folds 
SersemTT: calls $0.02
*** FLOP *** [Js Kd 7d]
SersemTT: checks 
Laian A. Sior: checks 
*** TURN *** [Js Kd 7d] [Ts]
SersemTT: checks 
Laian A. Sior: checks 
*** RIVER *** [Js Kd 7d Ts] [3h]
SersemTT: bets $0.10
Laian A. Sior: folds 
Uncalled bet ($0.10) returned to SersemTT
SersemTT collected $0.09 from pot
SersemTT: doesn't show hand 
*** SUMMARY ***
Total pot $0.09 | Rake $0 
Board [Js Kd 7d Ts 3h]
Seat 1: Laian A. Sior (button) folded on the River
Seat 2: hc agorist (small blind) folded before Flop
Seat 3: SersemTT (big blind) collected ($0.09)
Seat 4: juancho0007 folded before Flop (didn't bet)
Seat 5: 69Nails folded before Flop (didn't bet)
Seat 6: I Shaadzz I folded before Flop (didn't bet)



PokerStars Zoom Hand #193394503970:  Hold'em No Limit ($0.01/$0.02) - 2018/11/17 1:16:44 CUST [2018/11/16 12:16:44 ET]
Table 'Halley' 6-max Seat #1 is the button
Seat 1: mgrothe0815 ($2.17 in chips) 
Seat 2: take710 ($1.98 in chips) 
Seat 3: th_Zipf3L ($2.02 in chips) 
Seat 4: profi444 ($1.75 in chips) 
Seat 5: hc agorist ($1.96 in chips) 
Seat 6: Moqy ($2 in chips) 
take710: posts small blind $0.01
th_Zipf3L: posts big blind $0.02
*** HOLE CARDS ***
Dealt to hc agorist [2d 8h]
profi444: folds 
hc agorist: folds 
Moqy: raises $0.04 to $0.06
mgrothe0815: folds 
take710: raises $0.08 to $0.14
th_Zipf3L: folds 
Moqy: calls $0.08
*** FLOP *** [As 4s 5s]
take710: bets $0.16
Moqy: calls $0.16
*** TURN *** [As 4s 5s] [Kc]
take710: checks 
Moqy: bets $0.30
take710: calls $0.30
*** RIVER *** [As 4s 5s Kc] [2h]
take710: checks 
Moqy: checks 
*** SHOW DOWN ***
take710: shows [Kh Qc] (a pair of Kings)
Moqy: shows [Ad Jc] (a pair of Aces)
Moqy collected $1.18 from pot
*** SUMMARY ***
Total pot $1.22 | Rake $0.04 
Board [As 4s 5s Kc 2h]
Seat 1: mgrothe0815 (button) folded before Flop (didn't bet)
Seat 2: take710 (small blind) showed [Kh Qc] and lost with a pair of Kings
Seat 3: th_Zipf3L (big blind) folded before Flop
Seat 4: profi444 folded before Flop (didn't bet)
Seat 5: hc agorist folded before Flop (didn't bet)
Seat 6: Moqy showed [Ad Jc] and won ($1.18) with a pair of Aces



PokerStars Zoom Hand #193394508099:  Hold'em No Limit ($0.01/$0.02) - 2018/11/17 1:16:51 CUST [2018/11/16 12:16:51 ET]
Table 'Halley' 6-max Seat #1 is the button
Seat 1: VladKot ($2.01 in chips) 
Seat 2: So_funny700 ($2.22 in chips) 
Seat 3: ASplayer9119 ($2.02 in chips) 
Seat 4: hc agorist ($1.96 in chips) 
Seat 5: vladkhomenko ($3.16 in chips) 
Seat 6: artri3 ($2.05 in chips) 
So_funny700: posts small blind $0.01
ASplayer9119: posts big blind $0.02
*** HOLE CARDS ***
Dealt to hc agorist [Qd 5c]
hc agorist: folds 
vladkhomenko: raises $0.04 to $0.06
artri3: calls $0.06
VladKot: folds 
So_funny700: folds 
ASplayer9119: folds 
*** FLOP *** [4c 3d 6c]
vladkhomenko: bets $0.07
artri3: calls $0.07
*** TURN *** [4c 3d 6c] [Kc]
vladkhomenko: checks 
artri3: bets $0.14
vladkhomenko: folds 
Uncalled bet ($0.14) returned to artri3
artri3 collected $0.28 from pot
artri3: doesn't show hand 
*** SUMMARY ***
Total pot $0.29 | Rake $0.01 
Board [4c 3d 6c Kc]
Seat 1: VladKot (button) folded before Flop (didn't bet)
Seat 2: So_funny700 (small blind) folded before Flop
Seat 3: ASplayer9119 (big blind) folded before Flop
Seat 4: hc agorist folded before Flop (didn't bet)
Seat 5: vladkhomenko folded on the Turn
Seat 6: artri3 collected ($0.28)



PokerStars Zoom Hand #193394511683:  Hold'em No Limit ($0.01/$0.02) - 2018/11/17 1:16:57 CUST [2018/11/16 12:16:57 ET]
Table 'Halley' 6-max Seat #1 is the button
Seat 1: feels2goood ($4.18 in chips) 
Seat 2: Glivera77 ($2 in chips) 
Seat 3: hc agorist ($1.96 in chips) 
Seat 4: DANILZOL ($0.47 in chips) 
Seat 5: Flleys ($4.22 in chips) 
Seat 6: apolorab ($2.14 in chips) 
Glivera77: posts small blind $0.01
hc agorist: posts big blind $0.02
*** HOLE CARDS ***
Dealt to hc agorist [Ac Ad]
DANILZOL: raises $0.04 to $0.06
Flleys: folds 
apolorab: folds 
feels2goood: folds 
Glivera77: calls $0.05
hc agorist: calls $0.04
*** FLOP *** [Tc 5d 7d]
Glivera77: bets $0.10
hc agorist: calls $0.10
DANILZOL: raises $0.31 to $0.41 and is all-in
Glivera77: calls $0.31
hc agorist: raises $1.49 to $1.90 and is all-in
Glivera77: folds 
Uncalled bet ($1.49) returned to hc agorist
*** TURN *** [Tc 5d 7d] [Qc]
*** RIVER *** [Tc 5d 7d Qc] [3s]
*** SHOW DOWN ***
hc agorist: shows [Ac Ad] (a pair of Aces)
DANILZOL: shows [Ah Kd] (high card Ace)
hc agorist collected $1.36 from pot
*** SUMMARY ***
Total pot $1.41 | Rake $0.05 
Board [Tc 5d 7d Qc 3s]
Seat 1: feels2goood (button) folded before Flop (didn't bet)
Seat 2: Glivera77 (small blind) folded on the Flop
Seat 3: hc agorist (big blind) showed [Ac Ad] and won ($1.36) with a pair of Aces
Seat 4: DANILZOL showed [Ah Kd] and lost with high card Ace
Seat 5: Flleys folded before Flop (didn't bet)
Seat 6: apolorab folded before Flop (didn't bet)



PokerStars Zoom Hand #193394540399:  Hold'em No Limit ($0.01/$0.02) - 2018/11/17 1:17:46 CUST [2018/11/16 12:17:46 ET]
Table 'Halley' 6-max Seat #1 is the button
Seat 1: hc agorist ($2.85 in chips) 
Seat 2: Dimov ($5.27 in chips) 
Seat 3: serde4nik ($2 in chips) 
Seat 4: Marco0o12 ($2.05 in chips) 
Seat 5: argoha2010 ($2.16 in chips) 
Seat 6: Pysgodyn ($2 in chips) 
Dimov: posts small blind $0.01
serde4nik: posts big blind $0.02
*** HOLE CARDS ***
Dealt to hc agorist [6d Qs]
Marco0o12: folds 
argoha2010: folds 
Pysgodyn: folds 
hc agorist: raises $0.02 to $0.04
Dimov: folds 
serde4nik: folds 
Uncalled bet ($0.02) returned to hc agorist
hc agorist collected $0.05 from pot
hc agorist: doesn't show hand 
*** SUMMARY ***
Total pot $0.05 | Rake $0 
Seat 1: hc agorist (button) collected ($0.05)
Seat 2: Dimov (small blind) folded before Flop
Seat 3: serde4nik (big blind) folded before Flop
Seat 4: Marco0o12 folded before Flop (didn't bet)
Seat 5: argoha2010 folded before Flop (didn't bet)
Seat 6: Pysgodyn folded before Flop (didn't bet)



PokerStars Zoom Hand #193394548114:  Hold'em No Limit ($0.01/$0.02) - 2018/11/17 1:17:59 CUST [2018/11/16 12:17:59 ET]
Table 'Halley' 6-max Seat #1 is the button
Seat 1: SKFin ($1.77 in chips) 
Seat 2: hc agorist ($2.88 in chips) 
Seat 3: pkeJdlpHf56 ($1.84 in chips) 
Seat 4: Rybka4.1 ($2.06 in chips) 
Seat 5: darkoldmaker ($2.15 in chips) 
Seat 6: TIKS17 ($2.37 in chips) 
hc agorist: posts small blind $0.01
pkeJdlpHf56: posts big blind $0.02
*** HOLE CARDS ***
Dealt to hc agorist [3c 4c]
Rybka4.1: folds 
darkoldmaker: folds 
TIKS17: folds 
SKFin: raises $0.02 to $0.04
hc agorist: raises $0.12 to $0.16
pkeJdlpHf56: folds 
SKFin: raises $0.18 to $0.34
hc agorist: calls $0.18
*** FLOP *** [Jc Ks 2s]
hc agorist: checks 
SKFin: bets $0.22
hc agorist: folds 
Uncalled bet ($0.22) returned to SKFin
SKFin collected $0.68 from pot
SKFin: doesn't show hand 
*** SUMMARY ***
Total pot $0.70 | Rake $0.02 
Board [Jc Ks 2s]
Seat 1: SKFin (button) collected ($0.68)
Seat 2: hc agorist (small blind) folded on the Flop
Seat 3: pkeJdlpHf56 (big blind) folded before Flop
Seat 4: Rybka4.1 folded before Flop (didn't bet)
Seat 5: darkoldmaker folded before Flop (didn't bet)
Seat 6: TIKS17 folded before Flop (didn't bet)



PokerStars Zoom Hand #193394572330:  Hold'em No Limit ($0.01/$0.02) - 2018/11/17 1:18:40 CUST [2018/11/16 12:18:40 ET]
Table 'Halley' 6-max Seat #1 is the button
Seat 1: S. Biemans ($2.23 in chips) 
Seat 2: vitor.mt ($1.91 in chips) 
Seat 3: freexAAA ($1.43 in chips) 
Seat 4: dunnir ($2.38 in chips) 
Seat 5: hc agorist ($2.54 in chips) 
Seat 6: Sissifuz ($1.97 in chips) 
vitor.mt: posts small blind $0.01
freexAAA: posts big blind $0.02
*** HOLE CARDS ***
Dealt to hc agorist [Ah Ks]
dunnir: raises $0.04 to $0.06
hc agorist: raises $0.12 to $0.18
Sissifuz: folds 
S. Biemans: folds 
vitor.mt: folds 
freexAAA: folds 
dunnir: folds 
Uncalled bet ($0.12) returned to hc agorist
hc agorist collected $0.15 from pot
hc agorist: doesn't show hand 
*** SUMMARY ***
Total pot $0.15 | Rake $0 
Seat 1: S. Biemans (button) folded before Flop (didn't bet)
Seat 2: vitor.mt (small blind) folded before Flop
Seat 3: freexAAA (big blind) folded before Flop
Seat 4: dunnir folded before Flop
Seat 5: hc agorist collected ($0.15)
Seat 6: Sissifuz folded before Flop (didn't bet)



PokerStars Zoom Hand #193394583557:  Hold'em No Limit ($0.01/$0.02) - 2018/11/17 1:18:59 CUST [2018/11/16 12:18:59 ET]
Table 'Halley' 6-max Seat #1 is the button
Seat 1: S7CRENYZ ($3.08 in chips) 
Seat 2: mi$tralx ($2 in chips) 
Seat 3: hc agorist ($2.63 in chips) 
Seat 4: helicocat ($2.05 in chips) 
Seat 5: HyrymaN ($2.67 in chips) 
Seat 6: Aventad0r88 ($1.91 in chips) 
mi$tralx: posts small blind $0.01
hc agorist: posts big blind $0.02
*** HOLE CARDS ***
Dealt to hc agorist [7h Ah]
helicocat: raises $0.04 to $0.06
HyrymaN: folds 
Aventad0r88: folds 
S7CRENYZ: folds 
mi$tralx: folds 
hc agorist: folds 
Uncalled bet ($0.04) returned to helicocat
helicocat collected $0.05 from pot
helicocat: doesn't show hand 
*** SUMMARY ***
Total pot $0.05 | Rake $0 
Seat 1: S7CRENYZ (button) folded before Flop (didn't bet)
Seat 2: mi$tralx (small blind) folded before Flop
Seat 3: hc agorist (big blind) folded before Flop
Seat 4: helicocat collected ($0.05)
Seat 5: HyrymaN folded before Flop (didn't bet)
Seat 6: Aventad0r88 folded before Flop (didn't bet)



PokerStars Zoom Hand #193394590470:  Hold'em No Limit ($0.01/$0.02) - 2018/11/17 1:19:11 CUST [2018/11/16 12:19:11 ET]
Table 'Halley' 6-max Seat #1 is the button
Seat 1: ariana51130 ($7.09 in chips) 
Seat 2: Achen1027 ($3.23 in chips) 
Seat 3: straiki ($1 in chips) 
Seat 4: PrStalker ($2.13 in chips) 
Seat 5: aleksvp ($2.03 in chips) 
Seat 6: hc agorist ($2.61 in chips) 
Achen1027: posts small blind $0.01
straiki: posts big blind $0.02
*** HOLE CARDS ***
Dealt to hc agorist [6s Ac]
PrStalker: folds 
aleksvp: folds 
hc agorist: folds 
ariana51130: folds 
Achen1027: raises $0.04 to $0.06
straiki: folds 
Uncalled bet ($0.04) returned to Achen1027
Achen1027 collected $0.04 from pot
Achen1027: doesn't show hand 
*** SUMMARY ***
Total pot $0.04 | Rake $0 
Seat 1: ariana51130 (button) folded before Flop (didn't bet)
Seat 2: Achen1027 (small blind) collected ($0.04)
Seat 3: straiki (big blind) folded before Flop
Seat 4: PrStalker folded before Flop (didn't bet)
Seat 5: aleksvp folded before Flop (didn't bet)
Seat 6: hc agorist folded before Flop (didn't bet)



PokerStars Zoom Hand #193394593448:  Hold'em No Limit ($0.01/$0.02) - 2018/11/17 1:19:16 CUST [2018/11/16 12:19:16 ET]
Table 'Halley' 6-max Seat #1 is the button
Seat 1: skystaruk ($2.17 in chips) 
Seat 2: jepprdeppr ($3.92 in chips) 
Seat 3: ziorrr ($3.17 in chips) 
Seat 4: S7CRENYZ ($3.07 in chips) 
Seat 5: hc agorist ($2.61 in chips) 
Seat 6: baget36 ($2.02 in chips) 
jepprdeppr: posts small blind $0.01
ziorrr: posts big blind $0.02
*** HOLE CARDS ***
Dealt to hc agorist [Kh Ah]
S7CRENYZ: folds 
hc agorist: raises $0.04 to $0.06
baget36: folds 
skystaruk: folds 
jepprdeppr: folds 
ziorrr: calls $0.04
*** FLOP *** [As Ts 4s]
ziorrr: checks 
hc agorist: bets $0.05
ziorrr: calls $0.05
*** TURN *** [As Ts 4s] [Qs]
ziorrr: checks 
hc agorist: checks 
*** RIVER *** [As Ts 4s Qs] [Ad]
ziorrr: checks 
hc agorist: bets $0.08
ziorrr: folds 
Uncalled bet ($0.08) returned to hc agorist
hc agorist collected $0.22 from pot
hc agorist: doesn't show hand 
*** SUMMARY ***
Total pot $0.23 | Rake $0.01 
Board [As Ts 4s Qs Ad]
Seat 1: skystaruk (button) folded before Flop (didn't bet)
Seat 2: jepprdeppr (small blind) folded before Flop
Seat 3: ziorrr (big blind) folded on the River
Seat 4: S7CRENYZ folded before Flop (didn't bet)
Seat 5: hc agorist collected ($0.22)
Seat 6: baget36 folded before Flop (didn't bet)



PokerStars Zoom Hand #193394616471:  Hold'em No Limit ($0.01/$0.02) - 2018/11/17 1:19:55 CUST [2018/11/16 12:19:55 ET]
Table 'Halley' 6-max Seat #1 is the button
Seat 1: hc agorist ($2.72 in chips) 
Seat 2: Crazy Oll ($1.66 in chips) 
Seat 3: orangos ($1.21 in chips) 
Seat 4: Mokkelo ($2.33 in chips) 
Seat 5: MOU77Y ($2 in chips) 
Seat 6: DrMoZzz ($2.17 in chips) 
Crazy Oll: posts small blind $0.01
orangos: posts big blind $0.02
*** HOLE CARDS ***
Dealt to hc agorist [7c 3d]
Mokkelo: folds 
MOU77Y: folds 
DrMoZzz: folds 
hc agorist: folds 
Crazy Oll: raises $0.04 to $0.06
orangos: folds 
Uncalled bet ($0.04) returned to Crazy Oll
Crazy Oll collected $0.04 from pot
Crazy Oll: doesn't show hand 
*** SUMMARY ***
Total pot $0.04 | Rake $0 
Seat 1: hc agorist (button) folded before Flop (didn't bet)
Seat 2: Crazy Oll (small blind) collected ($0.04)
Seat 3: orangos (big blind) folded before Flop
Seat 4: Mokkelo folded before Flop (didn't bet)
Seat 5: MOU77Y folded before Flop (didn't bet)
Seat 6: DrMoZzz folded before Flop (didn't bet)



PokerStars Zoom Hand #193394627258:  Hold'em No Limit ($0.01/$0.02) - 2018/11/17 1:20:13 CUST [2018/11/16 12:20:13 ET]
Table 'Halley' 6-max Seat #1 is the button
Seat 1: Burij14 ($1.91 in chips) 
Seat 2: Ludo4kAA ($2.10 in chips) 
Seat 3: Achen1027 ($2.05 in chips) 
Seat 4: hc agorist ($2.72 in chips) 
Seat 5: tomcikas82 ($2.02 in chips) 
Seat 6: Sai.poker0 ($3.39 in chips) 
Ludo4kAA: posts small blind $0.01
Achen1027: posts big blind $0.02
*** HOLE CARDS ***
Dealt to hc agorist [2d 2c]
hc agorist: raises $0.04 to $0.06
tomcikas82: folds 
Sai.poker0: calls $0.06
Burij14: folds 
Ludo4kAA: folds 
Achen1027: folds 
*** FLOP *** [8d 6s As]
hc agorist: bets $0.05
Sai.poker0: folds 
Uncalled bet ($0.05) returned to hc agorist
hc agorist collected $0.14 from pot
hc agorist: doesn't show hand 
*** SUMMARY ***
Total pot $0.15 | Rake $0.01 
Board [8d 6s As]
Seat 1: Burij14 (button) folded before Flop (didn't bet)
Seat 2: Ludo4kAA (small blind) folded before Flop
Seat 3: Achen1027 (big blind) folded before Flop
Seat 4: hc agorist collected ($0.14)
Seat 5: tomcikas82 folded before Flop (didn't bet)
Seat 6: Sai.poker0 folded on the Flop



PokerStars Zoom Hand #193394651626:  Hold'em No Limit ($0.01/$0.02) - 2018/11/17 1:20:54 CUST [2018/11/16 12:20:54 ET]
Table 'Halley' 6-max Seat #1 is the button
Seat 1: Revers1990 ($2.22 in chips) 
Seat 2: hc agorist ($2.80 in chips) 
Seat 3: mietek198977 ($0.95 in chips) 
Seat 4: 3omigo ($6.10 in chips) 
Seat 5: Barra West ($2.21 in chips) 
Seat 6: EDSVC ($0.23 in chips) 
hc agorist: posts small blind $0.01
mietek198977: posts big blind $0.02
*** HOLE CARDS ***
Dealt to hc agorist [Tc Td]
3omigo: folds 
Barra West: folds 
EDSVC: folds 
Revers1990: raises $0.04 to $0.06
hc agorist: raises $0.18 to $0.24
mietek198977: folds 
Revers1990: folds 
Uncalled bet ($0.18) returned to hc agorist
hc agorist collected $0.14 from pot
hc agorist: doesn't show hand 
*** SUMMARY ***
Total pot $0.14 | Rake $0 
Seat 1: Revers1990 (button) folded before Flop
Seat 2: hc agorist (small blind) collected ($0.14)
Seat 3: mietek198977 (big blind) folded before Flop
Seat 4: 3omigo folded before Flop (didn't bet)
Seat 5: Barra West folded before Flop (didn't bet)
Seat 6: EDSVC folded before Flop (didn't bet)



PokerStars Zoom Hand #193394665241:  Hold'em No Limit ($0.01/$0.02) - 2018/11/17 1:21:17 CUST [2018/11/16 12:21:17 ET]
Table 'Halley' 6-max Seat #1 is the button
Seat 1: zequi1998 ($2.33 in chips) 
Seat 2: dubrovskiy84 ($1 in chips) 
Seat 3: dazn1k ($2.03 in chips) 
Seat 4: hc agorist ($2.88 in chips) 
Seat 5: hsienko ($2 in chips) 
Seat 6: PARIKMAXER88 ($0.34 in chips) 
dubrovskiy84: posts small blind $0.01
dazn1k: posts big blind $0.02
*** HOLE CARDS ***
Dealt to hc agorist [Tc 9d]
hc agorist: raises $0.04 to $0.06
hsienko: folds 
PARIKMAXER88: folds 
zequi1998: folds 
dubrovskiy84: folds 
dazn1k: folds 
Uncalled bet ($0.04) returned to hc agorist
hc agorist collected $0.05 from pot
hc agorist: doesn't show hand 
*** SUMMARY ***
Total pot $0.05 | Rake $0 
Seat 1: zequi1998 (button) folded before Flop (didn't bet)
Seat 2: dubrovskiy84 (small blind) folded before Flop
Seat 3: dazn1k (big blind) folded before Flop
Seat 4: hc agorist collected ($0.05)
Seat 5: hsienko folded before Flop (didn't bet)
Seat 6: PARIKMAXER88 folded before Flop (didn't bet)



PokerStars Zoom Hand #193394676970:  Hold'em No Limit ($0.01/$0.02) - 2018/11/17 1:21:37 CUST [2018/11/16 12:21:37 ET]
Table 'Halley' 6-max Seat #1 is the button
Seat 1: RIMMM867 ($1 in chips) 
Seat 2: AoMaZ ($3.08 in chips) 
Seat 3: nathaniel158 ($2.62 in chips) 
Seat 4: Bence Fekete ($8.58 in chips) 
Seat 5: Sjoerd228 ($0.94 in chips) 
Seat 6: hc agorist ($2.91 in chips) 
AoMaZ: posts small blind $0.01
nathaniel158: posts big blind $0.02
*** HOLE CARDS ***
Dealt to hc agorist [Td Ah]
Bence Fekete: raises $0.02 to $0.04
Sjoerd228: folds 
Sjoerd228 is disconnected 
hc agorist: calls $0.04
RIMMM867: folds 
AoMaZ: folds 
nathaniel158: folds 
*** FLOP *** [5c Qh 8c]
Bence Fekete: bets $0.06
hc agorist: folds 
Uncalled bet ($0.06) returned to Bence Fekete
Bence Fekete collected $0.11 from pot
Bence Fekete: doesn't show hand 
*** SUMMARY ***
Total pot $0.11 | Rake $0 
Board [5c Qh 8c]
Seat 1: RIMMM867 (button) folded before Flop (didn't bet)
Seat 2: AoMaZ (small blind) folded before Flop
Seat 3: nathaniel158 (big blind) folded before Flop
Seat 4: Bence Fekete collected ($0.11)
Seat 5: Sjoerd228 folded before Flop (didn't bet)
Seat 6: hc agorist folded on the Flop



PokerStars Zoom Hand #193394685850:  Hold'em No Limit ($0.01/$0.02) - 2018/11/17 1:21:52 CUST [2018/11/16 12:21:52 ET]
Table 'Halley' 6-max Seat #1 is the button
Seat 1: ekolog_uAE-4 ($2.55 in chips) 
Seat 2: GinthersRift ($5.27 in chips) 
Seat 3: SVG7777 ($1 in chips) 
Seat 4: MonqoI ($2.09 in chips) 
Seat 5: hc agorist ($2.87 in chips) 
Seat 6: MezMe95 ($1.94 in chips) 
GinthersRift: posts small blind $0.01
SVG7777: posts big blind $0.02
*** HOLE CARDS ***
Dealt to hc agorist [3c Ad]
MonqoI: folds 
hc agorist: folds 
MezMe95: folds 
ekolog_uAE-4: folds 
GinthersRift: raises $0.03 to $0.05
SVG7777: folds 
Uncalled bet ($0.03) returned to GinthersRift
GinthersRift collected $0.04 from pot
GinthersRift: doesn't show hand 
*** SUMMARY ***
Total pot $0.04 | Rake $0 
Seat 1: ekolog_uAE-4 (button) folded before Flop (didn't bet)
Seat 2: GinthersRift (small blind) collected ($0.04)
Seat 3: SVG7777 (big blind) folded before Flop
Seat 4: MonqoI folded before Flop (didn't bet)
Seat 5: hc agorist folded before Flop (didn't bet)
Seat 6: MezMe95 folded before Flop (didn't bet)



PokerStars Zoom Hand #193394688877:  Hold'em No Limit ($0.01/$0.02) - 2018/11/17 1:21:57 CUST [2018/11/16 12:21:57 ET]
Table 'Halley' 6-max Seat #1 is the button
Seat 1: ElectroSNB ($2.12 in chips) 
Seat 2: Zeemaz ($2.02 in chips) 
Seat 3: hc agorist ($2.87 in chips) 
Seat 4: Achen1027 ($2.34 in chips) 
Seat 5: ForHistory ($3.47 in chips) 
Seat 6: Alter7777 ($1.97 in chips) 
Zeemaz: posts small blind $0.01
hc agorist: posts big blind $0.02
*** HOLE CARDS ***
Dealt to hc agorist [9c 4d]
Achen1027: folds 
ForHistory: folds 
Alter7777: folds 
ElectroSNB: folds 
Zeemaz: folds 
Uncalled bet ($0.01) returned to hc agorist
hc agorist collected $0.02 from pot
hc agorist: doesn't show hand 
*** SUMMARY ***
Total pot $0.02 | Rake $0 
Seat 1: ElectroSNB (button) folded before Flop (didn't bet)
Seat 2: Zeemaz (small blind) folded before Flop
Seat 3: hc agorist (big blind) collected ($0.02)
Seat 4: Achen1027 folded before Flop (didn't bet)
Seat 5: ForHistory folded before Flop (didn't bet)
Seat 6: Alter7777 folded before Flop (didn't bet)



PokerStars Zoom Hand #193394694135:  Hold'em No Limit ($0.01/$0.02) - 2018/11/17 1:22:06 CUST [2018/11/16 12:22:06 ET]
Table 'Halley' 6-max Seat #1 is the button
Seat 1: ForHistory ($3.49 in chips) 
Seat 2: hc agorist ($2.88 in chips) 
Seat 3: arthurmloco ($1.61 in chips) 
Seat 4: Crazy Oll ($1.48 in chips) 
Seat 5: SpawnNVV ($2.42 in chips) 
Seat 6: RNSAMAD ($1.50 in chips) 
hc agorist: posts small blind $0.01
arthurmloco: posts big blind $0.02
*** HOLE CARDS ***
Dealt to hc agorist [Kd 2h]
Crazy Oll: folds 
SpawnNVV: raises $0.04 to $0.06
RNSAMAD: folds 
ForHistory: calls $0.06
hc agorist: folds 
arthurmloco: calls $0.04
*** FLOP *** [Ah 4h Qc]
arthurmloco: checks 
SpawnNVV: bets $0.08
ForHistory: folds 
arthurmloco: folds 
Uncalled bet ($0.08) returned to SpawnNVV
SpawnNVV collected $0.18 from pot
SpawnNVV: doesn't show hand 
*** SUMMARY ***
Total pot $0.19 | Rake $0.01 
Board [Ah 4h Qc]
Seat 1: ForHistory (button) folded on the Flop
Seat 2: hc agorist (small blind) folded before Flop
Seat 3: arthurmloco (big blind) folded on the Flop
Seat 4: Crazy Oll folded before Flop (didn't bet)
Seat 5: SpawnNVV collected ($0.18)
Seat 6: RNSAMAD folded before Flop (didn't bet)



PokerStars Zoom Hand #193394699972:  Hold'em No Limit ($0.01/$0.02) - 2018/11/17 1:22:16 CUST [2018/11/16 12:22:16 ET]
Table 'Halley' 6-max Seat #1 is the button
Seat 1: hd8500 ($1.17 in chips) 
Seat 2: deltanueve ($2.91 in chips) 
Seat 3: VreditelL ($3.81 in chips) 
Seat 4: BigFish4711 ($3.14 in chips) 
Seat 5: dazn1k ($2 in chips) 
Seat 6: hc agorist ($2.87 in chips) 
deltanueve: posts small blind $0.01
VreditelL: posts big blind $0.02
*** HOLE CARDS ***
Dealt to hc agorist [Kd 8d]
BigFish4711: folds 
dazn1k: raises $0.04 to $0.06
hc agorist: raises $0.12 to $0.18
hd8500: folds 
deltanueve: folds 
VreditelL: folds 
dazn1k: folds 
Uncalled bet ($0.12) returned to hc agorist
hc agorist collected $0.15 from pot
hc agorist: doesn't show hand 
*** SUMMARY ***
Total pot $0.15 | Rake $0 
Seat 1: hd8500 (button) folded before Flop (didn't bet)
Seat 2: deltanueve (small blind) folded before Flop
Seat 3: VreditelL (big blind) folded before Flop
Seat 4: BigFish4711 folded before Flop (didn't bet)
Seat 5: dazn1k folded before Flop
Seat 6: hc agorist collected ($0.15)



PokerStars Zoom Hand #193394719413:  Hold'em No Limit ($0.01/$0.02) - 2018/11/17 1:22:49 CUST [2018/11/16 12:22:49 ET]
Table 'Halley' 6-max Seat #1 is the button
Seat 1: ChuikaPridi ($2 in chips) 
Seat 2: zheka-tuk ($1.19 in chips) 
Seat 3: hc agorist ($2.96 in chips) 
Seat 4: Mr Drust ($1.21 in chips) 
Seat 5: mi$tralx ($2 in chips) 
Seat 6: d-potolok ($2 in chips) 
zheka-tuk: posts small blind $0.01
hc agorist: posts big blind $0.02
*** HOLE CARDS ***
Dealt to hc agorist [8h Tc]
Mr Drust: folds 
mi$tralx: folds 
d-potolok: folds 
ChuikaPridi: folds 
zheka-tuk: folds 
Uncalled bet ($0.01) returned to hc agorist
hc agorist collected $0.02 from pot
hc agorist: doesn't show hand 
*** SUMMARY ***
Total pot $0.02 | Rake $0 
Seat 1: ChuikaPridi (button) folded before Flop (didn't bet)
Seat 2: zheka-tuk (small blind) folded before Flop
Seat 3: hc agorist (big blind) collected ($0.02)
Seat 4: Mr Drust folded before Flop (didn't bet)
Seat 5: mi$tralx folded before Flop (didn't bet)
Seat 6: d-potolok folded before Flop (didn't bet)



PokerStars Zoom Hand #193394697042:  Hold'em No Limit ($0.01/$0.02) - 2018/11/17 1:22:11 CUST [2018/11/16 12:22:11 ET]
Table 'Halley' 6-max Seat #1 is the button
Seat 1: hc agorist ($2.87 in chips) 
Seat 2: manopuki ($2.17 in chips) 
Seat 3: DuyenBami ($2.03 in chips) 
Seat 4: d-potolok ($2.05 in chips) 
Seat 5: AdDeNooijer ($2.06 in chips) 
Seat 6: el visitante ($3.74 in chips) 
manopuki: posts small blind $0.01
DuyenBami: posts big blind $0.02
*** HOLE CARDS ***
Dealt to hc agorist [Kc 4d]
d-potolok: folds 
AdDeNooijer: folds 
el visitante: folds 
hc agorist: folds 
manopuki: calls $0.01
DuyenBami: raises $0.08 to $0.10
manopuki: calls $0.08
*** FLOP *** [Qc 2d 8c]
manopuki: checks 
DuyenBami: checks 
*** TURN *** [Qc 2d 8c] [3c]
manopuki: checks 
DuyenBami: checks 
*** RIVER *** [Qc 2d 8c 3c] [Qh]
manopuki: bets $0.10
DuyenBami: folds 
Uncalled bet ($0.10) returned to manopuki
manopuki collected $0.19 from pot
manopuki: doesn't show hand 
*** SUMMARY ***
Total pot $0.20 | Rake $0.01 
Board [Qc 2d 8c 3c Qh]
Seat 1: hc agorist (button) folded before Flop (didn't bet)
Seat 2: manopuki (small blind) collected ($0.19)
Seat 3: DuyenBami (big blind) folded on the River
Seat 4: d-potolok folded before Flop (didn't bet)
Seat 5: AdDeNooijer folded before Flop (didn't bet)
Seat 6: el visitante folded before Flop (didn't bet)



PokerStars Zoom Hand #193394716443:  Hold'em No Limit ($0.01/$0.02) - 2018/11/17 1:22:44 CUST [2018/11/16 12:22:44 ET]
Table 'Halley' 6-max Seat #1 is the button
Seat 1: hc agorist ($2.96 in chips) 
Seat 2: pandurka ($1.52 in chips) 
Seat 3: catch fire s ($0.88 in chips) 
Seat 4: VOVUK1983 ($1.99 in chips) 
Seat 5: maratik ($3.15 in chips) 
Seat 6: Enlassombras ($2 in chips) 
pandurka: posts small blind $0.01
catch fire s: posts big blind $0.02
*** HOLE CARDS ***
Dealt to hc agorist [7h 5d]
VOVUK1983: folds 
maratik: folds 
Enlassombras: raises $0.04 to $0.06
hc agorist: folds 
pandurka: folds 
catch fire s: folds 
Uncalled bet ($0.04) returned to Enlassombras
Enlassombras collected $0.05 from pot
Enlassombras: doesn't show hand 
*** SUMMARY ***
Total pot $0.05 | Rake $0 
Seat 1: hc agorist (button) folded before Flop (didn't bet)
Seat 2: pandurka (small blind) folded before Flop
Seat 3: catch fire s (big blind) folded before Flop
Seat 4: VOVUK1983 folded before Flop (didn't bet)
Seat 5: maratik folded before Flop (didn't bet)
Seat 6: Enlassombras collected ($0.05)



PokerStars Zoom Hand #193394730141:  Hold'em No Limit ($0.01/$0.02) - 2018/11/17 1:23:08 CUST [2018/11/16 12:23:08 ET]
Table 'Halley' 6-max Seat #1 is the button
Seat 1: nkw84 ($2.07 in chips) 
Seat 2: LdnOnDTrack ($3.96 in chips) 
Seat 3: dazn1k ($2.05 in chips) 
Seat 4: Crazy Oll ($1.40 in chips) 
Seat 5: hc agorist ($2.97 in chips) 
Seat 6: champion719 ($2.45 in chips) 
LdnOnDTrack: posts small blind $0.01
dazn1k: posts big blind $0.02
*** HOLE CARDS ***
Dealt to hc agorist [4h 8c]
Crazy Oll: folds 
hc agorist: folds 
champion719: folds 
nkw84: folds 
LdnOnDTrack: folds 
Uncalled bet ($0.01) returned to dazn1k
dazn1k collected $0.02 from pot
dazn1k: doesn't show hand 
*** SUMMARY ***
Total pot $0.02 | Rake $0 
Seat 1: nkw84 (button) folded before Flop (didn't bet)
Seat 2: LdnOnDTrack (small blind) folded before Flop
Seat 3: dazn1k (big blind) collected ($0.02)
Seat 4: Crazy Oll folded before Flop (didn't bet)
Seat 5: hc agorist folded before Flop (didn't bet)
Seat 6: champion719 folded before Flop (didn't bet)



PokerStars Zoom Hand #193394734746:  Hold'em No Limit ($0.01/$0.02) - 2018/11/17 1:23:15 CUST [2018/11/16 12:23:15 ET]
Table 'Halley' 6-max Seat #1 is the button
Seat 1: orangos ($1.33 in chips) 
Seat 2: alenastorm ($0.63 in chips) 
Seat 3: Quetlaah ($2.06 in chips) 
Seat 4: hc agorist ($2.97 in chips) 
Seat 5: Hubert1929 ($1.87 in chips) 
Seat 6: MOU5ER ($2.06 in chips) 
alenastorm: posts small blind $0.01
Quetlaah: posts big blind $0.02
*** HOLE CARDS ***
Dealt to hc agorist [5c Qs]
hc agorist: folds 
Hubert1929: folds 
MOU5ER: folds 
orangos: folds 
alenastorm: folds 
Uncalled bet ($0.01) returned to Quetlaah
Quetlaah collected $0.02 from pot
Quetlaah: doesn't show hand 
*** SUMMARY ***
Total pot $0.02 | Rake $0 
Seat 1: orangos (button) folded before Flop (didn't bet)
Seat 2: alenastorm (small blind) folded before Flop
Seat 3: Quetlaah (big blind) collected ($0.02)
Seat 4: hc agorist folded before Flop (didn't bet)
Seat 5: Hubert1929 folded before Flop (didn't bet)
Seat 6: MOU5ER folded before Flop (didn't bet)



PokerStars Zoom Hand #193394737642:  Hold'em No Limit ($0.01/$0.02) - 2018/11/17 1:23:20 CUST [2018/11/16 12:23:20 ET]
Table 'Halley' 6-max Seat #1 is the button
Seat 1: fomik33 ($2.44 in chips) 
Seat 2: hc agorist ($2.97 in chips) 
Seat 3: Funmaker007 ($4.84 in chips) 
Seat 4: SPACECASH 9 ($2.49 in chips) 
Seat 5: PPYPP ($5.71 in chips) 
Seat 6: xiazhen ($2.94 in chips) 
hc agorist: posts small blind $0.01
Funmaker007: posts big blind $0.02
*** HOLE CARDS ***
Dealt to hc agorist [Td 4s]
SPACECASH 9: folds 
PPYPP: folds 
xiazhen: folds 
fomik33: raises $0.03 to $0.05
hc agorist: folds 
Funmaker007: folds 
Uncalled bet ($0.03) returned to fomik33
fomik33 collected $0.05 from pot
fomik33: doesn't show hand 
*** SUMMARY ***
Total pot $0.05 | Rake $0 
Seat 1: fomik33 (button) collected ($0.05)
Seat 2: hc agorist (small blind) folded before Flop
Seat 3: Funmaker007 (big blind) folded before Flop
Seat 4: SPACECASH 9 folded before Flop (didn't bet)
Seat 5: PPYPP folded before Flop (didn't bet)
Seat 6: xiazhen folded before Flop (didn't bet)



PokerStars Zoom Hand #193394727067:  Hold'em No Limit ($0.01/$0.02) - 2018/11/17 1:23:02 CUST [2018/11/16 12:23:02 ET]
Table 'Halley' 6-max Seat #1 is the button
Seat 1: ChuikaPridi ($2 in chips) 
Seat 2: AdDeNooijer ($2.10 in chips) 
Seat 3: Bloodypowers ($2 in chips) 
Seat 4: HanaYukii ($2.19 in chips) 
Seat 5: Royl_AceStar ($2.19 in chips) 
Seat 6: hc agorist ($2.97 in chips) 
AdDeNooijer: posts small blind $0.01
Bloodypowers: posts big blind $0.02
*** HOLE CARDS ***
Dealt to hc agorist [2s 8c]
HanaYukii: folds 
Royl_AceStar: folds 
hc agorist: folds 
ChuikaPridi: raises $0.03 to $0.05
AdDeNooijer: calls $0.04
Bloodypowers: folds 
*** FLOP *** [4c 2h 4s]
AdDeNooijer: checks 
ChuikaPridi: checks 
*** TURN *** [4c 2h 4s] [Ad]
AdDeNooijer: checks 
ChuikaPridi: checks 
*** RIVER *** [4c 2h 4s Ad] [9s]
AdDeNooijer: bets $0.04
ChuikaPridi: calls $0.04
*** SHOW DOWN ***
AdDeNooijer: shows [9c Kd] (two pair, Nines and Fours)
ChuikaPridi: shows [9h 6h] (two pair, Nines and Fours)
AdDeNooijer collected $0.10 from pot
ChuikaPridi collected $0.09 from pot
*** SUMMARY ***
Total pot $0.20 | Rake $0.01 
Board [4c 2h 4s Ad 9s]
Seat 1: ChuikaPridi (button) showed [9h 6h] and won ($0.09) with two pair, Nines and Fours
Seat 2: AdDeNooijer (small blind) showed [9c Kd] and won ($0.10) with two pair, Nines and Fours
Seat 3: Bloodypowers (big blind) folded before Flop
Seat 4: HanaYukii folded before Flop (didn't bet)
Seat 5: Royl_AceStar folded before Flop (didn't bet)
Seat 6: hc agorist folded before Flop (didn't bet)



PokerStars Zoom Hand #193394746509:  Hold'em No Limit ($0.01/$0.02) - 2018/11/17 1:23:35 CUST [2018/11/16 12:23:35 ET]
Table 'Halley' 6-max Seat #1 is the button
Seat 1: hoyosuk513 ($2.13 in chips) 
Seat 2: BoltAngus ($2.36 in chips) 
Seat 3: KOMBAT2010 ($2 in chips) 
Seat 4: Mr. Jay12345 ($1.93 in chips) 
Seat 5: hc agorist ($2.96 in chips) 
Seat 6: kyoubaku ($3.34 in chips) 
BoltAngus: posts small blind $0.01
KOMBAT2010: posts big blind $0.02
*** HOLE CARDS ***
Dealt to hc agorist [3d Ad]
Mr. Jay12345: folds 
hc agorist: raises $0.04 to $0.06
kyoubaku: raises $0.15 to $0.21
hoyosuk513: folds 
BoltAngus: folds 
KOMBAT2010: folds 
hc agorist: folds 
Uncalled bet ($0.15) returned to kyoubaku
kyoubaku collected $0.15 from pot
kyoubaku: doesn't show hand 
*** SUMMARY ***
Total pot $0.15 | Rake $0 
Seat 1: hoyosuk513 (button) folded before Flop (didn't bet)
Seat 2: BoltAngus (small blind) folded before Flop
Seat 3: KOMBAT2010 (big blind) folded before Flop
Seat 4: Mr. Jay12345 folded before Flop (didn't bet)
Seat 5: hc agorist folded before Flop
Seat 6: kyoubaku collected ($0.15)



PokerStars Zoom Hand #193394758532:  Hold'em No Limit ($0.01/$0.02) - 2018/11/17 1:23:55 CUST [2018/11/16 12:23:55 ET]
Table 'Halley' 6-max Seat #1 is the button
Seat 1: n33d ($0.74 in chips) 
Seat 2: Rainmaker1978 ($2.27 in chips) 
Seat 3: hc agorist ($2.90 in chips) 
Seat 4: Ringde ($3.17 in chips) 
Seat 5: geesnode ($0.91 in chips) 
Seat 6: PritkovO ($1.01 in chips) 
Rainmaker1978: posts small blind $0.01
hc agorist: posts big blind $0.02
*** HOLE CARDS ***
Dealt to hc agorist [2d 7s]
Ringde: folds 
geesnode: folds 
PritkovO: raises $0.04 to $0.06
n33d: calls $0.06
Rainmaker1978: folds 
hc agorist: folds 
*** FLOP *** [4d Tc 2h]
PritkovO: checks 
n33d: bets $0.09
PritkovO: folds 
Uncalled bet ($0.09) returned to n33d
n33d collected $0.14 from pot
n33d: doesn't show hand 
*** SUMMARY ***
Total pot $0.15 | Rake $0.01 
Board [4d Tc 2h]
Seat 1: n33d (button) collected ($0.14)
Seat 2: Rainmaker1978 (small blind) folded before Flop
Seat 3: hc agorist (big blind) folded before Flop
Seat 4: Ringde folded before Flop (didn't bet)
Seat 5: geesnode folded before Flop (didn't bet)
Seat 6: PritkovO folded on the Flop



PokerStars Zoom Hand #193394764550:  Hold'em No Limit ($0.01/$0.02) - 2018/11/17 1:24:05 CUST [2018/11/16 12:24:05 ET]
Table 'Halley' 6-max Seat #1 is the button
Seat 1: aleksvp ($3.08 in chips) 
Seat 2: win0809 ($1.74 in chips) 
Seat 3: Ludo4kAA ($2.23 in chips) 
Seat 4: hc agorist ($2.88 in chips) 
Seat 5: Balzouman ($1.73 in chips) 
Seat 6: PrStalker ($2.10 in chips) 
win0809: posts small blind $0.01
Ludo4kAA: posts big blind $0.02
*** HOLE CARDS ***
Dealt to hc agorist [Kh Kc]
hc agorist: raises $0.04 to $0.06
Balzouman: raises $0.12 to $0.18
PrStalker: folds 
aleksvp: folds 
win0809: folds 
Ludo4kAA: folds 
hc agorist: raises $0.26 to $0.44
Balzouman: folds 
Uncalled bet ($0.26) returned to hc agorist
hc agorist collected $0.39 from pot
hc agorist: doesn't show hand 
*** SUMMARY ***
Total pot $0.39 | Rake $0 
Seat 1: aleksvp (button) folded before Flop (didn't bet)
Seat 2: win0809 (small blind) folded before Flop
Seat 3: Ludo4kAA (big blind) folded before Flop
Seat 4: hc agorist collected ($0.39)
Seat 5: Balzouman folded before Flop
Seat 6: PrStalker folded before Flop (didn't bet)



PokerStars Zoom Hand #193394780434:  Hold'em No Limit ($0.01/$0.02) - 2018/11/17 1:24:32 CUST [2018/11/16 12:24:32 ET]
Table 'Halley' 6-max Seat #1 is the button
Seat 1: SydneyBridge ($2.08 in chips) 
Seat 2: justanotherfish ($2 in chips) 
Seat 3: RIMMM867 ($0.98 in chips) 
Seat 4: hc agorist ($3.09 in chips) 
Seat 5: mr.los9682 ($2.65 in chips) 
Seat 6: donova ($1.61 in chips) 
justanotherfish: posts small blind $0.01
RIMMM867: posts big blind $0.02
*** HOLE CARDS ***
Dealt to hc agorist [Js 7h]
hc agorist: folds 
mr.los9682: folds 
donova: raises $0.03 to $0.05
SydneyBridge: folds 
justanotherfish: folds 
RIMMM867: folds 
Uncalled bet ($0.03) returned to donova
donova collected $0.05 from pot
donova: doesn't show hand 
*** SUMMARY ***
Total pot $0.05 | Rake $0 
Seat 1: SydneyBridge (button) folded before Flop (didn't bet)
Seat 2: justanotherfish (small blind) folded before Flop
Seat 3: RIMMM867 (big blind) folded before Flop
Seat 4: hc agorist folded before Flop (didn't bet)
Seat 5: mr.los9682 folded before Flop (didn't bet)
Seat 6: donova collected ($0.05)



PokerStars Zoom Hand #193394798822:  Hold'em No Limit ($0.01/$0.02) - 2018/11/17 1:25:03 CUST [2018/11/16 12:25:03 ET]
Table 'Halley' 6-max Seat #1 is the button
Seat 1: SPARRER75 ($1.89 in chips) 
Seat 2: gerykoma ($2.28 in chips) 
Seat 3: Bloodypowers ($2 in chips) 
Seat 4: hc agorist ($3.08 in chips) 
Seat 5: xiazhen ($2.11 in chips) 
Seat 6: Fixmenem ($2.06 in chips) 
gerykoma: posts small blind $0.01
Bloodypowers: posts big blind $0.02
*** HOLE CARDS ***
Dealt to hc agorist [4c 3c]
hc agorist: raises $0.04 to $0.06
xiazhen: folds 
Fixmenem: folds 
SPARRER75: folds 
gerykoma: folds 
Bloodypowers: folds 
Uncalled bet ($0.04) returned to hc agorist
hc agorist collected $0.05 from pot
hc agorist: doesn't show hand 
*** SUMMARY ***
Total pot $0.05 | Rake $0 
Seat 1: SPARRER75 (button) folded before Flop (didn't bet)
Seat 2: gerykoma (small blind) folded before Flop
Seat 3: Bloodypowers (big blind) folded before Flop
Seat 4: hc agorist collected ($0.05)
Seat 5: xiazhen folded before Flop (didn't bet)
Seat 6: Fixmenem folded before Flop (didn't bet)



PokerStars Zoom Hand #193394790515:  Hold'em No Limit ($0.01/$0.02) - 2018/11/17 1:24:49 CUST [2018/11/16 12:24:49 ET]
Table 'Halley' 6-max Seat #1 is the button
Seat 1: gerykoma ($3.92 in chips) 
Seat 2: hc agorist ($3.09 in chips) 
Seat 3: Celceeste ($2.02 in chips) 
Seat 4: AngelBear82 ($10.55 in chips) 
Seat 5: kasha1111 ($0.14 in chips) 
Seat 6: chetkevichus ($2.77 in chips) 
hc agorist: posts small blind $0.01
Celceeste: posts big blind $0.02
*** HOLE CARDS ***
Dealt to hc agorist [8c Ah]
AngelBear82: folds 
kasha1111: folds 
chetkevichus: raises $0.05 to $0.07
gerykoma: folds 
hc agorist: folds 
Celceeste: calls $0.05
*** FLOP *** [7c As 7s]
Celceeste: checks 
chetkevichus: bets $0.06
Celceeste: folds 
Uncalled bet ($0.06) returned to chetkevichus
chetkevichus collected $0.14 from pot
chetkevichus: doesn't show hand 
*** SUMMARY ***
Total pot $0.15 | Rake $0.01 
Board [7c As 7s]
Seat 1: gerykoma (button) folded before Flop (didn't bet)
Seat 2: hc agorist (small blind) folded before Flop
Seat 3: Celceeste (big blind) folded on the Flop
Seat 4: AngelBear82 folded before Flop (didn't bet)
Seat 5: kasha1111 folded before Flop (didn't bet)
Seat 6: chetkevichus collected ($0.14)



PokerStars Zoom Hand #193394783460:  Hold'em No Limit ($0.01/$0.02) - 2018/11/17 1:24:37 CUST [2018/11/16 12:24:37 ET]
Table 'Halley' 6-max Seat #1 is the button
Seat 1: hc agorist ($3.09 in chips) 
Seat 2: Quetlaah ($2.10 in chips) 
Seat 3: alisk0 ($2.13 in chips) 
Seat 4: Vule_ot ($2 in chips) 
Seat 5: SSU1985 ($2.12 in chips) 
Seat 6: Elchaza_1989 ($2.16 in chips) 
Quetlaah: posts small blind $0.01
alisk0: posts big blind $0.02
*** HOLE CARDS ***
Dealt to hc agorist [8d Qh]
Vule_ot: folds 
SSU1985: calls $0.02
Elchaza_1989: folds 
hc agorist: folds 
Quetlaah: folds 
alisk0: checks 
*** FLOP *** [6c 7s 4d]
alisk0: bets $0.03
SSU1985: calls $0.03
*** TURN *** [6c 7s 4d] [9c]
alisk0: checks 
SSU1985: checks 
*** RIVER *** [6c 7s 4d 9c] [6d]
alisk0: checks 
SSU1985: checks 
*** SHOW DOWN ***
alisk0: shows [Kd 3c] (a pair of Sixes)
SSU1985: shows [2s 2d] (two pair, Sixes and Deuces)
SSU1985 collected $0.11 from pot
*** SUMMARY ***
Total pot $0.11 | Rake $0 
Board [6c 7s 4d 9c 6d]
Seat 1: hc agorist (button) folded before Flop (didn't bet)
Seat 2: Quetlaah (small blind) folded before Flop
Seat 3: alisk0 (big blind) showed [Kd 3c] and lost with a pair of Sixes
Seat 4: Vule_ot folded before Flop (didn't bet)
Seat 5: SSU1985 showed [2s 2d] and won ($0.11) with two pair, Sixes and Deuces
Seat 6: Elchaza_1989 folded before Flop (didn't bet)



PokerStars Zoom Hand #193394804214:  Hold'em No Limit ($0.01/$0.02) - 2018/11/17 1:25:12 CUST [2018/11/16 12:25:12 ET]
Table 'Halley' 6-max Seat #1 is the button
Seat 1: SSU1985 ($1.74 in chips) 
Seat 2: ferenc456456 ($1.32 in chips) 
Seat 3: hc agorist ($3.11 in chips) 
Seat 4: chun188 ($2.62 in chips) 
Seat 5: Fuzz1q ($2.67 in chips) 
Seat 6: sensey44444 ($3.90 in chips) 
ferenc456456: posts small blind $0.01
hc agorist: posts big blind $0.02
*** HOLE CARDS ***
Dealt to hc agorist [Ts 6s]
chun188: folds 
Fuzz1q: folds 
sensey44444: folds 
SSU1985: folds 
ferenc456456: raises $0.04 to $0.06
hc agorist: calls $0.04
*** FLOP *** [4c 6c Jh]
ferenc456456: bets $0.07
hc agorist: calls $0.07
*** TURN *** [4c 6c Jh] [9c]
ferenc456456: bets $0.14
hc agorist: folds 
Uncalled bet ($0.14) returned to ferenc456456
ferenc456456 collected $0.25 from pot
ferenc456456: doesn't show hand 
*** SUMMARY ***
Total pot $0.26 | Rake $0.01 
Board [4c 6c Jh 9c]
Seat 1: SSU1985 (button) folded before Flop (didn't bet)
Seat 2: ferenc456456 (small blind) collected ($0.25)
Seat 3: hc agorist (big blind) folded on the Turn
Seat 4: chun188 folded before Flop (didn't bet)
Seat 5: Fuzz1q folded before Flop (didn't bet)
Seat 6: sensey44444 folded before Flop (didn't bet)



PokerStars Zoom Hand #193394821682:  Hold'em No Limit ($0.01/$0.02) - 2018/11/17 1:25:41 CUST [2018/11/16 12:25:41 ET]
Table 'Halley' 6-max Seat #1 is the button
Seat 1: hc agorist ($2.98 in chips) 
Seat 2: Lifecards7 ($2 in chips) 
Seat 3: Korsett84 ($2.55 in chips) 
Seat 4: Elchaza_1989 ($2.08 in chips) 
Seat 5: deltanueve ($2.01 in chips) 
Seat 6: ElectroSNB ($2 in chips) 
Lifecards7: posts small blind $0.01
Korsett84: posts big blind $0.02
*** HOLE CARDS ***
Dealt to hc agorist [Ad 9c]
Elchaza_1989: folds 
deltanueve: folds 
ElectroSNB: folds 
hc agorist: raises $0.02 to $0.04
Lifecards7: folds 
Korsett84: folds 
Uncalled bet ($0.02) returned to hc agorist
hc agorist collected $0.05 from pot
hc agorist: doesn't show hand 
*** SUMMARY ***
Total pot $0.05 | Rake $0 
Seat 1: hc agorist (button) collected ($0.05)
Seat 2: Lifecards7 (small blind) folded before Flop
Seat 3: Korsett84 (big blind) folded before Flop
Seat 4: Elchaza_1989 folded before Flop (didn't bet)
Seat 5: deltanueve folded before Flop (didn't bet)
Seat 6: ElectroSNB folded before Flop (didn't bet)



PokerStars Zoom Hand #193394795828:  Hold'em No Limit ($0.01/$0.02) - 2018/11/17 1:24:58 CUST [2018/11/16 12:24:58 ET]
Table 'Halley' 6-max Seat #1 is the button
Seat 1: astakhov ($1.31 in chips) 
Seat 2: SydneyBridge ($2.08 in chips) 
Seat 3: romanserferr ($1.57 in chips) 
Seat 4: Tomek VII ($0.80 in chips) 
Seat 5: nkw84 ($2.02 in chips) 
Seat 6: hc agorist ($3.08 in chips) 
SydneyBridge: posts small blind $0.01
romanserferr: posts big blind $0.02
*** HOLE CARDS ***
Dealt to hc agorist [8h 5d]
Tomek VII: folds 
nkw84: folds 
hc agorist: folds 
astakhov: raises $0.02 to $0.04
SydneyBridge: calls $0.03
romanserferr: raises $0.02 to $0.06
astakhov: calls $0.02
SydneyBridge: calls $0.02
*** FLOP *** [9d Jd Td]
SydneyBridge: bets $0.11
romanserferr: folds 
astakhov: calls $0.11
*** TURN *** [9d Jd Td] [Js]
SydneyBridge: bets $0.26
astakhov: calls $0.26
*** RIVER *** [9d Jd Td Js] [Th]
SydneyBridge: checks 
astakhov: bets $0.18
SydneyBridge: calls $0.18
*** SHOW DOWN ***
astakhov: shows [Kc Jh] (a full house, Jacks full of Tens)
SydneyBridge: mucks hand 
astakhov collected $1.24 from pot
*** SUMMARY ***
Total pot $1.28 | Rake $0.04 
Board [9d Jd Td Js Th]
Seat 1: astakhov (button) showed [Kc Jh] and won ($1.24) with a full house, Jacks full of Tens
Seat 2: SydneyBridge (small blind) mucked [5h Ad]
Seat 3: romanserferr (big blind) folded on the Flop
Seat 4: Tomek VII folded before Flop (didn't bet)
Seat 5: nkw84 folded before Flop (didn't bet)
Seat 6: hc agorist folded before Flop (didn't bet)



PokerStars Zoom Hand #193394829431:  Hold'em No Limit ($0.01/$0.02) - 2018/11/17 1:25:54 CUST [2018/11/16 12:25:54 ET]
Table 'Halley' 6-max Seat #1 is the button
Seat 1: MezMe95 ($2.05 in chips) 
Seat 2: mati230 ($4.15 in chips) 
Seat 3: chun188 ($2.59 in chips) 
Seat 4: blondin260 ($2.02 in chips) 
Seat 5: hc agorist ($3.01 in chips) 
Seat 6: AlanMinskii ($1 in chips) 
mati230: posts small blind $0.01
chun188: posts big blind $0.02
*** HOLE CARDS ***
Dealt to hc agorist [5c Ac]
blondin260: calls $0.02
hc agorist: calls $0.02
AlanMinskii: folds 
MezMe95: folds 
mati230: folds 
chun188: checks 
*** FLOP *** [2h As Jh]
chun188: checks 
blondin260: checks 
hc agorist: checks 
*** TURN *** [2h As Jh] [Th]
chun188: checks 
blondin260: checks 
hc agorist: bets $0.06
chun188: folds 
blondin260: calls $0.06
*** RIVER *** [2h As Jh Th] [7c]
blondin260: checks 
hc agorist: bets $0.16
blondin260: folds 
Uncalled bet ($0.16) returned to hc agorist
hc agorist collected $0.18 from pot
hc agorist: doesn't show hand 
*** SUMMARY ***
Total pot $0.19 | Rake $0.01 
Board [2h As Jh Th 7c]
Seat 1: MezMe95 (button) folded before Flop (didn't bet)
Seat 2: mati230 (small blind) folded before Flop
Seat 3: chun188 (big blind) folded on the Turn
Seat 4: blondin260 folded on the River
Seat 5: hc agorist collected ($0.18)
Seat 6: AlanMinskii folded before Flop (didn't bet)



PokerStars Zoom Hand #193394855847:  Hold'em No Limit ($0.01/$0.02) - 2018/11/17 1:26:38 CUST [2018/11/16 12:26:38 ET]
Table 'Halley' 6-max Seat #1 is the button
Seat 1: actionMoon ($2.02 in chips) 
Seat 2: hc agorist ($3.11 in chips) 
Seat 3: Marcelolemos ($2.03 in chips) 
Seat 4: teutonknight ($2.13 in chips) 
Seat 5: SkyElephant ($2.10 in chips) 
Seat 6: artpoker77 ($1.13 in chips) 
hc agorist: posts small blind $0.01
Marcelolemos: posts big blind $0.02
*** HOLE CARDS ***
Dealt to hc agorist [8d Kh]
teutonknight: raises $0.05 to $0.07
SkyElephant: folds 
artpoker77: folds 
actionMoon: folds 
hc agorist: folds 
Marcelolemos: calls $0.05
*** FLOP *** [Td 8s 2h]
Marcelolemos: checks 
teutonknight: checks 
*** TURN *** [Td 8s 2h] [6h]
Marcelolemos: checks 
teutonknight: checks 
*** RIVER *** [Td 8s 2h 6h] [Ad]
Marcelolemos: checks 
teutonknight: checks 
*** SHOW DOWN ***
Marcelolemos: shows [3c 3d] (a pair of Threes)
teutonknight: mucks hand 
Marcelolemos collected $0.14 from pot
*** SUMMARY ***
Total pot $0.15 | Rake $0.01 
Board [Td 8s 2h 6h Ad]
Seat 1: actionMoon (button) folded before Flop (didn't bet)
Seat 2: hc agorist (small blind) folded before Flop
Seat 3: Marcelolemos (big blind) showed [3c 3d] and won ($0.14) with a pair of Threes
Seat 4: teutonknight mucked [Jh Kc]
Seat 5: SkyElephant folded before Flop (didn't bet)
Seat 6: artpoker77 folded before Flop (didn't bet)



PokerStars Zoom Hand #193394858948:  Hold'em No Limit ($0.01/$0.02) - 2018/11/17 1:26:43 CUST [2018/11/16 12:26:43 ET]
Table 'Halley' 6-max Seat #1 is the button
Seat 1: uFoldPlz ($2.03 in chips) 
Seat 2: V@L74pro ($1.61 in chips) 
Seat 3: AdDeNooijer ($2.06 in chips) 
Seat 4: QQGrinder ($3.41 in chips) 
Seat 5: laggi^tl0 ($1.52 in chips) 
Seat 6: hc agorist ($3.10 in chips) 
V@L74pro: posts small blind $0.01
AdDeNooijer: posts big blind $0.02
*** HOLE CARDS ***
Dealt to hc agorist [Ah Js]
QQGrinder: folds 
laggi^tl0: folds 
hc agorist: raises $0.04 to $0.06
uFoldPlz: folds 
V@L74pro: folds 
AdDeNooijer: calls $0.04
*** FLOP *** [Tc Ac Jd]
AdDeNooijer: checks 
hc agorist: bets $0.05
AdDeNooijer: raises $0.10 to $0.15
hc agorist: calls $0.10
*** TURN *** [Tc Ac Jd] [Td]
AdDeNooijer: checks 
hc agorist: bets $0.22
AdDeNooijer: folds 
Uncalled bet ($0.22) returned to hc agorist
hc agorist collected $0.41 from pot
hc agorist: doesn't show hand 
*** SUMMARY ***
Total pot $0.43 | Rake $0.02 
Board [Tc Ac Jd Td]
Seat 1: uFoldPlz (button) folded before Flop (didn't bet)
Seat 2: V@L74pro (small blind) folded before Flop
Seat 3: AdDeNooijer (big blind) folded on the Turn
Seat 4: QQGrinder folded before Flop (didn't bet)
Seat 5: laggi^tl0 folded before Flop (didn't bet)
Seat 6: hc agorist collected ($0.41)



PokerStars Zoom Hand #193394891390:  Hold'em No Limit ($0.01/$0.02) - 2018/11/17 1:27:37 CUST [2018/11/16 12:27:37 ET]
Table 'Halley' 6-max Seat #1 is the button
Seat 1: vericaODnesinci ($1.61 in chips) 
Seat 2: briefmaso ($2 in chips) 
Seat 3: whiteJaul ($1.54 in chips) 
Seat 4: hc agorist ($3.30 in chips) 
Seat 5: WAOOGA ($2.95 in chips) 
Seat 6: chaogeNo1 ($2.96 in chips) 
briefmaso: posts small blind $0.01
whiteJaul: posts big blind $0.02
*** HOLE CARDS ***
Dealt to hc agorist [6h 9c]
hc agorist: folds 
WAOOGA: folds 
chaogeNo1: raises $0.04 to $0.06
vericaODnesinci: folds 
briefmaso: folds 
whiteJaul: folds 
Uncalled bet ($0.04) returned to chaogeNo1
chaogeNo1 collected $0.05 from pot
chaogeNo1: doesn't show hand 
*** SUMMARY ***
Total pot $0.05 | Rake $0 
Seat 1: vericaODnesinci (button) folded before Flop (didn't bet)
Seat 2: briefmaso (small blind) folded before Flop
Seat 3: whiteJaul (big blind) folded before Flop
Seat 4: hc agorist folded before Flop (didn't bet)
Seat 5: WAOOGA folded before Flop (didn't bet)
Seat 6: chaogeNo1 collected ($0.05)



PokerStars Zoom Hand #193394894430:  Hold'em No Limit ($0.01/$0.02) - 2018/11/17 1:27:42 CUST [2018/11/16 12:27:42 ET]
Table 'Halley' 6-max Seat #1 is the button
Seat 1: n33d ($0.99 in chips) 
Seat 2: Philippkay ($2.96 in chips) 
Seat 3: Funmaker007 ($4.86 in chips) 
Seat 4: renataseixas ($1.46 in chips) 
Seat 5: hc agorist ($3.30 in chips) 
Seat 6: Azart503 ($2.97 in chips) 
Philippkay: posts small blind $0.01
Funmaker007: posts big blind $0.02
*** HOLE CARDS ***
Dealt to hc agorist [7c Ts]
renataseixas: folds 
hc agorist: folds 
Azart503: folds 
n33d: folds 
Philippkay: folds 
Uncalled bet ($0.01) returned to Funmaker007
Funmaker007 collected $0.02 from pot
Funmaker007: doesn't show hand 
*** SUMMARY ***
Total pot $0.02 | Rake $0 
Seat 1: n33d (button) folded before Flop (didn't bet)
Seat 2: Philippkay (small blind) folded before Flop
Seat 3: Funmaker007 (big blind) collected ($0.02)
Seat 4: renataseixas folded before Flop (didn't bet)
Seat 5: hc agorist folded before Flop (didn't bet)
Seat 6: Azart503 folded before Flop (didn't bet)



PokerStars Zoom Hand #193394897441:  Hold'em No Limit ($0.01/$0.02) - 2018/11/17 1:27:47 CUST [2018/11/16 12:27:47 ET]
Table 'Halley' 6-max Seat #1 is the button
Seat 1: hc agorist ($3.30 in chips) 
Seat 2: PritkovO ($1.07 in chips) 
Seat 3: pavel111999 ($2 in chips) 
Seat 4: Savavlad97 ($3.15 in chips) 
Seat 5: BigFish4711 ($4.65 in chips) 
Seat 6: karzp ($3.84 in chips) 
PritkovO: posts small blind $0.01
pavel111999: posts big blind $0.02
*** HOLE CARDS ***
Dealt to hc agorist [Ad 6c]
Savavlad97: folds 
BigFish4711: folds 
karzp: folds 
hc agorist: raises $0.02 to $0.04
PritkovO: folds 
pavel111999 has timed out
pavel111999: folds 
Uncalled bet ($0.02) returned to hc agorist
hc agorist collected $0.05 from pot
hc agorist: doesn't show hand 
*** SUMMARY ***
Total pot $0.05 | Rake $0 
Seat 1: hc agorist (button) collected ($0.05)
Seat 2: PritkovO (small blind) folded before Flop
Seat 3: pavel111999 (big blind) folded before Flop
Seat 4: Savavlad97 folded before Flop (didn't bet)
Seat 5: BigFish4711 folded before Flop (didn't bet)
Seat 6: karzp folded before Flop (didn't bet)



PokerStars Zoom Hand #193394930444:  Hold'em No Limit ($0.01/$0.02) - 2018/11/17 1:28:42 CUST [2018/11/16 12:28:42 ET]
Table 'Halley' 6-max Seat #1 is the button
Seat 1: pauldon86 ($2.91 in chips) 
Seat 2: hc agorist ($3.29 in chips) 
Seat 3: Frosmorn ($1.68 in chips) 
Seat 4: phillo283 ($2.13 in chips) 
Seat 5: Neftot ($2 in chips) 
Seat 6: SaveRhino ($3.99 in chips) 
hc agorist: posts small blind $0.01
Frosmorn: posts big blind $0.02
*** HOLE CARDS ***
Dealt to hc agorist [8d 9c]
phillo283: folds 
Neftot: folds 
SaveRhino: raises $0.04 to $0.06
pauldon86: folds 
hc agorist: folds 
Frosmorn: folds 
Uncalled bet ($0.04) returned to SaveRhino
SaveRhino collected $0.05 from pot
SaveRhino: doesn't show hand 
*** SUMMARY ***
Total pot $0.05 | Rake $0 
Seat 1: pauldon86 (button) folded before Flop (didn't bet)
Seat 2: hc agorist (small blind) folded before Flop
Seat 3: Frosmorn (big blind) folded before Flop
Seat 4: phillo283 folded before Flop (didn't bet)
Seat 5: Neftot folded before Flop (didn't bet)
Seat 6: SaveRhino collected ($0.05)



PokerStars Zoom Hand #193394933437:  Hold'em No Limit ($0.01/$0.02) - 2018/11/17 1:28:47 CUST [2018/11/16 12:28:47 ET]
Table 'Halley' 6-max Seat #1 is the button
Seat 1: inhonestus ($2.06 in chips) 
Seat 2: gnomNa5copok ($5.78 in chips) 
Seat 3: James4Thewolf ($3.94 in chips) 
Seat 4: v4co ($2.80 in chips) 
Seat 5: xafe367 ($2.16 in chips) 
Seat 6: hc agorist ($3.28 in chips) 
gnomNa5copok: posts small blind $0.01
James4Thewolf: posts big blind $0.02
*** HOLE CARDS ***
Dealt to hc agorist [4c Qd]
v4co: folds 
xafe367: folds 
hc agorist: folds 
inhonestus: folds 
gnomNa5copok: raises $0.04 to $0.06
James4Thewolf: folds 
Uncalled bet ($0.04) returned to gnomNa5copok
gnomNa5copok collected $0.04 from pot
gnomNa5copok: doesn't show hand 
*** SUMMARY ***
Total pot $0.04 | Rake $0 
Seat 1: inhonestus (button) folded before Flop (didn't bet)
Seat 2: gnomNa5copok (small blind) collected ($0.04)
Seat 3: James4Thewolf (big blind) folded before Flop
Seat 4: v4co folded before Flop (didn't bet)
Seat 5: xafe367 folded before Flop (didn't bet)
Seat 6: hc agorist folded before Flop (didn't bet)



PokerStars Zoom Hand #193394914097:  Hold'em No Limit ($0.01/$0.02) - 2018/11/17 1:28:15 CUST [2018/11/16 12:28:15 ET]
Table 'Halley' 6-max Seat #1 is the button
Seat 1: S. Biemans ($4.65 in chips) 
Seat 2: GreenGrowers ($1.18 in chips) 
Seat 3: hc agorist ($3.33 in chips) 
Seat 4: MOU77Y ($2.97 in chips) 
Seat 5: Geovane.A.B ($2.19 in chips) 
Seat 6: Bischi c ($2.89 in chips) 
GreenGrowers: posts small blind $0.01
hc agorist: posts big blind $0.02
*** HOLE CARDS ***
Dealt to hc agorist [Qs 7s]
MOU77Y: folds 
Geovane.A.B: folds 
Bischi c: folds 
S. Biemans: raises $0.02 to $0.04
GreenGrowers: calls $0.03
hc agorist: calls $0.02
*** FLOP *** [2d 2c 3s]
GreenGrowers: checks 
hc agorist: checks 
S. Biemans: bets $0.08
GreenGrowers: calls $0.08
hc agorist: folds 
*** TURN *** [2d 2c 3s] [4h]
GreenGrowers: checks 
S. Biemans: bets $0.20
GreenGrowers: calls $0.20
*** RIVER *** [2d 2c 3s 4h] [9h]
GreenGrowers: bets $0.46
S. Biemans: raises $3.87 to $4.33 and is all-in
GreenGrowers: calls $0.40 and is all-in
Uncalled bet ($3.47) returned to S. Biemans
*** SHOW DOWN ***
S. Biemans: shows [4s 4d] (a full house, Fours full of Deuces)
GreenGrowers: shows [6s 6c] (two pair, Sixes and Deuces)
S. Biemans collected $2.32 from pot
*** SUMMARY ***
Total pot $2.40 | Rake $0.08 
Board [2d 2c 3s 4h 9h]
Seat 1: S. Biemans (button) showed [4s 4d] and won ($2.32) with a full house, Fours full of Deuces
Seat 2: GreenGrowers (small blind) showed [6s 6c] and lost with two pair, Sixes and Deuces
Seat 3: hc agorist (big blind) folded on the Flop
Seat 4: MOU77Y folded before Flop (didn't bet)
Seat 5: Geovane.A.B folded before Flop (didn't bet)
Seat 6: Bischi c folded before Flop (didn't bet)



PokerStars Zoom Hand #193394937092:  Hold'em No Limit ($0.01/$0.02) - 2018/11/17 1:28:53 CUST [2018/11/16 12:28:53 ET]
Table 'Halley' 6-max Seat #1 is the button
Seat 1: hc agorist ($3.28 in chips) 
Seat 2: Pantpant ($6.51 in chips) 
Seat 3: vladkhomenko ($6.11 in chips) 
Seat 4: VOVUK1983 ($1.48 in chips) 
Seat 5: alisk0 ($1.92 in chips) 
Seat 6: CFINKS410 ($0.99 in chips) 
Pantpant: posts small blind $0.01
vladkhomenko: posts big blind $0.02
*** HOLE CARDS ***
Dealt to hc agorist [2c 5d]
VOVUK1983: folds 
alisk0: folds 
CFINKS410: folds 
hc agorist: folds 
Pantpant: raises $0.02 to $0.04
vladkhomenko: calls $0.02
*** FLOP *** [Ad 6h Td]
Pantpant: bets $0.08
vladkhomenko: folds 
Uncalled bet ($0.08) returned to Pantpant
Pantpant collected $0.08 from pot
Pantpant: doesn't show hand 
*** SUMMARY ***
Total pot $0.08 | Rake $0 
Board [Ad 6h Td]
Seat 1: hc agorist (button) folded before Flop (didn't bet)
Seat 2: Pantpant (small blind) collected ($0.08)
Seat 3: vladkhomenko (big blind) folded on the Flop
Seat 4: VOVUK1983 folded before Flop (didn't bet)
Seat 5: alisk0 folded before Flop (didn't bet)
Seat 6: CFINKS410 folded before Flop (didn't bet)



PokerStars Zoom Hand #193394940742:  Hold'em No Limit ($0.01/$0.02) - 2018/11/17 1:28:59 CUST [2018/11/16 12:28:59 ET]
Table 'Halley' 6-max Seat #1 is the button
Seat 1: Malczev ($0.68 in chips) 
Seat 2: bilimb ($1.59 in chips) 
Seat 3: pyrosteam ($4.05 in chips) 
Seat 4: hc agorist ($3.28 in chips) 
Seat 5: Sarmatrus79 ($2 in chips) 
Seat 6: juNglef1ShH! ($2.19 in chips) 
bilimb: posts small blind $0.01
pyrosteam: posts big blind $0.02
*** HOLE CARDS ***
Dealt to hc agorist [9h 5c]
hc agorist: folds 
Sarmatrus79: folds 
juNglef1ShH!: raises $0.03 to $0.05
Malczev: folds 
bilimb: folds 
pyrosteam: folds 
Uncalled bet ($0.03) returned to juNglef1ShH!
juNglef1ShH! collected $0.05 from pot
juNglef1ShH!: doesn't show hand 
*** SUMMARY ***
Total pot $0.05 | Rake $0 
Seat 1: Malczev (button) folded before Flop (didn't bet)
Seat 2: bilimb (small blind) folded before Flop
Seat 3: pyrosteam (big blind) folded before Flop
Seat 4: hc agorist folded before Flop (didn't bet)
Seat 5: Sarmatrus79 folded before Flop (didn't bet)
Seat 6: juNglef1ShH! collected ($0.05)



PokerStars Zoom Hand #193394943759:  Hold'em No Limit ($0.01/$0.02) - 2018/11/17 1:29:04 CUST [2018/11/16 12:29:04 ET]
Table 'Halley' 6-max Seat #1 is the button
Seat 1: Fantomas353 ($3.48 in chips) 
Seat 2: Vule_ot ($2.75 in chips) 
Seat 3: hc agorist ($3.28 in chips) 
Seat 4: sAnt1n135 ($1.98 in chips) 
Seat 5: nullnullnull ($2.08 in chips) 
Seat 6: take710 ($0.89 in chips) 
Vule_ot: posts small blind $0.01
hc agorist: posts big blind $0.02
*** HOLE CARDS ***
Dealt to hc agorist [Kd 6h]
sAnt1n135: folds 
nullnullnull: folds 
take710: folds 
Fantomas353: folds 
Vule_ot: raises $0.04 to $0.06
hc agorist: folds 
Uncalled bet ($0.04) returned to Vule_ot
Vule_ot collected $0.04 from pot
Vule_ot: doesn't show hand 
*** SUMMARY ***
Total pot $0.04 | Rake $0 
Seat 1: Fantomas353 (button) folded before Flop (didn't bet)
Seat 2: Vule_ot (small blind) collected ($0.04)
Seat 3: hc agorist (big blind) folded before Flop
Seat 4: sAnt1n135 folded before Flop (didn't bet)
Seat 5: nullnullnull folded before Flop (didn't bet)
Seat 6: take710 folded before Flop (didn't bet)



PokerStars Zoom Hand #193394956416:  Hold'em No Limit ($0.01/$0.02) - 2018/11/17 1:29:25 CUST [2018/11/16 12:29:25 ET]
Table 'Halley' 6-max Seat #1 is the button
Seat 1: geesnode ($2.38 in chips) 
Seat 2: hc agorist ($3.26 in chips) 
Seat 3: xafe367 ($2.10 in chips) 
Seat 4: ForHistory ($3.29 in chips) 
Seat 5: oposs153 ($2.20 in chips) 
Seat 6: ferenc456456 ($1.93 in chips) 
hc agorist: posts small blind $0.01
xafe367: posts big blind $0.02
*** HOLE CARDS ***
Dealt to hc agorist [Ks 9c]
ForHistory: raises $0.04 to $0.06
oposs153: folds 
ferenc456456: folds 
geesnode: folds 
hc agorist: folds 
xafe367: folds 
Uncalled bet ($0.04) returned to ForHistory
ForHistory collected $0.05 from pot
ForHistory: doesn't show hand 
*** SUMMARY ***
Total pot $0.05 | Rake $0 
Seat 1: geesnode (button) folded before Flop (didn't bet)
Seat 2: hc agorist (small blind) folded before Flop
Seat 3: xafe367 (big blind) folded before Flop
Seat 4: ForHistory collected ($0.05)
Seat 5: oposs153 folded before Flop (didn't bet)
Seat 6: ferenc456456 folded before Flop (didn't bet)



PokerStars Zoom Hand #193394963045:  Hold'em No Limit ($0.01/$0.02) - 2018/11/17 1:29:36 CUST [2018/11/16 12:29:36 ET]
Table 'Halley' 6-max Seat #1 is the button
Seat 1: Alex_nvkz_42 ($2.05 in chips) 
Seat 2: RocknRolla5 ($2 in chips) 
Seat 3: hc agorist ($3.25 in chips) 
Seat 4: 777(KRV)777 ($1.83 in chips) 
Seat 5: AGT1960 ($4.22 in chips) 
Seat 6: Tootheye ($3.20 in chips) 
RocknRolla5: posts small blind $0.01
hc agorist: posts big blind $0.02
*** HOLE CARDS ***
Dealt to hc agorist [Kh 3s]
777(KRV)777: folds 
AGT1960: folds 
Tootheye: raises $0.03 to $0.05
Alex_nvkz_42: folds 
RocknRolla5: folds 
hc agorist: folds 
Uncalled bet ($0.03) returned to Tootheye
Tootheye collected $0.05 from pot
Tootheye: doesn't show hand 
*** SUMMARY ***
Total pot $0.05 | Rake $0 
Seat 1: Alex_nvkz_42 (button) folded before Flop (didn't bet)
Seat 2: RocknRolla5 (small blind) folded before Flop
Seat 3: hc agorist (big blind) folded before Flop
Seat 4: 777(KRV)777 folded before Flop (didn't bet)
Seat 5: AGT1960 folded before Flop (didn't bet)
Seat 6: Tootheye collected ($0.05)



PokerStars Zoom Hand #193394960020:  Hold'em No Limit ($0.01/$0.02) - 2018/11/17 1:29:31 CUST [2018/11/16 12:29:31 ET]
Table 'Halley' 6-max Seat #1 is the button
Seat 1: don_energo2 ($3.34 in chips) 
Seat 2: RUZZZZZZZZ ($2.51 in chips) 
Seat 3: Snegul ($0.92 in chips) 
Seat 4: vais8 ($0.88 in chips) 
Seat 5: hc agorist ($3.25 in chips) 
Seat 6: SKFin ($2.58 in chips) 
RUZZZZZZZZ: posts small blind $0.01
Snegul: posts big blind $0.02
*** HOLE CARDS ***
Dealt to hc agorist [3h 9h]
vais8: raises $0.02 to $0.04
hc agorist: folds 
SKFin: folds 
don_energo2: raises $0.10 to $0.14
RUZZZZZZZZ: folds 
Snegul: folds 
vais8: calls $0.10
*** FLOP *** [2c 6c 7c]
vais8: bets $0.15
don_energo2: raises $2.47 to $2.62
vais8: folds 
Uncalled bet ($2.47) returned to don_energo2
don_energo2 collected $0.59 from pot
don_energo2: doesn't show hand 
*** SUMMARY ***
Total pot $0.61 | Rake $0.02 
Board [2c 6c 7c]
Seat 1: don_energo2 (button) collected ($0.59)
Seat 2: RUZZZZZZZZ (small blind) folded before Flop
Seat 3: Snegul (big blind) folded before Flop
Seat 4: vais8 folded on the Flop
Seat 5: hc agorist folded before Flop (didn't bet)
Seat 6: SKFin folded before Flop (didn't bet)



PokerStars Zoom Hand #193394952216:  Hold'em No Limit ($0.01/$0.02) - 2018/11/17 1:29:18 CUST [2018/11/16 12:29:18 ET]
Table 'Halley' 6-max Seat #1 is the button
Seat 1: amg1155 ($2.34 in chips) 
Seat 2: m3ssy34 ($1.25 in chips) 
Seat 3: Savavlad97 ($3.11 in chips) 
Seat 4: Vule_ot ($2 in chips) 
Seat 5: hc agorist ($3.26 in chips) 
Seat 6: CloseR28 ($1.11 in chips) 
m3ssy34: posts small blind $0.01
Savavlad97: posts big blind $0.02
*** HOLE CARDS ***
Dealt to hc agorist [3h As]
Vule_ot: folds 
hc agorist: folds 
CloseR28: folds 
amg1155: raises $0.04 to $0.06
m3ssy34: folds 
Savavlad97: raises $0.12 to $0.18
amg1155: calls $0.12
*** FLOP *** [Jh 4s Tc]
Savavlad97: bets $0.14
amg1155: calls $0.14
*** TURN *** [Jh 4s Tc] [7h]
Savavlad97: bets $0.48
amg1155: calls $0.48
*** RIVER *** [Jh 4s Tc 7h] [3d]
Savavlad97: bets $2.31 and is all-in
amg1155: calls $1.54 and is all-in
Uncalled bet ($0.77) returned to Savavlad97
*** SHOW DOWN ***
Savavlad97: shows [8d 6d] (high card Jack)
amg1155: shows [Kd Ks] (a pair of Kings)
amg1155 collected $4.53 from pot
*** SUMMARY ***
Total pot $4.69 | Rake $0.16 
Board [Jh 4s Tc 7h 3d]
Seat 1: amg1155 (button) showed [Kd Ks] and won ($4.53) with a pair of Kings
Seat 2: m3ssy34 (small blind) folded before Flop
Seat 3: Savavlad97 (big blind) showed [8d 6d] and lost with high card Jack
Seat 4: Vule_ot folded before Flop (didn't bet)
Seat 5: hc agorist folded before Flop (didn't bet)
Seat 6: CloseR28 folded before Flop (didn't bet)



PokerStars Zoom Hand #193394967126:  Hold'em No Limit ($0.01/$0.02) - 2018/11/17 1:29:43 CUST [2018/11/16 12:29:43 ET]
Table 'Halley' 6-max Seat #1 is the button
Seat 1: hc agorist ($3.23 in chips) 
Seat 2: Viktoria9555 ($1.57 in chips) 
Seat 3: garrangarran ($1.01 in chips) 
Seat 4: khalatov ($3.21 in chips) 
Seat 5: AngelBear82 ($6.04 in chips) 
Seat 6: Crowy21 ($2.87 in chips) 
Viktoria9555: posts small blind $0.01
garrangarran: posts big blind $0.02
*** HOLE CARDS ***
Dealt to hc agorist [Qd Tc]
khalatov: folds 
AngelBear82: raises $0.04 to $0.06
Crowy21: calls $0.06
hc agorist: raises $0.18 to $0.24
Viktoria9555: folds 
garrangarran: folds 
AngelBear82: folds 
Crowy21: calls $0.18
*** FLOP *** [6s 4d Ks]
Crowy21: checks 
hc agorist: bets $0.18
Crowy21: calls $0.18
*** TURN *** [6s 4d Ks] [As]
Crowy21: checks 
hc agorist: bets $0.58
Crowy21: calls $0.58
*** RIVER *** [6s 4d Ks As] [2d]
Crowy21: checks 
hc agorist: bets $2.23 and is all-in
Crowy21: folds 
Uncalled bet ($2.23) returned to hc agorist
hc agorist collected $2.02 from pot
hc agorist: doesn't show hand 
*** SUMMARY ***
Total pot $2.09 | Rake $0.07 
Board [6s 4d Ks As 2d]
Seat 1: hc agorist (button) collected ($2.02)
Seat 2: Viktoria9555 (small blind) folded before Flop
Seat 3: garrangarran (big blind) folded before Flop
Seat 4: khalatov folded before Flop (didn't bet)
Seat 5: AngelBear82 folded before Flop
Seat 6: Crowy21 folded on the River



PokerStars Zoom Hand #193395003149:  Hold'em No Limit ($0.01/$0.02) - 2018/11/17 1:30:42 CUST [2018/11/16 12:30:42 ET]
Table 'Halley' 6-max Seat #1 is the button
Seat 1: 3Steve808 ($2 in chips) 
Seat 2: Caramba191 ($3.35 in chips) 
Seat 3: Harvey418 ($1 in chips) 
Seat 4: PritkovO ($1.07 in chips) 
Seat 5: Qwkl ($2.35 in chips) 
Seat 6: hc agorist ($4.25 in chips) 
Caramba191: posts small blind $0.01
Harvey418: posts big blind $0.02
*** HOLE CARDS ***
Dealt to hc agorist [As 3s]
PritkovO: folds 
Qwkl: folds 
hc agorist: raises $0.04 to $0.06
3Steve808: folds 
Caramba191: folds 
Harvey418: calls $0.04
*** FLOP *** [Td 6c Kd]
Harvey418: bets $0.02
hc agorist: calls $0.02
*** TURN *** [Td 6c Kd] [3d]
Harvey418: bets $0.16
hc agorist: folds 
Uncalled bet ($0.16) returned to Harvey418
Harvey418 collected $0.16 from pot
Harvey418: doesn't show hand 
*** SUMMARY ***
Total pot $0.17 | Rake $0.01 
Board [Td 6c Kd 3d]
Seat 1: 3Steve808 (button) folded before Flop (didn't bet)
Seat 2: Caramba191 (small blind) folded before Flop
Seat 3: Harvey418 (big blind) collected ($0.16)
Seat 4: PritkovO folded before Flop (didn't bet)
Seat 5: Qwkl folded before Flop (didn't bet)
Seat 6: hc agorist folded on the Turn



PokerStars Zoom Hand #193395024839:  Hold'em No Limit ($0.01/$0.02) - 2018/11/17 1:31:18 CUST [2018/11/16 12:31:18 ET]
Table 'Halley' 6-max Seat #1 is the button
Seat 1: Viktoria9555 ($1.59 in chips) 
Seat 2: hc agorist ($4.17 in chips) 
Seat 3: alisk0 ($1.92 in chips) 
Seat 4: gerbrisk ($2.03 in chips) 
Seat 5: sseldog1859 ($2.25 in chips) 
Seat 6: vallvulk ($1.91 in chips) 
hc agorist: posts small blind $0.01
alisk0: posts big blind $0.02
*** HOLE CARDS ***
Dealt to hc agorist [4c 5s]
gerbrisk: folds 
sseldog1859: folds 
vallvulk: raises $0.04 to $0.06
Viktoria9555: calls $0.06
hc agorist: folds 
alisk0: folds 
*** FLOP *** [6d 2d 3h]
vallvulk: bets $0.08
Viktoria9555: folds 
Uncalled bet ($0.08) returned to vallvulk
vallvulk collected $0.14 from pot
vallvulk: doesn't show hand 
*** SUMMARY ***
Total pot $0.15 | Rake $0.01 
Board [6d 2d 3h]
Seat 1: Viktoria9555 (button) folded on the Flop
Seat 2: hc agorist (small blind) folded before Flop
Seat 3: alisk0 (big blind) folded before Flop
Seat 4: gerbrisk folded before Flop (didn't bet)
Seat 5: sseldog1859 folded before Flop (didn't bet)
Seat 6: vallvulk collected ($0.14)



PokerStars Zoom Hand #193395021927:  Hold'em No Limit ($0.01/$0.02) - 2018/11/17 1:31:13 CUST [2018/11/16 12:31:13 ET]
Table 'Halley' 6-max Seat #1 is the button
Seat 1: devilseam264 ($3.89 in chips) 
Seat 2: chala-man999 ($2.06 in chips) 
Seat 3: RocknRolla5 ($2.08 in chips) 
Seat 4: hc agorist ($4.17 in chips) 
Seat 5: max.m.7deiL ($1.03 in chips) 
Seat 6: ForHistory ($3.73 in chips) 
chala-man999: posts small blind $0.01
RocknRolla5: posts big blind $0.02
*** HOLE CARDS ***
Dealt to hc agorist [9s 2s]
hc agorist: folds 
max.m.7deiL: folds 
ForHistory: folds 
devilseam264: folds 
chala-man999: raises $0.03 to $0.05
RocknRolla5: calls $0.03
*** FLOP *** [8s Qd 3s]
chala-man999: checks 
RocknRolla5: checks 
*** TURN *** [8s Qd 3s] [9h]
chala-man999: checks 
RocknRolla5: checks 
*** RIVER *** [8s Qd 3s 9h] [As]
chala-man999: checks 
RocknRolla5: bets $0.07
chala-man999: folds 
Uncalled bet ($0.07) returned to RocknRolla5
RocknRolla5 collected $0.10 from pot
RocknRolla5: doesn't show hand 
*** SUMMARY ***
Total pot $0.10 | Rake $0 
Board [8s Qd 3s 9h As]
Seat 1: devilseam264 (button) folded before Flop (didn't bet)
Seat 2: chala-man999 (small blind) folded on the River
Seat 3: RocknRolla5 (big blind) collected ($0.10)
Seat 4: hc agorist folded before Flop (didn't bet)
Seat 5: max.m.7deiL folded before Flop (didn't bet)
Seat 6: ForHistory folded before Flop (didn't bet)



PokerStars Zoom Hand #193395030457:  Hold'em No Limit ($0.01/$0.02) - 2018/11/17 1:31:27 CUST [2018/11/16 12:31:27 ET]
Table 'Halley' 6-max Seat #1 is the button
Seat 1: blackshpak ($2.54 in chips) 
Seat 2: cykablyatx ($2.15 in chips) 
Seat 3: Party4Arthy ($2.46 in chips) 
Seat 4: hc agorist ($4.16 in chips) 
Seat 5: Smirandal ($0.58 in chips) 
Seat 6: Armavir911 ($0.84 in chips) 
cykablyatx: posts small blind $0.01
Party4Arthy: posts big blind $0.02
*** HOLE CARDS ***
Dealt to hc agorist [Ks Ah]
hc agorist: raises $0.04 to $0.06
Smirandal: folds 
Armavir911: folds 
blackshpak: calls $0.06
cykablyatx: folds 
Party4Arthy: folds 
*** FLOP *** [Kh 7h 4s]
hc agorist: checks 
blackshpak: checks 
*** TURN *** [Kh 7h 4s] [Jd]
hc agorist: bets $0.12
blackshpak: folds 
Uncalled bet ($0.12) returned to hc agorist
hc agorist collected $0.14 from pot
hc agorist: doesn't show hand 
*** SUMMARY ***
Total pot $0.15 | Rake $0.01 
Board [Kh 7h 4s Jd]
Seat 1: blackshpak (button) folded on the Turn
Seat 2: cykablyatx (small blind) folded before Flop
Seat 3: Party4Arthy (big blind) folded before Flop
Seat 4: hc agorist collected ($0.14)
Seat 5: Smirandal folded before Flop (didn't bet)
Seat 6: Armavir911 folded before Flop (didn't bet)



PokerStars Zoom Hand #193395027321:  Hold'em No Limit ($0.01/$0.02) - 2018/11/17 1:31:22 CUST [2018/11/16 12:31:22 ET]
Table 'Halley' 6-max Seat #1 is the button
Seat 1: MadElegant ($2.97 in chips) 
Seat 2: ferenc456456 ($1.62 in chips) 
Seat 3: hazza257 ($2 in chips) 
Seat 4: ziaa 808 ($1.72 in chips) 
Seat 5: S. Biemans ($12.12 in chips) 
Seat 6: hc agorist ($4.16 in chips) 
ferenc456456: posts small blind $0.01
hazza257: posts big blind $0.02
*** HOLE CARDS ***
Dealt to hc agorist [7c 2d]
ziaa 808: folds 
S. Biemans: folds 
hc agorist: folds 
MadElegant: raises $0.03 to $0.05
ferenc456456: calls $0.04
hazza257: folds 
*** FLOP *** [3h 8h Qh]
ferenc456456: checks 
MadElegant: checks 
*** TURN *** [3h 8h Qh] [7s]
ferenc456456: bets $0.07
MadElegant: calls $0.07
*** RIVER *** [3h 8h Qh 7s] [Tc]
ferenc456456: bets $0.14
MadElegant: folds 
Uncalled bet ($0.14) returned to ferenc456456
ferenc456456 collected $0.25 from pot
ferenc456456: doesn't show hand 
*** SUMMARY ***
Total pot $0.26 | Rake $0.01 
Board [3h 8h Qh 7s Tc]
Seat 1: MadElegant (button) folded on the River
Seat 2: ferenc456456 (small blind) collected ($0.25)
Seat 3: hazza257 (big blind) folded before Flop
Seat 4: ziaa 808 folded before Flop (didn't bet)
Seat 5: S. Biemans folded before Flop (didn't bet)
Seat 6: hc agorist folded before Flop (didn't bet)



PokerStars Zoom Hand #193395051864:  Hold'em No Limit ($0.01/$0.02) - 2018/11/17 1:32:02 CUST [2018/11/16 12:32:02 ET]
Table 'Halley' 6-max Seat #1 is the button
Seat 1: xafe367 ($2.58 in chips) 
Seat 2: LigoL ($2.02 in chips) 
Seat 3: hc agorist ($4.24 in chips) 
Seat 4: 3omigo ($3 in chips) 
Seat 5: orangos ($1.84 in chips) 
Seat 6: Rybka4.1 ($2.25 in chips) 
LigoL: posts small blind $0.01
hc agorist: posts big blind $0.02
*** HOLE CARDS ***
Dealt to hc agorist [5s Ks]
3omigo: raises $0.03 to $0.05
orangos: folds 
Rybka4.1: folds 
xafe367: folds 
LigoL: folds 
hc agorist: folds 
Uncalled bet ($0.03) returned to 3omigo
3omigo collected $0.05 from pot
3omigo: doesn't show hand 
*** SUMMARY ***
Total pot $0.05 | Rake $0 
Seat 1: xafe367 (button) folded before Flop (didn't bet)
Seat 2: LigoL (small blind) folded before Flop
Seat 3: hc agorist (big blind) folded before Flop
Seat 4: 3omigo collected ($0.05)
Seat 5: orangos folded before Flop (didn't bet)
Seat 6: Rybka4.1 folded before Flop (didn't bet)



PokerStars Zoom Hand #193395058511:  Hold'em No Limit ($0.01/$0.02) - 2018/11/17 1:32:13 CUST [2018/11/16 12:32:13 ET]
Table 'Halley' 6-max Seat #1 is the button
Seat 1: wildberi ($2 in chips) 
Seat 2: hc agorist ($4.22 in chips) 
Seat 3: don_energo2 ($2.14 in chips) 
Seat 4: Quadko228 ($2.91 in chips) 
Seat 5: RIMMM867 ($1.04 in chips) 
Seat 6: artpoker77 ($1.15 in chips) 
hc agorist: posts small blind $0.01
don_energo2: posts big blind $0.02
*** HOLE CARDS ***
Dealt to hc agorist [4h Ks]
Quadko228: raises $0.04 to $0.06
RIMMM867: folds 
artpoker77: folds 
wildberi: folds 
hc agorist: folds 
don_energo2: folds 
Uncalled bet ($0.04) returned to Quadko228
Quadko228 collected $0.05 from pot
Quadko228: doesn't show hand 
*** SUMMARY ***
Total pot $0.05 | Rake $0 
Seat 1: wildberi (button) folded before Flop (didn't bet)
Seat 2: hc agorist (small blind) folded before Flop
Seat 3: don_energo2 (big blind) folded before Flop
Seat 4: Quadko228 collected ($0.05)
Seat 5: RIMMM867 folded before Flop (didn't bet)
Seat 6: artpoker77 folded before Flop (didn't bet)



PokerStars Zoom Hand #193395055516:  Hold'em No Limit ($0.01/$0.02) - 2018/11/17 1:32:08 CUST [2018/11/16 12:32:08 ET]
Table 'Halley' 6-max Seat #1 is the button
Seat 1: kugelmeer ($4.37 in chips) 
Seat 2: Daleks0512 ($1.24 in chips) 
Seat 3: hazza257 ($2 in chips) 
Seat 4: Crowy21 ($3.81 in chips) 
Seat 5: hc agorist ($4.22 in chips) 
Seat 6: MistrzPaki ($1.48 in chips) 
Daleks0512: posts small blind $0.01
hazza257: posts big blind $0.02
*** HOLE CARDS ***
Dealt to hc agorist [7h 3s]
Crowy21: folds 
hc agorist: folds 
MistrzPaki: folds 
kugelmeer: raises $0.04 to $0.06
Daleks0512: calls $0.05
hazza257: folds 
*** FLOP *** [Qc 8h 7s]
Daleks0512: checks 
kugelmeer: checks 
*** TURN *** [Qc 8h 7s] [7d]
Daleks0512: checks 
kugelmeer: checks 
*** RIVER *** [Qc 8h 7s 7d] [3h]
Daleks0512: checks 
kugelmeer: checks 
*** SHOW DOWN ***
Daleks0512: shows [Tc As] (a pair of Sevens)
kugelmeer: shows [Kd Ad] (a pair of Sevens - Ace+King kicker)
kugelmeer collected $0.14 from pot
*** SUMMARY ***
Total pot $0.14 | Rake $0 
Board [Qc 8h 7s 7d 3h]
Seat 1: kugelmeer (button) showed [Kd Ad] and won ($0.14) with a pair of Sevens
Seat 2: Daleks0512 (small blind) showed [Tc As] and lost with a pair of Sevens
Seat 3: hazza257 (big blind) folded before Flop
Seat 4: Crowy21 folded before Flop (didn't bet)
Seat 5: hc agorist folded before Flop (didn't bet)
Seat 6: MistrzPaki folded before Flop (didn't bet)



PokerStars Zoom Hand #193395061616:  Hold'em No Limit ($0.01/$0.02) - 2018/11/17 1:32:18 CUST [2018/11/16 12:32:18 ET]
Table 'Halley' 6-max Seat #1 is the button
Seat 1: hc agorist ($4.21 in chips) 
Seat 2: AdDeNooijer ($4.21 in chips) 
Seat 3: hsienko ($2 in chips) 
Seat 4: Enlassombras ($2 in chips) 
Seat 5: LdnOnDTrack ($4.04 in chips) 
Seat 6: darkoldmaker ($2.01 in chips) 
AdDeNooijer: posts small blind $0.01
hsienko: posts big blind $0.02
*** HOLE CARDS ***
Dealt to hc agorist [Ac 5c]
Enlassombras: folds 
LdnOnDTrack: folds 
darkoldmaker: folds 
hc agorist: raises $0.04 to $0.06
AdDeNooijer: folds 
hsienko: calls $0.04
*** FLOP *** [8h 6h 7c]
hsienko: checks 
hc agorist: checks 
*** TURN *** [8h 6h 7c] [Kc]
hsienko: checks 
hc agorist: bets $0.12
hsienko: folds 
Uncalled bet ($0.12) returned to hc agorist
hc agorist collected $0.13 from pot
hc agorist: doesn't show hand 
*** SUMMARY ***
Total pot $0.13 | Rake $0 
Board [8h 6h 7c Kc]
Seat 1: hc agorist (button) collected ($0.13)
Seat 2: AdDeNooijer (small blind) folded before Flop
Seat 3: hsienko (big blind) folded on the Turn
Seat 4: Enlassombras folded before Flop (didn't bet)
Seat 5: LdnOnDTrack folded before Flop (didn't bet)
Seat 6: darkoldmaker folded before Flop (didn't bet)



PokerStars Zoom Hand #193395089824:  Hold'em No Limit ($0.01/$0.02) - 2018/11/17 1:33:04 CUST [2018/11/16 12:33:04 ET]
Table 'Halley' 6-max Seat #1 is the button
Seat 1: hc agorist ($4.28 in chips) 
Seat 2: trad_mac ($2.03 in chips) 
Seat 3: Le Clienth ($4.21 in chips) 
Seat 4: pmb1984 ($2 in chips) 
Seat 5: ZKM10 ($2.02 in chips) 
Seat 6: maris1993 ($3.51 in chips) 
trad_mac: posts small blind $0.01
Le Clienth: posts big blind $0.02
*** HOLE CARDS ***
Dealt to hc agorist [8d 5s]
pmb1984: raises $0.05 to $0.07
ZKM10: calls $0.07
maris1993: folds 
hc agorist: folds 
trad_mac: folds 
Le Clienth: folds 
*** FLOP *** [3d 8h 8s]
pmb1984: bets $0.08
ZKM10: calls $0.08
*** TURN *** [3d 8h 8s] [9h]
pmb1984: checks 
ZKM10: bets $0.21
pmb1984: folds 
Uncalled bet ($0.21) returned to ZKM10
ZKM10 collected $0.32 from pot
ZKM10: doesn't show hand 
*** SUMMARY ***
Total pot $0.33 | Rake $0.01 
Board [3d 8h 8s 9h]
Seat 1: hc agorist (button) folded before Flop (didn't bet)
Seat 2: trad_mac (small blind) folded before Flop
Seat 3: Le Clienth (big blind) folded before Flop
Seat 4: pmb1984 folded on the Turn
Seat 5: ZKM10 collected ($0.32)
Seat 6: maris1993 folded before Flop (didn't bet)



PokerStars Zoom Hand #193395092907:  Hold'em No Limit ($0.01/$0.02) - 2018/11/17 1:33:09 CUST [2018/11/16 12:33:09 ET]
Table 'Halley' 6-max Seat #1 is the button
Seat 1: baget36 ($2.52 in chips) 
Seat 2: S7CRENYZ ($2.34 in chips) 
Seat 3: himani7 ($2 in chips) 
Seat 4: chancefatum ($3.33 in chips) 
Seat 5: plasencia345 ($4.14 in chips) 
Seat 6: hc agorist ($4.28 in chips) 
S7CRENYZ: posts small blind $0.01
himani7: posts big blind $0.02
*** HOLE CARDS ***
Dealt to hc agorist [6s Jd]
chancefatum: folds 
plasencia345: folds 
hc agorist: folds 
baget36: raises $0.02 to $0.04
S7CRENYZ: folds 
himani7: calls $0.02
*** FLOP *** [9c 5c 7c]
himani7: bets $0.08
baget36: folds 
Uncalled bet ($0.08) returned to himani7
himani7 collected $0.09 from pot
himani7: doesn't show hand 
*** SUMMARY ***
Total pot $0.09 | Rake $0 
Board [9c 5c 7c]
Seat 1: baget36 (button) folded on the Flop
Seat 2: S7CRENYZ (small blind) folded before Flop
Seat 3: himani7 (big blind) collected ($0.09)
Seat 4: chancefatum folded before Flop (didn't bet)
Seat 5: plasencia345 folded before Flop (didn't bet)
Seat 6: hc agorist folded before Flop (didn't bet)



PokerStars Zoom Hand #193395096515:  Hold'em No Limit ($0.01/$0.02) - 2018/11/17 1:33:15 CUST [2018/11/16 12:33:15 ET]
Table 'Halley' 6-max Seat #1 is the button
Seat 1: MistrzPaki ($6.68 in chips) 
Seat 2: all_starrrs ($0.85 in chips) 
Seat 3: hc agorist ($4.28 in chips) 
Seat 4: plasencia345 ($4.14 in chips) 
Seat 5: July Van7 ($2.26 in chips) 
Seat 6: Takich7 ($2.01 in chips) 
all_starrrs: posts small blind $0.01
hc agorist: posts big blind $0.02
*** HOLE CARDS ***
Dealt to hc agorist [Kh Ah]
plasencia345: folds 
July Van7: folds 
Takich7: raises $0.04 to $0.06
MistrzPaki: folds 
all_starrrs: folds 
hc agorist: raises $0.18 to $0.24
Takich7: folds 
Uncalled bet ($0.18) returned to hc agorist
hc agorist collected $0.13 from pot
hc agorist: doesn't show hand 
*** SUMMARY ***
Total pot $0.13 | Rake $0 
Seat 1: MistrzPaki (button) folded before Flop (didn't bet)
Seat 2: all_starrrs (small blind) folded before Flop
Seat 3: hc agorist (big blind) collected ($0.13)
Seat 4: plasencia345 folded before Flop (didn't bet)
Seat 5: July Van7 folded before Flop (didn't bet)
Seat 6: Takich7 folded before Flop



PokerStars Zoom Hand #193395118957:  Hold'em No Limit ($0.01/$0.02) - 2018/11/17 1:33:51 CUST [2018/11/16 12:33:51 ET]
Table 'Halley' 6-max Seat #1 is the button
Seat 1: ventur5 ($1.90 in chips) 
Seat 2: Wild Sttar ($2.03 in chips) 
Seat 3: pmb1984 ($2.07 in chips) 
Seat 4: hc agorist ($4.35 in chips) 
Seat 5: laoban888 ($2.09 in chips) 
Seat 6: Dimoni797979 ($9.93 in chips) 
Wild Sttar: posts small blind $0.01
pmb1984: posts big blind $0.02
*** HOLE CARDS ***
Dealt to hc agorist [Qs 5c]
hc agorist: folds 
laoban888: folds 
Dimoni797979: folds 
ventur5: folds 
Wild Sttar: folds 
Uncalled bet ($0.01) returned to pmb1984
pmb1984 collected $0.02 from pot
pmb1984: doesn't show hand 
*** SUMMARY ***
Total pot $0.02 | Rake $0 
Seat 1: ventur5 (button) folded before Flop (didn't bet)
Seat 2: Wild Sttar (small blind) folded before Flop
Seat 3: pmb1984 (big blind) collected ($0.02)
Seat 4: hc agorist folded before Flop (didn't bet)
Seat 5: laoban888 folded before Flop (didn't bet)
Seat 6: Dimoni797979 folded before Flop (didn't bet)



PokerStars Zoom Hand #193395122089:  Hold'em No Limit ($0.01/$0.02) - 2018/11/17 1:33:56 CUST [2018/11/16 12:33:56 ET]
Table 'Halley' 6-max Seat #1 is the button
Seat 1: SILK207 ($2.80 in chips) 
Seat 2: hc agorist ($4.35 in chips) 
Seat 3: elite252 ($2.03 in chips) 
Seat 4: 1nnuendo ($2.02 in chips) 
Seat 5: Logrus99 ($1.17 in chips) 
Seat 6: sseldog1859 ($2.18 in chips) 
hc agorist: posts small blind $0.01
elite252: posts big blind $0.02
*** HOLE CARDS ***
Dealt to hc agorist [As Ad]
1nnuendo: folds 
Logrus99: folds 
sseldog1859: folds 
SILK207: raises $0.02 to $0.04
hc agorist: raises $0.14 to $0.18
elite252: folds 
SILK207: folds 
Uncalled bet ($0.14) returned to hc agorist
hc agorist collected $0.10 from pot
hc agorist: doesn't show hand 
*** SUMMARY ***
Total pot $0.10 | Rake $0 
Seat 1: SILK207 (button) folded before Flop
Seat 2: hc agorist (small blind) collected ($0.10)
Seat 3: elite252 (big blind) folded before Flop
Seat 4: 1nnuendo folded before Flop (didn't bet)
Seat 5: Logrus99 folded before Flop (didn't bet)
Seat 6: sseldog1859 folded before Flop (didn't bet)



PokerStars Zoom Hand #193395115274:  Hold'em No Limit ($0.01/$0.02) - 2018/11/17 1:33:45 CUST [2018/11/16 12:33:45 ET]
Table 'Halley' 6-max Seat #1 is the button
Seat 1: RIMMM867 ($0.73 in chips) 
Seat 2: Danilloo93 ($2.07 in chips) 
Seat 3: Cloud_Hsieh ($2 in chips) 
Seat 4: chipkid11 ($3.38 in chips) 
Seat 5: hc agorist ($4.35 in chips) 
Seat 6: CowboyNicky ($2.18 in chips) 
Danilloo93: posts small blind $0.01
Cloud_Hsieh: posts big blind $0.02
*** HOLE CARDS ***
Dealt to hc agorist [Js 5d]
chipkid11: calls $0.02
hc agorist: folds 
CowboyNicky: calls $0.02
RIMMM867: folds 
Danilloo93: folds 
Cloud_Hsieh: checks 
*** FLOP *** [Ad 9s Td]
Cloud_Hsieh: checks 
chipkid11: checks 
CowboyNicky: bets $0.05
Cloud_Hsieh: folds 
chipkid11: calls $0.05
*** TURN *** [Ad 9s Td] [Qc]
chipkid11: checks 
CowboyNicky: bets $0.11
chipkid11: calls $0.11
*** RIVER *** [Ad 9s Td Qc] [Kh]
chipkid11: bets $0.21
CowboyNicky: folds 
Uncalled bet ($0.21) returned to chipkid11
chipkid11 collected $0.38 from pot
chipkid11: doesn't show hand 
*** SUMMARY ***
Total pot $0.39 | Rake $0.01 
Board [Ad 9s Td Qc Kh]
Seat 1: RIMMM867 (button) folded before Flop (didn't bet)
Seat 2: Danilloo93 (small blind) folded before Flop
Seat 3: Cloud_Hsieh (big blind) folded on the Flop
Seat 4: chipkid11 collected ($0.38)
Seat 5: hc agorist folded before Flop (didn't bet)
Seat 6: CowboyNicky folded on the River



PokerStars Zoom Hand #193395136061:  Hold'em No Limit ($0.01/$0.02) - 2018/11/17 1:34:19 CUST [2018/11/16 12:34:19 ET]
Table 'Halley' 6-max Seat #1 is the button
Seat 1: pianobeast ($3.25 in chips) 
Seat 2: SkyElephant ($2 in chips) 
Seat 3: RatMaster123 ($2.05 in chips) 
Seat 4: hc agorist ($4.41 in chips) 
Seat 5: ForHistory ($2.12 in chips) 
Seat 6: laoban888 ($2.47 in chips) 
SkyElephant: posts small blind $0.01
RatMaster123: posts big blind $0.02
*** HOLE CARDS ***
Dealt to hc agorist [5d Kh]
hc agorist: folds 
ForHistory: folds 
laoban888: folds 
pianobeast: raises $0.04 to $0.06
SkyElephant: folds 
RatMaster123: folds 
Uncalled bet ($0.04) returned to pianobeast
pianobeast collected $0.05 from pot
pianobeast: doesn't show hand 
*** SUMMARY ***
Total pot $0.05 | Rake $0 
Seat 1: pianobeast (button) collected ($0.05)
Seat 2: SkyElephant (small blind) folded before Flop
Seat 3: RatMaster123 (big blind) folded before Flop
Seat 4: hc agorist folded before Flop (didn't bet)
Seat 5: ForHistory folded before Flop (didn't bet)
Seat 6: laoban888 folded before Flop (didn't bet)



PokerStars Zoom Hand #193395139134:  Hold'em No Limit ($0.01/$0.02) - 2018/11/17 1:34:24 CUST [2018/11/16 12:34:24 ET]
Table 'Halley' 6-max Seat #1 is the button
Seat 1: Williwacker9 ($2.20 in chips) 
Seat 2: VladKot ($2.20 in chips) 
Seat 3: hc agorist ($4.41 in chips) 
Seat 4: Elchaza_1989 ($2.74 in chips) 
Seat 5: RocknRolla5 ($2.31 in chips) 
Seat 6: gerykoma ($2.08 in chips) 
VladKot: posts small blind $0.01
hc agorist: posts big blind $0.02
*** HOLE CARDS ***
Dealt to hc agorist [Js 5c]
Elchaza_1989: folds 
RocknRolla5: folds 
gerykoma: folds 
Williwacker9: folds 
VladKot: folds 
Uncalled bet ($0.01) returned to hc agorist
hc agorist collected $0.02 from pot
hc agorist: doesn't show hand 
*** SUMMARY ***
Total pot $0.02 | Rake $0 
Seat 1: Williwacker9 (button) folded before Flop (didn't bet)
Seat 2: VladKot (small blind) folded before Flop
Seat 3: hc agorist (big blind) collected ($0.02)
Seat 4: Elchaza_1989 folded before Flop (didn't bet)
Seat 5: RocknRolla5 folded before Flop (didn't bet)
Seat 6: gerykoma folded before Flop (didn't bet)



PokerStars Zoom Hand #193395151937:  Hold'em No Limit ($0.01/$0.02) - 2018/11/17 1:34:45 CUST [2018/11/16 12:34:45 ET]
Table 'Halley' 6-max Seat #1 is the button
Seat 1: hc agorist ($4.42 in chips) 
Seat 2: alexborovDEN ($1.01 in chips) 
Seat 3: Qwkl ($2.11 in chips) 
Seat 4: evaevaevita ($1.97 in chips) 
Seat 5: BuddhaJesu ($1.33 in chips) 
Seat 6: RatMaster123 ($2.06 in chips) 
alexborovDEN: posts small blind $0.01
Qwkl: posts big blind $0.02
*** HOLE CARDS ***
Dealt to hc agorist [2h 7c]
evaevaevita: folds 
BuddhaJesu: raises $0.04 to $0.06
RatMaster123: folds 
hc agorist: folds 
alexborovDEN: folds 
Qwkl: folds 
Uncalled bet ($0.04) returned to BuddhaJesu
BuddhaJesu collected $0.05 from pot
BuddhaJesu: doesn't show hand 
*** SUMMARY ***
Total pot $0.05 | Rake $0 
Seat 1: hc agorist (button) folded before Flop (didn't bet)
Seat 2: alexborovDEN (small blind) folded before Flop
Seat 3: Qwkl (big blind) folded before Flop
Seat 4: evaevaevita folded before Flop (didn't bet)
Seat 5: BuddhaJesu collected ($0.05)
Seat 6: RatMaster123 folded before Flop (didn't bet)



PokerStars Zoom Hand #193395133105:  Hold'em No Limit ($0.01/$0.02) - 2018/11/17 1:34:14 CUST [2018/11/16 12:34:14 ET]
Table 'Halley' 6-max Seat #1 is the button
Seat 1: Zeemaz ($3.06 in chips) 
Seat 2: FMorgen ($2.92 in chips) 
Seat 3: Qwkl ($2.44 in chips) 
Seat 4: AertsTim ($2.15 in chips) 
Seat 5: Revers1990 ($2.53 in chips) 
Seat 6: hc agorist ($4.41 in chips) 
FMorgen: posts small blind $0.01
Qwkl: posts big blind $0.02
*** HOLE CARDS ***
Dealt to hc agorist [6h Ts]
AertsTim: folds 
Revers1990: raises $0.03 to $0.05
hc agorist: folds 
Zeemaz: calls $0.05
FMorgen: calls $0.04
Qwkl: folds 
*** FLOP *** [Td Qh 2h]
FMorgen: checks 
Revers1990: bets $0.10
Zeemaz: calls $0.10
FMorgen: folds 
*** TURN *** [Td Qh 2h] [Kh]
Revers1990: bets $0.22
Zeemaz: calls $0.22
*** RIVER *** [Td Qh 2h Kh] [9s]
Revers1990: checks 
Zeemaz: bets $0.64
Revers1990: calls $0.64
*** SHOW DOWN ***
Zeemaz: shows [Jd Jh] (a straight, Nine to King)
Revers1990: mucks hand 
Zeemaz collected $2.02 from pot
*** SUMMARY ***
Total pot $2.09 | Rake $0.07 
Board [Td Qh 2h Kh 9s]
Seat 1: Zeemaz (button) showed [Jd Jh] and won ($2.02) with a straight, Nine to King
Seat 2: FMorgen (small blind) folded on the Flop
Seat 3: Qwkl (big blind) folded before Flop
Seat 4: AertsTim folded before Flop (didn't bet)
Seat 5: Revers1990 mucked [Ah As]
Seat 6: hc agorist folded before Flop (didn't bet)



PokerStars Zoom Hand #193395147576:  Hold'em No Limit ($0.01/$0.02) - 2018/11/17 1:34:38 CUST [2018/11/16 12:34:38 ET]
Table 'Halley' 6-max Seat #1 is the button
Seat 1: pyrosteam ($2 in chips) 
Seat 2: tenenson ($2.03 in chips) 
Seat 3: Alexromcar ($2 in chips) 
Seat 4: PARIKMAXER88 ($1.10 in chips) 
Seat 5: Crazy Oll ($3.06 in chips) 
Seat 6: hc agorist ($4.42 in chips) 
tenenson: posts small blind $0.01
Alexromcar: posts big blind $0.02
*** HOLE CARDS ***
Dealt to hc agorist [9h 4s]
PARIKMAXER88: folds 
Crazy Oll: folds 
hc agorist: folds 
pyrosteam: raises $0.04 to $0.06
tenenson: folds 
Alexromcar: folds 
Uncalled bet ($0.04) returned to pyrosteam
pyrosteam collected $0.05 from pot
pyrosteam: doesn't show hand 
*** SUMMARY ***
Total pot $0.05 | Rake $0 
Seat 1: pyrosteam (button) collected ($0.05)
Seat 2: tenenson (small blind) folded before Flop
Seat 3: Alexromcar (big blind) folded before Flop
Seat 4: PARIKMAXER88 folded before Flop (didn't bet)
Seat 5: Crazy Oll folded before Flop (didn't bet)
Seat 6: hc agorist folded before Flop (didn't bet)



PokerStars Zoom Hand #193395156146:  Hold'em No Limit ($0.01/$0.02) - 2018/11/17 1:34:52 CUST [2018/11/16 12:34:52 ET]
Table 'Halley' 6-max Seat #1 is the button
Seat 1: SCORPMAN666 ($1.90 in chips) 
Seat 2: tank231 ($0.37 in chips) 
Seat 3: Williwacker9 ($2.22 in chips) 
Seat 4: BingoTilejmis ($2.24 in chips) 
Seat 5: hc agorist ($4.42 in chips) 
Seat 6: tsokos10 ($10.63 in chips) 
tank231: posts small blind $0.01
Williwacker9: posts big blind $0.02
*** HOLE CARDS ***
Dealt to hc agorist [Th 9h]
BingoTilejmis: folds 
hc agorist: raises $0.04 to $0.06
tsokos10: folds 
SCORPMAN666: calls $0.06
tank231: folds 
Williwacker9: folds 
*** FLOP *** [Ac 7s Qc]
hc agorist: checks 
SCORPMAN666: checks 
*** TURN *** [Ac 7s Qc] [As]
hc agorist: checks 
SCORPMAN666: checks 
*** RIVER *** [Ac 7s Qc As] [7c]
hc agorist: checks 
SCORPMAN666: checks 
*** SHOW DOWN ***
hc agorist: shows [Th 9h] (two pair, Aces and Sevens)
SCORPMAN666: shows [Td 5d] (two pair, Aces and Sevens)
hc agorist collected $0.07 from pot
SCORPMAN666 collected $0.07 from pot
*** SUMMARY ***
Total pot $0.15 | Rake $0.01 
Board [Ac 7s Qc As 7c]
Seat 1: SCORPMAN666 (button) showed [Td 5d] and won ($0.07) with two pair, Aces and Sevens
Seat 2: tank231 (small blind) folded before Flop
Seat 3: Williwacker9 (big blind) folded before Flop
Seat 4: BingoTilejmis folded before Flop (didn't bet)
Seat 5: hc agorist showed [Th 9h] and won ($0.07) with two pair, Aces and Sevens
Seat 6: tsokos10 folded before Flop (didn't bet)



PokerStars Zoom Hand #193395175085:  Hold'em No Limit ($0.01/$0.02) - 2018/11/17 1:35:23 CUST [2018/11/16 12:35:23 ET]
Table 'Halley' 6-max Seat #1 is the button
Seat 1: VreditelL ($4.95 in chips) 
Seat 2: hc agorist ($4.43 in chips) 
Seat 3: Beaker103 ($2.23 in chips) 
Seat 4: betojch ($2.76 in chips) 
Seat 5: Wild Sttar ($2.73 in chips) 
Seat 6: LigoL ($2.02 in chips) 
hc agorist: posts small blind $0.01
Beaker103: posts big blind $0.02
*** HOLE CARDS ***
Dealt to hc agorist [4d 8h]
betojch: folds 
Wild Sttar: folds 
LigoL: folds 
VreditelL: folds 
hc agorist: folds 
Uncalled bet ($0.01) returned to Beaker103
Beaker103 collected $0.02 from pot
Beaker103: doesn't show hand 
*** SUMMARY ***
Total pot $0.02 | Rake $0 
Seat 1: VreditelL (button) folded before Flop (didn't bet)
Seat 2: hc agorist (small blind) folded before Flop
Seat 3: Beaker103 (big blind) collected ($0.02)
Seat 4: betojch folded before Flop (didn't bet)
Seat 5: Wild Sttar folded before Flop (didn't bet)
Seat 6: LigoL folded before Flop (didn't bet)



PokerStars Zoom Hand #193395182493:  Hold'em No Limit ($0.01/$0.02) - 2018/11/17 1:35:35 CUST [2018/11/16 12:35:35 ET]
Table 'Halley' 6-max Seat #1 is the button
Seat 1: hc agorist ($4.42 in chips) 
Seat 2: esquime72 ($2.63 in chips) 
Seat 3: fishrus23 ($2.26 in chips) 
Seat 4: PritkovO ($0.87 in chips) 
Seat 5: tsokos10 ($5.59 in chips) 
Seat 6: gerbrisk ($2.46 in chips) 
esquime72: posts small blind $0.01
fishrus23: posts big blind $0.02
*** HOLE CARDS ***
Dealt to hc agorist [Qh 2h]
PritkovO: folds 
tsokos10: folds 
gerbrisk: folds 
hc agorist: folds 
esquime72: folds 
Uncalled bet ($0.01) returned to fishrus23
fishrus23 collected $0.02 from pot
fishrus23: doesn't show hand 
*** SUMMARY ***
Total pot $0.02 | Rake $0 
Seat 1: hc agorist (button) folded before Flop (didn't bet)
Seat 2: esquime72 (small blind) folded before Flop
Seat 3: fishrus23 (big blind) collected ($0.02)
Seat 4: PritkovO folded before Flop (didn't bet)
Seat 5: tsokos10 folded before Flop (didn't bet)
Seat 6: gerbrisk folded before Flop (didn't bet)



PokerStars Zoom Hand #193395188641:  Hold'em No Limit ($0.01/$0.02) - 2018/11/17 1:35:45 CUST [2018/11/16 12:35:45 ET]
Table 'Halley' 6-max Seat #1 is the button
Seat 1: dupon101 ($2.26 in chips) 
Seat 2: Daleks0512 ($1.17 in chips) 
Seat 3: rusich-vil ($2.03 in chips) 
Seat 4: ED_NEA ($2.36 in chips) 
Seat 5: EstebanTTT ($2.29 in chips) 
Seat 6: hc agorist ($4.42 in chips) 
Daleks0512: posts small blind $0.01
rusich-vil: posts big blind $0.02
*** HOLE CARDS ***
Dealt to hc agorist [2c Js]
ED_NEA: folds 
EstebanTTT: folds 
hc agorist: folds 
dupon101: folds 
Daleks0512: raises $0.06 to $0.08
rusich-vil: folds 
Uncalled bet ($0.06) returned to Daleks0512
Daleks0512 collected $0.04 from pot
Daleks0512: doesn't show hand 
*** SUMMARY ***
Total pot $0.04 | Rake $0 
Seat 1: dupon101 (button) folded before Flop (didn't bet)
Seat 2: Daleks0512 (small blind) collected ($0.04)
Seat 3: rusich-vil (big blind) folded before Flop
Seat 4: ED_NEA folded before Flop (didn't bet)
Seat 5: EstebanTTT folded before Flop (didn't bet)
Seat 6: hc agorist folded before Flop (didn't bet)



PokerStars Zoom Hand #193395185616:  Hold'em No Limit ($0.01/$0.02) - 2018/11/17 1:35:40 CUST [2018/11/16 12:35:40 ET]
Table 'Halley' 6-max Seat #1 is the button
Seat 1: DANILZOL ($1.97 in chips) 
Seat 2: Faiavuds ($1.74 in chips) 
Seat 3: Bombadao ($5.61 in chips) 
Seat 4: hc agorist ($4.42 in chips) 
Seat 5: Green3445 ($1.73 in chips) 
Seat 6: nullnullnull ($2.49 in chips) 
Faiavuds: posts small blind $0.01
Bombadao: posts big blind $0.02
*** HOLE CARDS ***
Dealt to hc agorist [Ts 2c]
hc agorist: folds 
Green3445: folds 
nullnullnull: folds 
DANILZOL: raises $0.04 to $0.06
Faiavuds: calls $0.05
Bombadao: folds 
*** FLOP *** [8d Jd Ah]
Faiavuds: bets $0.04
DANILZOL: raises $0.10 to $0.14
Faiavuds: calls $0.10
*** TURN *** [8d Jd Ah] [6d]
Faiavuds: checks 
DANILZOL: checks 
*** RIVER *** [8d Jd Ah 6d] [Ac]
Faiavuds: bets $0.41
DANILZOL: calls $0.41
*** SHOW DOWN ***
Faiavuds: shows [4d Ad] (a flush, Ace high)
DANILZOL: mucks hand 
Faiavuds collected $1.20 from pot
*** SUMMARY ***
Total pot $1.24 | Rake $0.04 
Board [8d Jd Ah 6d Ac]
Seat 1: DANILZOL (button) mucked [Qh Qs]
Seat 2: Faiavuds (small blind) showed [4d Ad] and won ($1.20) with a flush, Ace high
Seat 3: Bombadao (big blind) folded before Flop
Seat 4: hc agorist folded before Flop (didn't bet)
Seat 5: Green3445 folded before Flop (didn't bet)
Seat 6: nullnullnull folded before Flop (didn't bet)



PokerStars Zoom Hand #193395192254:  Hold'em No Limit ($0.01/$0.02) - 2018/11/17 1:35:51 CUST [2018/11/16 12:35:51 ET]
Table 'Halley' 6-max Seat #1 is the button
Seat 1: elvis_genius ($3.60 in chips) 
Seat 2: RAIN_ACID ($1.79 in chips) 
Seat 3: hc agorist ($4.42 in chips) 
Seat 4: mr.aslamin ($4.01 in chips) 
Seat 5: Hulyeur ($2.20 in chips) 
Seat 6: All-Might2018 ($1.31 in chips) 
RAIN_ACID: posts small blind $0.01
hc agorist: posts big blind $0.02
*** HOLE CARDS ***
Dealt to hc agorist [Ad 5c]
mr.aslamin: folds 
Hulyeur: folds 
All-Might2018: folds 
elvis_genius: folds 
RAIN_ACID has timed out
RAIN_ACID: folds 
Uncalled bet ($0.01) returned to hc agorist
hc agorist collected $0.02 from pot
hc agorist: doesn't show hand 
*** SUMMARY ***
Total pot $0.02 | Rake $0 
Seat 1: elvis_genius (button) folded before Flop (didn't bet)
Seat 2: RAIN_ACID (small blind) folded before Flop
Seat 3: hc agorist (big blind) collected ($0.02)
Seat 4: mr.aslamin folded before Flop (didn't bet)
Seat 5: Hulyeur folded before Flop (didn't bet)
Seat 6: All-Might2018 folded before Flop (didn't bet)



PokerStars Zoom Hand #193395235376:  Hold'em No Limit ($0.01/$0.02) - 2018/11/17 1:37:01 CUST [2018/11/16 12:37:01 ET]
Table 'Halley' 6-max Seat #1 is the button
Seat 1: Teodor_Teo ($2.97 in chips) 
Seat 2: beginer04 ($2.33 in chips) 
Seat 3: chancefatum ($3.75 in chips) 
Seat 4: Saerdna1 ($3.66 in chips) 
Seat 5: hc agorist ($4.43 in chips) 
Seat 6: rotkiv287 ($1.61 in chips) 
beginer04: posts small blind $0.01
chancefatum: posts big blind $0.02
*** HOLE CARDS ***
Dealt to hc agorist [8c 9d]
Saerdna1: folds 
hc agorist: folds 
rotkiv287: folds 
Teodor_Teo: folds 
beginer04: raises $0.04 to $0.06
chancefatum: raises $0.10 to $0.16
beginer04: folds 
Uncalled bet ($0.10) returned to chancefatum
chancefatum collected $0.12 from pot
chancefatum: doesn't show hand 
*** SUMMARY ***
Total pot $0.12 | Rake $0 
Seat 1: Teodor_Teo (button) folded before Flop (didn't bet)
Seat 2: beginer04 (small blind) folded before Flop
Seat 3: chancefatum (big blind) collected ($0.12)
Seat 4: Saerdna1 folded before Flop (didn't bet)
Seat 5: hc agorist folded before Flop (didn't bet)
Seat 6: rotkiv287 folded before Flop (didn't bet)



PokerStars Zoom Hand #193395241421:  Hold'em No Limit ($0.01/$0.02) - 2018/11/17 1:37:11 CUST [2018/11/16 12:37:11 ET]
Table 'Halley' 6-max Seat #1 is the button
Seat 1: hc agorist ($4.42 in chips) 
Seat 2: Balzouman ($3.05 in chips) 
Seat 3: Angel1545 ($0.92 in chips) 
Seat 4: SkyElephant ($2.84 in chips) 
Seat 5: CptBirdy ($1.98 in chips) 
Seat 6: Dimoni797979 ($2.33 in chips) 
Balzouman: posts small blind $0.01
Angel1545: posts big blind $0.02
*** HOLE CARDS ***
Dealt to hc agorist [Qc 2d]
SkyElephant: folds 
CptBirdy: raises $0.04 to $0.06
Dimoni797979: folds 
hc agorist: folds 
Balzouman: folds 
Angel1545: folds 
Uncalled bet ($0.04) returned to CptBirdy
CptBirdy collected $0.05 from pot
CptBirdy: doesn't show hand 
*** SUMMARY ***
Total pot $0.05 | Rake $0 
Seat 1: hc agorist (button) folded before Flop (didn't bet)
Seat 2: Balzouman (small blind) folded before Flop
Seat 3: Angel1545 (big blind) folded before Flop
Seat 4: SkyElephant folded before Flop (didn't bet)
Seat 5: CptBirdy collected ($0.05)
Seat 6: Dimoni797979 folded before Flop (didn't bet)



PokerStars Zoom Hand #193395238428:  Hold'em No Limit ($0.01/$0.02) - 2018/11/17 1:37:06 CUST [2018/11/16 12:37:06 ET]
Table 'Halley' 6-max Seat #1 is the button
Seat 1: LuM3r--O ($6.18 in chips) 
Seat 2: hc agorist ($4.43 in chips) 
Seat 3: Niphet ($2.54 in chips) 
Seat 4: EstebanTTT ($2.10 in chips) 
Seat 5: TheN@kedGun ($2.23 in chips) 
Seat 6: kyoubaku ($2.22 in chips) 
hc agorist: posts small blind $0.01
Niphet: posts big blind $0.02
*** HOLE CARDS ***
Dealt to hc agorist [4c Jd]
EstebanTTT has timed out
EstebanTTT: folds 
TheN@kedGun: folds 
kyoubaku: folds 
LuM3r--O: raises $0.03 to $0.05
hc agorist: folds 
Niphet: folds 
Uncalled bet ($0.03) returned to LuM3r--O
LuM3r--O collected $0.05 from pot
LuM3r--O: doesn't show hand 
*** SUMMARY ***
Total pot $0.05 | Rake $0 
Seat 1: LuM3r--O (button) collected ($0.05)
Seat 2: hc agorist (small blind) folded before Flop
Seat 3: Niphet (big blind) folded before Flop
Seat 4: EstebanTTT folded before Flop (didn't bet)
Seat 5: TheN@kedGun folded before Flop (didn't bet)
Seat 6: kyoubaku folded before Flop (didn't bet)



PokerStars Zoom Hand #193395244472:  Hold'em No Limit ($0.01/$0.02) - 2018/11/17 1:37:16 CUST [2018/11/16 12:37:16 ET]
Table 'Halley' 6-max Seat #1 is the button
Seat 1: rusich-vil ($2 in chips) 
Seat 2: creativez0r ($4.80 in chips) 
Seat 3: willthare24 ($5.47 in chips) 
Seat 4: hc agorist ($4.42 in chips) 
Seat 5: geoffrey5670 ($1.74 in chips) 
Seat 6: Frosmorn ($0.91 in chips) 
creativez0r: posts small blind $0.01
willthare24: posts big blind $0.02
*** HOLE CARDS ***
Dealt to hc agorist [Jh 8h]
hc agorist: raises $0.04 to $0.06
geoffrey5670: folds 
Frosmorn: folds 
rusich-vil: calls $0.06
creativez0r: folds 
willthare24: folds 
*** FLOP *** [6s 3h Jc]
hc agorist: checks 
rusich-vil: bets $0.09
hc agorist: calls $0.09
*** TURN *** [6s 3h Jc] [5s]
hc agorist: checks 
rusich-vil: bets $0.24
hc agorist: calls $0.24
*** RIVER *** [6s 3h Jc 5s] [8d]
hc agorist: checks 
rusich-vil: bets $0.30
hc agorist: raises $3.73 to $4.03 and is all-in
rusich-vil: folds 
Uncalled bet ($3.73) returned to hc agorist
hc agorist collected $1.36 from pot
hc agorist: doesn't show hand 
*** SUMMARY ***
Total pot $1.41 | Rake $0.05 
Board [6s 3h Jc 5s 8d]
Seat 1: rusich-vil (button) folded on the River
Seat 2: creativez0r (small blind) folded before Flop
Seat 3: willthare24 (big blind) folded before Flop
Seat 4: hc agorist collected ($1.36)
Seat 5: geoffrey5670 folded before Flop (didn't bet)
Seat 6: Frosmorn folded before Flop (didn't bet)



PokerStars Zoom Hand #193395294601:  Hold'em No Limit ($0.01/$0.02) - 2018/11/17 1:38:38 CUST [2018/11/16 12:38:38 ET]
Table 'Halley' 6-max Seat #1 is the button
Seat 1: pawelllo1 ($2.49 in chips) 
Seat 2: ForHistory ($2.09 in chips) 
Seat 3: hc agorist ($5.09 in chips) 
Seat 4: bLoNdiNkek ($6.61 in chips) 
Seat 5: Ludo4kAA ($2.06 in chips) 
Seat 6: IfromSPb ($2 in chips) 
ForHistory: posts small blind $0.01
hc agorist: posts big blind $0.02
*** HOLE CARDS ***
Dealt to hc agorist [4s Jc]
bLoNdiNkek: folds 
Ludo4kAA: folds 
IfromSPb: folds 
pawelllo1: raises $0.02 to $0.04
ForHistory: folds 
hc agorist: folds 
Uncalled bet ($0.02) returned to pawelllo1
pawelllo1 collected $0.05 from pot
pawelllo1: doesn't show hand 
*** SUMMARY ***
Total pot $0.05 | Rake $0 
Seat 1: pawelllo1 (button) collected ($0.05)
Seat 2: ForHistory (small blind) folded before Flop
Seat 3: hc agorist (big blind) folded before Flop
Seat 4: bLoNdiNkek folded before Flop (didn't bet)
Seat 5: Ludo4kAA folded before Flop (didn't bet)
Seat 6: IfromSPb folded before Flop (didn't bet)



PokerStars Zoom Hand #193395307447:  Hold'em No Limit ($0.01/$0.02) - 2018/11/17 1:38:59 CUST [2018/11/16 12:38:59 ET]
Table 'Halley' 6-max Seat #1 is the button
Seat 1: hc agorist ($5.07 in chips) 
Seat 2: RocknRolla5 ($2 in chips) 
Seat 3: dunnir ($2 in chips) 
Seat 4: pv2903 ($2.34 in chips) 
Seat 5: RUZZZZZZZZ ($1.69 in chips) 
Seat 6: JIMMYONTILT ($2.15 in chips) 
RocknRolla5: posts small blind $0.01
dunnir: posts big blind $0.02
*** HOLE CARDS ***
Dealt to hc agorist [Js 3d]
pv2903: folds 
RUZZZZZZZZ: folds 
JIMMYONTILT: folds 
hc agorist: folds 
RocknRolla5: folds 
Uncalled bet ($0.01) returned to dunnir
dunnir collected $0.02 from pot
dunnir: doesn't show hand 
*** SUMMARY ***
Total pot $0.02 | Rake $0 
Seat 1: hc agorist (button) folded before Flop (didn't bet)
Seat 2: RocknRolla5 (small blind) folded before Flop
Seat 3: dunnir (big blind) collected ($0.02)
Seat 4: pv2903 folded before Flop (didn't bet)
Seat 5: RUZZZZZZZZ folded before Flop (didn't bet)
Seat 6: JIMMYONTILT folded before Flop (didn't bet)



PokerStars Zoom Hand #193395292170:  Hold'em No Limit ($0.01/$0.02) - 2018/11/17 1:38:34 CUST [2018/11/16 12:38:34 ET]
Table 'Halley' 6-max Seat #1 is the button
Seat 1: chetkevichus ($2.27 in chips) 
Seat 2: Edelhustler ($1.41 in chips) 
Seat 3: vivientoeroek ($3.47 in chips) 
Seat 4: hc agorist ($5.09 in chips) 
Seat 5: dimon39ru ($4.99 in chips) 
Seat 6: Sisy_O. ($2.07 in chips) 
Edelhustler: posts small blind $0.01
vivientoeroek: posts big blind $0.02
*** HOLE CARDS ***
Dealt to hc agorist [Jc 8h]
hc agorist: folds 
dimon39ru: raises $0.04 to $0.06
Sisy_O.: folds 
chetkevichus: folds 
Edelhustler: folds 
vivientoeroek: calls $0.04
*** FLOP *** [Ac Qh 7h]
vivientoeroek: checks 
dimon39ru: checks 
*** TURN *** [Ac Qh 7h] [4d]
vivientoeroek: checks 
dimon39ru: checks 
*** RIVER *** [Ac Qh 7h 4d] [8c]
vivientoeroek: checks 
dimon39ru: checks 
*** SHOW DOWN ***
vivientoeroek: shows [4s Js] (a pair of Fours)
dimon39ru: mucks hand 
vivientoeroek collected $0.13 from pot
*** SUMMARY ***
Total pot $0.13 | Rake $0 
Board [Ac Qh 7h 4d 8c]
Seat 1: chetkevichus (button) folded before Flop (didn't bet)
Seat 2: Edelhustler (small blind) folded before Flop
Seat 3: vivientoeroek (big blind) showed [4s Js] and won ($0.13) with a pair of Fours
Seat 4: hc agorist folded before Flop (didn't bet)
Seat 5: dimon39ru mucked [Kc Jd]
Seat 6: Sisy_O. folded before Flop (didn't bet)



PokerStars Zoom Hand #193395310560:  Hold'em No Limit ($0.01/$0.02) - 2018/11/17 1:39:04 CUST [2018/11/16 12:39:04 ET]
Table 'Halley' 6-max Seat #1 is the button
Seat 1: Danat54 ($2 in chips) 
Seat 2: Vule_ot ($3.09 in chips) 
Seat 3: 27magneto27 ($4.10 in chips) 
Seat 4: hazza257 ($2 in chips) 
Seat 5: Pysgodyn ($7.03 in chips) 
Seat 6: hc agorist ($5.07 in chips) 
Vule_ot: posts small blind $0.01
27magneto27: posts big blind $0.02
*** HOLE CARDS ***
Dealt to hc agorist [Qs 9s]
hazza257: folds 
Pysgodyn: folds 
hc agorist: raises $0.04 to $0.06
Danat54: folds 
Vule_ot: folds 
27magneto27: folds 
Uncalled bet ($0.04) returned to hc agorist
hc agorist collected $0.05 from pot
hc agorist: doesn't show hand 
*** SUMMARY ***
Total pot $0.05 | Rake $0 
Seat 1: Danat54 (button) folded before Flop (didn't bet)
Seat 2: Vule_ot (small blind) folded before Flop
Seat 3: 27magneto27 (big blind) folded before Flop
Seat 4: hazza257 folded before Flop (didn't bet)
Seat 5: Pysgodyn folded before Flop (didn't bet)
Seat 6: hc agorist collected ($0.05)



PokerStars Zoom Hand #193395321528:  Hold'em No Limit ($0.01/$0.02) - 2018/11/17 1:39:22 CUST [2018/11/16 12:39:22 ET]
Table 'Halley' 6-max Seat #1 is the button
Seat 1: esquime72 ($1.99 in chips) 
Seat 2: hc agorist ($5.10 in chips) 
Seat 3: betojch ($2.64 in chips) 
Seat 4: pmb1984 ($3.06 in chips) 
Seat 5: SRERAF ($2 in chips) 
Seat 6: Zeemaz ($1.59 in chips) 
hc agorist: posts small blind $0.01
betojch: posts big blind $0.02
*** HOLE CARDS ***
Dealt to hc agorist [9c 8c]
pmb1984: folds 
SRERAF: folds 
Zeemaz: raises $0.04 to $0.06
esquime72: calls $0.06
hc agorist: raises $0.20 to $0.26
betojch: folds 
Zeemaz: raises $0.36 to $0.62
esquime72: folds 
hc agorist: calls $0.36
*** FLOP *** [5d 3c Td]
hc agorist: checks 
Zeemaz: bets $0.32
hc agorist: folds 
Uncalled bet ($0.32) returned to Zeemaz
Zeemaz collected $1.27 from pot
Zeemaz: doesn't show hand 
*** SUMMARY ***
Total pot $1.32 | Rake $0.05 
Board [5d 3c Td]
Seat 1: esquime72 (button) folded before Flop
Seat 2: hc agorist (small blind) folded on the Flop
Seat 3: betojch (big blind) folded before Flop
Seat 4: pmb1984 folded before Flop (didn't bet)
Seat 5: SRERAF folded before Flop (didn't bet)
Seat 6: Zeemaz collected ($1.27)



PokerStars Zoom Hand #193395364547:  Hold'em No Limit ($0.01/$0.02) - 2018/11/17 1:40:32 CUST [2018/11/16 12:40:32 ET]
Table 'Halley' 6-max Seat #1 is the button
Seat 1: JIMMYONTILT ($6.20 in chips) 
Seat 2: orangos ($1.48 in chips) 
Seat 3: hc agorist ($4.48 in chips) 
Seat 4: BohdanChubyk ($3.41 in chips) 
Seat 5: hazza257 ($2 in chips) 
Seat 6: krosallt ($3.29 in chips) 
orangos: posts small blind $0.01
hc agorist: posts big blind $0.02
*** HOLE CARDS ***
Dealt to hc agorist [7c 2h]
BohdanChubyk: folds 
hazza257: folds 
krosallt: folds 
JIMMYONTILT: raises $0.05 to $0.07
orangos: folds 
hc agorist: folds 
Uncalled bet ($0.05) returned to JIMMYONTILT
JIMMYONTILT collected $0.05 from pot
JIMMYONTILT: doesn't show hand 
*** SUMMARY ***
Total pot $0.05 | Rake $0 
Seat 1: JIMMYONTILT (button) collected ($0.05)
Seat 2: orangos (small blind) folded before Flop
Seat 3: hc agorist (big blind) folded before Flop
Seat 4: BohdanChubyk folded before Flop (didn't bet)
Seat 5: hazza257 folded before Flop (didn't bet)
Seat 6: krosallt folded before Flop (didn't bet)



PokerStars Zoom Hand #193395357225:  Hold'em No Limit ($0.01/$0.02) - 2018/11/17 1:40:20 CUST [2018/11/16 12:40:20 ET]
Table 'Halley' 6-max Seat #1 is the button
Seat 1: BigFish4711 ($4.45 in chips) 
Seat 2: handvil ($4.59 in chips) 
Seat 3: Uckeham ($0.96 in chips) 
Seat 4: beatboy01 ($8.34 in chips) 
Seat 5: hc agorist ($4.48 in chips) 
Seat 6: Dima Leleko ($3.26 in chips) 
handvil: posts small blind $0.01
Uckeham: posts big blind $0.02
*** HOLE CARDS ***
Dealt to hc agorist [6c 4c]
beatboy01: folds 
hc agorist: folds 
Dima Leleko: calls $0.02
BigFish4711: folds 
handvil: folds 
Uckeham: checks 
*** FLOP *** [Jh 4d 2s]
Uckeham: checks 
Dima Leleko: checks 
*** TURN *** [Jh 4d 2s] [9d]
Uckeham: checks 
Dima Leleko: checks 
*** RIVER *** [Jh 4d 2s 9d] [7h]
Uckeham: checks 
Dima Leleko: bets $0.02
Uckeham: calls $0.02
*** SHOW DOWN ***
Dima Leleko: shows [6d 7d] (a pair of Sevens)
Uckeham: mucks hand 
Dima Leleko collected $0.09 from pot
*** SUMMARY ***
Total pot $0.09 | Rake $0 
Board [Jh 4d 2s 9d 7h]
Seat 1: BigFish4711 (button) folded before Flop (didn't bet)
Seat 2: handvil (small blind) folded before Flop
Seat 3: Uckeham (big blind) mucked [3c 2c]
Seat 4: beatboy01 folded before Flop (didn't bet)
Seat 5: hc agorist folded before Flop (didn't bet)
Seat 6: Dima Leleko showed [6d 7d] and won ($0.09) with a pair of Sevens



PokerStars Zoom Hand #193395375673:  Hold'em No Limit ($0.01/$0.02) - 2018/11/17 1:40:50 CUST [2018/11/16 12:40:50 ET]
Table 'Halley' 6-max Seat #1 is the button
Seat 1: hc agorist ($4.46 in chips) 
Seat 2: chaogeNo1 ($2.01 in chips) 
Seat 3: rusich-vil ($2.05 in chips) 
Seat 4: Ludo4kAA ($2 in chips) 
Seat 5: billy the x ($2.34 in chips) 
Seat 6: 4andha ($2 in chips) 
chaogeNo1: posts small blind $0.01
rusich-vil: posts big blind $0.02
*** HOLE CARDS ***
Dealt to hc agorist [5h 3c]
Ludo4kAA: folds 
billy the x: raises $0.02 to $0.04
4andha: folds 
hc agorist: folds 
chaogeNo1: raises $0.14 to $0.18
rusich-vil: folds 
billy the x: calls $0.14
*** FLOP *** [2c 9d Qs]
chaogeNo1: checks 
billy the x: bets $0.25
chaogeNo1: folds 
Uncalled bet ($0.25) returned to billy the x
billy the x collected $0.37 from pot
billy the x: doesn't show hand 
*** SUMMARY ***
Total pot $0.38 | Rake $0.01 
Board [2c 9d Qs]
Seat 1: hc agorist (button) folded before Flop (didn't bet)
Seat 2: chaogeNo1 (small blind) folded on the Flop
Seat 3: rusich-vil (big blind) folded before Flop
Seat 4: Ludo4kAA folded before Flop (didn't bet)
Seat 5: billy the x collected ($0.37)
Seat 6: 4andha folded before Flop (didn't bet)



PokerStars Zoom Hand #193395378807:  Hold'em No Limit ($0.01/$0.02) - 2018/11/17 1:40:55 CUST [2018/11/16 12:40:55 ET]
Table 'Halley' 6-max Seat #1 is the button
Seat 1: pavel111999 ($2.57 in chips) 
Seat 2: hc agorist ($4.46 in chips) 
Seat 3: bscca ($4.25 in chips) 
Seat 4: Huul 55 ($2 in chips) 
Seat 5: tenenson ($1.59 in chips) 
Seat 6: MRTNPHN ($1.98 in chips) 
hc agorist: posts small blind $0.01
bscca: posts big blind $0.02
*** HOLE CARDS ***
Dealt to hc agorist [Qh 9d]
Huul 55: folds 
tenenson: folds 
MRTNPHN: calls $0.02
pavel111999: folds 
hc agorist: folds 
bscca: checks 
*** FLOP *** [As 6d 2s]
bscca: checks 
MRTNPHN: checks 
*** TURN *** [As 6d 2s] [Ks]
bscca: checks 
MRTNPHN: checks 
*** RIVER *** [As 6d 2s Ks] [Kc]
bscca: checks 
MRTNPHN: checks 
*** SHOW DOWN ***
bscca: shows [5h Ad] (two pair, Aces and Kings)
MRTNPHN: mucks hand 
bscca collected $0.05 from pot
*** SUMMARY ***
Total pot $0.05 | Rake $0 
Board [As 6d 2s Ks Kc]
Seat 1: pavel111999 (button) folded before Flop (didn't bet)
Seat 2: hc agorist (small blind) folded before Flop
Seat 3: bscca (big blind) showed [5h Ad] and won ($0.05) with two pair, Aces and Kings
Seat 4: Huul 55 folded before Flop (didn't bet)
Seat 5: tenenson folded before Flop (didn't bet)
Seat 6: MRTNPHN mucked [Jc Qs]



PokerStars Zoom Hand #193395360303:  Hold'em No Limit ($0.01/$0.02) - 2018/11/17 1:40:25 CUST [2018/11/16 12:40:25 ET]
Table 'Halley' 6-max Seat #1 is the button
Seat 1: handvil ($4.58 in chips) 
Seat 2: feels2goood ($2.27 in chips) 
Seat 3: TeRoRb13 ($3.01 in chips) 
Seat 4: TheN@kedGun ($2.79 in chips) 
Seat 5: soldim327 ($2.42 in chips) 
Seat 6: hc agorist ($4.48 in chips) 
feels2goood: posts small blind $0.01
TeRoRb13: posts big blind $0.02
*** HOLE CARDS ***
Dealt to hc agorist [4c 8d]
TheN@kedGun: folds 
soldim327: folds 
hc agorist: folds 
handvil: raises $0.04 to $0.06
feels2goood: raises $0.15 to $0.21
TeRoRb13: folds 
handvil: calls $0.15
*** FLOP *** [Ad 9c 7d]
feels2goood: bets $0.13
handvil: calls $0.13
*** TURN *** [Ad 9c 7d] [5c]
feels2goood: checks 
handvil: bets $0.34
feels2goood: folds 
Uncalled bet ($0.34) returned to handvil
handvil collected $0.68 from pot
handvil: doesn't show hand 
*** SUMMARY ***
Total pot $0.70 | Rake $0.02 
Board [Ad 9c 7d 5c]
Seat 1: handvil (button) collected ($0.68)
Seat 2: feels2goood (small blind) folded on the Turn
Seat 3: TeRoRb13 (big blind) folded before Flop
Seat 4: TheN@kedGun folded before Flop (didn't bet)
Seat 5: soldim327 folded before Flop (didn't bet)
Seat 6: hc agorist folded before Flop (didn't bet)



PokerStars Zoom Hand #193395381873:  Hold'em No Limit ($0.01/$0.02) - 2018/11/17 1:41:00 CUST [2018/11/16 12:41:00 ET]
Table 'Halley' 6-max Seat #1 is the button
Seat 1: 1nnuendo ($4.18 in chips) 
Seat 2: uFoldPlz ($4.38 in chips) 
Seat 3: tonkarla ($2.20 in chips) 
Seat 4: UZ=ZERO=UZ ($2 in chips) 
Seat 5: hc agorist ($4.45 in chips) 
Seat 6: handvil ($2.11 in chips) 
uFoldPlz: posts small blind $0.01
tonkarla: posts big blind $0.02
*** HOLE CARDS ***
Dealt to hc agorist [Qh Kc]
UZ=ZERO=UZ: raises $0.02 to $0.04
hc agorist: calls $0.04
handvil: folds 
1nnuendo: folds 
uFoldPlz: folds 
tonkarla: folds 
*** FLOP *** [7d Js 9h]
UZ=ZERO=UZ: checks 
hc agorist: bets $0.04
UZ=ZERO=UZ: calls $0.04
*** TURN *** [7d Js 9h] [6c]
UZ=ZERO=UZ: checks 
hc agorist: bets $0.14
UZ=ZERO=UZ: calls $0.14
*** RIVER *** [7d Js 9h 6c] [6h]
UZ=ZERO=UZ: checks 
hc agorist: bets $0.34
UZ=ZERO=UZ: folds 
Uncalled bet ($0.34) returned to hc agorist
hc agorist collected $0.45 from pot
hc agorist: doesn't show hand 
*** SUMMARY ***
Total pot $0.47 | Rake $0.02 
Board [7d Js 9h 6c 6h]
Seat 1: 1nnuendo (button) folded before Flop (didn't bet)
Seat 2: uFoldPlz (small blind) folded before Flop
Seat 3: tonkarla (big blind) folded before Flop
Seat 4: UZ=ZERO=UZ folded on the River
Seat 5: hc agorist collected ($0.45)
Seat 6: handvil folded before Flop (didn't bet)



PokerStars Zoom Hand #193395426252:  Hold'em No Limit ($0.01/$0.02) - 2018/11/17 1:42:12 CUST [2018/11/16 12:42:12 ET]
Table 'Halley' 6-max Seat #1 is the button
Seat 1: serde4nik ($2.03 in chips) 
Seat 2: SanDmitri4 ($4.46 in chips) 
Seat 3: Bombadao ($3.15 in chips) 
Seat 4: 27magneto27 ($2.40 in chips) 
Seat 5: hc agorist ($4.68 in chips) 
Seat 6: devilz1978 ($3.03 in chips) 
SanDmitri4: posts small blind $0.01
Bombadao: posts big blind $0.02
*** HOLE CARDS ***
Dealt to hc agorist [2h As]
27magneto27: folds 
hc agorist: raises $0.04 to $0.06
devilz1978: folds 
serde4nik: folds 
SanDmitri4: folds 
Bombadao: folds 
Uncalled bet ($0.04) returned to hc agorist
hc agorist collected $0.05 from pot
hc agorist: doesn't show hand 
*** SUMMARY ***
Total pot $0.05 | Rake $0 
Seat 1: serde4nik (button) folded before Flop (didn't bet)
Seat 2: SanDmitri4 (small blind) folded before Flop
Seat 3: Bombadao (big blind) folded before Flop
Seat 4: 27magneto27 folded before Flop (didn't bet)
Seat 5: hc agorist collected ($0.05)
Seat 6: devilz1978 folded before Flop (didn't bet)



PokerStars Zoom Hand #193395443702:  Hold'em No Limit ($0.01/$0.02) - 2018/11/17 1:42:40 CUST [2018/11/16 12:42:40 ET]
Table 'Halley' 6-max Seat #1 is the button
Seat 1: argboat ($1.70 in chips) 
Seat 2: 5th Rutland ($1.16 in chips) 
Seat 3: skystaruk ($1.99 in chips) 
Seat 4: hc agorist ($4.71 in chips) 
Seat 5: laoban888 ($2.07 in chips) 
Seat 6: Edyard23 ($0.84 in chips) 
5th Rutland: posts small blind $0.01
skystaruk: posts big blind $0.02
*** HOLE CARDS ***
Dealt to hc agorist [8d 5h]
hc agorist: folds 
laoban888: folds 
Edyard23: folds 
argboat: folds 
5th Rutland: folds 
Uncalled bet ($0.01) returned to skystaruk
skystaruk collected $0.02 from pot
skystaruk: doesn't show hand 
*** SUMMARY ***
Total pot $0.02 | Rake $0 
Seat 1: argboat (button) folded before Flop (didn't bet)
Seat 2: 5th Rutland (small blind) folded before Flop
Seat 3: skystaruk (big blind) collected ($0.02)
Seat 4: hc agorist folded before Flop (didn't bet)
Seat 5: laoban888 folded before Flop (didn't bet)
Seat 6: Edyard23 folded before Flop (didn't bet)



PokerStars Zoom Hand #193395446729:  Hold'em No Limit ($0.01/$0.02) - 2018/11/17 1:42:45 CUST [2018/11/16 12:42:45 ET]
Table 'Halley' 6-max Seat #1 is the button
Seat 1: $SBIGSHARK$$ ($4.42 in chips) 
Seat 2: max.m.7deiL ($2.37 in chips) 
Seat 3: hc agorist ($4.71 in chips) 
Seat 4: billy the x ($2.01 in chips) 
Seat 5: Enlassombras ($12.47 in chips) 
Seat 6: babiloniaxxx ($2.17 in chips) 
max.m.7deiL: posts small blind $0.01
hc agorist: posts big blind $0.02
*** HOLE CARDS ***
Dealt to hc agorist [Td 2h]
billy the x: folds 
Enlassombras: raises $0.04 to $0.06
babiloniaxxx: folds 
$SBIGSHARK$$: folds 
max.m.7deiL: folds 
hc agorist: folds 
Uncalled bet ($0.04) returned to Enlassombras
Enlassombras collected $0.05 from pot
Enlassombras: doesn't show hand 
*** SUMMARY ***
Total pot $0.05 | Rake $0 
Seat 1: $SBIGSHARK$$ (button) folded before Flop (didn't bet)
Seat 2: max.m.7deiL (small blind) folded before Flop
Seat 3: hc agorist (big blind) folded before Flop
Seat 4: billy the x folded before Flop (didn't bet)
Seat 5: Enlassombras collected ($0.05)
Seat 6: babiloniaxxx folded before Flop (didn't bet)



PokerStars Zoom Hand #193395451754:  Hold'em No Limit ($0.01/$0.02) - 2018/11/17 1:42:53 CUST [2018/11/16 12:42:53 ET]
Table 'Halley' 6-max Seat #1 is the button
Seat 1: hc agorist ($4.69 in chips) 
Seat 2: smokonaj ($4.58 in chips) 
Seat 3: sQud_AK ($2.03 in chips) 
Seat 4: Alter7777 ($2.39 in chips) 
Seat 5: pkrgirl94 ($0.96 in chips) 
Seat 6: Nagash1349 ($9.27 in chips) 
smokonaj: posts small blind $0.01
sQud_AK: posts big blind $0.02
*** HOLE CARDS ***
Dealt to hc agorist [Qc 4h]
Alter7777: folds 
pkrgirl94: folds 
Nagash1349: folds 
hc agorist: folds 
smokonaj: folds 
Uncalled bet ($0.01) returned to sQud_AK
sQud_AK collected $0.02 from pot
sQud_AK: doesn't show hand 
*** SUMMARY ***
Total pot $0.02 | Rake $0 
Seat 1: hc agorist (button) folded before Flop (didn't bet)
Seat 2: smokonaj (small blind) folded before Flop
Seat 3: sQud_AK (big blind) collected ($0.02)
Seat 4: Alter7777 folded before Flop (didn't bet)
Seat 5: pkrgirl94 folded before Flop (didn't bet)
Seat 6: Nagash1349 folded before Flop (didn't bet)



PokerStars Zoom Hand #193395456172:  Hold'em No Limit ($0.01/$0.02) - 2018/11/17 1:43:00 CUST [2018/11/16 12:43:00 ET]
Table 'Halley' 6-max Seat #1 is the button
Seat 1: CMEXX84 ($4.73 in chips) 
Seat 2: profi444 ($1.62 in chips) 
Seat 3: dupon101 ($3.05 in chips) 
Seat 4: chaogeNo1 ($2.11 in chips) 
Seat 5: Therm0 ($1.94 in chips) 
Seat 6: hc agorist ($4.69 in chips) 
profi444: posts small blind $0.01
dupon101: posts big blind $0.02
*** HOLE CARDS ***
Dealt to hc agorist [Kc 5s]
chaogeNo1: folds 
Therm0: raises $0.04 to $0.06
hc agorist: folds 
CMEXX84: folds 
profi444: folds 
dupon101: folds 
Uncalled bet ($0.04) returned to Therm0
Therm0 collected $0.05 from pot
Therm0: doesn't show hand 
*** SUMMARY ***
Total pot $0.05 | Rake $0 
Seat 1: CMEXX84 (button) folded before Flop (didn't bet)
Seat 2: profi444 (small blind) folded before Flop
Seat 3: dupon101 (big blind) folded before Flop
Seat 4: chaogeNo1 folded before Flop (didn't bet)
Seat 5: Therm0 collected ($0.05)
Seat 6: hc agorist folded before Flop (didn't bet)



PokerStars Zoom Hand #193395463403:  Hold'em No Limit ($0.01/$0.02) - 2018/11/17 1:43:12 CUST [2018/11/16 12:43:12 ET]
Table 'Halley' 6-max Seat #1 is the button
Seat 1: tatipolo ($1.80 in chips) 
Seat 2: hc agorist ($4.69 in chips) 
Seat 3: bilimb ($0.97 in chips) 
Seat 4: July Van7 ($2.50 in chips) 
Seat 5: BluffOnTable ($2 in chips) 
Seat 6: SkyElephant ($2 in chips) 
hc agorist: posts small blind $0.01
bilimb: posts big blind $0.02
*** HOLE CARDS ***
Dealt to hc agorist [6d 6s]
July Van7: folds 
BluffOnTable: folds 
SkyElephant: folds 
tatipolo: folds 
hc agorist: raises $0.04 to $0.06
bilimb: folds 
Uncalled bet ($0.04) returned to hc agorist
hc agorist collected $0.04 from pot
hc agorist: doesn't show hand 
*** SUMMARY ***
Total pot $0.04 | Rake $0 
Seat 1: tatipolo (button) folded before Flop (didn't bet)
Seat 2: hc agorist (small blind) collected ($0.04)
Seat 3: bilimb (big blind) folded before Flop
Seat 4: July Van7 folded before Flop (didn't bet)
Seat 5: BluffOnTable folded before Flop (didn't bet)
Seat 6: SkyElephant folded before Flop (didn't bet)



PokerStars Zoom Hand #193395460364:  Hold'em No Limit ($0.01/$0.02) - 2018/11/17 1:43:07 CUST [2018/11/16 12:43:07 ET]
Table 'Halley' 6-max Seat #1 is the button
Seat 1: madydoll ($2 in chips) 
Seat 2: HanaYukii ($2.01 in chips) 
Seat 3: dunnir ($2.39 in chips) 
Seat 4: sztuciec ($2 in chips) 
Seat 5: hc agorist ($4.69 in chips) 
Seat 6: plasencia345 ($4.37 in chips) 
HanaYukii: posts small blind $0.01
dunnir: posts big blind $0.02
*** HOLE CARDS ***
Dealt to hc agorist [3h 8s]
sztuciec: folds 
hc agorist: folds 
plasencia345: folds 
madydoll: folds 
HanaYukii: raises $0.02 to $0.04
dunnir: calls $0.02
*** FLOP *** [Ac 7s 5s]
HanaYukii: bets $0.04
dunnir: folds 
Uncalled bet ($0.04) returned to HanaYukii
HanaYukii collected $0.08 from pot
HanaYukii: doesn't show hand 
*** SUMMARY ***
Total pot $0.08 | Rake $0 
Board [Ac 7s 5s]
Seat 1: madydoll (button) folded before Flop (didn't bet)
Seat 2: HanaYukii (small blind) collected ($0.08)
Seat 3: dunnir (big blind) folded on the Flop
Seat 4: sztuciec folded before Flop (didn't bet)
Seat 5: hc agorist folded before Flop (didn't bet)
Seat 6: plasencia345 folded before Flop (didn't bet)



PokerStars Zoom Hand #193395470873:  Hold'em No Limit ($0.01/$0.02) - 2018/11/17 1:43:24 CUST [2018/11/16 12:43:24 ET]
Table 'Halley' 6-max Seat #1 is the button
Seat 1: EvaldasRa ($4.69 in chips) 
Seat 2: erinor1 ($2.62 in chips) 
Seat 3: Funmaker007 ($5.37 in chips) 
Seat 4: hc agorist ($4.71 in chips) 
Seat 5: ForHistory ($3.85 in chips) 
Seat 6: take710 ($2 in chips) 
erinor1: posts small blind $0.01
Funmaker007: posts big blind $0.02
*** HOLE CARDS ***
Dealt to hc agorist [7d 5d]
hc agorist: raises $0.04 to $0.06
ForHistory: folds 
take710: folds 
EvaldasRa: folds 
erinor1: folds 
Funmaker007: folds 
Uncalled bet ($0.04) returned to hc agorist
hc agorist collected $0.05 from pot
hc agorist: doesn't show hand 
*** SUMMARY ***
Total pot $0.05 | Rake $0 
Seat 1: EvaldasRa (button) folded before Flop (didn't bet)
Seat 2: erinor1 (small blind) folded before Flop
Seat 3: Funmaker007 (big blind) folded before Flop
Seat 4: hc agorist collected ($0.05)
Seat 5: ForHistory folded before Flop (didn't bet)
Seat 6: take710 folded before Flop (didn't bet)



PokerStars Zoom Hand #193395477705:  Hold'em No Limit ($0.01/$0.02) - 2018/11/17 1:43:35 CUST [2018/11/16 12:43:35 ET]
Table 'Halley' 6-max Seat #1 is the button
Seat 1: dj99mma ($6.11 in chips) 
Seat 2: redkaja77 ($0.81 in chips) 
Seat 3: alex197030 ($1.64 in chips) 
Seat 4: ASplayer9119 ($2.18 in chips) 
Seat 5: Edelhustler ($1.65 in chips) 
Seat 6: hc agorist ($4.74 in chips) 
redkaja77: posts small blind $0.01
alex197030: posts big blind $0.02
*** HOLE CARDS ***
Dealt to hc agorist [2s Qs]
ASplayer9119: folds 
Edelhustler: folds 
hc agorist: raises $0.02 to $0.04
dj99mma: folds 
redkaja77: folds 
alex197030: calls $0.02
*** FLOP *** [Ts Jd 5c]
alex197030: checks 
hc agorist: checks 
*** TURN *** [Ts Jd 5c] [9d]
alex197030: checks 
hc agorist: bets $0.08
alex197030: calls $0.08
*** RIVER *** [Ts Jd 5c 9d] [6c]
alex197030: checks 
hc agorist: bets $0.24
alex197030: folds 
Uncalled bet ($0.24) returned to hc agorist
hc agorist collected $0.24 from pot
hc agorist: doesn't show hand 
*** SUMMARY ***
Total pot $0.25 | Rake $0.01 
Board [Ts Jd 5c 9d 6c]
Seat 1: dj99mma (button) folded before Flop (didn't bet)
Seat 2: redkaja77 (small blind) folded before Flop
Seat 3: alex197030 (big blind) folded on the River
Seat 4: ASplayer9119 folded before Flop (didn't bet)
Seat 5: Edelhustler folded before Flop (didn't bet)
Seat 6: hc agorist collected ($0.24)



PokerStars Zoom Hand #193395497502:  Hold'em No Limit ($0.01/$0.02) - 2018/11/17 1:44:07 CUST [2018/11/16 12:44:07 ET]
Table 'Halley' 6-max Seat #1 is the button
Seat 1: Wadazet00 ($2.85 in chips) 
Seat 2: vais8 ($0.98 in chips) 
Seat 3: hc agorist ($4.86 in chips) 
Seat 4: Rooney_ais7 ($2.25 in chips) 
Seat 5: manmld ($2.28 in chips) 
Seat 6: PPYPP ($2.77 in chips) 
vais8: posts small blind $0.01
hc agorist: posts big blind $0.02
*** HOLE CARDS ***
Dealt to hc agorist [5d 7c]
Rooney_ais7: folds 
manmld: folds 
PPYPP: folds 
Wadazet00: folds 
vais8: raises $0.02 to $0.04
hc agorist: folds 
Uncalled bet ($0.02) returned to vais8
vais8 collected $0.04 from pot
vais8: doesn't show hand 
*** SUMMARY ***
Total pot $0.04 | Rake $0 
Seat 1: Wadazet00 (button) folded before Flop (didn't bet)
Seat 2: vais8 (small blind) collected ($0.04)
Seat 3: hc agorist (big blind) folded before Flop
Seat 4: Rooney_ais7 folded before Flop (didn't bet)
Seat 5: manmld folded before Flop (didn't bet)
Seat 6: PPYPP folded before Flop (didn't bet)



PokerStars Zoom Hand #193395511828:  Hold'em No Limit ($0.01/$0.02) - 2018/11/17 1:44:30 CUST [2018/11/16 12:44:30 ET]
Table 'Halley' 6-max Seat #1 is the button
Seat 1: derser1000 ($2 in chips) 
Seat 2: hc agorist ($4.84 in chips) 
Seat 3: metz_fitness ($2.18 in chips) 
Seat 4: MadElegant ($2.51 in chips) 
Seat 5: artri3 ($2.60 in chips) 
Seat 6: SVG7777 ($3.84 in chips) 
hc agorist: posts small blind $0.01
metz_fitness: posts big blind $0.02
*** HOLE CARDS ***
Dealt to hc agorist [7s Kd]
MadElegant: raises $0.03 to $0.05
artri3: folds 
SVG7777: folds 
derser1000: folds 
hc agorist: folds 
metz_fitness: folds 
Uncalled bet ($0.03) returned to MadElegant
MadElegant collected $0.05 from pot
MadElegant: doesn't show hand 
*** SUMMARY ***
Total pot $0.05 | Rake $0 
Seat 1: derser1000 (button) folded before Flop (didn't bet)
Seat 2: hc agorist (small blind) folded before Flop
Seat 3: metz_fitness (big blind) folded before Flop
Seat 4: MadElegant collected ($0.05)
Seat 5: artri3 folded before Flop (didn't bet)
Seat 6: SVG7777 folded before Flop (didn't bet)



PokerStars Zoom Hand #193395514911:  Hold'em No Limit ($0.01/$0.02) - 2018/11/17 1:44:35 CUST [2018/11/16 12:44:35 ET]
Table 'Halley' 6-max Seat #1 is the button
Seat 1: forteducks ($2 in chips) 
Seat 2: tenishevo ($2.96 in chips) 
Seat 3: SevastyanovM ($2.47 in chips) 
Seat 4: Caramba191 ($2 in chips) 
Seat 5: hc agorist ($4.83 in chips) 
Seat 6: DANILZOL ($4.93 in chips) 
tenishevo: posts small blind $0.01
SevastyanovM: posts big blind $0.02
*** HOLE CARDS ***
Dealt to hc agorist [3s 7h]
Caramba191: folds 
hc agorist: folds 
DANILZOL: calls $0.02
forteducks: folds 
tenishevo: folds 
SevastyanovM: checks 
*** FLOP *** [Js 5s 5d]
SevastyanovM: checks 
DANILZOL: bets $0.02
SevastyanovM: folds 
Uncalled bet ($0.02) returned to DANILZOL
DANILZOL collected $0.05 from pot
DANILZOL: doesn't show hand 
*** SUMMARY ***
Total pot $0.05 | Rake $0 
Board [Js 5s 5d]
Seat 1: forteducks (button) folded before Flop (didn't bet)
Seat 2: tenishevo (small blind) folded before Flop
Seat 3: SevastyanovM (big blind) folded on the Flop
Seat 4: Caramba191 folded before Flop (didn't bet)
Seat 5: hc agorist folded before Flop (didn't bet)
Seat 6: DANILZOL collected ($0.05)



PokerStars Zoom Hand #193395517981:  Hold'em No Limit ($0.01/$0.02) - 2018/11/17 1:44:40 CUST [2018/11/16 12:44:40 ET]
Table 'Halley' 6-max Seat #1 is the button
Seat 1: hc agorist ($4.83 in chips) 
Seat 2: Dimitriy7272 ($1.98 in chips) 
Seat 3: JIMMYONTILT ($2 in chips) 
Seat 4: Spi4ek ($1 in chips) 
Seat 5: SamiusMester ($3.43 in chips) 
Seat 6: hhonda7777 ($1.69 in chips) 
Dimitriy7272: posts small blind $0.01
JIMMYONTILT: posts big blind $0.02
*** HOLE CARDS ***
Dealt to hc agorist [Ad Qd]
Spi4ek: folds 
SamiusMester: folds 
hhonda7777: folds 
hc agorist: raises $0.04 to $0.06
Dimitriy7272: folds 
JIMMYONTILT: calls $0.04
*** FLOP *** [Ac Ts Kc]
JIMMYONTILT: checks 
hc agorist: bets $0.05
JIMMYONTILT: folds 
Uncalled bet ($0.05) returned to hc agorist
hc agorist collected $0.13 from pot
hc agorist: doesn't show hand 
*** SUMMARY ***
Total pot $0.13 | Rake $0 
Board [Ac Ts Kc]
Seat 1: hc agorist (button) collected ($0.13)
Seat 2: Dimitriy7272 (small blind) folded before Flop
Seat 3: JIMMYONTILT (big blind) folded on the Flop
Seat 4: Spi4ek folded before Flop (didn't bet)
Seat 5: SamiusMester folded before Flop (didn't bet)
Seat 6: hhonda7777 folded before Flop (didn't bet)



PokerStars Zoom Hand #193395534603:  Hold'em No Limit ($0.01/$0.02) - 2018/11/17 1:45:07 CUST [2018/11/16 12:45:07 ET]
Table 'Halley' 6-max Seat #1 is the button
Seat 1: Vule_ot ($2.49 in chips) 
Seat 2: skystaruk ($1.69 in chips) 
Seat 3: hc agorist ($4.90 in chips) 
Seat 4: Hulyeur ($2.29 in chips) 
Seat 5: nana7733104 ($2.24 in chips) 
Seat 6: MOU77Y ($5.36 in chips) 
skystaruk: posts small blind $0.01
hc agorist: posts big blind $0.02
*** HOLE CARDS ***
Dealt to hc agorist [9s 3d]
Hulyeur: folds 
nana7733104: folds 
MOU77Y: folds 
Vule_ot: raises $0.04 to $0.06
skystaruk: calls $0.05
hc agorist: folds 
*** FLOP *** [6d 7d Kh]
skystaruk: checks 
Vule_ot: bets $0.07
skystaruk: folds 
Uncalled bet ($0.07) returned to Vule_ot
Vule_ot collected $0.14 from pot
Vule_ot: doesn't show hand 
*** SUMMARY ***
Total pot $0.14 | Rake $0 
Board [6d 7d Kh]
Seat 1: Vule_ot (button) collected ($0.14)
Seat 2: skystaruk (small blind) folded on the Flop
Seat 3: hc agorist (big blind) folded before Flop
Seat 4: Hulyeur folded before Flop (didn't bet)
Seat 5: nana7733104 folded before Flop (didn't bet)
Seat 6: MOU77Y folded before Flop (didn't bet)



PokerStars Zoom Hand #193395530922:  Hold'em No Limit ($0.01/$0.02) - 2018/11/17 1:45:01 CUST [2018/11/16 12:45:01 ET]
Table 'Halley' 6-max Seat #1 is the button
Seat 1: S. Biemans ($5.37 in chips) 
Seat 2: 4andha ($2.19 in chips) 
Seat 3: Barra West ($7.04 in chips) 
Seat 4: hc agorist ($4.90 in chips) 
Seat 5: orangos ($1.38 in chips) 
Seat 6: metz_fitness ($1.79 in chips) 
4andha: posts small blind $0.01
Barra West: posts big blind $0.02
*** HOLE CARDS ***
Dealt to hc agorist [4d 8d]
hc agorist: folds 
orangos: raises $0.04 to $0.06
metz_fitness: folds 
S. Biemans: folds 
4andha: folds 
Barra West: calls $0.04
*** FLOP *** [Tc 9h Ac]
Barra West: checks 
orangos: bets $0.09
Barra West: folds 
Uncalled bet ($0.09) returned to orangos
orangos collected $0.13 from pot
orangos: doesn't show hand 
*** SUMMARY ***
Total pot $0.13 | Rake $0 
Board [Tc 9h Ac]
Seat 1: S. Biemans (button) folded before Flop (didn't bet)
Seat 2: 4andha (small blind) folded before Flop
Seat 3: Barra West (big blind) folded on the Flop
Seat 4: hc agorist folded before Flop (didn't bet)
Seat 5: orangos collected ($0.13)
Seat 6: metz_fitness folded before Flop (didn't bet)



PokerStars Zoom Hand #193395541522:  Hold'em No Limit ($0.01/$0.02) - 2018/11/17 1:45:18 CUST [2018/11/16 12:45:18 ET]
Table 'Halley' 6-max Seat #1 is the button
Seat 1: hc agorist ($4.88 in chips) 
Seat 2: VOVUK1983 ($1.97 in chips) 
Seat 3: Anothernoobguy ($2.66 in chips) 
Seat 4: brenddow ($1.16 in chips) 
Seat 5: dra12345 ($1.98 in chips) 
Seat 6: VladKot ($4.13 in chips) 
VOVUK1983: posts small blind $0.01
Anothernoobguy: posts big blind $0.02
*** HOLE CARDS ***
Dealt to hc agorist [6h 4h]
brenddow: folds 
dra12345: raises $0.04 to $0.06
VladKot: folds 
hc agorist: raises $0.12 to $0.18
VOVUK1983: calls $0.17
Anothernoobguy: folds 
dra12345: folds 
*** FLOP *** [7h 2s Qc]
VOVUK1983: checks 
hc agorist: bets $0.15
VOVUK1983: folds 
Uncalled bet ($0.15) returned to hc agorist
hc agorist collected $0.42 from pot
hc agorist: doesn't show hand 
*** SUMMARY ***
Total pot $0.44 | Rake $0.02 
Board [7h 2s Qc]
Seat 1: hc agorist (button) collected ($0.42)
Seat 2: VOVUK1983 (small blind) folded on the Flop
Seat 3: Anothernoobguy (big blind) folded before Flop
Seat 4: brenddow folded before Flop (didn't bet)
Seat 5: dra12345 folded before Flop
Seat 6: VladKot folded before Flop (didn't bet)



PokerStars Zoom Hand #193395573142:  Hold'em No Limit ($0.01/$0.02) - 2018/11/17 1:46:09 CUST [2018/11/16 12:46:09 ET]
Table 'Halley' 6-max Seat #1 is the button
Seat 1: withym ($3.59 in chips) 
Seat 2: NLG0M€$ ($4.63 in chips) 
Seat 3: Edelhustler ($1.65 in chips) 
Seat 4: _Nik_780 ($2.07 in chips) 
Seat 5: dimati10 ($2 in chips) 
Seat 6: hc agorist ($5.11 in chips) 
NLG0M€$: posts small blind $0.01
Edelhustler: posts big blind $0.02
*** HOLE CARDS ***
Dealt to hc agorist [3s 2c]
_Nik_780: raises $0.06 to $0.08
dimati10: folds 
hc agorist: folds 
withym: folds 
NLG0M€$: folds 
Edelhustler: folds 
Uncalled bet ($0.06) returned to _Nik_780
_Nik_780 collected $0.05 from pot
_Nik_780: doesn't show hand 
*** SUMMARY ***
Total pot $0.05 | Rake $0 
Seat 1: withym (button) folded before Flop (didn't bet)
Seat 2: NLG0M€$ (small blind) folded before Flop
Seat 3: Edelhustler (big blind) folded before Flop
Seat 4: _Nik_780 collected ($0.05)
Seat 5: dimati10 folded before Flop (didn't bet)
Seat 6: hc agorist folded before Flop (didn't bet)



PokerStars Zoom Hand #193395579315:  Hold'em No Limit ($0.01/$0.02) - 2018/11/17 1:46:19 CUST [2018/11/16 12:46:19 ET]
Table 'Halley' 6-max Seat #1 is the button
Seat 1: Rooney_ais7 ($2.80 in chips) 
Seat 2: Party4Arthy ($2.38 in chips) 
Seat 3: 1anXIce ($0.57 in chips) 
Seat 4: Evgen1907 ($2.20 in chips) 
Seat 5: hc agorist ($5.11 in chips) 
Seat 6: xiazhen ($2.68 in chips) 
Party4Arthy: posts small blind $0.01
1anXIce: posts big blind $0.02
*** HOLE CARDS ***
Dealt to hc agorist [7s Js]
Evgen1907: folds 
hc agorist: raises $0.04 to $0.06
xiazhen: folds 
Rooney_ais7: folds 
Party4Arthy has timed out
Party4Arthy: folds 
1anXIce: folds 
Uncalled bet ($0.04) returned to hc agorist
hc agorist collected $0.05 from pot
hc agorist: doesn't show hand 
*** SUMMARY ***
Total pot $0.05 | Rake $0 
Seat 1: Rooney_ais7 (button) folded before Flop (didn't bet)
Seat 2: Party4Arthy (small blind) folded before Flop
Seat 3: 1anXIce (big blind) folded before Flop
Seat 4: Evgen1907 folded before Flop (didn't bet)
Seat 5: hc agorist collected ($0.05)
Seat 6: xiazhen folded before Flop (didn't bet)



PokerStars Zoom Hand #193395568781:  Hold'em No Limit ($0.01/$0.02) - 2018/11/17 1:46:02 CUST [2018/11/16 12:46:02 ET]
Table 'Halley' 6-max Seat #1 is the button
Seat 1: tenishevo ($3 in chips) 
Seat 2: hc agorist ($5.12 in chips) 
Seat 3: vikonda85 ($2.05 in chips) 
Seat 4: dupon101 ($4.02 in chips) 
Seat 5: evovida ($1.83 in chips) 
Seat 6: shtooc ($2.96 in chips) 
hc agorist: posts small blind $0.01
vikonda85: posts big blind $0.02
*** HOLE CARDS ***
Dealt to hc agorist [8d 7c]
dupon101: folds 
evovida: folds 
shtooc: calls $0.02
tenishevo: folds 
hc agorist: folds 
vikonda85: checks 
*** FLOP *** [6d 5s 6h]
vikonda85: checks 
shtooc: bets $0.03
vikonda85: raises $0.09 to $0.12
shtooc: calls $0.09
*** TURN *** [6d 5s 6h] [Qs]
vikonda85: bets $0.20
shtooc: calls $0.20
*** RIVER *** [6d 5s 6h Qs] [4d]
vikonda85: bets $0.38
shtooc: calls $0.38
*** SHOW DOWN ***
vikonda85: shows [6c Jd] (three of a kind, Sixes)
shtooc: mucks hand 
vikonda85 collected $1.40 from pot
*** SUMMARY ***
Total pot $1.45 | Rake $0.05 
Board [6d 5s 6h Qs 4d]
Seat 1: tenishevo (button) folded before Flop (didn't bet)
Seat 2: hc agorist (small blind) folded before Flop
Seat 3: vikonda85 (big blind) showed [6c Jd] and won ($1.40) with three of a kind, Sixes
Seat 4: dupon101 folded before Flop (didn't bet)
Seat 5: evovida folded before Flop (didn't bet)
Seat 6: shtooc mucked [Td Qh]



PokerStars Zoom Hand #193395576256:  Hold'em No Limit ($0.01/$0.02) - 2018/11/17 1:46:14 CUST [2018/11/16 12:46:14 ET]
Table 'Halley' 6-max Seat #1 is the button
Seat 1: fomik33 ($2.52 in chips) 
Seat 2: UZ=ZERO=UZ ($1.75 in chips) 
Seat 3: DANILZOL ($3.32 in chips) 
Seat 4: hc agorist ($5.11 in chips) 
Seat 5: epikouros93 ($4.07 in chips) 
Seat 6: and_67rus ($3.30 in chips) 
UZ=ZERO=UZ: posts small blind $0.01
DANILZOL: posts big blind $0.02
*** HOLE CARDS ***
Dealt to hc agorist [6d Js]
hc agorist: folds 
epikouros93: folds 
and_67rus: raises $0.04 to $0.06
fomik33: folds 
UZ=ZERO=UZ: folds 
DANILZOL: raises $0.10 to $0.16
and_67rus: calls $0.10
*** FLOP *** [5h 8c 2h]
DANILZOL: bets $0.32
and_67rus: folds 
Uncalled bet ($0.32) returned to DANILZOL
DANILZOL collected $0.32 from pot
DANILZOL: doesn't show hand 
*** SUMMARY ***
Total pot $0.33 | Rake $0.01 
Board [5h 8c 2h]
Seat 1: fomik33 (button) folded before Flop (didn't bet)
Seat 2: UZ=ZERO=UZ (small blind) folded before Flop
Seat 3: DANILZOL (big blind) collected ($0.32)
Seat 4: hc agorist folded before Flop (didn't bet)
Seat 5: epikouros93 folded before Flop (didn't bet)
Seat 6: and_67rus folded on the Flop



PokerStars Zoom Hand #193395598219:  Hold'em No Limit ($0.01/$0.02) - 2018/11/17 1:46:50 CUST [2018/11/16 12:46:50 ET]
Table 'Halley' 6-max Seat #1 is the button
Seat 1: soldim327 ($1.61 in chips) 
Seat 2: FumkyMon ($4.98 in chips) 
Seat 3: hc agorist ($5.14 in chips) 
Seat 4: mr.los9682 ($3 in chips) 
Seat 5: Evgen1907 ($2 in chips) 
Seat 6: Simkooo ($2.24 in chips) 
FumkyMon: posts small blind $0.01
hc agorist: posts big blind $0.02
*** HOLE CARDS ***
Dealt to hc agorist [2s 2c]
mr.los9682: folds 
Evgen1907: raises $0.04 to $0.06
Simkooo: folds 
soldim327: raises $0.12 to $0.18
FumkyMon: raises $0.28 to $0.46
hc agorist: folds 
Evgen1907: folds 
soldim327: folds 
Uncalled bet ($0.28) returned to FumkyMon
FumkyMon collected $0.44 from pot
FumkyMon: doesn't show hand 
*** SUMMARY ***
Total pot $0.44 | Rake $0 
Seat 1: soldim327 (button) folded before Flop
Seat 2: FumkyMon (small blind) collected ($0.44)
Seat 3: hc agorist (big blind) folded before Flop
Seat 4: mr.los9682 folded before Flop (didn't bet)
Seat 5: Evgen1907 folded before Flop
Seat 6: Simkooo folded before Flop (didn't bet)



PokerStars Zoom Hand #193395613782:  Hold'em No Limit ($0.01/$0.02) - 2018/11/17 1:47:15 CUST [2018/11/16 12:47:15 ET]
Table 'Halley' 6-max Seat #1 is the button
Seat 1: MOU77Y ($5.21 in chips) 
Seat 2: hc agorist ($5.12 in chips) 
Seat 3: 9opium9 ($2.08 in chips) 
Seat 4: Zehgrillo ($1.85 in chips) 
Seat 5: Simkooo ($2.23 in chips) 
Seat 6: SersemTT ($6.79 in chips) 
hc agorist: posts small blind $0.01
9opium9: posts big blind $0.02
*** HOLE CARDS ***
Dealt to hc agorist [6h 7c]
Zehgrillo: folds 
Simkooo: folds 
SersemTT: raises $0.04 to $0.06
MOU77Y: folds 
hc agorist: folds 
9opium9: folds 
Uncalled bet ($0.04) returned to SersemTT
SersemTT collected $0.05 from pot
SersemTT: doesn't show hand 
*** SUMMARY ***
Total pot $0.05 | Rake $0 
Seat 1: MOU77Y (button) folded before Flop (didn't bet)
Seat 2: hc agorist (small blind) folded before Flop
Seat 3: 9opium9 (big blind) folded before Flop
Seat 4: Zehgrillo folded before Flop (didn't bet)
Seat 5: Simkooo folded before Flop (didn't bet)
Seat 6: SersemTT collected ($0.05)



PokerStars Zoom Hand #193395595157:  Hold'em No Limit ($0.01/$0.02) - 2018/11/17 1:46:45 CUST [2018/11/16 12:46:45 ET]
Table 'Halley' 6-max Seat #1 is the button
Seat 1: nickbriggs82 ($3.35 in chips) 
Seat 2: Y.Zakharov ($2.37 in chips) 
Seat 3: ForHistory ($2.67 in chips) 
Seat 4: hc agorist ($5.14 in chips) 
Seat 5: pyrosteam ($3.23 in chips) 
Seat 6: AoMaZ ($3.97 in chips) 
Y.Zakharov: posts small blind $0.01
ForHistory: posts big blind $0.02
*** HOLE CARDS ***
Dealt to hc agorist [5d 6h]
hc agorist: folds 
pyrosteam: folds 
AoMaZ: folds 
nickbriggs82: folds 
Y.Zakharov: calls $0.01
ForHistory: raises $0.06 to $0.08
Y.Zakharov: calls $0.06
*** FLOP *** [5c 4c Qs]
Y.Zakharov: checks 
ForHistory: bets $0.10
Y.Zakharov: folds 
Uncalled bet ($0.10) returned to ForHistory
ForHistory collected $0.15 from pot
ForHistory: doesn't show hand 
*** SUMMARY ***
Total pot $0.16 | Rake $0.01 
Board [5c 4c Qs]
Seat 1: nickbriggs82 (button) folded before Flop (didn't bet)
Seat 2: Y.Zakharov (small blind) folded on the Flop
Seat 3: ForHistory (big blind) collected ($0.15)
Seat 4: hc agorist folded before Flop (didn't bet)
Seat 5: pyrosteam folded before Flop (didn't bet)
Seat 6: AoMaZ folded before Flop (didn't bet)



PokerStars Zoom Hand #193395610651:  Hold'em No Limit ($0.01/$0.02) - 2018/11/17 1:47:10 CUST [2018/11/16 12:47:10 ET]
Table 'Halley' 6-max Seat #1 is the button
Seat 1: gary01407 ($0.39 in chips) 
Seat 2: motoi8motoi ($2.06 in chips) 
Seat 3: Dindee1 ($7.24 in chips) 
Seat 4: MezMe95 ($3.98 in chips) 
Seat 5: Igor22913 ($2.40 in chips) 
Seat 6: hc agorist ($5.12 in chips) 
motoi8motoi: posts small blind $0.01
Dindee1: posts big blind $0.02
*** HOLE CARDS ***
Dealt to hc agorist [Jd 5s]
MezMe95: raises $0.04 to $0.06
Igor22913: folds 
hc agorist: folds 
gary01407: folds 
motoi8motoi: folds 
Dindee1: folds 
Uncalled bet ($0.04) returned to MezMe95
MezMe95 collected $0.05 from pot
MezMe95: doesn't show hand 
*** SUMMARY ***
Total pot $0.05 | Rake $0 
Seat 1: gary01407 (button) folded before Flop (didn't bet)
Seat 2: motoi8motoi (small blind) folded before Flop
Seat 3: Dindee1 (big blind) folded before Flop
Seat 4: MezMe95 collected ($0.05)
Seat 5: Igor22913 folded before Flop (didn't bet)
Seat 6: hc agorist folded before Flop (didn't bet)



PokerStars Zoom Hand #193395618649:  Hold'em No Limit ($0.01/$0.02) - 2018/11/17 1:47:23 CUST [2018/11/16 12:47:23 ET]
Table 'Halley' 6-max Seat #1 is the button
Seat 1: hc agorist ($5.11 in chips) 
Seat 2: sztuciec ($2.23 in chips) 
Seat 3: Fantomas353 ($2 in chips) 
Seat 4: dimati10 ($2 in chips) 
Seat 5: Nostrak_BR ($2.56 in chips) 
Seat 6: pojaba1111 ($2.44 in chips) 
sztuciec: posts small blind $0.01
Fantomas353: posts big blind $0.02
*** HOLE CARDS ***
Dealt to hc agorist [Kd Ac]
dimati10: raises $0.04 to $0.06
Nostrak_BR: folds 
pojaba1111: folds 
hc agorist: calls $0.06
sztuciec: folds 
Fantomas353: folds 
*** FLOP *** [2h 7h Ks]
dimati10: checks 
hc agorist: checks 
*** TURN *** [2h 7h Ks] [9s]
dimati10: checks 
hc agorist: bets $0.10
dimati10: folds 
Uncalled bet ($0.10) returned to hc agorist
hc agorist collected $0.14 from pot
hc agorist: doesn't show hand 
*** SUMMARY ***
Total pot $0.15 | Rake $0.01 
Board [2h 7h Ks 9s]
Seat 1: hc agorist (button) collected ($0.14)
Seat 2: sztuciec (small blind) folded before Flop
Seat 3: Fantomas353 (big blind) folded before Flop
Seat 4: dimati10 folded on the Turn
Seat 5: Nostrak_BR folded before Flop (didn't bet)
Seat 6: pojaba1111 folded before Flop (didn't bet)



PokerStars Zoom Hand #193395644108:  Hold'em No Limit ($0.01/$0.02) - 2018/11/17 1:48:04 CUST [2018/11/16 12:48:04 ET]
Table 'Halley' 6-max Seat #1 is the button
Seat 1: FAMMA_okk ($7.14 in chips) 
Seat 2: EvgenyUSSS ($2 in chips) 
Seat 3: hc agorist ($5.19 in chips) 
Seat 4: Niphet ($2.24 in chips) 
Seat 5: Edyard23 ($1.35 in chips) 
Seat 6: RaTzFaTz72 ($3.32 in chips) 
EvgenyUSSS: posts small blind $0.01
hc agorist: posts big blind $0.02
*** HOLE CARDS ***
Dealt to hc agorist [7c 3h]
Niphet: folds 
Edyard23: folds 
RaTzFaTz72: folds 
FAMMA_okk: folds 
EvgenyUSSS: raises $0.04 to $0.06
hc agorist: folds 
Uncalled bet ($0.04) returned to EvgenyUSSS
EvgenyUSSS collected $0.04 from pot
EvgenyUSSS: doesn't show hand 
*** SUMMARY ***
Total pot $0.04 | Rake $0 
Seat 1: FAMMA_okk (button) folded before Flop (didn't bet)
Seat 2: EvgenyUSSS (small blind) collected ($0.04)
Seat 3: hc agorist (big blind) folded before Flop
Seat 4: Niphet folded before Flop (didn't bet)
Seat 5: Edyard23 folded before Flop (didn't bet)
Seat 6: RaTzFaTz72 folded before Flop (didn't bet)



PokerStars Zoom Hand #193395640944:  Hold'em No Limit ($0.01/$0.02) - 2018/11/17 1:47:59 CUST [2018/11/16 12:47:59 ET]
Table 'Halley' 6-max Seat #1 is the button
Seat 1: EvaldasRa ($4.59 in chips) 
Seat 2: betojch ($2.15 in chips) 
Seat 3: Savavlad97 ($2.06 in chips) 
Seat 4: alenastorm ($0.83 in chips) 
Seat 5: hc agorist ($5.19 in chips) 
Seat 6: darkoldmaker ($2.06 in chips) 
betojch: posts small blind $0.01
Savavlad97: posts big blind $0.02
*** HOLE CARDS ***
Dealt to hc agorist [6h 2c]
alenastorm: folds 
hc agorist: folds 
darkoldmaker: raises $0.03 to $0.05
EvaldasRa: folds 
betojch: folds 
Savavlad97: raises $0.13 to $0.18
darkoldmaker: raises $1.88 to $2.06 and is all-in
Savavlad97: folds 
Uncalled bet ($1.88) returned to darkoldmaker
darkoldmaker collected $0.37 from pot
darkoldmaker: doesn't show hand 
*** SUMMARY ***
Total pot $0.37 | Rake $0 
Seat 1: EvaldasRa (button) folded before Flop (didn't bet)
Seat 2: betojch (small blind) folded before Flop
Seat 3: Savavlad97 (big blind) folded before Flop
Seat 4: alenastorm folded before Flop (didn't bet)
Seat 5: hc agorist folded before Flop (didn't bet)
Seat 6: darkoldmaker collected ($0.37)



PokerStars Zoom Hand #193395658995:  Hold'em No Limit ($0.01/$0.02) - 2018/11/17 1:48:28 CUST [2018/11/16 12:48:28 ET]
Table 'Halley' 6-max Seat #1 is the button
Seat 1: juancho0007 ($4.27 in chips) 
Seat 2: Qwkl ($2.01 in chips) 
Seat 3: hazza257 ($2.81 in chips) 
Seat 4: lastfox ($2.90 in chips) 
Seat 5: Edelhustler ($1.52 in chips) 
Seat 6: hc agorist ($5.17 in chips) 
Qwkl: posts small blind $0.01
hazza257: posts big blind $0.02
*** HOLE CARDS ***
Dealt to hc agorist [8s 8h]
lastfox: raises $0.04 to $0.06
Edelhustler: calls $0.06
hc agorist: calls $0.06
juancho0007: folds 
Qwkl: folds 
hazza257: calls $0.04
*** FLOP *** [Th 7c 9d]
hazza257: checks 
lastfox: checks 
Edelhustler: bets $0.13
hc agorist: calls $0.13
hazza257: folds 
lastfox: folds 
*** TURN *** [Th 7c 9d] [5h]
Edelhustler: checks 
hc agorist: checks 
*** RIVER *** [Th 7c 9d 5h] [Tc]
Edelhustler: checks 
hc agorist: checks 
*** SHOW DOWN ***
Edelhustler: shows [Ac Js] (a pair of Tens)
hc agorist: shows [8s 8h] (two pair, Tens and Eights)
hc agorist collected $0.49 from pot
*** SUMMARY ***
Total pot $0.51 | Rake $0.02 
Board [Th 7c 9d 5h Tc]
Seat 1: juancho0007 (button) folded before Flop (didn't bet)
Seat 2: Qwkl (small blind) folded before Flop
Seat 3: hazza257 (big blind) folded on the Flop
Seat 4: lastfox folded on the Flop
Seat 5: Edelhustler showed [Ac Js] and lost with a pair of Tens
Seat 6: hc agorist showed [8s 8h] and won ($0.49) with two pair, Tens and Eights



PokerStars Zoom Hand #193395691334:  Hold'em No Limit ($0.01/$0.02) - 2018/11/17 1:49:20 CUST [2018/11/16 12:49:20 ET]
Table 'Halley' 6-max Seat #1 is the button
Seat 1: hc agorist ($5.46 in chips) 
Seat 2: Muuule ($4.29 in chips) 
Seat 3: 1nnuendo ($2.30 in chips) 
Seat 4: positivefind ($3.10 in chips) 
Seat 5: dimati10 ($2.01 in chips) 
Seat 6: ultimate1998 ($2 in chips) 
Muuule: posts small blind $0.01
1nnuendo: posts big blind $0.02
*** HOLE CARDS ***
Dealt to hc agorist [9d 4d]
positivefind: folds 
dimati10: raises $0.04 to $0.06
ultimate1998: folds 
hc agorist: folds 
Muuule: folds 
1nnuendo: folds 
Uncalled bet ($0.04) returned to dimati10
dimati10 collected $0.05 from pot
dimati10: doesn't show hand 
*** SUMMARY ***
Total pot $0.05 | Rake $0 
Seat 1: hc agorist (button) folded before Flop (didn't bet)
Seat 2: Muuule (small blind) folded before Flop
Seat 3: 1nnuendo (big blind) folded before Flop
Seat 4: positivefind folded before Flop (didn't bet)
Seat 5: dimati10 collected ($0.05)
Seat 6: ultimate1998 folded before Flop (didn't bet)



PokerStars Zoom Hand #193395696225:  Hold'em No Limit ($0.01/$0.02) - 2018/11/17 1:49:28 CUST [2018/11/16 12:49:28 ET]
Table 'Halley' 6-max Seat #1 is the button
Seat 1: MOU77Y ($4.92 in chips) 
Seat 2: 4andha ($2.94 in chips) 
Seat 3: Vicki2016 ($0.62 in chips) 
Seat 4: SVG7777 ($3.42 in chips) 
Seat 5: hc agorist ($5.46 in chips) 
Seat 6: Muuule ($4.28 in chips) 
4andha: posts small blind $0.01
Vicki2016: posts big blind $0.02
*** HOLE CARDS ***
Dealt to hc agorist [4h 2d]
SVG7777: folds 
hc agorist: folds 
Muuule: folds 
MOU77Y: folds 
4andha: folds 
Uncalled bet ($0.01) returned to Vicki2016
Vicki2016 collected $0.02 from pot
Vicki2016: doesn't show hand 
*** SUMMARY ***
Total pot $0.02 | Rake $0 
Seat 1: MOU77Y (button) folded before Flop (didn't bet)
Seat 2: 4andha (small blind) folded before Flop
Seat 3: Vicki2016 (big blind) collected ($0.02)
Seat 4: SVG7777 folded before Flop (didn't bet)
Seat 5: hc agorist folded before Flop (didn't bet)
Seat 6: Muuule folded before Flop (didn't bet)



PokerStars Zoom Hand #193395655885:  Hold'em No Limit ($0.01/$0.02) - 2018/11/17 1:48:23 CUST [2018/11/16 12:48:23 ET]
Table 'Halley' 6-max Seat #1 is the button
Seat 1: JIMMYONTILT ($6.36 in chips) 
Seat 2: msu.fedos ($3.44 in chips) 
Seat 3: TBDKA ($1.91 in chips) 
Seat 4: batigan ($3.23 in chips) 
Seat 5: hc agorist ($5.17 in chips) 
Seat 6: alenastorm ($0.81 in chips) 
msu.fedos: posts small blind $0.01
TBDKA: posts big blind $0.02
*** HOLE CARDS ***
Dealt to hc agorist [6c 9h]
batigan: folds 
hc agorist: folds 
alenastorm: folds 
JIMMYONTILT: raises $0.05 to $0.07
msu.fedos: raises $0.21 to $0.28
TBDKA: calls $0.26
JIMMYONTILT: calls $0.21
*** FLOP *** [Qd 5c 2d]
msu.fedos: checks 
TBDKA: checks 
JIMMYONTILT: checks 
*** TURN *** [Qd 5c 2d] [Ts]
msu.fedos: bets $0.48
TBDKA: calls $0.48
JIMMYONTILT: folds 
*** RIVER *** [Qd 5c 2d Ts] [Ac]
msu.fedos: checks 
TBDKA: checks 
*** SHOW DOWN ***
msu.fedos: shows [Kc Kh] (a pair of Kings)
TBDKA: shows [Ad Jh] (a pair of Aces)
TBDKA collected $1.74 from pot
*** SUMMARY ***
Total pot $1.80 | Rake $0.06 
Board [Qd 5c 2d Ts Ac]
Seat 1: JIMMYONTILT (button) folded on the Turn
Seat 2: msu.fedos (small blind) showed [Kc Kh] and lost with a pair of Kings
Seat 3: TBDKA (big blind) showed [Ad Jh] and won ($1.74) with a pair of Aces
Seat 4: batigan folded before Flop (didn't bet)
Seat 5: hc agorist folded before Flop (didn't bet)
Seat 6: alenastorm folded before Flop (didn't bet)



PokerStars Zoom Hand #193395687522:  Hold'em No Limit ($0.01/$0.02) - 2018/11/17 1:49:14 CUST [2018/11/16 12:49:14 ET]
Table 'Halley' 6-max Seat #1 is the button
Seat 1: Dreaming.12138 ($3.10 in chips) 
Seat 2: hc agorist ($5.47 in chips) 
Seat 3: TUGUN 1 ($2.04 in chips) 
Seat 4: Burij14 ($7.27 in chips) 
Seat 5: 5th Rutland ($1.97 in chips) 
Seat 6: 8JI8 ($1.28 in chips) 
hc agorist: posts small blind $0.01
TUGUN 1: posts big blind $0.02
*** HOLE CARDS ***
Dealt to hc agorist [4d 5s]
Burij14: folds 
5th Rutland: folds 
8JI8: folds 
Dreaming.12138: raises $0.04 to $0.06
hc agorist: folds 
TUGUN 1: calls $0.04
*** FLOP *** [Tc 5c 3s]
TUGUN 1: checks 
Dreaming.12138: bets $0.06
TUGUN 1: calls $0.06
*** TURN *** [Tc 5c 3s] [2c]
TUGUN 1: checks 
Dreaming.12138: checks 
*** RIVER *** [Tc 5c 3s 2c] [6h]
TUGUN 1: bets $0.15
Dreaming.12138: folds 
Uncalled bet ($0.15) returned to TUGUN 1
TUGUN 1 collected $0.24 from pot
TUGUN 1: doesn't show hand 
*** SUMMARY ***
Total pot $0.25 | Rake $0.01 
Board [Tc 5c 3s 2c 6h]
Seat 1: Dreaming.12138 (button) folded on the River
Seat 2: hc agorist (small blind) folded before Flop
Seat 3: TUGUN 1 (big blind) collected ($0.24)
Seat 4: Burij14 folded before Flop (didn't bet)
Seat 5: 5th Rutland folded before Flop (didn't bet)
Seat 6: 8JI8 folded before Flop (didn't bet)



PokerStars Zoom Hand #193395699332:  Hold'em No Limit ($0.01/$0.02) - 2018/11/17 1:49:33 CUST [2018/11/16 12:49:33 ET]
Table 'Halley' 6-max Seat #1 is the button
Seat 1: trad_mac ($2.92 in chips) 
Seat 2: gerykoma ($2.54 in chips) 
Seat 3: hc agorist ($5.46 in chips) 
Seat 4: Vicki2016 ($1.20 in chips) 
Seat 5: vvk22 ($2.02 in chips) 
Seat 6: radamer1 ($2 in chips) 
gerykoma: posts small blind $0.01
hc agorist: posts big blind $0.02
*** HOLE CARDS ***
Dealt to hc agorist [3c Qd]
Vicki2016: calls $0.02
vvk22: folds 
radamer1: folds 
trad_mac: folds 
gerykoma: folds 
hc agorist: checks 
*** FLOP *** [7s 3s 2s]
hc agorist: checks 
Vicki2016: checks 
*** TURN *** [7s 3s 2s] [2h]
hc agorist: bets $0.02
Vicki2016: calls $0.02
*** RIVER *** [7s 3s 2s 2h] [Td]
hc agorist: checks 
Vicki2016: checks 
*** SHOW DOWN ***
hc agorist: shows [3c Qd] (two pair, Threes and Deuces)
Vicki2016: shows [7c Kc] (two pair, Sevens and Deuces)
Vicki2016 collected $0.09 from pot
*** SUMMARY ***
Total pot $0.09 | Rake $0 
Board [7s 3s 2s 2h Td]
Seat 1: trad_mac (button) folded before Flop (didn't bet)
Seat 2: gerykoma (small blind) folded before Flop
Seat 3: hc agorist (big blind) showed [3c Qd] and lost with two pair, Threes and Deuces
Seat 4: Vicki2016 showed [7c Kc] and won ($0.09) with two pair, Sevens and Deuces
Seat 5: vvk22 folded before Flop (didn't bet)
Seat 6: radamer1 folded before Flop (didn't bet)



PokerStars Zoom Hand #193395739337:  Hold'em No Limit ($0.01/$0.02) - 2018/11/17 1:50:38 CUST [2018/11/16 12:50:38 ET]
Table 'Halley' 6-max Seat #1 is the button
Seat 1: hc agorist ($5.42 in chips) 
Seat 2: Alexarulit ($1.98 in chips) 
Seat 3: akvest ($0.96 in chips) 
Seat 4: krosallt ($2.84 in chips) 
Seat 5: orangos ($1.64 in chips) 
Seat 6: Andrei748 ($2.50 in chips) 
Alexarulit: posts small blind $0.01
akvest: posts big blind $0.02
*** HOLE CARDS ***
Dealt to hc agorist [2s Qs]
krosallt: folds 
orangos: folds 
Andrei748: folds 
hc agorist: folds 
Alexarulit: folds 
Uncalled bet ($0.01) returned to akvest
akvest collected $0.02 from pot
akvest: doesn't show hand 
*** SUMMARY ***
Total pot $0.02 | Rake $0 
Seat 1: hc agorist (button) folded before Flop (didn't bet)
Seat 2: Alexarulit (small blind) folded before Flop
Seat 3: akvest (big blind) collected ($0.02)
Seat 4: krosallt folded before Flop (didn't bet)
Seat 5: orangos folded before Flop (didn't bet)
Seat 6: Andrei748 folded before Flop (didn't bet)



PokerStars Zoom Hand #193395736279:  Hold'em No Limit ($0.01/$0.02) - 2018/11/17 1:50:33 CUST [2018/11/16 12:50:33 ET]
Table 'Halley' 6-max Seat #1 is the button
Seat 1: chucky4x4 ($2.13 in chips) 
Seat 2: Therm0 ($1.62 in chips) 
Seat 3: SevastyanovM ($4.24 in chips) 
Seat 4: hc agorist ($5.42 in chips) 
Seat 5: Evgen1907 ($2 in chips) 
Seat 6: igor.leone33 ($1.86 in chips) 
Therm0: posts small blind $0.01
SevastyanovM: posts big blind $0.02
*** HOLE CARDS ***
Dealt to hc agorist [6c 4d]
hc agorist: folds 
Evgen1907: folds 
igor.leone33: folds 
chucky4x4: folds 
Therm0: raises $0.04 to $0.06
SevastyanovM: calls $0.04
*** FLOP *** [3h Td 8s]
Therm0: bets $0.08
SevastyanovM: folds 
Uncalled bet ($0.08) returned to Therm0
Therm0 collected $0.12 from pot
Therm0: doesn't show hand 
*** SUMMARY ***
Total pot $0.12 | Rake $0 
Board [3h Td 8s]
Seat 1: chucky4x4 (button) folded before Flop (didn't bet)
Seat 2: Therm0 (small blind) collected ($0.12)
Seat 3: SevastyanovM (big blind) folded on the Flop
Seat 4: hc agorist folded before Flop (didn't bet)
Seat 5: Evgen1907 folded before Flop (didn't bet)
Seat 6: igor.leone33 folded before Flop (didn't bet)



PokerStars Zoom Hand #193395744933:  Hold'em No Limit ($0.01/$0.02) - 2018/11/17 1:50:47 CUST [2018/11/16 12:50:47 ET]
Table 'Halley' 6-max Seat #1 is the button
Seat 1: pv2903 ($2.39 in chips) 
Seat 2: fomik33 ($2.33 in chips) 
Seat 3: ariana51130 ($3.21 in chips) 
Seat 4: soakedinmud ($2.07 in chips) 
Seat 5: Party4Arthy ($2.29 in chips) 
Seat 6: hc agorist ($5.42 in chips) 
fomik33: posts small blind $0.01
ariana51130: posts big blind $0.02
*** HOLE CARDS ***
Dealt to hc agorist [2c 2d]
soakedinmud: folds 
Party4Arthy: folds 
hc agorist: raises $0.04 to $0.06
pv2903: folds 
fomik33: folds 
ariana51130: calls $0.04
*** FLOP *** [9h 7s Ad]
ariana51130: checks 
hc agorist: bets $0.05
ariana51130: calls $0.05
*** TURN *** [9h 7s Ad] [2h]
ariana51130: checks 
hc agorist: bets $0.36
ariana51130: folds 
Uncalled bet ($0.36) returned to hc agorist
hc agorist collected $0.22 from pot
hc agorist: doesn't show hand 
*** SUMMARY ***
Total pot $0.23 | Rake $0.01 
Board [9h 7s Ad 2h]
Seat 1: pv2903 (button) folded before Flop (didn't bet)
Seat 2: fomik33 (small blind) folded before Flop
Seat 3: ariana51130 (big blind) folded on the Turn
Seat 4: soakedinmud folded before Flop (didn't bet)
Seat 5: Party4Arthy folded before Flop (didn't bet)
Seat 6: hc agorist collected ($0.22)



PokerStars Zoom Hand #193395774372:  Hold'em No Limit ($0.01/$0.02) - 2018/11/17 1:51:35 CUST [2018/11/16 12:51:35 ET]
Table 'Halley' 6-max Seat #1 is the button
Seat 1: VladKot ($3.11 in chips) 
Seat 2: hc agorist ($5.53 in chips) 
Seat 3: deazbest ($2.82 in chips) 
Seat 4: spookie 1971 ($2 in chips) 
Seat 5: JIMMYONTILT ($7.78 in chips) 
Seat 6: Artl26 ($1.52 in chips) 
hc agorist: posts small blind $0.01
deazbest: posts big blind $0.02
*** HOLE CARDS ***
Dealt to hc agorist [8d Jh]
spookie 1971: folds 
JIMMYONTILT: raises $0.05 to $0.07
Artl26: folds 
VladKot: folds 
hc agorist: folds 
deazbest: folds 
Uncalled bet ($0.05) returned to JIMMYONTILT
JIMMYONTILT collected $0.05 from pot
JIMMYONTILT: doesn't show hand 
*** SUMMARY ***
Total pot $0.05 | Rake $0 
Seat 1: VladKot (button) folded before Flop (didn't bet)
Seat 2: hc agorist (small blind) folded before Flop
Seat 3: deazbest (big blind) folded before Flop
Seat 4: spookie 1971 folded before Flop (didn't bet)
Seat 5: JIMMYONTILT collected ($0.05)
Seat 6: Artl26 folded before Flop (didn't bet)



PokerStars Zoom Hand #193395781217:  Hold'em No Limit ($0.01/$0.02) - 2018/11/17 1:51:46 CUST [2018/11/16 12:51:46 ET]
Table 'Halley' 6-max Seat #1 is the button
Seat 1: Bhz2905 ($4.66 in chips) 
Seat 2: kvendik ($0.11 in chips) 
Seat 3: hc agorist ($5.52 in chips) 
Seat 4: artmkiss90 ($0.96 in chips) 
Seat 5: CaptTugbeard ($2.46 in chips) 
Seat 6: vais8 ($0.46 in chips) 
kvendik: posts small blind $0.01
hc agorist: posts big blind $0.02
*** HOLE CARDS ***
Dealt to hc agorist [2s 8s]
artmkiss90: raises $0.02 to $0.04
CaptTugbeard: folds 
vais8: folds 
Bhz2905: raises $0.14 to $0.18
kvendik: folds 
hc agorist: folds 
artmkiss90: folds 
Uncalled bet ($0.14) returned to Bhz2905
Bhz2905 collected $0.11 from pot
Bhz2905: doesn't show hand 
*** SUMMARY ***
Total pot $0.11 | Rake $0 
Seat 1: Bhz2905 (button) collected ($0.11)
Seat 2: kvendik (small blind) folded before Flop
Seat 3: hc agorist (big blind) folded before Flop
Seat 4: artmkiss90 folded before Flop
Seat 5: CaptTugbeard folded before Flop (didn't bet)
Seat 6: vais8 folded before Flop (didn't bet)



PokerStars Zoom Hand #193395777460:  Hold'em No Limit ($0.01/$0.02) - 2018/11/17 1:51:40 CUST [2018/11/16 12:51:40 ET]
Table 'Halley' 6-max Seat #1 is the button
Seat 1: MOU77Y ($4.83 in chips) 
Seat 2: Mokkelo ($2.54 in chips) 
Seat 3: 27magneto27 ($2.03 in chips) 
Seat 4: TUGUN 1 ($2.12 in chips) 
Seat 5: hc agorist ($5.52 in chips) 
Seat 6: webboadam101 ($1.92 in chips) 
Mokkelo: posts small blind $0.01
27magneto27: posts big blind $0.02
*** HOLE CARDS ***
Dealt to hc agorist [7h 4d]
TUGUN 1: folds 
hc agorist: folds 
webboadam101: raises $0.04 to $0.06
MOU77Y: folds 
Mokkelo: folds 
27magneto27: folds 
Uncalled bet ($0.04) returned to webboadam101
webboadam101 collected $0.05 from pot
webboadam101: doesn't show hand 
*** SUMMARY ***
Total pot $0.05 | Rake $0 
Seat 1: MOU77Y (button) folded before Flop (didn't bet)
Seat 2: Mokkelo (small blind) folded before Flop
Seat 3: 27magneto27 (big blind) folded before Flop
Seat 4: TUGUN 1 folded before Flop (didn't bet)
Seat 5: hc agorist folded before Flop (didn't bet)
Seat 6: webboadam101 collected ($0.05)



PokerStars Zoom Hand #193395800458:  Hold'em No Limit ($0.01/$0.02) - 2018/11/17 1:52:03 CUST [2018/11/16 12:52:03 ET]
Table 'Halley' 6-max Seat #1 is the button
Seat 1: 1anXIce ($2.45 in chips) 
Seat 2: hc agorist ($5.50 in chips) 
Seat 3: Niphet ($2.13 in chips) 
Seat 4: positivefind ($3.11 in chips) 
Seat 5: chucky4x4 ($2.22 in chips) 
Seat 6: Party4Arthy ($2.21 in chips) 
hc agorist: posts small blind $0.01
Niphet: posts big blind $0.02
*** HOLE CARDS ***
Dealt to hc agorist [9c Js]
positivefind: folds 
chucky4x4: folds 
Party4Arthy: folds 
1anXIce: folds 
hc agorist: raises $0.02 to $0.04
Niphet: calls $0.02
*** FLOP *** [Ks 6s As]
hc agorist: checks 
Niphet: bets $0.06
hc agorist: calls $0.06
*** TURN *** [Ks 6s As] [Ts]
hc agorist: checks 
Niphet: checks 
*** RIVER *** [Ks 6s As Ts] [Ac]
hc agorist: bets $0.26
Niphet: folds 
Uncalled bet ($0.26) returned to hc agorist
hc agorist collected $0.19 from pot
hc agorist: doesn't show hand 
*** SUMMARY ***
Total pot $0.20 | Rake $0.01 
Board [Ks 6s As Ts Ac]
Seat 1: 1anXIce (button) folded before Flop (didn't bet)
Seat 2: hc agorist (small blind) collected ($0.19)
Seat 3: Niphet (big blind) folded on the River
Seat 4: positivefind folded before Flop (didn't bet)
Seat 5: chucky4x4 folded before Flop (didn't bet)
Seat 6: Party4Arthy folded before Flop (didn't bet)



PokerStars Zoom Hand #193395828137:  Hold'em No Limit ($0.01/$0.02) - 2018/11/17 1:52:48 CUST [2018/11/16 12:52:48 ET]
Table 'Halley' 6-max Seat #1 is the button
Seat 1: Nightshadex4 ($2.52 in chips) 
Seat 2: ASplayer9119 ($2.58 in chips) 
Seat 3: DOC037IV ($1.20 in chips) 
Seat 4: infiniti888 ($1.48 in chips) 
Seat 5: el visitante ($2 in chips) 
Seat 6: hc agorist ($5.59 in chips) 
ASplayer9119: posts small blind $0.01
DOC037IV: posts big blind $0.02
*** HOLE CARDS ***
Dealt to hc agorist [9d 5h]
infiniti888: folds 
el visitante: folds 
hc agorist: folds 
Nightshadex4: folds 
ASplayer9119: folds 
Uncalled bet ($0.01) returned to DOC037IV
DOC037IV collected $0.02 from pot
DOC037IV: doesn't show hand 
*** SUMMARY ***
Total pot $0.02 | Rake $0 
Seat 1: Nightshadex4 (button) folded before Flop (didn't bet)
Seat 2: ASplayer9119 (small blind) folded before Flop
Seat 3: DOC037IV (big blind) collected ($0.02)
Seat 4: infiniti888 folded before Flop (didn't bet)
Seat 5: el visitante folded before Flop (didn't bet)
Seat 6: hc agorist folded before Flop (didn't bet)



PokerStars Zoom Hand #193395831188:  Hold'em No Limit ($0.01/$0.02) - 2018/11/17 1:52:53 CUST [2018/11/16 12:52:53 ET]
Table 'Halley' 6-max Seat #1 is the button
Seat 1: hc agorist ($5.59 in chips) 
Seat 2: tonkarla ($4.10 in chips) 
Seat 3: artri3 ($2.40 in chips) 
Seat 4: VOVUK1983 ($1.96 in chips) 
Seat 5: max.m.7deiL ($2 in chips) 
Seat 6: alanzajapoker ($1.65 in chips) 
tonkarla: posts small blind $0.01
artri3: posts big blind $0.02
*** HOLE CARDS ***
Dealt to hc agorist [Ts 5s]
VOVUK1983: folds 
max.m.7deiL: folds 
alanzajapoker: folds 
hc agorist: raises $0.02 to $0.04
tonkarla: raises $0.26 to $0.30
artri3: folds 
hc agorist: folds 
Uncalled bet ($0.26) returned to tonkarla
tonkarla collected $0.10 from pot
tonkarla: doesn't show hand 
*** SUMMARY ***
Total pot $0.10 | Rake $0 
Seat 1: hc agorist (button) folded before Flop
Seat 2: tonkarla (small blind) collected ($0.10)
Seat 3: artri3 (big blind) folded before Flop
Seat 4: VOVUK1983 folded before Flop (didn't bet)
Seat 5: max.m.7deiL folded before Flop (didn't bet)
Seat 6: alanzajapoker folded before Flop (didn't bet)



