PokerStars Hand #174033861737:  Hold'em No Limit ($0.05/$0.10) - 2017/08/07 22:33:54 CCT [2017/08/07 10:33:54 ET]
Table 'Aludra' 6-max Seat #1 is the button
Seat 1: invincy ($10.05 in chips) 
Seat 2: pobedito ($10 in chips) 
Seat 3: HubertusB ($10 in chips) 
Seat 4: Panda0777 ($12.11 in chips) 
Seat 5: Yagnow ($10 in chips) 
Seat 6: dieterW21 ($7.60 in chips) 
pobedito: posts small blind $0.05
HubertusB: posts big blind $0.10
*** HOLE CARDS ***
Dealt to HubertusB [3c Td]
Panda0777: folds 
Yagnow: folds 
dieterW21: folds 
invincy: raises $0.15 to $0.25
pobedito: folds 
HubertusB: folds 
Uncalled bet ($0.15) returned to invincy
invincy collected $0.25 from pot
invincy: doesn't show hand 
*** SUMMARY ***
Total pot $0.25 | Rake $0 
Seat 1: invincy (button) collected ($0.25)
Seat 2: pobedito (small blind) folded before Flop
Seat 3: HubertusB (big blind) folded before Flop
Seat 4: Panda0777 folded before Flop (didn't bet)
Seat 5: Yagnow folded before Flop (didn't bet)
Seat 6: dieterW21 folded before Flop (didn't bet)



PokerStars Hand #174033889506:  Hold'em No Limit ($0.05/$0.10) - 2017/08/07 22:34:45 CCT [2017/08/07 10:34:45 ET]
Table 'Aludra' 6-max Seat #1 is the button
Seat 1: bigfreddo86 ($16.36 in chips) 
Seat 2: vista79$ ($10.13 in chips) 
Seat 3: HubertusB ($9.95 in chips) 
Seat 4: aka_d_trick ($11.80 in chips) 
Seat 5: su-kantu ($17.56 in chips) 
Seat 6: REGNIMOR ($10.15 in chips) 
vista79$: posts small blind $0.05
HubertusB: posts big blind $0.10
*** HOLE CARDS ***
Dealt to HubertusB [6c Ks]
aka_d_trick: raises $0.15 to $0.25
su-kantu: folds 
REGNIMOR: folds 
bigfreddo86: folds 
vista79$: folds 
HubertusB: folds 
Uncalled bet ($0.15) returned to aka_d_trick
aka_d_trick collected $0.25 from pot
aka_d_trick: doesn't show hand 
*** SUMMARY ***
Total pot $0.25 | Rake $0 
Seat 1: bigfreddo86 (button) folded before Flop (didn't bet)
Seat 2: vista79$ (small blind) folded before Flop
Seat 3: HubertusB (big blind) folded before Flop
Seat 4: aka_d_trick collected ($0.25)
Seat 5: su-kantu folded before Flop (didn't bet)
Seat 6: REGNIMOR folded before Flop (didn't bet)



PokerStars Hand #174033936496:  Hold'em No Limit ($0.05/$0.10) - 2017/08/07 22:36:12 CCT [2017/08/07 10:36:12 ET]
Table 'Aludra' 6-max Seat #1 is the button
Seat 1: GustavoAPB ($21.43 in chips) 
Seat 2: Panda0777 ($4.16 in chips) 
Seat 3: HubertusB ($9.44 in chips) 
Seat 4: chingyuan ($8.27 in chips) 
Seat 5: stas177 ($27.60 in chips) 
Seat 6: dh4ls1m ($14.76 in chips) 
Panda0777: posts small blind $0.05
HubertusB: posts big blind $0.10
*** HOLE CARDS ***
Dealt to HubertusB [Qs 9h]
chingyuan: folds 
stas177: raises $0.20 to $0.30
dh4ls1m: calls $0.30
GustavoAPB: folds 
Panda0777: folds 
HubertusB: folds 
*** FLOP *** [Kc 2s 5d]
stas177: checks 
dh4ls1m: bets $0.50
stas177: folds 
Uncalled bet ($0.50) returned to dh4ls1m
dh4ls1m collected $0.72 from pot
dh4ls1m: doesn't show hand 
*** SUMMARY ***
Total pot $0.75 | Rake $0.03 
Board [Kc 2s 5d]
Seat 1: GustavoAPB (button) folded before Flop (didn't bet)
Seat 2: Panda0777 (small blind) folded before Flop
Seat 3: HubertusB (big blind) folded before Flop
Seat 4: chingyuan folded before Flop (didn't bet)
Seat 5: stas177 folded on the Flop
Seat 6: dh4ls1m collected ($0.72)



PokerStars Hand #174033965102:  Hold'em No Limit ($0.05/$0.10) - 2017/08/07 22:37:05 CCT [2017/08/07 10:37:05 ET]
Table 'Aludra' 6-max Seat #1 is the button
Seat 1: madravida ($5.32 in chips) 
Seat 2: SWAYZE999 ($9.53 in chips) 
Seat 3: HubertusB ($9.62 in chips) 
Seat 4: someji ($4.90 in chips) 
Seat 5: REGNIMOR ($18.87 in chips) 
Seat 6: TrIGoRs ($9.05 in chips) 
SWAYZE999: posts small blind $0.05
HubertusB: posts big blind $0.10
*** HOLE CARDS ***
Dealt to HubertusB [4d 2c]
someji: folds 
REGNIMOR: folds 
TrIGoRs: folds 
madravida: folds 
SWAYZE999: folds 
Uncalled bet ($0.05) returned to HubertusB
HubertusB collected $0.10 from pot
HubertusB: doesn't show hand 
*** SUMMARY ***
Total pot $0.10 | Rake $0 
Seat 1: madravida (button) folded before Flop (didn't bet)
Seat 2: SWAYZE999 (small blind) folded before Flop
Seat 3: HubertusB (big blind) collected ($0.10)
Seat 4: someji folded before Flop (didn't bet)
Seat 5: REGNIMOR folded before Flop (didn't bet)
Seat 6: TrIGoRs folded before Flop (didn't bet)



PokerStars Hand #174033986795:  Hold'em No Limit ($0.05/$0.10) - 2017/08/07 22:37:45 CCT [2017/08/07 10:37:45 ET]
Table 'Aludra' 6-max Seat #1 is the button
Seat 1: invincy ($12.05 in chips) 
Seat 2: BigBadaBoom8 ($10.40 in chips) 
Seat 3: HubertusB ($9.62 in chips) 
Seat 4: JasonBalm ($4.70 in chips) 
Seat 5: Ajon_rus ($6.30 in chips) 
Seat 6: ckostt ($38.79 in chips) 
BigBadaBoom8: posts small blind $0.05
HubertusB: posts big blind $0.10
*** HOLE CARDS ***
Dealt to HubertusB [3c 4h]
JasonBalm: folds 
Ajon_rus: raises $0.20 to $0.30
ckostt: folds 
invincy: folds 
BigBadaBoom8: folds 
HubertusB: folds 
Uncalled bet ($0.20) returned to Ajon_rus
Ajon_rus collected $0.25 from pot
Ajon_rus: doesn't show hand 
*** SUMMARY ***
Total pot $0.25 | Rake $0 
Seat 1: invincy (button) folded before Flop (didn't bet)
Seat 2: BigBadaBoom8 (small blind) folded before Flop
Seat 3: HubertusB (big blind) folded before Flop
Seat 4: JasonBalm folded before Flop (didn't bet)
Seat 5: Ajon_rus collected ($0.25)
Seat 6: ckostt folded before Flop (didn't bet)



PokerStars Hand #174034006364:  Hold'em No Limit ($0.05/$0.10) - 2017/08/07 22:38:21 CCT [2017/08/07 10:38:21 ET]
Table 'Aludra' 6-max Seat #1 is the button
Seat 1: AB5OLUTI0N ($10.25 in chips) 
Seat 2: MariosPro999 ($13.17 in chips) 
Seat 3: HubertusB ($9.47 in chips) 
Seat 4: Benj13372 ($14.21 in chips) 
Seat 5: SEXXYMARTIN ($9.21 in chips) 
Seat 6: mariaa1985 ($11.13 in chips) 
MariosPro999: posts small blind $0.05
HubertusB: posts big blind $0.10
*** HOLE CARDS ***
Dealt to HubertusB [Kc Ad]
Benj13372: folds 
SEXXYMARTIN: folds 
mariaa1985: raises $0.20 to $0.30
AB5OLUTI0N: folds 
MariosPro999: folds 
HubertusB: raises $0.60 to $0.90
mariaa1985: calls $0.60
*** FLOP *** [8d 6h Js]
HubertusB: bets $1.10
mariaa1985: calls $1.10
*** TURN *** [8d 6h Js] [9d]
HubertusB: checks 
mariaa1985: bets $2
HubertusB: folds 
Uncalled bet ($2) returned to mariaa1985
mariaa1985 collected $3.87 from pot
mariaa1985: doesn't show hand 
*** SUMMARY ***
Total pot $4.05 | Rake $0.18 
Board [8d 6h Js 9d]
Seat 1: AB5OLUTI0N (button) folded before Flop (didn't bet)
Seat 2: MariosPro999 (small blind) folded before Flop
Seat 3: HubertusB (big blind) folded on the Turn
Seat 4: Benj13372 folded before Flop (didn't bet)
Seat 5: SEXXYMARTIN folded before Flop (didn't bet)
Seat 6: mariaa1985 collected ($3.87)



PokerStars Hand #174034088730:  Hold'em No Limit ($0.05/$0.10) - 2017/08/07 22:40:52 CCT [2017/08/07 10:40:52 ET]
Table 'Aludra' 6-max Seat #1 is the button
Seat 1: TheLonelyGuy ($10 in chips) 
Seat 2: nemabob85 ($10 in chips) 
Seat 3: HubertusB ($7.19 in chips) 
Seat 4: countsheep ($22 in chips) 
Seat 5: Redbooker ($10 in chips) 
Seat 6: AndreyK11 ($10 in chips) 
nemabob85: posts small blind $0.05
HubertusB: posts big blind $0.10
*** HOLE CARDS ***
Dealt to HubertusB [9c 5h]
countsheep: raises $0.15 to $0.25
Redbooker: folds 
AndreyK11: folds 
TheLonelyGuy: folds 
nemabob85: folds 
HubertusB: folds 
Uncalled bet ($0.15) returned to countsheep
countsheep collected $0.25 from pot
countsheep: doesn't show hand 
*** SUMMARY ***
Total pot $0.25 | Rake $0 
Seat 1: TheLonelyGuy (button) folded before Flop (didn't bet)
Seat 2: nemabob85 (small blind) folded before Flop
Seat 3: HubertusB (big blind) folded before Flop
Seat 4: countsheep collected ($0.25)
Seat 5: Redbooker folded before Flop (didn't bet)
Seat 6: AndreyK11 folded before Flop (didn't bet)



PokerStars Hand #174034145720:  Hold'em No Limit ($0.05/$0.10) - 2017/08/07 22:42:36 CCT [2017/08/07 10:42:36 ET]
Table 'Aludra' 6-max Seat #1 is the button
Seat 1: pody606 ($11.95 in chips) 
Seat 2: afrika14 ($10 in chips) 
Seat 3: HubertusB ($13.42 in chips) 
Seat 4: nemabob85 ($10 in chips) 
Seat 5: pobedito ($9.94 in chips) 
Seat 6: auraph333 ($8.73 in chips) 
afrika14: posts small blind $0.05
HubertusB: posts big blind $0.10
*** HOLE CARDS ***
Dealt to HubertusB [8s Td]
nemabob85: folds 
pobedito: folds 
auraph333: folds 
pody606: folds 
afrika14: folds 
Uncalled bet ($0.05) returned to HubertusB
HubertusB collected $0.10 from pot
HubertusB: doesn't show hand 
*** SUMMARY ***
Total pot $0.10 | Rake $0 
Seat 1: pody606 (button) folded before Flop (didn't bet)
Seat 2: afrika14 (small blind) folded before Flop
Seat 3: HubertusB (big blind) collected ($0.10)
Seat 4: nemabob85 folded before Flop (didn't bet)
Seat 5: pobedito folded before Flop (didn't bet)
Seat 6: auraph333 folded before Flop (didn't bet)



PokerStars Hand #174034186758:  Hold'em No Limit ($0.05/$0.10) - 2017/08/07 22:43:51 CCT [2017/08/07 10:43:51 ET]
Table 'Aludra' 6-max Seat #1 is the button
Seat 1: pody606 ($11.11 in chips) 
Seat 2: piirakka87 ($11.73 in chips) 
Seat 3: HubertusB ($13.57 in chips) 
Seat 4: d.paul141 ($15.34 in chips) 
Seat 5: MinezNunez ($18.66 in chips) 
Seat 6: SensationSRB ($12.50 in chips) 
piirakka87: posts small blind $0.05
HubertusB: posts big blind $0.10
*** HOLE CARDS ***
Dealt to HubertusB [Kd 8s]
d.paul141: folds 
MinezNunez: folds 
SensationSRB: folds 
pody606: folds 
piirakka87: folds 
Uncalled bet ($0.05) returned to HubertusB
HubertusB collected $0.10 from pot
HubertusB: doesn't show hand 
*** SUMMARY ***
Total pot $0.10 | Rake $0 
Seat 1: pody606 (button) folded before Flop (didn't bet)
Seat 2: piirakka87 (small blind) folded before Flop
Seat 3: HubertusB (big blind) collected ($0.10)
Seat 4: d.paul141 folded before Flop (didn't bet)
Seat 5: MinezNunez folded before Flop (didn't bet)
Seat 6: SensationSRB folded before Flop (didn't bet)



PokerStars Hand #174034220672:  Hold'em No Limit ($0.05/$0.10) - 2017/08/07 22:44:53 CCT [2017/08/07 10:44:53 ET]
Table 'Aludra' 6-max Seat #1 is the button
Seat 1: vista79$ ($12.70 in chips) 
Seat 2: 99mess99 ($13.01 in chips) 
Seat 3: HubertusB ($13.45 in chips) 
Seat 4: BigBadaBoom8 ($11.53 in chips) 
Seat 5: uraal ($12.17 in chips) 
Seat 6: Romantik881 ($3.45 in chips) 
99mess99: posts small blind $0.05
HubertusB: posts big blind $0.10
*** HOLE CARDS ***
Dealt to HubertusB [Ad 3s]
BigBadaBoom8: folds 
uraal: folds 
Romantik881: folds 
vista79$: folds 
99mess99: folds 
Uncalled bet ($0.05) returned to HubertusB
HubertusB collected $0.10 from pot
HubertusB: doesn't show hand 
*** SUMMARY ***
Total pot $0.10 | Rake $0 
Seat 1: vista79$ (button) folded before Flop (didn't bet)
Seat 2: 99mess99 (small blind) folded before Flop
Seat 3: HubertusB (big blind) collected ($0.10)
Seat 4: BigBadaBoom8 folded before Flop (didn't bet)
Seat 5: uraal folded before Flop (didn't bet)
Seat 6: Romantik881 folded before Flop (didn't bet)



PokerStars Hand #174034274675:  Hold'em No Limit ($0.05/$0.10) - 2017/08/07 22:46:31 CCT [2017/08/07 10:46:31 ET]
Table 'Aludra' 6-max Seat #1 is the button
Seat 1: argintina ($11.18 in chips) 
Seat 2: pobedito ($6.82 in chips) 
Seat 3: HubertusB ($14.59 in chips) 
Seat 4: abe1988jp ($16.74 in chips) 
Seat 5: ChikoKz740 ($10.60 in chips) 
Seat 6: dh4ls1m ($10 in chips) 
pobedito: posts small blind $0.05
HubertusB: posts big blind $0.10
*** HOLE CARDS ***
Dealt to HubertusB [6c 2c]
abe1988jp: folds 
ChikoKz740: folds 
dh4ls1m: raises $0.20 to $0.30
argintina: raises $0.50 to $0.80
pobedito: folds 
HubertusB: folds 
dh4ls1m: folds 
Uncalled bet ($0.50) returned to argintina
argintina collected $0.75 from pot
argintina: doesn't show hand 
*** SUMMARY ***
Total pot $0.75 | Rake $0 
Seat 1: argintina (button) collected ($0.75)
Seat 2: pobedito (small blind) folded before Flop
Seat 3: HubertusB (big blind) folded before Flop
Seat 4: abe1988jp folded before Flop (didn't bet)
Seat 5: ChikoKz740 folded before Flop (didn't bet)
Seat 6: dh4ls1m folded before Flop



PokerStars Hand #174034309326:  Hold'em No Limit ($0.05/$0.10) - 2017/08/07 22:47:34 CCT [2017/08/07 10:47:34 ET]
Table 'Aludra' 6-max Seat #1 is the button
Seat 1: vista79$ ($10.97 in chips) 
Seat 2: beatyugly ($9.59 in chips) 
Seat 3: HubertusB ($15.18 in chips) 
Seat 4: ar13ms ($11.55 in chips) 
Seat 5: fedim4 ($7.28 in chips) 
Seat 6: invincy ($10.45 in chips) 
beatyugly: posts small blind $0.05
HubertusB: posts big blind $0.10
*** HOLE CARDS ***
Dealt to HubertusB [5h Ac]
ar13ms: raises $0.20 to $0.30
fedim4: folds 
invincy: folds 
vista79$: folds 
beatyugly: folds 
HubertusB: folds 
Uncalled bet ($0.20) returned to ar13ms
ar13ms collected $0.25 from pot
ar13ms: doesn't show hand 
*** SUMMARY ***
Total pot $0.25 | Rake $0 
Seat 1: vista79$ (button) folded before Flop (didn't bet)
Seat 2: beatyugly (small blind) folded before Flop
Seat 3: HubertusB (big blind) folded before Flop
Seat 4: ar13ms collected ($0.25)
Seat 5: fedim4 folded before Flop (didn't bet)
Seat 6: invincy folded before Flop (didn't bet)



PokerStars Hand #174034353791:  Hold'em No Limit ($0.05/$0.10) - 2017/08/07 22:48:55 CCT [2017/08/07 10:48:55 ET]
Table 'Aludra' 6-max Seat #1 is the button
Seat 1: VictorTomsk ($11.07 in chips) 
Seat 2: Imthenewfish ($10.39 in chips) 
Seat 3: HubertusB ($14.46 in chips) 
Seat 4: DavidSeko ($10 in chips) 
Seat 5: QeeNz ($10.47 in chips) 
Seat 6: BaconNHeggs ($20.20 in chips) 
Imthenewfish: posts small blind $0.05
HubertusB: posts big blind $0.10
*** HOLE CARDS ***
Dealt to HubertusB [7s 5d]
DavidSeko: folds 
QeeNz: raises $0.20 to $0.30
BaconNHeggs: folds 
VictorTomsk: folds 
Imthenewfish: folds 
HubertusB: folds 
Uncalled bet ($0.20) returned to QeeNz
QeeNz collected $0.25 from pot
QeeNz: doesn't show hand 
*** SUMMARY ***
Total pot $0.25 | Rake $0 
Seat 1: VictorTomsk (button) folded before Flop (didn't bet)
Seat 2: Imthenewfish (small blind) folded before Flop
Seat 3: HubertusB (big blind) folded before Flop
Seat 4: DavidSeko folded before Flop (didn't bet)
Seat 5: QeeNz collected ($0.25)
Seat 6: BaconNHeggs folded before Flop (didn't bet)



PokerStars Hand #174034388170:  Hold'em No Limit ($0.05/$0.10) - 2017/08/07 22:49:57 CCT [2017/08/07 10:49:57 ET]
Table 'Aludra' 6-max Seat #1 is the button
Seat 1: jessycarbf ($10 in chips) 
Seat 2: RabbiTAndrE ($4.87 in chips) 
Seat 3: HubertusB ($14.15 in chips) 
Seat 4: Mentos Cola ($5.90 in chips) 
Seat 5: TheLonelyGuy ($10 in chips) 
Seat 6: coic0098 ($10 in chips) 
RabbiTAndrE: posts small blind $0.05
HubertusB: posts big blind $0.10
*** HOLE CARDS ***
Dealt to HubertusB [Ah 6d]
Mentos Cola: folds 
TheLonelyGuy: folds 
coic0098: folds 
jessycarbf: raises $0.15 to $0.25
RabbiTAndrE: folds 
HubertusB: folds 
Uncalled bet ($0.15) returned to jessycarbf
jessycarbf collected $0.25 from pot
jessycarbf: doesn't show hand 
*** SUMMARY ***
Total pot $0.25 | Rake $0 
Seat 1: jessycarbf (button) collected ($0.25)
Seat 2: RabbiTAndrE (small blind) folded before Flop
Seat 3: HubertusB (big blind) folded before Flop
Seat 4: Mentos Cola folded before Flop (didn't bet)
Seat 5: TheLonelyGuy folded before Flop (didn't bet)
Seat 6: coic0098 folded before Flop (didn't bet)



PokerStars Hand #174034403188:  Hold'em No Limit ($0.05/$0.10) - 2017/08/07 22:50:24 CCT [2017/08/07 10:50:24 ET]
Table 'Aludra' 6-max Seat #1 is the button
Seat 1: zazexp ($10.30 in chips) 
Seat 2: Blizzad888 ($18.49 in chips) 
Seat 3: HubertusB ($14.05 in chips) 
Seat 4: Bacilis92 ($35.55 in chips) 
Seat 5: LeonTPro ($12.21 in chips) 
Seat 6: YaAmadayOK ($9.55 in chips) 
Blizzad888: posts small blind $0.05
HubertusB: posts big blind $0.10
*** HOLE CARDS ***
Dealt to HubertusB [5d 2c]
Bacilis92: folds 
LeonTPro: folds 
YaAmadayOK: raises $0.18 to $0.28
zazexp: raises $0.71 to $0.99
Blizzad888: folds 
HubertusB: folds 
YaAmadayOK: folds 
Uncalled bet ($0.71) returned to zazexp
zazexp collected $0.71 from pot
zazexp: doesn't show hand 
*** SUMMARY ***
Total pot $0.71 | Rake $0 
Seat 1: zazexp (button) collected ($0.71)
Seat 2: Blizzad888 (small blind) folded before Flop
Seat 3: HubertusB (big blind) folded before Flop
Seat 4: Bacilis92 folded before Flop (didn't bet)
Seat 5: LeonTPro folded before Flop (didn't bet)
Seat 6: YaAmadayOK folded before Flop



PokerStars Hand #174034470653:  Hold'em No Limit ($0.05/$0.10) - 2017/08/07 22:52:25 CCT [2017/08/07 10:52:25 ET]
Table 'Aludra' 6-max Seat #1 is the button
Seat 1: kivelof ($10 in chips) 
Seat 2: bigfeet885 ($13.03 in chips) 
Seat 3: HubertusB ($13.37 in chips) 
Seat 4: BaconNHeggs ($18.63 in chips) 
Seat 5: stas177 ($49.91 in chips) 
Seat 6: Bacilis92 ($36.03 in chips) 
bigfeet885: posts small blind $0.05
HubertusB: posts big blind $0.10
*** HOLE CARDS ***
Dealt to HubertusB [As 5h]
BaconNHeggs: folds 
stas177: folds 
Bacilis92: folds 
kivelof: raises $0.12 to $0.22
bigfeet885: raises $0.58 to $0.80
HubertusB: folds 
kivelof: folds 
Uncalled bet ($0.58) returned to bigfeet885
bigfeet885 collected $0.54 from pot
bigfeet885: doesn't show hand 
*** SUMMARY ***
Total pot $0.54 | Rake $0 
Seat 1: kivelof (button) folded before Flop
Seat 2: bigfeet885 (small blind) collected ($0.54)
Seat 3: HubertusB (big blind) folded before Flop
Seat 4: BaconNHeggs folded before Flop (didn't bet)
Seat 5: stas177 folded before Flop (didn't bet)
Seat 6: Bacilis92 folded before Flop (didn't bet)



PokerStars Hand #174034536932:  Hold'em No Limit ($0.05/$0.10) - 2017/08/07 22:54:24 CCT [2017/08/07 10:54:24 ET]
Table 'Aludra' 6-max Seat #1 is the button
Seat 1: alex88835 ($10.05 in chips) 
Seat 2: LedHeadLight ($10.46 in chips) 
Seat 3: HubertusB ($13.37 in chips) 
Seat 4: Antoszy ($10.22 in chips) 
Seat 5: Alex 1975646 ($8.09 in chips) 
Seat 6: Alek5is ($6.04 in chips) 
LedHeadLight: posts small blind $0.05
HubertusB: posts big blind $0.10
*** HOLE CARDS ***
Dealt to HubertusB [2s 3h]
Antoszy: folds 
Alex 1975646: folds 
Alek5is: folds 
alex88835: folds 
LedHeadLight: raises $0.10 to $0.20
HubertusB: folds 
Uncalled bet ($0.10) returned to LedHeadLight
LedHeadLight collected $0.20 from pot
LedHeadLight: doesn't show hand 
*** SUMMARY ***
Total pot $0.20 | Rake $0 
Seat 1: alex88835 (button) folded before Flop (didn't bet)
Seat 2: LedHeadLight (small blind) collected ($0.20)
Seat 3: HubertusB (big blind) folded before Flop
Seat 4: Antoszy folded before Flop (didn't bet)
Seat 5: Alex 1975646 folded before Flop (didn't bet)
Seat 6: Alek5is folded before Flop (didn't bet)



PokerStars Hand #174034558068:  Hold'em No Limit ($0.05/$0.10) - 2017/08/07 22:55:02 CCT [2017/08/07 10:55:02 ET]
Table 'Aludra' 6-max Seat #1 is the button
Seat 1: starkmage ($10 in chips) 
Seat 2: piirakka87 ($22.22 in chips) 
Seat 3: HubertusB ($13.17 in chips) 
Seat 4: Quetlaah ($31.42 in chips) 
Seat 5: Jas0nLee ($25.46 in chips) 
Seat 6: nikbelal ($10.15 in chips) 
piirakka87: posts small blind $0.05
HubertusB: posts big blind $0.10
*** HOLE CARDS ***
Dealt to HubertusB [8d Kh]
Quetlaah: folds 
Jas0nLee: folds 
nikbelal: folds 
starkmage: raises $0.10 to $0.20
piirakka87: raises $0.60 to $0.80
HubertusB: folds 
starkmage: folds 
Uncalled bet ($0.60) returned to piirakka87
piirakka87 collected $0.50 from pot
piirakka87: doesn't show hand 
*** SUMMARY ***
Total pot $0.50 | Rake $0 
Seat 1: starkmage (button) folded before Flop
Seat 2: piirakka87 (small blind) collected ($0.50)
Seat 3: HubertusB (big blind) folded before Flop
Seat 4: Quetlaah folded before Flop (didn't bet)
Seat 5: Jas0nLee folded before Flop (didn't bet)
Seat 6: nikbelal folded before Flop (didn't bet)



PokerStars Hand #174034579239:  Hold'em No Limit ($0.05/$0.10) - 2017/08/07 22:55:45 CCT [2017/08/07 10:55:45 ET]
Table 'Aludra' 6-max Seat #1 is the button
Seat 1: Elpihl ($11.97 in chips) 
Seat 2: copetin11 ($12.09 in chips) 
Seat 3: HubertusB ($13.07 in chips) 
Seat 4: piirakka87 ($35.35 in chips) 
Seat 5: kamala3494 ($12.03 in chips) 
Seat 6: Goatz7 ($17.85 in chips) 
copetin11: posts small blind $0.05
HubertusB: posts big blind $0.10
*** HOLE CARDS ***
Dealt to HubertusB [Kc 3h]
piirakka87: folds 
kamala3494: folds 
Goatz7: folds 
Elpihl: folds 
copetin11: raises $0.20 to $0.30
HubertusB: folds 
Uncalled bet ($0.20) returned to copetin11
copetin11 collected $0.20 from pot
copetin11: doesn't show hand 
*** SUMMARY ***
Total pot $0.20 | Rake $0 
Seat 1: Elpihl (button) folded before Flop (didn't bet)
Seat 2: copetin11 (small blind) collected ($0.20)
Seat 3: HubertusB (big blind) folded before Flop
Seat 4: piirakka87 folded before Flop (didn't bet)
Seat 5: kamala3494 folded before Flop (didn't bet)
Seat 6: Goatz7 folded before Flop (didn't bet)



PokerStars Hand #174034613910:  Hold'em No Limit ($0.05/$0.10) - 2017/08/07 22:56:56 CCT [2017/08/07 10:56:56 ET]
Table 'Aludra' 6-max Seat #1 is the button
Seat 1: Banginukas ($37.75 in chips) 
Seat 2: Alehandro279 ($12.32 in chips) 
Seat 3: HubertusB ($13.19 in chips) 
Seat 4: Elpihl ($8.97 in chips) 
Seat 5: zainaz ($10.35 in chips) 
Seat 6: kamala3494 ($12.06 in chips) 
Alehandro279: posts small blind $0.05
HubertusB: posts big blind $0.10
*** HOLE CARDS ***
Dealt to HubertusB [Jh 6h]
Elpihl: folds 
zainaz: folds 
kamala3494: folds 
Banginukas: raises $0.20 to $0.30
Alehandro279: folds 
HubertusB: folds 
Uncalled bet ($0.20) returned to Banginukas
Banginukas collected $0.25 from pot
Banginukas: doesn't show hand 
*** SUMMARY ***
Total pot $0.25 | Rake $0 
Seat 1: Banginukas (button) collected ($0.25)
Seat 2: Alehandro279 (small blind) folded before Flop
Seat 3: HubertusB (big blind) folded before Flop
Seat 4: Elpihl folded before Flop (didn't bet)
Seat 5: zainaz folded before Flop (didn't bet)
Seat 6: kamala3494 folded before Flop (didn't bet)



PokerStars Hand #174034629032:  Hold'em No Limit ($0.05/$0.10) - 2017/08/07 22:57:27 CCT [2017/08/07 10:57:27 ET]
Table 'Aludra' 6-max Seat #1 is the button
Seat 1: d.paul141 ($19.63 in chips) 
Seat 2: N0$tradamu$ ($6.18 in chips) 
Seat 3: HubertusB ($13.09 in chips) 
Seat 4: pro_raduga ($10 in chips) 
Seat 5: bober228 ($12.05 in chips) 
Seat 6: 31415Andy ($9.80 in chips) 
N0$tradamu$: posts small blind $0.05
HubertusB: posts big blind $0.10
*** HOLE CARDS ***
Dealt to HubertusB [6c 8d]
pro_raduga: folds 
bober228: folds 
31415Andy: folds 
d.paul141: raises $0.20 to $0.30
N0$tradamu$: folds 
HubertusB: folds 
Uncalled bet ($0.20) returned to d.paul141
d.paul141 collected $0.25 from pot
d.paul141: doesn't show hand 
*** SUMMARY ***
Total pot $0.25 | Rake $0 
Seat 1: d.paul141 (button) collected ($0.25)
Seat 2: N0$tradamu$ (small blind) folded before Flop
Seat 3: HubertusB (big blind) folded before Flop
Seat 4: pro_raduga folded before Flop (didn't bet)
Seat 5: bober228 folded before Flop (didn't bet)
Seat 6: 31415Andy folded before Flop (didn't bet)



PokerStars Hand #174034662567:  Hold'em No Limit ($0.05/$0.10) - 2017/08/07 22:58:35 CCT [2017/08/07 10:58:35 ET]
Table 'Aludra' 6-max Seat #1 is the button
Seat 1: Dteam-92 ($22.13 in chips) 
Seat 2: gamedore ($10.07 in chips) 
Seat 3: HubertusB ($12.01 in chips) 
Seat 4: Hospidal ($14.35 in chips) 
Seat 5: AAcidjazzAA ($9.60 in chips) 
Seat 6: bureas-TILT ($11.32 in chips) 
gamedore: posts small blind $0.05
HubertusB: posts big blind $0.10
*** HOLE CARDS ***
Dealt to HubertusB [5h 9s]
Hospidal: calls $0.10
AAcidjazzAA: folds 
bureas-TILT: calls $0.10
Dteam-92: folds 
gamedore: calls $0.05
HubertusB: checks 
*** FLOP *** [Jc Ac 7h]
gamedore: bets $0.30
HubertusB: folds 
Hospidal: calls $0.30
bureas-TILT: calls $0.30
*** TURN *** [Jc Ac 7h] [Qs]
gamedore: bets $0.62
Hospidal: folds 
bureas-TILT: calls $0.62
*** RIVER *** [Jc Ac 7h Qs] [7s]
gamedore: checks 
bureas-TILT: checks 
*** SHOW DOWN ***
gamedore: shows [As Td] (two pair, Aces and Sevens)
bureas-TILT: mucks hand 
gamedore collected $2.43 from pot
*** SUMMARY ***
Total pot $2.54 | Rake $0.11 
Board [Jc Ac 7h Qs 7s]
Seat 1: Dteam-92 (button) folded before Flop (didn't bet)
Seat 2: gamedore (small blind) showed [As Td] and won ($2.43) with two pair, Aces and Sevens
Seat 3: HubertusB (big blind) folded on the Flop
Seat 4: Hospidal folded on the Turn
Seat 5: AAcidjazzAA folded before Flop (didn't bet)
Seat 6: bureas-TILT mucked [Qc 5c]



PokerStars Hand #174034712123:  Hold'em No Limit ($0.05/$0.10) - 2017/08/07 23:00:15 CCT [2017/08/07 11:00:15 ET]
Table 'Aludra' 6-max Seat #1 is the button
Seat 1: kiwinho83 ($9.85 in chips) 
Seat 2: bober228 ($16.33 in chips) 
Seat 3: HubertusB ($12.08 in chips) 
Seat 4: JesperKing ($10 in chips) 
Seat 5: kawa6919 ($10.23 in chips) 
Seat 6: F1895 ($11.35 in chips) 
bober228: posts small blind $0.05
HubertusB: posts big blind $0.10
*** HOLE CARDS ***
Dealt to HubertusB [7c Td]
JesperKing: folds 
kawa6919: raises $0.20 to $0.30
F1895: folds 
kiwinho83: folds 
bober228: folds 
HubertusB: folds 
Uncalled bet ($0.20) returned to kawa6919
kawa6919 collected $0.25 from pot
kawa6919: doesn't show hand 
*** SUMMARY ***
Total pot $0.25 | Rake $0 
Seat 1: kiwinho83 (button) folded before Flop (didn't bet)
Seat 2: bober228 (small blind) folded before Flop
Seat 3: HubertusB (big blind) folded before Flop
Seat 4: JesperKing folded before Flop (didn't bet)
Seat 5: kawa6919 collected ($0.25)
Seat 6: F1895 folded before Flop (didn't bet)



PokerStars Hand #174034792584:  Hold'em No Limit ($0.05/$0.10) - 2017/08/07 23:02:45 CCT [2017/08/07 11:02:45 ET]
Table 'Aludra' 6-max Seat #1 is the button
Seat 1: mattu0 ($9.90 in chips) 
Seat 2: crash3r68 ($13.21 in chips) 
Seat 3: HubertusB ($11.99 in chips) 
Seat 4: alixir ($8.83 in chips) 
Seat 5: d.kach24 ($15.40 in chips) 
Seat 6: mannnnnu985 ($6.86 in chips) 
crash3r68: posts small blind $0.05
HubertusB: posts big blind $0.10
*** HOLE CARDS ***
Dealt to HubertusB [7d Qs]
alixir: folds 
d.kach24: folds 
mannnnnu985: folds 
mattu0: folds 
crash3r68: raises $0.15 to $0.25
HubertusB: folds 
Uncalled bet ($0.15) returned to crash3r68
crash3r68 collected $0.20 from pot
crash3r68: doesn't show hand 
*** SUMMARY ***
Total pot $0.20 | Rake $0 
Seat 1: mattu0 (button) folded before Flop (didn't bet)
Seat 2: crash3r68 (small blind) collected ($0.20)
Seat 3: HubertusB (big blind) folded before Flop
Seat 4: alixir folded before Flop (didn't bet)
Seat 5: d.kach24 folded before Flop (didn't bet)
Seat 6: mannnnnu985 folded before Flop (didn't bet)



PokerStars Hand #174034845850:  Hold'em No Limit ($0.05/$0.10) - 2017/08/07 23:04:20 CCT [2017/08/07 11:04:20 ET]
Table 'Aludra' 6-max Seat #1 is the button
Seat 1: alex88835 ($11.52 in chips) 
Seat 2: paya0809 ($7.68 in chips) 
Seat 3: HubertusB ($11.94 in chips) 
Seat 4: BigBadaBoom8 ($12.57 in chips) 
Seat 5: 6x6x6x6x6 ($17.82 in chips) 
Seat 6: kefaln ($10 in chips) 
paya0809: posts small blind $0.05
HubertusB: posts big blind $0.10
*** HOLE CARDS ***
Dealt to HubertusB [9s 9d]
BigBadaBoom8: folds 
6x6x6x6x6: folds 
kefaln: folds 
alex88835: raises $0.20 to $0.30
paya0809: folds 
HubertusB: raises $0.60 to $0.90
alex88835: raises $1.85 to $2.75
HubertusB: folds 
Uncalled bet ($1.85) returned to alex88835
alex88835 collected $1.85 from pot
alex88835: doesn't show hand 
*** SUMMARY ***
Total pot $1.85 | Rake $0 
Seat 1: alex88835 (button) collected ($1.85)
Seat 2: paya0809 (small blind) folded before Flop
Seat 3: HubertusB (big blind) folded before Flop
Seat 4: BigBadaBoom8 folded before Flop (didn't bet)
Seat 5: 6x6x6x6x6 folded before Flop (didn't bet)
Seat 6: kefaln folded before Flop (didn't bet)



