PokerStars Zoom Hand #177966733589:  Hold'em No Limit ($0.02/$0.05) - 2017/11/09 1:54:47 CCT [2017/11/08 12:54:47 ET]
Table 'Donati' 6-max Seat #1 is the button
Seat 1: FishoIogy ($6.29 in chips) 
Seat 2: ciceron86 ($5 in chips) 
Seat 3: HubertusB ($5 in chips) 
Seat 4: Volke!n kz ($8.46 in chips) 
Seat 5: DARTS_LAW ($4.96 in chips) 
Seat 6: Unstoppabble ($6.95 in chips) 
ciceron86: posts small blind $0.02
HubertusB: posts big blind $0.05
*** HOLE CARDS ***
Dealt to HubertusB [5h Qs]
Volke!n kz: folds 
DARTS_LAW: folds 
Unstoppabble: folds 
FishoIogy: raises $0.05 to $0.10
ciceron86: folds 
HubertusB: folds 
Uncalled bet ($0.05) returned to FishoIogy
FishoIogy collected $0.12 from pot
FishoIogy: doesn't show hand 
*** SUMMARY ***
Total pot $0.12 | Rake $0 
Seat 1: FishoIogy (button) collected ($0.12)
Seat 2: ciceron86 (small blind) folded before Flop
Seat 3: HubertusB (big blind) folded before Flop
Seat 4: Volke!n kz folded before Flop (didn't bet)
Seat 5: DARTS_LAW folded before Flop (didn't bet)
Seat 6: Unstoppabble folded before Flop (didn't bet)



PokerStars Zoom Hand #177966741070:  Hold'em No Limit ($0.02/$0.05) - 2017/11/09 1:54:57 CCT [2017/11/08 12:54:57 ET]
Table 'Donati' 6-max Seat #1 is the button
Seat 1: alexm883 ($6.26 in chips) 
Seat 2: HubertusB ($4.95 in chips) 
Seat 3: amolochan ($5.07 in chips) 
Seat 4: Planck88 ($13.72 in chips) 
Seat 5: I´m Grinder ($5.36 in chips) 
Seat 6: rmcnei03 ($1.40 in chips) 
HubertusB: posts small blind $0.02
amolochan: posts big blind $0.05
*** HOLE CARDS ***
Dealt to HubertusB [Th 9c]
Planck88: folds 
I´m Grinder: folds 
rmcnei03: calls $0.05
alexm883: folds 
HubertusB: folds 
amolochan: checks 
*** FLOP *** [5d 2h 7c]
amolochan: checks 
rmcnei03: bets $0.05
amolochan: folds 
Uncalled bet ($0.05) returned to rmcnei03
rmcnei03 collected $0.12 from pot
rmcnei03: doesn't show hand 
*** SUMMARY ***
Total pot $0.12 | Rake $0 
Board [5d 2h 7c]
Seat 1: alexm883 (button) folded before Flop (didn't bet)
Seat 2: HubertusB (small blind) folded before Flop
Seat 3: amolochan (big blind) folded on the Flop
Seat 4: Planck88 folded before Flop (didn't bet)
Seat 5: I´m Grinder folded before Flop (didn't bet)
Seat 6: rmcnei03 collected ($0.12)



PokerStars Zoom Hand #177966745530:  Hold'em No Limit ($0.02/$0.05) - 2017/11/09 1:55:03 CCT [2017/11/08 12:55:03 ET]
Table 'Donati' 6-max Seat #1 is the button
Seat 1: HubertusB ($4.93 in chips) 
Seat 2: LukksAA ($6.98 in chips) 
Seat 3: Rassty1983 ($6.13 in chips) 
Seat 4: kkllaass ($5.36 in chips) 
Seat 5: Funharti ($2.47 in chips) 
Seat 6: mel1in ($3.77 in chips) 
LukksAA: posts small blind $0.02
Rassty1983: posts big blind $0.05
*** HOLE CARDS ***
Dealt to HubertusB [2c 6d]
kkllaass: folds 
Funharti: folds 
mel1in: folds 
HubertusB: folds 
LukksAA: folds 
Uncalled bet ($0.03) returned to Rassty1983
Rassty1983 collected $0.04 from pot
Rassty1983: doesn't show hand 
*** SUMMARY ***
Total pot $0.04 | Rake $0 
Seat 1: HubertusB (button) folded before Flop (didn't bet)
Seat 2: LukksAA (small blind) folded before Flop
Seat 3: Rassty1983 (big blind) collected ($0.04)
Seat 4: kkllaass folded before Flop (didn't bet)
Seat 5: Funharti folded before Flop (didn't bet)
Seat 6: mel1in folded before Flop (didn't bet)



PokerStars Zoom Hand #177966750058:  Hold'em No Limit ($0.02/$0.05) - 2017/11/09 1:55:09 CCT [2017/11/08 12:55:09 ET]
Table 'Donati' 6-max Seat #1 is the button
Seat 1: fless836 ($6.47 in chips) 
Seat 2: aodwntm ($5.08 in chips) 
Seat 3: lenya_stein ($5.17 in chips) 
Seat 4: pokersito84 ($5 in chips) 
Seat 5: uncia7 ($4.41 in chips) 
Seat 6: HubertusB ($4.93 in chips) 
aodwntm: posts small blind $0.02
lenya_stein: posts big blind $0.05
*** HOLE CARDS ***
Dealt to HubertusB [7s 4h]
pokersito84: folds 
uncia7: raises $0.05 to $0.10
HubertusB: raises $0.20 to $0.30
fless836: folds 
aodwntm: folds 
lenya_stein: folds 
uncia7: calls $0.20
*** FLOP *** [Js Jh 3s]
uncia7: checks 
HubertusB: bets $0.35
uncia7: calls $0.35
*** TURN *** [Js Jh 3s] [Kd]
uncia7: checks 
HubertusB: bets $0.85
uncia7: raises $2.91 to $3.76 and is all-in
HubertusB: folds 
Uncalled bet ($2.91) returned to uncia7
uncia7 collected $2.94 from pot
uncia7: doesn't show hand 
*** SUMMARY ***
Total pot $3.07 | Rake $0.13 
Board [Js Jh 3s Kd]
Seat 1: fless836 (button) folded before Flop (didn't bet)
Seat 2: aodwntm (small blind) folded before Flop
Seat 3: lenya_stein (big blind) folded before Flop
Seat 4: pokersito84 folded before Flop (didn't bet)
Seat 5: uncia7 collected ($2.94)
Seat 6: HubertusB folded on the Turn



PokerStars Zoom Hand #177966781432:  Hold'em No Limit ($0.02/$0.05) - 2017/11/09 1:55:59 CCT [2017/11/08 12:55:59 ET]
Table 'Donati' 6-max Seat #1 is the button
Seat 1: 78LuckyAlex ($13.28 in chips) 
Seat 2: bzm73 ($13.57 in chips) 
Seat 3: thekingdrogb ($5 in chips) 
Seat 4: HubertusB ($3.33 in chips) 
Seat 5: Ruslan1111s ($10.03 in chips) 
Seat 6: uwanttobeeme ($6.65 in chips) 
bzm73: posts small blind $0.02
thekingdrogb: posts big blind $0.05
*** HOLE CARDS ***
Dealt to HubertusB [9h Qs]
HubertusB: folds 
Ruslan1111s: folds 
uwanttobeeme: folds 
78LuckyAlex: folds 
bzm73: folds 
Uncalled bet ($0.03) returned to thekingdrogb
thekingdrogb collected $0.04 from pot
thekingdrogb: doesn't show hand 
*** SUMMARY ***
Total pot $0.04 | Rake $0 
Seat 1: 78LuckyAlex (button) folded before Flop (didn't bet)
Seat 2: bzm73 (small blind) folded before Flop
Seat 3: thekingdrogb (big blind) collected ($0.04)
Seat 4: HubertusB folded before Flop (didn't bet)
Seat 5: Ruslan1111s folded before Flop (didn't bet)
Seat 6: uwanttobeeme folded before Flop (didn't bet)



PokerStars Zoom Hand #177966775348:  Hold'em No Limit ($0.02/$0.05) - 2017/11/09 1:55:49 CCT [2017/11/08 12:55:49 ET]
Table 'Donati' 6-max Seat #1 is the button
Seat 1: makis305 ($5.95 in chips) 
Seat 2: Volke!n kz ($8.41 in chips) 
Seat 3: swesda21 ($22.34 in chips) 
Seat 4: trall1 ($10.25 in chips) 
Seat 5: HubertusB ($3.43 in chips) 
Seat 6: Petkunas ($5 in chips) 
Volke!n kz: posts small blind $0.02
swesda21: posts big blind $0.05
*** HOLE CARDS ***
Dealt to HubertusB [7h Kh]
trall1: folds 
HubertusB: raises $0.05 to $0.10
Petkunas: folds 
makis305: raises $0.25 to $0.35
Volke!n kz: folds 
swesda21: folds 
HubertusB: folds 
Uncalled bet ($0.25) returned to makis305
makis305 collected $0.27 from pot
makis305: doesn't show hand 
*** SUMMARY ***
Total pot $0.27 | Rake $0 
Seat 1: makis305 (button) collected ($0.27)
Seat 2: Volke!n kz (small blind) folded before Flop
Seat 3: swesda21 (big blind) folded before Flop
Seat 4: trall1 folded before Flop (didn't bet)
Seat 5: HubertusB folded before Flop
Seat 6: Petkunas folded before Flop (didn't bet)



PokerStars Zoom Hand #177966784581:  Hold'em No Limit ($0.02/$0.05) - 2017/11/09 1:56:04 CCT [2017/11/08 12:56:04 ET]
Table 'Donati' 6-max Seat #1 is the button
Seat 1: BOSCOBOT ($7.38 in chips) 
Seat 2: laiha ($5.11 in chips) 
Seat 3: HubertusB ($3.33 in chips) 
Seat 4: audiraise ($5.26 in chips) 
Seat 5: prata_uk ($14.23 in chips) 
Seat 6: Smeja21 ($11.17 in chips) 
laiha: posts small blind $0.02
HubertusB: posts big blind $0.05
*** HOLE CARDS ***
Dealt to HubertusB [Ac Td]
audiraise: raises $0.10 to $0.15
prata_uk: folds 
Smeja21: folds 
BOSCOBOT: folds 
laiha: folds 
HubertusB: folds 
Uncalled bet ($0.10) returned to audiraise
audiraise collected $0.12 from pot
audiraise: doesn't show hand 
*** SUMMARY ***
Total pot $0.12 | Rake $0 
Seat 1: BOSCOBOT (button) folded before Flop (didn't bet)
Seat 2: laiha (small blind) folded before Flop
Seat 3: HubertusB (big blind) folded before Flop
Seat 4: audiraise collected ($0.12)
Seat 5: prata_uk folded before Flop (didn't bet)
Seat 6: Smeja21 folded before Flop (didn't bet)



PokerStars Zoom Hand #177966790110:  Hold'em No Limit ($0.02/$0.05) - 2017/11/09 1:56:13 CCT [2017/11/08 12:56:13 ET]
Table 'Donati' 6-max Seat #1 is the button
Seat 1: Bunnytrickz7 ($2.41 in chips) 
Seat 2: HubertusB ($3.28 in chips) 
Seat 3: -=KZ PRO=- ($7.54 in chips) 
Seat 4: plazawolf ($5.74 in chips) 
Seat 5: DmitrySh85 ($7.98 in chips) 
Seat 6: kopatich52 ($8.89 in chips) 
HubertusB: posts small blind $0.02
-=KZ PRO=-: posts big blind $0.05
*** HOLE CARDS ***
Dealt to HubertusB [Qd 6d]
plazawolf: raises $0.10 to $0.15
DmitrySh85: folds 
kopatich52: folds 
Bunnytrickz7: folds 
HubertusB: folds 
-=KZ PRO=-: folds 
Uncalled bet ($0.10) returned to plazawolf
plazawolf collected $0.12 from pot
plazawolf: doesn't show hand 
*** SUMMARY ***
Total pot $0.12 | Rake $0 
Seat 1: Bunnytrickz7 (button) folded before Flop (didn't bet)
Seat 2: HubertusB (small blind) folded before Flop
Seat 3: -=KZ PRO=- (big blind) folded before Flop
Seat 4: plazawolf collected ($0.12)
Seat 5: DmitrySh85 folded before Flop (didn't bet)
Seat 6: kopatich52 folded before Flop (didn't bet)



PokerStars Zoom Hand #177966799466:  Hold'em No Limit ($0.02/$0.05) - 2017/11/09 1:56:28 CCT [2017/11/08 12:56:28 ET]
Table 'Donati' 6-max Seat #1 is the button
Seat 1: Porian ($5 in chips) 
Seat 2: booster61 ($7.13 in chips) 
Seat 3: ertras ($5.98 in chips) 
Seat 4: Ba!aganov ($13.46 in chips) 
Seat 5: fenix321 ($2.76 in chips) 
Seat 6: HubertusB ($3.26 in chips) 
booster61: posts small blind $0.02
ertras: posts big blind $0.05
*** HOLE CARDS ***
Dealt to HubertusB [8d Jd]
Ba!aganov: folds 
fenix321: raises $0.10 to $0.15
HubertusB: raises $0.30 to $0.45
Porian: folds 
booster61: folds 
ertras: folds 
fenix321: folds 
Uncalled bet ($0.30) returned to HubertusB
HubertusB collected $0.37 from pot
HubertusB: doesn't show hand 
*** SUMMARY ***
Total pot $0.37 | Rake $0 
Seat 1: Porian (button) folded before Flop (didn't bet)
Seat 2: booster61 (small blind) folded before Flop
Seat 3: ertras (big blind) folded before Flop
Seat 4: Ba!aganov folded before Flop (didn't bet)
Seat 5: fenix321 folded before Flop
Seat 6: HubertusB collected ($0.37)



PokerStars Zoom Hand #177966796269:  Hold'em No Limit ($0.02/$0.05) - 2017/11/09 1:56:23 CCT [2017/11/08 12:56:23 ET]
Table 'Donati' 6-max Seat #1 is the button
Seat 1: HubertusB ($3.26 in chips) 
Seat 2: Erkan97 ($4.61 in chips) 
Seat 3: duniy ($7.32 in chips) 
Seat 4: Pelimouse ($9.11 in chips) 
Seat 5: kkllaass ($5.12 in chips) 
Seat 6: newnick13 ($6.02 in chips) 
Erkan97: posts small blind $0.02
duniy: posts big blind $0.05
*** HOLE CARDS ***
Dealt to HubertusB [2d Ks]
Pelimouse: folds 
kkllaass: folds 
newnick13: folds 
HubertusB: folds 
Erkan97: calls $0.03
duniy: checks 
*** FLOP *** [Qc Ah 9h]
Erkan97: checks 
duniy: checks 
*** TURN *** [Qc Ah 9h] [4s]
Erkan97: checks 
duniy: checks 
*** RIVER *** [Qc Ah 9h 4s] [2s]
Erkan97: bets $0.10
duniy: calls $0.10
*** SHOW DOWN ***
Erkan97: shows [4d Td] (a pair of Fours)
duniy: shows [6c 6d] (a pair of Sixes)
duniy collected $0.29 from pot
*** SUMMARY ***
Total pot $0.30 | Rake $0.01 
Board [Qc Ah 9h 4s 2s]
Seat 1: HubertusB (button) folded before Flop (didn't bet)
Seat 2: Erkan97 (small blind) showed [4d Td] and lost with a pair of Fours
Seat 3: duniy (big blind) showed [6c 6d] and won ($0.29) with a pair of Sixes
Seat 4: Pelimouse folded before Flop (didn't bet)
Seat 5: kkllaass folded before Flop (didn't bet)
Seat 6: newnick13 folded before Flop (didn't bet)



PokerStars Zoom Hand #177966810191:  Hold'em No Limit ($0.02/$0.05) - 2017/11/09 1:56:45 CCT [2017/11/08 12:56:45 ET]
Table 'Donati' 6-max Seat #1 is the button
Seat 1: badman time ($5.55 in chips) 
Seat 2: Rassty1983 ($4.45 in chips) 
Seat 3: Friisbak ($16.09 in chips) 
Seat 4: BAAMBUR ($6.66 in chips) 
Seat 5: HubertusB ($3.48 in chips) 
Seat 6: DonRazVan18 ($16.85 in chips) 
Rassty1983: posts small blind $0.02
Friisbak: posts big blind $0.05
*** HOLE CARDS ***
Dealt to HubertusB [4d 6c]
BAAMBUR: raises $0.10 to $0.15
HubertusB: folds 
DonRazVan18: folds 
badman time: folds 
Rassty1983: folds 
Friisbak: folds 
Uncalled bet ($0.10) returned to BAAMBUR
BAAMBUR collected $0.12 from pot
BAAMBUR: doesn't show hand 
*** SUMMARY ***
Total pot $0.12 | Rake $0 
Seat 1: badman time (button) folded before Flop (didn't bet)
Seat 2: Rassty1983 (small blind) folded before Flop
Seat 3: Friisbak (big blind) folded before Flop
Seat 4: BAAMBUR collected ($0.12)
Seat 5: HubertusB folded before Flop (didn't bet)
Seat 6: DonRazVan18 folded before Flop (didn't bet)



PokerStars Zoom Hand #177966813273:  Hold'em No Limit ($0.02/$0.05) - 2017/11/09 1:56:50 CCT [2017/11/08 12:56:50 ET]
Table 'Donati' 6-max Seat #1 is the button
Seat 1: Maroshi99 ($5.36 in chips) 
Seat 2: coolgrays ($12.67 in chips) 
Seat 3: HubertusB ($3.48 in chips) 
Seat 4: ilya306c ($10.58 in chips) 
Seat 5: renat199125 ($2.13 in chips) 
Seat 6: Mantaz ($5.05 in chips) 
coolgrays: posts small blind $0.02
HubertusB: posts big blind $0.05
*** HOLE CARDS ***
Dealt to HubertusB [6h 3s]
ilya306c: folds 
renat199125: folds 
Mantaz: folds 
Maroshi99: folds 
coolgrays: folds 
Uncalled bet ($0.03) returned to HubertusB
HubertusB collected $0.04 from pot
HubertusB: doesn't show hand 
*** SUMMARY ***
Total pot $0.04 | Rake $0 
Seat 1: Maroshi99 (button) folded before Flop (didn't bet)
Seat 2: coolgrays (small blind) folded before Flop
Seat 3: HubertusB (big blind) collected ($0.04)
Seat 4: ilya306c folded before Flop (didn't bet)
Seat 5: renat199125 folded before Flop (didn't bet)
Seat 6: Mantaz folded before Flop (didn't bet)



PokerStars Zoom Hand #177966820780:  Hold'em No Limit ($0.02/$0.05) - 2017/11/09 1:57:02 CCT [2017/11/08 12:57:02 ET]
Table 'Donati' 6-max Seat #1 is the button
Seat 1: HubertusB ($3.50 in chips) 
Seat 2: makis305 ($6.21 in chips) 
Seat 3: rmcnei03 ($1.49 in chips) 
Seat 4: lR0G3Rl ($6.93 in chips) 
Seat 5: yourtsu ($4.48 in chips) 
Seat 6: Rassty1983 ($4.43 in chips) 
makis305: posts small blind $0.02
rmcnei03: posts big blind $0.05
*** HOLE CARDS ***
Dealt to HubertusB [3h Tc]
lR0G3Rl: raises $0.10 to $0.15
yourtsu: folds 
Rassty1983: folds 
HubertusB: folds 
makis305: folds 
rmcnei03: folds 
Uncalled bet ($0.10) returned to lR0G3Rl
lR0G3Rl collected $0.12 from pot
lR0G3Rl: doesn't show hand 
*** SUMMARY ***
Total pot $0.12 | Rake $0 
Seat 1: HubertusB (button) folded before Flop (didn't bet)
Seat 2: makis305 (small blind) folded before Flop
Seat 3: rmcnei03 (big blind) folded before Flop
Seat 4: lR0G3Rl collected ($0.12)
Seat 5: yourtsu folded before Flop (didn't bet)
Seat 6: Rassty1983 folded before Flop (didn't bet)



PokerStars Zoom Hand #177966824490:  Hold'em No Limit ($0.02/$0.05) - 2017/11/09 1:57:08 CCT [2017/11/08 12:57:08 ET]
Table 'Donati' 6-max Seat #1 is the button
Seat 1: Zepka1988 ($7.26 in chips) 
Seat 2: Escard0 ($8.82 in chips) 
Seat 3: Kondr-KAV ($1.14 in chips) 
Seat 4: HH-hour ($7.06 in chips) 
Seat 5: plazawolf ($6.57 in chips) 
Seat 6: HubertusB ($3.50 in chips) 
Escard0: posts small blind $0.02
Kondr-KAV: posts big blind $0.05
*** HOLE CARDS ***
Dealt to HubertusB [Qc 2c]
HH-hour: folds 
plazawolf: folds 
HubertusB: raises $0.05 to $0.10
Zepka1988: folds 
Escard0: folds 
Kondr-KAV: folds 
Uncalled bet ($0.05) returned to HubertusB
HubertusB collected $0.12 from pot
HubertusB: doesn't show hand 
*** SUMMARY ***
Total pot $0.12 | Rake $0 
Seat 1: Zepka1988 (button) folded before Flop (didn't bet)
Seat 2: Escard0 (small blind) folded before Flop
Seat 3: Kondr-KAV (big blind) folded before Flop
Seat 4: HH-hour folded before Flop (didn't bet)
Seat 5: plazawolf folded before Flop (didn't bet)
Seat 6: HubertusB collected ($0.12)



PokerStars Zoom Hand #177966835632:  Hold'em No Limit ($0.02/$0.05) - 2017/11/09 1:57:26 CCT [2017/11/08 12:57:26 ET]
Table 'Donati' 6-max Seat #1 is the button
Seat 1: GaaMaster95 ($11.05 in chips) 
Seat 2: HubertusB ($3.57 in chips) 
Seat 3: SpicedGoldie ($5.24 in chips) 
Seat 4: O0r4nga ($5 in chips) 
Seat 5: Teariny0rEye ($6.08 in chips) 
Seat 6: marianoacha ($5.78 in chips) 
HubertusB: posts small blind $0.02
SpicedGoldie: posts big blind $0.05
*** HOLE CARDS ***
Dealt to HubertusB [8h 9s]
O0r4nga: raises $0.10 to $0.15
Teariny0rEye: folds 
marianoacha: folds 
GaaMaster95: folds 
HubertusB: folds 
SpicedGoldie: folds 
Uncalled bet ($0.10) returned to O0r4nga
O0r4nga collected $0.12 from pot
O0r4nga: doesn't show hand 
*** SUMMARY ***
Total pot $0.12 | Rake $0 
Seat 1: GaaMaster95 (button) folded before Flop (didn't bet)
Seat 2: HubertusB (small blind) folded before Flop
Seat 3: SpicedGoldie (big blind) folded before Flop
Seat 4: O0r4nga collected ($0.12)
Seat 5: Teariny0rEye folded before Flop (didn't bet)
Seat 6: marianoacha folded before Flop (didn't bet)



PokerStars Zoom Hand #177966844911:  Hold'em No Limit ($0.02/$0.05) - 2017/11/09 1:57:41 CCT [2017/11/08 12:57:41 ET]
Table 'Donati' 6-max Seat #1 is the button
Seat 1: Luzod ($6.95 in chips) 
Seat 2: Maverick 085 ($5.24 in chips) 
Seat 3: awekisa ($9.15 in chips) 
Seat 4: domitorii ($6.05 in chips) 
Seat 5: HubertusB ($3.55 in chips) 
Seat 6: djben2005 ($5.72 in chips) 
Maverick 085: posts small blind $0.02
awekisa: posts big blind $0.05
*** HOLE CARDS ***
Dealt to HubertusB [As 5h]
domitorii: folds 
HubertusB: raises $0.05 to $0.10
djben2005: folds 
Luzod: folds 
Maverick 085: folds 
awekisa: folds 
Uncalled bet ($0.05) returned to HubertusB
HubertusB collected $0.12 from pot
HubertusB: doesn't show hand 
*** SUMMARY ***
Total pot $0.12 | Rake $0 
Seat 1: Luzod (button) folded before Flop (didn't bet)
Seat 2: Maverick 085 (small blind) folded before Flop
Seat 3: awekisa (big blind) folded before Flop
Seat 4: domitorii folded before Flop (didn't bet)
Seat 5: HubertusB collected ($0.12)
Seat 6: djben2005 folded before Flop (didn't bet)



PokerStars Zoom Hand #177966854906:  Hold'em No Limit ($0.02/$0.05) - 2017/11/09 1:57:57 CCT [2017/11/08 12:57:57 ET]
Table 'Donati' 6-max Seat #1 is the button
Seat 1: b0wly ($9.05 in chips) 
Seat 2: Pro100PaPaN ($5.02 in chips) 
Seat 3: psychowallst ($9.42 in chips) 
Seat 4: HubertusB ($3.62 in chips) 
Seat 5: kopatich52 ($5.90 in chips) 
Seat 6: BOOLDOZER767 ($2.30 in chips) 
Pro100PaPaN: posts small blind $0.02
psychowallst: posts big blind $0.05
*** HOLE CARDS ***
Dealt to HubertusB [Qc 9h]
HubertusB: folds 
kopatich52: folds 
BOOLDOZER767: folds 
b0wly: folds 
Pro100PaPaN: raises $0.10 to $0.15
psychowallst: folds 
Uncalled bet ($0.10) returned to Pro100PaPaN
Pro100PaPaN collected $0.10 from pot
Pro100PaPaN: doesn't show hand 
*** SUMMARY ***
Total pot $0.10 | Rake $0 
Seat 1: b0wly (button) folded before Flop (didn't bet)
Seat 2: Pro100PaPaN (small blind) collected ($0.10)
Seat 3: psychowallst (big blind) folded before Flop
Seat 4: HubertusB folded before Flop (didn't bet)
Seat 5: kopatich52 folded before Flop (didn't bet)
Seat 6: BOOLDOZER767 folded before Flop (didn't bet)



PokerStars Zoom Hand #177966857983:  Hold'em No Limit ($0.02/$0.05) - 2017/11/09 1:58:02 CCT [2017/11/08 12:58:02 ET]
Table 'Donati' 6-max Seat #1 is the button
Seat 1: Pro131 ($11.40 in chips) 
Seat 2: SpicedGoldie ($5.06 in chips) 
Seat 3: jibanats ($2.47 in chips) 
Seat 4: HubertusB ($3.62 in chips) 
Seat 5: s_academia ($8.52 in chips) 
Seat 6: Porian ($5 in chips) 
SpicedGoldie: posts small blind $0.02
jibanats: posts big blind $0.05
*** HOLE CARDS ***
Dealt to HubertusB [Jc As]
HubertusB: raises $0.05 to $0.10
s_academia: calls $0.10
Porian: folds 
Pro131: folds 
SpicedGoldie: calls $0.08
jibanats: folds 
*** FLOP *** [4s Qh 4c]
SpicedGoldie: checks 
HubertusB: bets $0.15
s_academia: calls $0.15
SpicedGoldie: folds 
*** TURN *** [4s Qh 4c] [5s]
HubertusB: checks 
s_academia: bets $0.37
HubertusB: folds 
Uncalled bet ($0.37) returned to s_academia
s_academia collected $0.62 from pot
s_academia: doesn't show hand 
*** SUMMARY ***
Total pot $0.65 | Rake $0.03 
Board [4s Qh 4c 5s]
Seat 1: Pro131 (button) folded before Flop (didn't bet)
Seat 2: SpicedGoldie (small blind) folded on the Flop
Seat 3: jibanats (big blind) folded before Flop
Seat 4: HubertusB folded on the Turn
Seat 5: s_academia collected ($0.62)
Seat 6: Porian folded before Flop (didn't bet)



PokerStars Zoom Hand #177966841858:  Hold'em No Limit ($0.02/$0.05) - 2017/11/09 1:57:36 CCT [2017/11/08 12:57:36 ET]
Table 'Donati' 6-max Seat #1 is the button
Seat 1: halbsowild11 ($3.70 in chips) 
Seat 2: nonsensever ($5.04 in chips) 
Seat 3: Dm.Kochelkov ($9.30 in chips) 
Seat 4: HubertusB ($3.55 in chips) 
Seat 5: dontdoit665 ($5.72 in chips) 
Seat 6: Odvajke1 ($5.53 in chips) 
nonsensever: posts small blind $0.02
Dm.Kochelkov: posts big blind $0.05
*** HOLE CARDS ***
Dealt to HubertusB [5d 9h]
HubertusB: folds 
dontdoit665: folds 
Odvajke1: raises $0.07 to $0.12
halbsowild11: folds 
nonsensever: calls $0.10
Dm.Kochelkov: calls $0.07
*** FLOP *** [6s Ts Ad]
nonsensever: checks 
Dm.Kochelkov: checks 
Odvajke1: checks 
*** TURN *** [6s Ts Ad] [9d]
nonsensever: checks 
Dm.Kochelkov: bets $0.19
Odvajke1: folds 
nonsensever: folds 
Uncalled bet ($0.19) returned to Dm.Kochelkov
Dm.Kochelkov collected $0.35 from pot
Dm.Kochelkov: doesn't show hand 
*** SUMMARY ***
Total pot $0.36 | Rake $0.01 
Board [6s Ts Ad 9d]
Seat 1: halbsowild11 (button) folded before Flop (didn't bet)
Seat 2: nonsensever (small blind) folded on the Turn
Seat 3: Dm.Kochelkov (big blind) collected ($0.35)
Seat 4: HubertusB folded before Flop (didn't bet)
Seat 5: dontdoit665 folded before Flop (didn't bet)
Seat 6: Odvajke1 folded on the Turn



PokerStars Zoom Hand #177966885978:  Hold'em No Limit ($0.02/$0.05) - 2017/11/09 1:58:47 CCT [2017/11/08 12:58:47 ET]
Table 'Donati' 6-max Seat #1 is the button
Seat 1: dmi9644 ($6.10 in chips) 
Seat 2: ronjuan1976 ($1.27 in chips) 
Seat 3: HubertusB ($3.37 in chips) 
Seat 4: marianoacha ($10.97 in chips) 
Seat 5: KHLOVE ($8.88 in chips) 
Seat 6: Planck88 ($7.51 in chips) 
ronjuan1976: posts small blind $0.02
HubertusB: posts big blind $0.05
*** HOLE CARDS ***
Dealt to HubertusB [3h As]
marianoacha: folds 
KHLOVE: folds 
Planck88: raises $0.05 to $0.10
dmi9644: calls $0.10
ronjuan1976: calls $0.08
HubertusB: folds 
*** FLOP *** [Qd 5d Jd]
ronjuan1976: checks 
Planck88: checks 
dmi9644: checks 
*** TURN *** [Qd 5d Jd] [9h]
ronjuan1976: checks 
Planck88: checks 
dmi9644: checks 
*** RIVER *** [Qd 5d Jd 9h] [Jc]
ronjuan1976: bets $0.15
Planck88: folds 
dmi9644: folds 
Uncalled bet ($0.15) returned to ronjuan1976
ronjuan1976 collected $0.34 from pot
ronjuan1976: doesn't show hand 
*** SUMMARY ***
Total pot $0.35 | Rake $0.01 
Board [Qd 5d Jd 9h Jc]
Seat 1: dmi9644 (button) folded on the River
Seat 2: ronjuan1976 (small blind) collected ($0.34)
Seat 3: HubertusB (big blind) folded before Flop
Seat 4: marianoacha folded before Flop (didn't bet)
Seat 5: KHLOVE folded before Flop (didn't bet)
Seat 6: Planck88 folded on the River



PokerStars Zoom Hand #177966896516:  Hold'em No Limit ($0.02/$0.05) - 2017/11/09 1:59:04 CCT [2017/11/08 12:59:04 ET]
Table 'Donati' 6-max Seat #1 is the button
Seat 1: HubertusB ($3.30 in chips) 
Seat 2: Shurnjaja ($7.17 in chips) 
Seat 3: Pro100PaPaN ($5.46 in chips) 
Seat 4: Erkan97 ($3.01 in chips) 
Seat 5: Ignite13 ($11.35 in chips) 
Seat 6: nostlagia ($5.26 in chips) 
Shurnjaja: posts small blind $0.02
Pro100PaPaN: posts big blind $0.05
*** HOLE CARDS ***
Dealt to HubertusB [2c 5h]
Erkan97: folds 
Ignite13: folds 
nostlagia: folds 
HubertusB: raises $0.05 to $0.10
Shurnjaja: calls $0.08
Pro100PaPaN: calls $0.05
*** FLOP *** [3c 2d Js]
Shurnjaja: bets $0.15
Pro100PaPaN: folds 
HubertusB: raises $0.30 to $0.45
Shurnjaja: folds 
Uncalled bet ($0.30) returned to HubertusB
HubertusB collected $0.58 from pot
HubertusB: doesn't show hand 
*** SUMMARY ***
Total pot $0.60 | Rake $0.02 
Board [3c 2d Js]
Seat 1: HubertusB (button) collected ($0.58)
Seat 2: Shurnjaja (small blind) folded on the Flop
Seat 3: Pro100PaPaN (big blind) folded on the Flop
Seat 4: Erkan97 folded before Flop (didn't bet)
Seat 5: Ignite13 folded before Flop (didn't bet)
Seat 6: nostlagia folded before Flop (didn't bet)



PokerStars Zoom Hand #177966892738:  Hold'em No Limit ($0.02/$0.05) - 2017/11/09 1:58:58 CCT [2017/11/08 12:58:58 ET]
Table 'Donati' 6-max Seat #1 is the button
Seat 1: jullikka25 ($13.66 in chips) 
Seat 2: HubertusB ($3.32 in chips) 
Seat 3: Smeja21 ($11.39 in chips) 
Seat 4: KHLOVE ($13.58 in chips) 
Seat 5: Seyonne ($6.39 in chips) 
Seat 6: irina087 ($5.05 in chips) 
HubertusB: posts small blind $0.02
Smeja21: posts big blind $0.05
*** HOLE CARDS ***
Dealt to HubertusB [4d 2h]
KHLOVE: folds 
Seyonne: folds 
irina087: calls $0.05
jullikka25: folds 
HubertusB: folds 
Smeja21: checks 
*** FLOP *** [Ah 9h 6h]
Smeja21: checks 
irina087: checks 
*** TURN *** [Ah 9h 6h] [5h]
Smeja21: bets $0.08
irina087: calls $0.08
*** RIVER *** [Ah 9h 6h 5h] [6d]
Smeja21: bets $0.18
irina087: folds 
Uncalled bet ($0.18) returned to Smeja21
Smeja21 collected $0.27 from pot
Smeja21: doesn't show hand 
*** SUMMARY ***
Total pot $0.28 | Rake $0.01 
Board [Ah 9h 6h 5h 6d]
Seat 1: jullikka25 (button) folded before Flop (didn't bet)
Seat 2: HubertusB (small blind) folded before Flop
Seat 3: Smeja21 (big blind) collected ($0.27)
Seat 4: KHLOVE folded before Flop (didn't bet)
Seat 5: Seyonne folded before Flop (didn't bet)
Seat 6: irina087 folded on the River



PokerStars Zoom Hand #177966917171:  Hold'em No Limit ($0.02/$0.05) - 2017/11/09 1:59:37 CCT [2017/11/08 12:59:37 ET]
Table 'Donati' 6-max Seat #1 is the button
Seat 1: Shurnjaja ($7.15 in chips) 
Seat 2: balabir ($8.75 in chips) 
Seat 3: tsurumai ($4.51 in chips) 
Seat 4: berliner214 ($0.53 in chips) 
Seat 5: Rassty1983 ($19.71 in chips) 
Seat 6: HubertusB ($3.63 in chips) 
balabir: posts small blind $0.02
tsurumai: posts big blind $0.05
*** HOLE CARDS ***
Dealt to HubertusB [Td 5s]
berliner214: folds 
Rassty1983: folds 
HubertusB: raises $0.05 to $0.10
Shurnjaja: folds 
balabir: folds 
tsurumai: calls $0.05
*** FLOP *** [6c 9s 3d]
tsurumai: checks 
HubertusB: bets $0.15
tsurumai: folds 
Uncalled bet ($0.15) returned to HubertusB
HubertusB collected $0.21 from pot
HubertusB: doesn't show hand 
*** SUMMARY ***
Total pot $0.22 | Rake $0.01 
Board [6c 9s 3d]
Seat 1: Shurnjaja (button) folded before Flop (didn't bet)
Seat 2: balabir (small blind) folded before Flop
Seat 3: tsurumai (big blind) folded on the Flop
Seat 4: berliner214 folded before Flop (didn't bet)
Seat 5: Rassty1983 folded before Flop (didn't bet)
Seat 6: HubertusB collected ($0.21)



PokerStars Zoom Hand #177966934369:  Hold'em No Limit ($0.02/$0.05) - 2017/11/09 2:00:05 CCT [2017/11/08 13:00:05 ET]
Table 'Donati' 6-max Seat #1 is the button
Seat 1: sigsauer555 ($13.19 in chips) 
Seat 2: kanclerz ($5.62 in chips) 
Seat 3: HubertusB ($3.74 in chips) 
Seat 4: halbsowild11 ($3.31 in chips) 
Seat 5: MstrJJ ($12.41 in chips) 
Seat 6: KHLOVE ($13.58 in chips) 
kanclerz: posts small blind $0.02
HubertusB: posts big blind $0.05
*** HOLE CARDS ***
Dealt to HubertusB [5d 4h]
halbsowild11: folds 
MstrJJ: raises $0.10 to $0.15
KHLOVE: raises $0.37 to $0.52
sigsauer555: folds 
kanclerz: folds 
HubertusB: folds 
MstrJJ: folds 
Uncalled bet ($0.37) returned to KHLOVE
KHLOVE collected $0.37 from pot
KHLOVE: doesn't show hand 
*** SUMMARY ***
Total pot $0.37 | Rake $0 
Seat 1: sigsauer555 (button) folded before Flop (didn't bet)
Seat 2: kanclerz (small blind) folded before Flop
Seat 3: HubertusB (big blind) folded before Flop
Seat 4: halbsowild11 folded before Flop (didn't bet)
Seat 5: MstrJJ folded before Flop
Seat 6: KHLOVE collected ($0.37)



PokerStars Zoom Hand #177966930664:  Hold'em No Limit ($0.02/$0.05) - 2017/11/09 1:59:59 CCT [2017/11/08 12:59:59 ET]
Table 'Donati' 6-max Seat #1 is the button
Seat 1: s_academia ($9.30 in chips) 
Seat 2: Bragaa93 ($8.56 in chips) 
Seat 3: Unstoppabble ($6.43 in chips) 
Seat 4: sojuice ($5.32 in chips) 
Seat 5: HubertusB ($3.74 in chips) 
Seat 6: cl05rrr ($12.35 in chips) 
Bragaa93: posts small blind $0.02
Unstoppabble: posts big blind $0.05
*** HOLE CARDS ***
Dealt to HubertusB [2h 6d]
sojuice: folds 
HubertusB: folds 
cl05rrr: raises $0.12 to $0.17
s_academia: folds 
Bragaa93: folds 
Unstoppabble: folds 
Uncalled bet ($0.12) returned to cl05rrr
cl05rrr collected $0.12 from pot
cl05rrr: doesn't show hand 
*** SUMMARY ***
Total pot $0.12 | Rake $0 
Seat 1: s_academia (button) folded before Flop (didn't bet)
Seat 2: Bragaa93 (small blind) folded before Flop
Seat 3: Unstoppabble (big blind) folded before Flop
Seat 4: sojuice folded before Flop (didn't bet)
Seat 5: HubertusB folded before Flop (didn't bet)
Seat 6: cl05rrr collected ($0.12)



PokerStars Zoom Hand #177966938268:  Hold'em No Limit ($0.02/$0.05) - 2017/11/09 2:00:11 CCT [2017/11/08 13:00:11 ET]
Table 'Donati' 6-max Seat #1 is the button
Seat 1: -=KZ PRO=- ($8.12 in chips) 
Seat 2: -O5KAR5$-842 ($1.85 in chips) 
Seat 3: Erynaur ($5.75 in chips) 
Seat 4: zxmgp99 ($4.64 in chips) 
Seat 5: pevialex ($3.12 in chips) 
Seat 6: HubertusB ($3.69 in chips) 
-O5KAR5$-842: posts small blind $0.02
Erynaur: posts big blind $0.05
*** HOLE CARDS ***
Dealt to HubertusB [5s Qh]
zxmgp99: folds 
pevialex: folds 
HubertusB: raises $0.05 to $0.10
-=KZ PRO=-: folds 
-O5KAR5$-842: folds 
Erynaur: folds 
Uncalled bet ($0.05) returned to HubertusB
HubertusB collected $0.12 from pot
HubertusB: doesn't show hand 
*** SUMMARY ***
Total pot $0.12 | Rake $0 
Seat 1: -=KZ PRO=- (button) folded before Flop (didn't bet)
Seat 2: -O5KAR5$-842 (small blind) folded before Flop
Seat 3: Erynaur (big blind) folded before Flop
Seat 4: zxmgp99 folded before Flop (didn't bet)
Seat 5: pevialex folded before Flop (didn't bet)
Seat 6: HubertusB collected ($0.12)



PokerStars Zoom Hand #177966949365:  Hold'em No Limit ($0.02/$0.05) - 2017/11/09 2:00:28 CCT [2017/11/08 13:00:28 ET]
Table 'Donati' 6-max Seat #1 is the button
Seat 1: lukasamace ($5.26 in chips) 
Seat 2: HubertusB ($3.76 in chips) 
Seat 3: XeroLP ($9.18 in chips) 
Seat 4: bzm73 ($10.66 in chips) 
Seat 5: VVS2874 ($5.18 in chips) 
Seat 6: zsmoala ($4.81 in chips) 
HubertusB: posts small blind $0.02
XeroLP: posts big blind $0.05
*** HOLE CARDS ***
Dealt to HubertusB [Js 9d]
bzm73: folds 
VVS2874: folds 
zsmoala: folds 
lukasamace: folds 
HubertusB: folds 
Uncalled bet ($0.03) returned to XeroLP
XeroLP collected $0.04 from pot
XeroLP: doesn't show hand 
*** SUMMARY ***
Total pot $0.04 | Rake $0 
Seat 1: lukasamace (button) folded before Flop (didn't bet)
Seat 2: HubertusB (small blind) folded before Flop
Seat 3: XeroLP (big blind) collected ($0.04)
Seat 4: bzm73 folded before Flop (didn't bet)
Seat 5: VVS2874 folded before Flop (didn't bet)
Seat 6: zsmoala folded before Flop (didn't bet)



PokerStars Zoom Hand #177966946095:  Hold'em No Limit ($0.02/$0.05) - 2017/11/09 2:00:23 CCT [2017/11/08 13:00:23 ET]
Table 'Donati' 6-max Seat #1 is the button
Seat 1: HubertusB ($3.76 in chips) 
Seat 2: _Rodion_I_84 ($11.65 in chips) 
Seat 3: Rep_Nothing ($5.87 in chips) 
Seat 4: platypus681 ($5 in chips) 
Seat 5: almos548 ($4.44 in chips) 
Seat 6: domitorii ($5.55 in chips) 
_Rodion_I_84: posts small blind $0.02
Rep_Nothing: posts big blind $0.05
*** HOLE CARDS ***
Dealt to HubertusB [Qd 3s]
platypus681: folds 
almos548: folds 
domitorii: folds 
HubertusB: folds 
_Rodion_I_84: raises $0.05 to $0.10
Rep_Nothing: folds 
Uncalled bet ($0.05) returned to _Rodion_I_84
_Rodion_I_84 collected $0.10 from pot
_Rodion_I_84: doesn't show hand 
*** SUMMARY ***
Total pot $0.10 | Rake $0 
Seat 1: HubertusB (button) folded before Flop (didn't bet)
Seat 2: _Rodion_I_84 (small blind) collected ($0.10)
Seat 3: Rep_Nothing (big blind) folded before Flop
Seat 4: platypus681 folded before Flop (didn't bet)
Seat 5: almos548 folded before Flop (didn't bet)
Seat 6: domitorii folded before Flop (didn't bet)



PokerStars Zoom Hand #177966952584:  Hold'em No Limit ($0.02/$0.05) - 2017/11/09 2:00:33 CCT [2017/11/08 13:00:33 ET]
Table 'Donati' 6-max Seat #1 is the button
Seat 1: simple s0o ($7.35 in chips) 
Seat 2: VVS2874 ($5.35 in chips) 
Seat 3: Elchaza_1989 ($5.16 in chips) 
Seat 4: HubertusB ($3.74 in chips) 
Seat 5: Simenkloster ($1.11 in chips) 
Seat 6: SGD_Raptor ($9.37 in chips) 
VVS2874: posts small blind $0.02
Elchaza_1989: posts big blind $0.05
*** HOLE CARDS ***
Dealt to HubertusB [7s Js]
HubertusB: raises $0.05 to $0.10
Simenkloster: folds 
SGD_Raptor: raises $0.20 to $0.30
simple s0o: calls $0.30
VVS2874: folds 
Elchaza_1989: folds 
HubertusB: raises $0.75 to $1.05
SGD_Raptor: calls $0.75
simple s0o: raises $6.30 to $7.35 and is all-in
HubertusB: folds 
SGD_Raptor: calls $6.30
*** FLOP *** [9s Qd 3h]
*** TURN *** [9s Qd 3h] [3s]
*** RIVER *** [9s Qd 3h 3s] [Jh]
*** SHOW DOWN ***
SGD_Raptor: shows [8h 8s] (two pair, Eights and Threes)
simple s0o: shows [Ks Ac] (a pair of Threes)
SGD_Raptor collected $15.16 from pot
*** SUMMARY ***
Total pot $15.82 | Rake $0.66 
Board [9s Qd 3h 3s Jh]
Seat 1: simple s0o (button) showed [Ks Ac] and lost with a pair of Threes
Seat 2: VVS2874 (small blind) folded before Flop
Seat 3: Elchaza_1989 (big blind) folded before Flop
Seat 4: HubertusB folded before Flop
Seat 5: Simenkloster folded before Flop (didn't bet)
Seat 6: SGD_Raptor showed [8h 8s] and won ($15.16) with two pair, Eights and Threes



PokerStars Zoom Hand #177966996002:  Hold'em No Limit ($0.02/$0.05) - 2017/11/09 2:01:37 CCT [2017/11/08 13:01:37 ET]
Table 'Donati' 6-max Seat #1 is the button
Seat 1: SpicedGoldie ($4.14 in chips) 
Seat 2: Sonic.lg777 ($3.44 in chips) 
Seat 3: HubertusB ($2.69 in chips) 
Seat 4: lR0G3Rl ($6.02 in chips) 
Seat 5: prochy1909 ($5 in chips) 
Seat 6: HH-hour ($5.10 in chips) 
Sonic.lg777: posts small blind $0.02
HubertusB: posts big blind $0.05
*** HOLE CARDS ***
Dealt to HubertusB [Qc 6s]
lR0G3Rl: folds 
prochy1909: folds 
HH-hour: raises $0.10 to $0.15
SpicedGoldie: folds 
Sonic.lg777: folds 
HubertusB: folds 
Uncalled bet ($0.10) returned to HH-hour
HH-hour collected $0.12 from pot
HH-hour: doesn't show hand 
*** SUMMARY ***
Total pot $0.12 | Rake $0 
Seat 1: SpicedGoldie (button) folded before Flop (didn't bet)
Seat 2: Sonic.lg777 (small blind) folded before Flop
Seat 3: HubertusB (big blind) folded before Flop
Seat 4: lR0G3Rl folded before Flop (didn't bet)
Seat 5: prochy1909 folded before Flop (didn't bet)
Seat 6: HH-hour collected ($0.12)



PokerStars Zoom Hand #177966992489:  Hold'em No Limit ($0.02/$0.05) - 2017/11/09 2:01:32 CCT [2017/11/08 13:01:32 ET]
Table 'Donati' 6-max Seat #1 is the button
Seat 1: crash. xxxx ($0.79 in chips) 
Seat 2: awekisa ($6.45 in chips) 
Seat 3: slavatsatur ($2.99 in chips) 
Seat 4: HubertusB ($2.69 in chips) 
Seat 5: MedChrize ($20.11 in chips) 
Seat 6: chucky4x4 ($5 in chips) 
awekisa: posts small blind $0.02
slavatsatur: posts big blind $0.05
*** HOLE CARDS ***
Dealt to HubertusB [2d Ah]
HubertusB: folds 
MedChrize: folds 
chucky4x4: folds 
crash. xxxx: calls $0.05
awekisa: folds 
slavatsatur: checks 
*** FLOP *** [Jh 6c 6h]
slavatsatur: checks 
crash. xxxx: bets $0.05
slavatsatur: folds 
Uncalled bet ($0.05) returned to crash. xxxx
crash. xxxx collected $0.12 from pot
crash. xxxx: doesn't show hand 
*** SUMMARY ***
Total pot $0.12 | Rake $0 
Board [Jh 6c 6h]
Seat 1: crash. xxxx (button) collected ($0.12)
Seat 2: awekisa (small blind) folded before Flop
Seat 3: slavatsatur (big blind) folded on the Flop
Seat 4: HubertusB folded before Flop (didn't bet)
Seat 5: MedChrize folded before Flop (didn't bet)
Seat 6: chucky4x4 folded before Flop (didn't bet)



PokerStars Zoom Hand #177967016776:  Hold'em No Limit ($0.02/$0.05) - 2017/11/09 2:02:06 CCT [2017/11/08 13:02:06 ET]
Table 'Donati' 6-max Seat #1 is the button
Seat 1: pokersito84 ($5.54 in chips) 
Seat 2: makis305 ($7.50 in chips) 
Seat 3: sebano2 ($5 in chips) 
Seat 4: Maverick 085 ($5.40 in chips) 
Seat 5: lukasamace ($4.97 in chips) 
Seat 6: HubertusB ($2.54 in chips) 
makis305: posts small blind $0.02
sebano2: posts big blind $0.05
*** HOLE CARDS ***
Dealt to HubertusB [9s Kd]
Maverick 085: folds 
lukasamace: folds 
HubertusB: raises $0.05 to $0.10
pokersito84: folds 
makis305: folds 
sebano2: folds 
Uncalled bet ($0.05) returned to HubertusB
HubertusB collected $0.12 from pot
HubertusB: doesn't show hand 
*** SUMMARY ***
Total pot $0.12 | Rake $0 
Seat 1: pokersito84 (button) folded before Flop (didn't bet)
Seat 2: makis305 (small blind) folded before Flop
Seat 3: sebano2 (big blind) folded before Flop
Seat 4: Maverick 085 folded before Flop (didn't bet)
Seat 5: lukasamace folded before Flop (didn't bet)
Seat 6: HubertusB collected ($0.12)



PokerStars Zoom Hand #177967002933:  Hold'em No Limit ($0.02/$0.05) - 2017/11/09 2:01:47 CCT [2017/11/08 13:01:47 ET]
Table 'Donati' 6-max Seat #1 is the button
Seat 1: HubertusB ($2.64 in chips) 
Seat 2: BAAMBUR ($6.64 in chips) 
Seat 3: Odvajke1 ($5.39 in chips) 
Seat 4: nostlagia ($5.02 in chips) 
Seat 5: ilya306c ($9.95 in chips) 
Seat 6: HH-hour ($5.92 in chips) 
BAAMBUR: posts small blind $0.02
Odvajke1: posts big blind $0.05
*** HOLE CARDS ***
Dealt to HubertusB [Td 9c]
nostlagia: folds 
ilya306c: folds 
HH-hour: folds 
HubertusB: raises $0.05 to $0.10
BAAMBUR: calls $0.08
Odvajke1: calls $0.05
*** FLOP *** [5h 7h Ah]
BAAMBUR: bets $0.15
Odvajke1: calls $0.15
HubertusB: folds 
*** TURN *** [5h 7h Ah] [Kc]
BAAMBUR: bets $0.30
Odvajke1: calls $0.30
*** RIVER *** [5h 7h Ah Kc] [2h]
BAAMBUR: checks 
Odvajke1: checks 
*** SHOW DOWN ***
BAAMBUR: shows [7s Ac] (two pair, Aces and Sevens)
Odvajke1: shows [6h Th] (a flush, Ace high)
Odvajke1 collected $1.15 from pot
*** SUMMARY ***
Total pot $1.20 | Rake $0.05 
Board [5h 7h Ah Kc 2h]
Seat 1: HubertusB (button) folded on the Flop
Seat 2: BAAMBUR (small blind) showed [7s Ac] and lost with two pair, Aces and Sevens
Seat 3: Odvajke1 (big blind) showed [6h Th] and won ($1.15) with a flush, Ace high
Seat 4: nostlagia folded before Flop (didn't bet)
Seat 5: ilya306c folded before Flop (didn't bet)
Seat 6: HH-hour folded before Flop (didn't bet)



PokerStars Zoom Hand #177967027109:  Hold'em No Limit ($0.02/$0.05) - 2017/11/09 2:02:20 CCT [2017/11/08 13:02:20 ET]
Table 'Donati' 6-max Seat #1 is the button
Seat 1: Sonic.lg777 ($2.63 in chips) 
Seat 2: HubertusB ($2.61 in chips) 
Seat 3: CrazyFar ($3.40 in chips) 
Seat 4: Pro100PaPaN ($5.14 in chips) 
Seat 5: D-TeamPro ($17.15 in chips) 
Seat 6: Elchaza_1989 ($5.25 in chips) 
HubertusB: posts small blind $0.02
CrazyFar: posts big blind $0.05
*** HOLE CARDS ***
Dealt to HubertusB [4c Jc]
Pro100PaPaN: folds 
D-TeamPro: folds 
Elchaza_1989: folds 
Sonic.lg777: folds 
HubertusB: folds 
Uncalled bet ($0.03) returned to CrazyFar
CrazyFar collected $0.04 from pot
CrazyFar: doesn't show hand 
*** SUMMARY ***
Total pot $0.04 | Rake $0 
Seat 1: Sonic.lg777 (button) folded before Flop (didn't bet)
Seat 2: HubertusB (small blind) folded before Flop
Seat 3: CrazyFar (big blind) collected ($0.04)
Seat 4: Pro100PaPaN folded before Flop (didn't bet)
Seat 5: D-TeamPro folded before Flop (didn't bet)
Seat 6: Elchaza_1989 folded before Flop (didn't bet)



PokerStars Zoom Hand #177967040770:  Hold'em No Limit ($0.02/$0.05) - 2017/11/09 2:02:39 CCT [2017/11/08 13:02:39 ET]
Table 'Donati' 6-max Seat #1 is the button
Seat 1: Morris ViC ($5 in chips) 
Seat 2: CrazyFar ($3.42 in chips) 
Seat 3: HubertusB ($2.59 in chips) 
Seat 4: balabir ($8.10 in chips) 
Seat 5: ilya306c ($9.83 in chips) 
Seat 6: bzm73 ($13.26 in chips) 
CrazyFar: posts small blind $0.02
HubertusB: posts big blind $0.05
*** HOLE CARDS ***
Dealt to HubertusB [5s 4c]
balabir: folds 
ilya306c: folds 
bzm73: folds 
Morris ViC: folds 
CrazyFar: folds 
Uncalled bet ($0.03) returned to HubertusB
HubertusB collected $0.04 from pot
HubertusB: doesn't show hand 
*** SUMMARY ***
Total pot $0.04 | Rake $0 
Seat 1: Morris ViC (button) folded before Flop (didn't bet)
Seat 2: CrazyFar (small blind) folded before Flop
Seat 3: HubertusB (big blind) collected ($0.04)
Seat 4: balabir folded before Flop (didn't bet)
Seat 5: ilya306c folded before Flop (didn't bet)
Seat 6: bzm73 folded before Flop (didn't bet)



PokerStars Zoom Hand #177967031340:  Hold'em No Limit ($0.02/$0.05) - 2017/11/09 2:02:26 CCT [2017/11/08 13:02:26 ET]
Table 'Donati' 6-max Seat #1 is the button
Seat 1: HubertusB ($2.59 in chips) 
Seat 2: IIIYCTPULO ($5.26 in chips) 
Seat 3: DAVIDOFF351 ($5.89 in chips) 
Seat 4: class29 ($5.02 in chips) 
Seat 5: 72odonkey ($7.24 in chips) 
Seat 6: SCAMMER12345 ($6.12 in chips) 
IIIYCTPULO: posts small blind $0.02
DAVIDOFF351: posts big blind $0.05
*** HOLE CARDS ***
Dealt to HubertusB [5h 9s]
class29: folds 
72odonkey: folds 
SCAMMER12345: folds 
HubertusB: folds 
IIIYCTPULO: raises $0.10 to $0.15
DAVIDOFF351: folds 
Uncalled bet ($0.10) returned to IIIYCTPULO
IIIYCTPULO collected $0.10 from pot
IIIYCTPULO: doesn't show hand 
*** SUMMARY ***
Total pot $0.10 | Rake $0 
Seat 1: HubertusB (button) folded before Flop (didn't bet)
Seat 2: IIIYCTPULO (small blind) collected ($0.10)
Seat 3: DAVIDOFF351 (big blind) folded before Flop
Seat 4: class29 folded before Flop (didn't bet)
Seat 5: 72odonkey folded before Flop (didn't bet)
Seat 6: SCAMMER12345 folded before Flop (didn't bet)



PokerStars Zoom Hand #177967046707:  Hold'em No Limit ($0.02/$0.05) - 2017/11/09 2:02:46 CCT [2017/11/08 13:02:46 ET]
Table 'Donati' 6-max Seat #1 is the button
Seat 1: GeorgSL1 ($5.87 in chips) 
Seat 2: bzm73 ($4.04 in chips) 
Seat 3: schaemic ($7.43 in chips) 
Seat 4: Hellshinn ($18.42 in chips) 
Seat 5: HubertusB ($2.61 in chips) 
Seat 6: Lehi423 ($5.08 in chips) 
bzm73: posts small blind $0.02
schaemic: posts big blind $0.05
*** HOLE CARDS ***
Dealt to HubertusB [Jc Tc]
Hellshinn: folds 
HubertusB: raises $0.05 to $0.10
Lehi423: folds 
GeorgSL1: folds 
bzm73: calls $0.08
schaemic: folds 
*** FLOP *** [2c Ac Ts]
bzm73: checks 
HubertusB: bets $0.15
bzm73: raises $0.31 to $0.46
HubertusB: calls $0.31
*** TURN *** [2c Ac Ts] [Jh]
bzm73: bets $0.70
HubertusB: raises $1.35 to $2.05 and is all-in
bzm73: calls $1.35
*** RIVER *** [2c Ac Ts Jh] [3c]
*** SHOW DOWN ***
bzm73: shows [Ks Ah] (a pair of Aces)
HubertusB: shows [Jc Tc] (a flush, Ace high)
HubertusB collected $5.05 from pot
*** SUMMARY ***
Total pot $5.27 | Rake $0.22 
Board [2c Ac Ts Jh 3c]
Seat 1: GeorgSL1 (button) folded before Flop (didn't bet)
Seat 2: bzm73 (small blind) showed [Ks Ah] and lost with a pair of Aces
Seat 3: schaemic (big blind) folded before Flop
Seat 4: Hellshinn folded before Flop (didn't bet)
Seat 5: HubertusB showed [Jc Tc] and won ($5.05) with a flush, Ace high
Seat 6: Lehi423 folded before Flop (didn't bet)



PokerStars Zoom Hand #177967100714:  Hold'em No Limit ($0.02/$0.05) - 2017/11/09 2:03:59 CCT [2017/11/08 13:03:59 ET]
Table 'Donati' 6-max Seat #1 is the button
Seat 1: Dimango93 ($2.77 in chips) 
Seat 2: Ignite13 ($11.19 in chips) 
Seat 3: ooiaooao ($6.59 in chips) 
Seat 4: HubertusB ($5.05 in chips) 
Seat 5: taratita ($3.18 in chips) 
Seat 6: 6runogn ($7.72 in chips) 
Ignite13: posts small blind $0.02
ooiaooao: posts big blind $0.05
*** HOLE CARDS ***
Dealt to HubertusB [Jd 4c]
HubertusB: folds 
taratita: folds 
6runogn: raises $0.10 to $0.15
Dimango93: folds 
Ignite13: folds 
ooiaooao: folds 
Uncalled bet ($0.10) returned to 6runogn
6runogn collected $0.12 from pot
6runogn: doesn't show hand 
*** SUMMARY ***
Total pot $0.12 | Rake $0 
Seat 1: Dimango93 (button) folded before Flop (didn't bet)
Seat 2: Ignite13 (small blind) folded before Flop
Seat 3: ooiaooao (big blind) folded before Flop
Seat 4: HubertusB folded before Flop (didn't bet)
Seat 5: taratita folded before Flop (didn't bet)
Seat 6: 6runogn collected ($0.12)



PokerStars Zoom Hand #177967104374:  Hold'em No Limit ($0.02/$0.05) - 2017/11/09 2:04:04 CCT [2017/11/08 13:04:04 ET]
Table 'Donati' 6-max Seat #1 is the button
Seat 1: Hxrtxng ($5.83 in chips) 
Seat 2: dimg8 ($4.90 in chips) 
Seat 3: Mantaz ($5.06 in chips) 
Seat 4: zugunder11 ($4.99 in chips) 
Seat 5: TheGladBG ($9.19 in chips) 
Seat 6: HubertusB ($5.05 in chips) 
dimg8: posts small blind $0.02
Mantaz: posts big blind $0.05
*** HOLE CARDS ***
Dealt to HubertusB [As 7h]
zugunder11: folds 
TheGladBG: folds 
HubertusB: raises $0.05 to $0.10
Hxrtxng: folds 
dimg8: folds 
Mantaz: folds 
Uncalled bet ($0.05) returned to HubertusB
HubertusB collected $0.12 from pot
HubertusB: doesn't show hand 
*** SUMMARY ***
Total pot $0.12 | Rake $0 
Seat 1: Hxrtxng (button) folded before Flop (didn't bet)
Seat 2: dimg8 (small blind) folded before Flop
Seat 3: Mantaz (big blind) folded before Flop
Seat 4: zugunder11 folded before Flop (didn't bet)
Seat 5: TheGladBG folded before Flop (didn't bet)
Seat 6: HubertusB collected ($0.12)



PokerStars Zoom Hand #177967116288:  Hold'em No Limit ($0.02/$0.05) - 2017/11/09 2:04:20 CCT [2017/11/08 13:04:20 ET]
Table 'Donati' 6-max Seat #1 is the button
Seat 1: tsatsos3 ($2.73 in chips) 
Seat 2: HubertusB ($5.12 in chips) 
Seat 3: Holand153 ($5 in chips) 
Seat 4: Einherjer91 ($5.37 in chips) 
Seat 5: Rassty1983 ($19.59 in chips) 
Seat 6: lR0G3Rl ($7.02 in chips) 
HubertusB: posts small blind $0.02
Holand153: posts big blind $0.05
*** HOLE CARDS ***
Dealt to HubertusB [Ac 4s]
Einherjer91: folds 
Rassty1983: folds 
lR0G3Rl: folds 
tsatsos3: raises $0.05 to $0.10
HubertusB: folds 
Holand153: folds 
Uncalled bet ($0.05) returned to tsatsos3
tsatsos3 collected $0.12 from pot
tsatsos3: doesn't show hand 
*** SUMMARY ***
Total pot $0.12 | Rake $0 
Seat 1: tsatsos3 (button) collected ($0.12)
Seat 2: HubertusB (small blind) folded before Flop
Seat 3: Holand153 (big blind) folded before Flop
Seat 4: Einherjer91 folded before Flop (didn't bet)
Seat 5: Rassty1983 folded before Flop (didn't bet)
Seat 6: lR0G3Rl folded before Flop (didn't bet)



PokerStars Zoom Hand #177967112501:  Hold'em No Limit ($0.02/$0.05) - 2017/11/09 2:04:15 CCT [2017/11/08 13:04:15 ET]
Table 'Donati' 6-max Seat #1 is the button
Seat 1: navy463 ($5 in chips) 
Seat 2: andsaymon ($2.63 in chips) 
Seat 3: Dimango93 ($2.77 in chips) 
Seat 4: WEIPEI1 ($5 in chips) 
Seat 5: HubertusB ($5.12 in chips) 
Seat 6: balbes weva ($5.12 in chips) 
andsaymon: posts small blind $0.02
Dimango93: posts big blind $0.05
*** HOLE CARDS ***
Dealt to HubertusB [7c 3s]
WEIPEI1: folds 
HubertusB: folds 
balbes weva: folds 
navy463: raises $0.10 to $0.15
andsaymon: folds 
Dimango93: calls $0.10
*** FLOP *** [Ah 9d 8h]
Dimango93: checks 
navy463: bets $0.23
Dimango93: folds 
Uncalled bet ($0.23) returned to navy463
navy463 collected $0.31 from pot
navy463: doesn't show hand 
*** SUMMARY ***
Total pot $0.32 | Rake $0.01 
Board [Ah 9d 8h]
Seat 1: navy463 (button) collected ($0.31)
Seat 2: andsaymon (small blind) folded before Flop
Seat 3: Dimango93 (big blind) folded on the Flop
Seat 4: WEIPEI1 folded before Flop (didn't bet)
Seat 5: HubertusB folded before Flop (didn't bet)
Seat 6: balbes weva folded before Flop (didn't bet)



PokerStars Zoom Hand #177967124519:  Hold'em No Limit ($0.02/$0.05) - 2017/11/09 2:04:31 CCT [2017/11/08 13:04:31 ET]
Table 'Donati' 6-max Seat #1 is the button
Seat 1: darkman11770 ($8.74 in chips) 
Seat 2: woocha33 ($5.18 in chips) 
Seat 3: kopatich52 ($6.50 in chips) 
Seat 4: iampokerdaft ($9.05 in chips) 
Seat 5: HubertusB ($5.10 in chips) 
Seat 6: Vindictive69 ($5.44 in chips) 
woocha33: posts small blind $0.02
kopatich52: posts big blind $0.05
*** HOLE CARDS ***
Dealt to HubertusB [4d 6h]
iampokerdaft: folds 
HubertusB: folds 
Vindictive69: folds 
darkman11770: folds 
woocha33: folds 
Uncalled bet ($0.03) returned to kopatich52
kopatich52 collected $0.04 from pot
kopatich52: doesn't show hand 
*** SUMMARY ***
Total pot $0.04 | Rake $0 
Seat 1: darkman11770 (button) folded before Flop (didn't bet)
Seat 2: woocha33 (small blind) folded before Flop
Seat 3: kopatich52 (big blind) collected ($0.04)
Seat 4: iampokerdaft folded before Flop (didn't bet)
Seat 5: HubertusB folded before Flop (didn't bet)
Seat 6: Vindictive69 folded before Flop (didn't bet)



PokerStars Zoom Hand #177967130523:  Hold'em No Limit ($0.02/$0.05) - 2017/11/09 2:04:39 CCT [2017/11/08 13:04:39 ET]
Table 'Donati' 6-max Seat #1 is the button
Seat 1: coolgrays ($4.19 in chips) 
Seat 2: Ignite13 ($11.19 in chips) 
Seat 3: HubertusB ($5.10 in chips) 
Seat 4: SCAMMER12345 ($5.93 in chips) 
Seat 5: genei0 ($3.92 in chips) 
Seat 6: TC.Yesman ($9.29 in chips) 
Ignite13: posts small blind $0.02
HubertusB: posts big blind $0.05
*** HOLE CARDS ***
Dealt to HubertusB [7d Qs]
SCAMMER12345: folds 
genei0: folds 
TC.Yesman: folds 
coolgrays: folds 
Ignite13: folds 
Uncalled bet ($0.03) returned to HubertusB
HubertusB collected $0.04 from pot
HubertusB: doesn't show hand 
*** SUMMARY ***
Total pot $0.04 | Rake $0 
Seat 1: coolgrays (button) folded before Flop (didn't bet)
Seat 2: Ignite13 (small blind) folded before Flop
Seat 3: HubertusB (big blind) collected ($0.04)
Seat 4: SCAMMER12345 folded before Flop (didn't bet)
Seat 5: genei0 folded before Flop (didn't bet)
Seat 6: TC.Yesman folded before Flop (didn't bet)



PokerStars Zoom Hand #177967137185:  Hold'em No Limit ($0.02/$0.05) - 2017/11/09 2:04:48 CCT [2017/11/08 13:04:48 ET]
Table 'Donati' 6-max Seat #1 is the button
Seat 1: t$unami cr ($8.09 in chips) 
Seat 2: ben1clark ($4.56 in chips) 
Seat 3: oleg777886 ($6.15 in chips) 
Seat 4: HubertusB ($5.12 in chips) 
Seat 5: MedChrize ($9.98 in chips) 
Seat 6: devianin96 ($5 in chips) 
ben1clark: posts small blind $0.02
oleg777886: posts big blind $0.05
*** HOLE CARDS ***
Dealt to HubertusB [Ac Ad]
HubertusB: raises $0.05 to $0.10
MedChrize: folds 
devianin96: folds 
t$unami cr: folds 
ben1clark: folds 
oleg777886: folds 
Uncalled bet ($0.05) returned to HubertusB
HubertusB collected $0.12 from pot
HubertusB: doesn't show hand 
*** SUMMARY ***
Total pot $0.12 | Rake $0 
Seat 1: t$unami cr (button) folded before Flop (didn't bet)
Seat 2: ben1clark (small blind) folded before Flop
Seat 3: oleg777886 (big blind) folded before Flop
Seat 4: HubertusB collected ($0.12)
Seat 5: MedChrize folded before Flop (didn't bet)
Seat 6: devianin96 folded before Flop (didn't bet)



PokerStars Zoom Hand #177967143285:  Hold'em No Limit ($0.02/$0.05) - 2017/11/09 2:04:56 CCT [2017/11/08 13:04:56 ET]
Table 'Donati' 6-max Seat #1 is the button
Seat 1: HubertusB ($5.19 in chips) 
Seat 2: Mantaz ($30.81 in chips) 
Seat 3: askksa ($11.93 in chips) 
Seat 4: vecinul ($16.17 in chips) 
Seat 5: audiraise ($13.68 in chips) 
Seat 6: Shurnjaja ($9.97 in chips) 
Mantaz: posts small blind $0.02
askksa: posts big blind $0.05
*** HOLE CARDS ***
Dealt to HubertusB [9s 6c]
vecinul: folds 
audiraise: raises $0.10 to $0.15
Shurnjaja: folds 
HubertusB: folds 
Mantaz: folds 
askksa: folds 
Uncalled bet ($0.10) returned to audiraise
audiraise collected $0.12 from pot
audiraise: doesn't show hand 
*** SUMMARY ***
Total pot $0.12 | Rake $0 
Seat 1: HubertusB (button) folded before Flop (didn't bet)
Seat 2: Mantaz (small blind) folded before Flop
Seat 3: askksa (big blind) folded before Flop
Seat 4: vecinul folded before Flop (didn't bet)
Seat 5: audiraise collected ($0.12)
Seat 6: Shurnjaja folded before Flop (didn't bet)



PokerStars Zoom Hand #177967149352:  Hold'em No Limit ($0.02/$0.05) - 2017/11/09 2:05:04 CCT [2017/11/08 13:05:04 ET]
Table 'Donati' 6-max Seat #1 is the button
Seat 1: XeroLP ($5.30 in chips) 
Seat 2: woocha33 ($11.32 in chips) 
Seat 3: mr_z1ro ($11.60 in chips) 
Seat 4: max_polonez ($5.62 in chips) 
Seat 5: Pro100PaPaN ($5.14 in chips) 
Seat 6: HubertusB ($5.19 in chips) 
woocha33: posts small blind $0.02
mr_z1ro: posts big blind $0.05
*** HOLE CARDS ***
Dealt to HubertusB [8h 7h]
max_polonez: folds 
Pro100PaPaN: folds 
HubertusB: raises $0.05 to $0.10
XeroLP: folds 
woocha33: folds 
mr_z1ro: calls $0.05
*** FLOP *** [6h Ad Kh]
mr_z1ro: checks 
HubertusB: bets $0.10
mr_z1ro: calls $0.10
*** TURN *** [6h Ad Kh] [Jd]
mr_z1ro: checks 
HubertusB: checks 
*** RIVER *** [6h Ad Kh Jd] [Ah]
mr_z1ro: checks 
HubertusB: bets $0.70
mr_z1ro: folds 
Uncalled bet ($0.70) returned to HubertusB
HubertusB collected $0.40 from pot
HubertusB: doesn't show hand 
*** SUMMARY ***
Total pot $0.42 | Rake $0.02 
Board [6h Ad Kh Jd Ah]
Seat 1: XeroLP (button) folded before Flop (didn't bet)
Seat 2: woocha33 (small blind) folded before Flop
Seat 3: mr_z1ro (big blind) folded on the River
Seat 4: max_polonez folded before Flop (didn't bet)
Seat 5: Pro100PaPaN folded before Flop (didn't bet)
Seat 6: HubertusB collected ($0.40)



PokerStars Zoom Hand #177967185555:  Hold'em No Limit ($0.02/$0.05) - 2017/11/09 2:05:50 CCT [2017/11/08 13:05:50 ET]
Table 'Donati' 6-max Seat #1 is the button
Seat 1: Zepka1988 ($5 in chips) 
Seat 2: HubertusB ($5.39 in chips) 
Seat 3: Luzod ($6.99 in chips) 
Seat 4: Koelle81er ($3.67 in chips) 
Seat 5: SpjaldJB ($5.08 in chips) 
Seat 6: romeo243 ($3.80 in chips) 
HubertusB: posts small blind $0.02
Luzod: posts big blind $0.05
*** HOLE CARDS ***
Dealt to HubertusB [5d 3h]
Koelle81er: folds 
SpjaldJB: folds 
romeo243: raises $0.10 to $0.15
Zepka1988: folds 
HubertusB: folds 
Luzod: folds 
Uncalled bet ($0.10) returned to romeo243
romeo243 collected $0.12 from pot
romeo243: doesn't show hand 
*** SUMMARY ***
Total pot $0.12 | Rake $0 
Seat 1: Zepka1988 (button) folded before Flop (didn't bet)
Seat 2: HubertusB (small blind) folded before Flop
Seat 3: Luzod (big blind) folded before Flop
Seat 4: Koelle81er folded before Flop (didn't bet)
Seat 5: SpjaldJB folded before Flop (didn't bet)
Seat 6: romeo243 collected ($0.12)



PokerStars Zoom Hand #177967189391:  Hold'em No Limit ($0.02/$0.05) - 2017/11/09 2:05:55 CCT [2017/11/08 13:05:55 ET]
Table 'Donati' 6-max Seat #1 is the button
Seat 1: 3rikBernard ($5.14 in chips) 
Seat 2: arlequím ($5.02 in chips) 
Seat 3: YoungKazimir ($15.77 in chips) 
Seat 4: MaximAstra ($3.54 in chips) 
Seat 5: HubertusB ($5.37 in chips) 
Seat 6: 6runogn ($8.16 in chips) 
arlequím: posts small blind $0.02
YoungKazimir: posts big blind $0.05
*** HOLE CARDS ***
Dealt to HubertusB [Th 6d]
MaximAstra: folds 
HubertusB: folds 
6runogn: raises $0.10 to $0.15
3rikBernard: folds 
arlequím: folds 
YoungKazimir: folds 
Uncalled bet ($0.10) returned to 6runogn
6runogn collected $0.12 from pot
6runogn: doesn't show hand 
*** SUMMARY ***
Total pot $0.12 | Rake $0 
Seat 1: 3rikBernard (button) folded before Flop (didn't bet)
Seat 2: arlequím (small blind) folded before Flop
Seat 3: YoungKazimir (big blind) folded before Flop
Seat 4: MaximAstra folded before Flop (didn't bet)
Seat 5: HubertusB folded before Flop (didn't bet)
Seat 6: 6runogn collected ($0.12)



PokerStars Zoom Hand #177967195688:  Hold'em No Limit ($0.02/$0.05) - 2017/11/09 2:06:03 CCT [2017/11/08 13:06:03 ET]
Table 'Donati' 6-max Seat #1 is the button
Seat 1: -=KZ PRO=- ($6.66 in chips) 
Seat 2: renat199125 ($2.26 in chips) 
Seat 3: HubertusB ($5.37 in chips) 
Seat 4: devianin96 ($5.05 in chips) 
Seat 5: ben1clark ($4.42 in chips) 
Seat 6: peterdonat ($7.37 in chips) 
renat199125: posts small blind $0.02
HubertusB: posts big blind $0.05
*** HOLE CARDS ***
Dealt to HubertusB [Td 8h]
devianin96: folds 
ben1clark: folds 
peterdonat: folds 
-=KZ PRO=- has timed out
-=KZ PRO=-: folds 
renat199125: folds 
Uncalled bet ($0.03) returned to HubertusB
HubertusB collected $0.04 from pot
HubertusB: doesn't show hand 
*** SUMMARY ***
Total pot $0.04 | Rake $0 
Seat 1: -=KZ PRO=- (button) folded before Flop (didn't bet)
Seat 2: renat199125 (small blind) folded before Flop
Seat 3: HubertusB (big blind) collected ($0.04)
Seat 4: devianin96 folded before Flop (didn't bet)
Seat 5: ben1clark folded before Flop (didn't bet)
Seat 6: peterdonat folded before Flop (didn't bet)



PokerStars Zoom Hand #177967217145:  Hold'em No Limit ($0.02/$0.05) - 2017/11/09 2:06:30 CCT [2017/11/08 13:06:30 ET]
Table 'Donati' 6-max Seat #1 is the button
Seat 1: HubertusB ($5.39 in chips) 
Seat 2: LukksAA ($11.07 in chips) 
Seat 3: navy463 ($5 in chips) 
Seat 4: tsurumai ($12.49 in chips) 
Seat 5: s_academia ($7.69 in chips) 
Seat 6: Dmialber ($8.36 in chips) 
LukksAA: posts small blind $0.02
navy463: posts big blind $0.05
*** HOLE CARDS ***
Dealt to HubertusB [As Qc]
tsurumai: folds 
s_academia: folds 
Dmialber: folds 
HubertusB: raises $0.05 to $0.10
LukksAA: folds 
navy463: folds 
Uncalled bet ($0.05) returned to HubertusB
HubertusB collected $0.12 from pot
HubertusB: doesn't show hand 
*** SUMMARY ***
Total pot $0.12 | Rake $0 
Seat 1: HubertusB (button) collected ($0.12)
Seat 2: LukksAA (small blind) folded before Flop
Seat 3: navy463 (big blind) folded before Flop
Seat 4: tsurumai folded before Flop (didn't bet)
Seat 5: s_academia folded before Flop (didn't bet)
Seat 6: Dmialber folded before Flop (didn't bet)



PokerStars Zoom Hand #177967228969:  Hold'em No Limit ($0.02/$0.05) - 2017/11/09 2:06:45 CCT [2017/11/08 13:06:45 ET]
Table 'Donati' 6-max Seat #1 is the button
Seat 1: Rep_Nothing ($5.92 in chips) 
Seat 2: bro20016 ($5.31 in chips) 
Seat 3: prochy1909 ($11.96 in chips) 
Seat 4: devianin96 ($5 in chips) 
Seat 5: HubertusB ($5.46 in chips) 
Seat 6: slick.nov ($5.48 in chips) 
bro20016: posts small blind $0.02
prochy1909: posts big blind $0.05
*** HOLE CARDS ***
Dealt to HubertusB [3c Kh]
devianin96: folds 
HubertusB: raises $0.05 to $0.10
slick.nov: folds 
Rep_Nothing: folds 
bro20016: folds 
prochy1909: calls $0.05
*** FLOP *** [4h Jd Qd]
prochy1909: checks 
HubertusB: bets $0.15
prochy1909: calls $0.15
*** TURN *** [4h Jd Qd] [7d]
prochy1909: checks 
HubertusB: bets $0.40
prochy1909: calls $0.40
*** RIVER *** [4h Jd Qd 7d] [2h]
prochy1909: checks 
HubertusB: bets $0.95
prochy1909: calls $0.95
*** SHOW DOWN ***
HubertusB: shows [3c Kh] (high card King)
prochy1909: shows [Ks Jc] (a pair of Jacks)
prochy1909 collected $3.09 from pot
*** SUMMARY ***
Total pot $3.22 | Rake $0.13 
Board [4h Jd Qd 7d 2h]
Seat 1: Rep_Nothing (button) folded before Flop (didn't bet)
Seat 2: bro20016 (small blind) folded before Flop
Seat 3: prochy1909 (big blind) showed [Ks Jc] and won ($3.09) with a pair of Jacks
Seat 4: devianin96 folded before Flop (didn't bet)
Seat 5: HubertusB showed [3c Kh] and lost with high card King
Seat 6: slick.nov folded before Flop (didn't bet)



PokerStars Zoom Hand #177967262002:  Hold'em No Limit ($0.02/$0.05) - 2017/11/09 2:07:27 CCT [2017/11/08 13:07:27 ET]
Table 'Donati' 6-max Seat #1 is the button
Seat 1: 3rikBernard ($5.05 in chips) 
Seat 2: HubertusB ($3.86 in chips) 
Seat 3: axeldada ($5.57 in chips) 
Seat 4: SpicedGoldie ($3.32 in chips) 
Seat 5: McJoggers ($9.21 in chips) 
Seat 6: askksa ($9.20 in chips) 
HubertusB: posts small blind $0.02
axeldada: posts big blind $0.05
*** HOLE CARDS ***
Dealt to HubertusB [8s 2d]
SpicedGoldie: folds 
McJoggers: folds 
askksa: folds 
3rikBernard: raises $0.10 to $0.15
HubertusB: folds 
axeldada: folds 
Uncalled bet ($0.10) returned to 3rikBernard
3rikBernard collected $0.12 from pot
3rikBernard: doesn't show hand 
*** SUMMARY ***
Total pot $0.12 | Rake $0 
Seat 1: 3rikBernard (button) collected ($0.12)
Seat 2: HubertusB (small blind) folded before Flop
Seat 3: axeldada (big blind) folded before Flop
Seat 4: SpicedGoldie folded before Flop (didn't bet)
Seat 5: McJoggers folded before Flop (didn't bet)
Seat 6: askksa folded before Flop (didn't bet)



PokerStars Zoom Hand #177967266653:  Hold'em No Limit ($0.02/$0.05) - 2017/11/09 2:07:33 CCT [2017/11/08 13:07:33 ET]
Table 'Donati' 6-max Seat #1 is the button
Seat 1: rnjsdbsrb ($15.36 in chips) 
Seat 2: Les Paul 987 ($6.09 in chips) 
Seat 3: timugin12 ($33.05 in chips) 
Seat 4: navy463 ($5.07 in chips) 
Seat 5: VVS2874 ($6.81 in chips) 
Seat 6: HubertusB ($3.84 in chips) 
Les Paul 987: posts small blind $0.02
timugin12: posts big blind $0.05
*** HOLE CARDS ***
Dealt to HubertusB [3d 3s]
navy463: folds 
VVS2874: folds 
HubertusB: raises $0.05 to $0.10
rnjsdbsrb: folds 
Les Paul 987: folds 
timugin12: folds 
Uncalled bet ($0.05) returned to HubertusB
HubertusB collected $0.12 from pot
HubertusB: doesn't show hand 
*** SUMMARY ***
Total pot $0.12 | Rake $0 
Seat 1: rnjsdbsrb (button) folded before Flop (didn't bet)
Seat 2: Les Paul 987 (small blind) folded before Flop
Seat 3: timugin12 (big blind) folded before Flop
Seat 4: navy463 folded before Flop (didn't bet)
Seat 5: VVS2874 folded before Flop (didn't bet)
Seat 6: HubertusB collected ($0.12)



PokerStars Zoom Hand #177967277732:  Hold'em No Limit ($0.02/$0.05) - 2017/11/09 2:07:47 CCT [2017/11/08 13:07:47 ET]
Table 'Donati' 6-max Seat #1 is the button
Seat 1: asusone3 ($5.60 in chips) 
Seat 2: BOOLDOZER767 ($1.20 in chips) 
Seat 3: schaemic ($11.07 in chips) 
Seat 4: HubertusB ($3.91 in chips) 
Seat 5: -=KZ PRO=- ($5.69 in chips) 
Seat 6: VANDEL67 ($2.23 in chips) 
BOOLDOZER767: posts small blind $0.02
schaemic: posts big blind $0.05
*** HOLE CARDS ***
Dealt to HubertusB [Ad 7d]
HubertusB: raises $0.05 to $0.10
-=KZ PRO=-: folds 
VANDEL67: folds 
asusone3: folds 
BOOLDOZER767: folds 
schaemic: folds 
Uncalled bet ($0.05) returned to HubertusB
HubertusB collected $0.12 from pot
HubertusB: doesn't show hand 
*** SUMMARY ***
Total pot $0.12 | Rake $0 
Seat 1: asusone3 (button) folded before Flop (didn't bet)
Seat 2: BOOLDOZER767 (small blind) folded before Flop
Seat 3: schaemic (big blind) folded before Flop
Seat 4: HubertusB collected ($0.12)
Seat 5: -=KZ PRO=- folded before Flop (didn't bet)
Seat 6: VANDEL67 folded before Flop (didn't bet)



PokerStars Zoom Hand #177967290140:  Hold'em No Limit ($0.02/$0.05) - 2017/11/09 2:08:03 CCT [2017/11/08 13:08:03 ET]
Table 'Donati' 6-max Seat #1 is the button
Seat 1: Leshchik ($5.20 in chips) 
Seat 2: jullikka25 ($13.80 in chips) 
Seat 3: HubertusB ($3.98 in chips) 
Seat 4: balbes weva ($5.60 in chips) 
Seat 5: audiraise ($13.64 in chips) 
Seat 6: nonsensever ($6.33 in chips) 
jullikka25: posts small blind $0.02
HubertusB: posts big blind $0.05
*** HOLE CARDS ***
Dealt to HubertusB [5s 6s]
balbes weva: raises $0.10 to $0.15
audiraise: folds 
nonsensever: folds 
Leshchik: folds 
jullikka25: folds 
HubertusB: folds 
Uncalled bet ($0.10) returned to balbes weva
balbes weva collected $0.12 from pot
balbes weva: doesn't show hand 
*** SUMMARY ***
Total pot $0.12 | Rake $0 
Seat 1: Leshchik (button) folded before Flop (didn't bet)
Seat 2: jullikka25 (small blind) folded before Flop
Seat 3: HubertusB (big blind) folded before Flop
Seat 4: balbes weva collected ($0.12)
Seat 5: audiraise folded before Flop (didn't bet)
Seat 6: nonsensever folded before Flop (didn't bet)



PokerStars Zoom Hand #177967285565:  Hold'em No Limit ($0.02/$0.05) - 2017/11/09 2:07:57 CCT [2017/11/08 13:07:57 ET]
Table 'Donati' 6-max Seat #1 is the button
Seat 1: HubertusB ($3.98 in chips) 
Seat 2: platypus681 ($5.60 in chips) 
Seat 3: Rep_Nothing ($5.45 in chips) 
Seat 4: woocha33 ($11.09 in chips) 
Seat 5: marianoacha ($10.34 in chips) 
Seat 6: Alfie Bear ($5.51 in chips) 
platypus681: posts small blind $0.02
Rep_Nothing: posts big blind $0.05
*** HOLE CARDS ***
Dealt to HubertusB [Ts 3d]
woocha33: folds 
marianoacha: folds 
Alfie Bear: folds 
HubertusB: folds 
platypus681: raises $0.07 to $0.12
Rep_Nothing: calls $0.07
*** FLOP *** [4d Kd 5c]
platypus681: checks 
Rep_Nothing: bets $0.12
platypus681: folds 
Uncalled bet ($0.12) returned to Rep_Nothing
Rep_Nothing collected $0.23 from pot
Rep_Nothing: doesn't show hand 
*** SUMMARY ***
Total pot $0.24 | Rake $0.01 
Board [4d Kd 5c]
Seat 1: HubertusB (button) folded before Flop (didn't bet)
Seat 2: platypus681 (small blind) folded on the Flop
Seat 3: Rep_Nothing (big blind) collected ($0.23)
Seat 4: woocha33 folded before Flop (didn't bet)
Seat 5: marianoacha folded before Flop (didn't bet)
Seat 6: Alfie Bear folded before Flop (didn't bet)



PokerStars Zoom Hand #177967306770:  Hold'em No Limit ($0.02/$0.05) - 2017/11/09 2:08:24 CCT [2017/11/08 13:08:24 ET]
Table 'Donati' 6-max Seat #1 is the button
Seat 1: zugy37ru ($4.28 in chips) 
Seat 2: HubertusB ($3.93 in chips) 
Seat 3: dersasa ($2.37 in chips) 
Seat 4: LUTCUS ($11.75 in chips) 
Seat 5: Romuks33 ($5 in chips) 
Seat 6: class29 ($5 in chips) 
HubertusB: posts small blind $0.02
dersasa: posts big blind $0.05
*** HOLE CARDS ***
Dealt to HubertusB [6d 9h]
LUTCUS: folds 
Romuks33: folds 
class29: folds 
zugy37ru: folds 
HubertusB: folds 
Uncalled bet ($0.03) returned to dersasa
dersasa collected $0.04 from pot
dersasa: doesn't show hand 
*** SUMMARY ***
Total pot $0.04 | Rake $0 
Seat 1: zugy37ru (button) folded before Flop (didn't bet)
Seat 2: HubertusB (small blind) folded before Flop
Seat 3: dersasa (big blind) collected ($0.04)
Seat 4: LUTCUS folded before Flop (didn't bet)
Seat 5: Romuks33 folded before Flop (didn't bet)
Seat 6: class29 folded before Flop (didn't bet)



PokerStars Zoom Hand #177967317783:  Hold'em No Limit ($0.02/$0.05) - 2017/11/09 2:08:38 CCT [2017/11/08 13:08:38 ET]
Table 'Donati' 6-max Seat #1 is the button
Seat 1: badman time ($6.09 in chips) 
Seat 2: HH-hour ($5.29 in chips) 
Seat 3: peladonk ($6.12 in chips) 
Seat 4: Rassty1983 ($12.39 in chips) 
Seat 5: HubertusB ($3.91 in chips) 
Seat 6: SHARK44444 ($5.50 in chips) 
HH-hour: posts small blind $0.02
peladonk: posts big blind $0.05
*** HOLE CARDS ***
Dealt to HubertusB [Ac Kd]
Rassty1983: folds 
HubertusB: raises $0.05 to $0.10
SHARK44444: folds 
badman time: folds 
HH-hour: folds 
peladonk: folds 
Uncalled bet ($0.05) returned to HubertusB
HubertusB collected $0.12 from pot
HubertusB: doesn't show hand 
*** SUMMARY ***
Total pot $0.12 | Rake $0 
Seat 1: badman time (button) folded before Flop (didn't bet)
Seat 2: HH-hour (small blind) folded before Flop
Seat 3: peladonk (big blind) folded before Flop
Seat 4: Rassty1983 folded before Flop (didn't bet)
Seat 5: HubertusB collected ($0.12)
Seat 6: SHARK44444 folded before Flop (didn't bet)



PokerStars Zoom Hand #177967301981:  Hold'em No Limit ($0.02/$0.05) - 2017/11/09 2:08:18 CCT [2017/11/08 13:08:18 ET]
Table 'Donati' 6-max Seat #1 is the button
Seat 1: Love7822 ($3.06 in chips) 
Seat 2: luckydziad ($2.39 in chips) 
Seat 3: 72odonkey ($5.05 in chips) 
Seat 4: HubertusB ($3.93 in chips) 
Seat 5: Funharti ($4.64 in chips) 
Seat 6: laiha ($4.75 in chips) 
luckydziad: posts small blind $0.02
72odonkey: posts big blind $0.05
*** HOLE CARDS ***
Dealt to HubertusB [4d 9d]
HubertusB: folds 
Funharti: folds 
laiha: raises $0.10 to $0.15
Love7822: folds 
luckydziad: calls $0.13
72odonkey: folds 
*** FLOP *** [Jh 4c Js]
luckydziad: checks 
laiha: bets $0.15
luckydziad: folds 
Uncalled bet ($0.15) returned to laiha
laiha collected $0.34 from pot
laiha: doesn't show hand 
*** SUMMARY ***
Total pot $0.35 | Rake $0.01 
Board [Jh 4c Js]
Seat 1: Love7822 (button) folded before Flop (didn't bet)
Seat 2: luckydziad (small blind) folded on the Flop
Seat 3: 72odonkey (big blind) folded before Flop
Seat 4: HubertusB folded before Flop (didn't bet)
Seat 5: Funharti folded before Flop (didn't bet)
Seat 6: laiha collected ($0.34)



PokerStars Zoom Hand #177967335050:  Hold'em No Limit ($0.02/$0.05) - 2017/11/09 2:09:00 CCT [2017/11/08 13:09:00 ET]
Table 'Donati' 6-max Seat #1 is the button
Seat 1: nonsensever ($5 in chips) 
Seat 2: Mikaeus ($5.45 in chips) 
Seat 3: HubertusB ($3.98 in chips) 
Seat 4: Odvajke1 ($5.16 in chips) 
Seat 5: Nomoney099 ($6.88 in chips) 
Seat 6: Tautietis852 ($5 in chips) 
Mikaeus: posts small blind $0.02
HubertusB: posts big blind $0.05
*** HOLE CARDS ***
Dealt to HubertusB [3h Kd]
Odvajke1: folds 
Nomoney099: folds 
Tautietis852: folds 
nonsensever: folds 
Mikaeus: folds 
Uncalled bet ($0.03) returned to HubertusB
HubertusB collected $0.04 from pot
HubertusB: doesn't show hand 
*** SUMMARY ***
Total pot $0.04 | Rake $0 
Seat 1: nonsensever (button) folded before Flop (didn't bet)
Seat 2: Mikaeus (small blind) folded before Flop
Seat 3: HubertusB (big blind) collected ($0.04)
Seat 4: Odvajke1 folded before Flop (didn't bet)
Seat 5: Nomoney099 folded before Flop (didn't bet)
Seat 6: Tautietis852 folded before Flop (didn't bet)



PokerStars Zoom Hand #177967312239:  Hold'em No Limit ($0.02/$0.05) - 2017/11/09 2:08:31 CCT [2017/11/08 13:08:31 ET]
Table 'Donati' 6-max Seat #1 is the button
Seat 1: Erynaur ($7.66 in chips) 
Seat 2: serg-hw ($5.84 in chips) 
Seat 3: IIIYCTPULO ($5 in chips) 
Seat 4: Volke!n kz ($8.66 in chips) 
Seat 5: tsurumai ($12.34 in chips) 
Seat 6: HubertusB ($3.91 in chips) 
serg-hw: posts small blind $0.02
IIIYCTPULO: posts big blind $0.05
*** HOLE CARDS ***
Dealt to HubertusB [3d 6h]
Volke!n kz: folds 
tsurumai: folds 
HubertusB: folds 
Erynaur: raises $0.10 to $0.15
serg-hw: folds 
IIIYCTPULO: raises $0.30 to $0.45
Erynaur: raises $0.60 to $1.05
IIIYCTPULO: calls $0.60
*** FLOP *** [5d Ac 9h]
IIIYCTPULO: bets $1.25
Erynaur: folds 
Uncalled bet ($1.25) returned to IIIYCTPULO
IIIYCTPULO collected $2.03 from pot
IIIYCTPULO: doesn't show hand 
*** SUMMARY ***
Total pot $2.12 | Rake $0.09 
Board [5d Ac 9h]
Seat 1: Erynaur (button) folded on the Flop
Seat 2: serg-hw (small blind) folded before Flop
Seat 3: IIIYCTPULO (big blind) collected ($2.03)
Seat 4: Volke!n kz folded before Flop (didn't bet)
Seat 5: tsurumai folded before Flop (didn't bet)
Seat 6: HubertusB folded before Flop (didn't bet)



PokerStars Zoom Hand #177967330342:  Hold'em No Limit ($0.02/$0.05) - 2017/11/09 2:08:54 CCT [2017/11/08 13:08:54 ET]
Table 'Donati' 6-max Seat #1 is the button
Seat 1: oumitt ($3.43 in chips) 
Seat 2: Alex 63R ($1.84 in chips) 
Seat 3: Mikaeus ($5.32 in chips) 
Seat 4: HubertusB ($3.98 in chips) 
Seat 5: tsatsos3 ($2.47 in chips) 
Seat 6: Luzod ($6.78 in chips) 
Alex 63R: posts small blind $0.02
Mikaeus: posts big blind $0.05
*** HOLE CARDS ***
Dealt to HubertusB [Qc 4c]
HubertusB: folds 
tsatsos3: folds 
Luzod: raises $0.10 to $0.15
oumitt: folds 
Alex 63R: folds 
Mikaeus: calls $0.10
*** FLOP *** [4s 7d 5h]
Mikaeus: checks 
Luzod: checks 
*** TURN *** [4s 7d 5h] [4h]
Mikaeus: bets $0.22
Luzod: calls $0.22
*** RIVER *** [4s 7d 5h 4h] [6s]
Mikaeus: checks 
Luzod: checks 
*** SHOW DOWN ***
Mikaeus: shows [Ac Jc] (a pair of Fours)
Luzod: shows [Qs As] (a pair of Fours - Ace+Queen kicker)
Luzod collected $0.73 from pot
*** SUMMARY ***
Total pot $0.76 | Rake $0.03 
Board [4s 7d 5h 4h 6s]
Seat 1: oumitt (button) folded before Flop (didn't bet)
Seat 2: Alex 63R (small blind) folded before Flop
Seat 3: Mikaeus (big blind) showed [Ac Jc] and lost with a pair of Fours
Seat 4: HubertusB folded before Flop (didn't bet)
Seat 5: tsatsos3 folded before Flop (didn't bet)
Seat 6: Luzod showed [Qs As] and won ($0.73) with a pair of Fours



PokerStars Zoom Hand #177967342778:  Hold'em No Limit ($0.02/$0.05) - 2017/11/09 2:09:10 CCT [2017/11/08 13:09:10 ET]
Table 'Donati' 6-max Seat #1 is the button
Seat 1: Shinoda89 ($7.79 in chips) 
Seat 2: HubertusB ($4 in chips) 
Seat 3: Teariny0rEye ($5.29 in chips) 
Seat 4: plazawolf ($6.03 in chips) 
Seat 5: s_academia ($11.58 in chips) 
Seat 6: balbes weva ($5 in chips) 
HubertusB: posts small blind $0.02
Teariny0rEye: posts big blind $0.05
*** HOLE CARDS ***
Dealt to HubertusB [Ad 8d]
plazawolf: folds 
s_academia: folds 
balbes weva: folds 
Shinoda89: raises $0.07 to $0.12
HubertusB: calls $0.10
Teariny0rEye: calls $0.07
*** FLOP *** [2s 3c 8c]
HubertusB: checks 
Teariny0rEye: checks 
Shinoda89: checks 
*** TURN *** [2s 3c 8c] [5c]
HubertusB: checks 
Teariny0rEye: checks 
Shinoda89: bets $0.18
HubertusB: calls $0.18
Teariny0rEye: folds 
*** RIVER *** [2s 3c 8c 5c] [4s]
HubertusB: checks 
Shinoda89: bets $0.40
HubertusB: calls $0.40
*** SHOW DOWN ***
Shinoda89: shows [Ac 7d] (a straight, Ace to Five)
HubertusB: shows [Ad 8d] (a straight, Ace to Five)
HubertusB collected $0.73 from pot
Shinoda89 collected $0.73 from pot
*** SUMMARY ***
Total pot $1.52 | Rake $0.06 
Board [2s 3c 8c 5c 4s]
Seat 1: Shinoda89 (button) showed [Ac 7d] and won ($0.73) with a straight, Ace to Five
Seat 2: HubertusB (small blind) showed [Ad 8d] and won ($0.73) with a straight, Ace to Five
Seat 3: Teariny0rEye (big blind) folded on the Turn
Seat 4: plazawolf folded before Flop (didn't bet)
Seat 5: s_academia folded before Flop (didn't bet)
Seat 6: balbes weva folded before Flop (didn't bet)



PokerStars Zoom Hand #177967395183:  Hold'em No Limit ($0.02/$0.05) - 2017/11/09 2:10:17 CCT [2017/11/08 13:10:17 ET]
Table 'Donati' 6-max Seat #1 is the button
Seat 1: DAVIDOFF351 ($5.05 in chips) 
Seat 2: kotopes24 ($15.78 in chips) 
Seat 3: Holand153 ($5.07 in chips) 
Seat 4: EyeEmmaJedi ($13.10 in chips) 
Seat 5: Rep_Nothing ($6.25 in chips) 
Seat 6: HubertusB ($4.03 in chips) 
kotopes24: posts small blind $0.02
Holand153: posts big blind $0.05
*** HOLE CARDS ***
Dealt to HubertusB [6d Ad]
EyeEmmaJedi: folds 
Rep_Nothing: folds 
HubertusB: raises $0.05 to $0.10
DAVIDOFF351: folds 
kotopes24: folds 
Holand153: folds 
Uncalled bet ($0.05) returned to HubertusB
HubertusB collected $0.12 from pot
HubertusB: doesn't show hand 
*** SUMMARY ***
Total pot $0.12 | Rake $0 
Seat 1: DAVIDOFF351 (button) folded before Flop (didn't bet)
Seat 2: kotopes24 (small blind) folded before Flop
Seat 3: Holand153 (big blind) folded before Flop
Seat 4: EyeEmmaJedi folded before Flop (didn't bet)
Seat 5: Rep_Nothing folded before Flop (didn't bet)
Seat 6: HubertusB collected ($0.12)



PokerStars Zoom Hand #177967390639:  Hold'em No Limit ($0.02/$0.05) - 2017/11/09 2:10:11 CCT [2017/11/08 13:10:11 ET]
Table 'Donati' 6-max Seat #1 is the button
Seat 1: HubertusB ($4.03 in chips) 
Seat 2: kotopes24 ($5.72 in chips) 
Seat 3: FNSC ($2.50 in chips) 
Seat 4: Shinoda89 ($7.82 in chips) 
Seat 5: whotrust?mee ($5 in chips) 
Seat 6: 2525Sourie ($9.80 in chips) 
kotopes24: posts small blind $0.02
FNSC: posts big blind $0.05
*** HOLE CARDS ***
Dealt to HubertusB [3h 4c]
Shinoda89: folds 
whotrust?mee: folds 
2525Sourie: folds 
HubertusB: folds 
kotopes24: raises $0.07 to $0.12
FNSC: calls $0.07
*** FLOP *** [Kd Js Th]
kotopes24: checks 
FNSC: checks 
*** TURN *** [Kd Js Th] [7h]
kotopes24: checks 
FNSC: checks 
*** RIVER *** [Kd Js Th 7h] [3d]
kotopes24: checks 
FNSC: checks 
*** SHOW DOWN ***
kotopes24: shows [8c 8d] (a pair of Eights)
FNSC: mucks hand 
kotopes24 collected $0.23 from pot
*** SUMMARY ***
Total pot $0.24 | Rake $0.01 
Board [Kd Js Th 7h 3d]
Seat 1: HubertusB (button) folded before Flop (didn't bet)
Seat 2: kotopes24 (small blind) showed [8c 8d] and won ($0.23) with a pair of Eights
Seat 3: FNSC (big blind) mucked [6c 6h]
Seat 4: Shinoda89 folded before Flop (didn't bet)
Seat 5: whotrust?mee folded before Flop (didn't bet)
Seat 6: 2525Sourie folded before Flop (didn't bet)



PokerStars Zoom Hand #177967406784:  Hold'em No Limit ($0.02/$0.05) - 2017/11/09 2:10:32 CCT [2017/11/08 13:10:32 ET]
Table 'Donati' 6-max Seat #1 is the button
Seat 1: Erynaur ($6.37 in chips) 
Seat 2: EyeEmmaJedi ($13.10 in chips) 
Seat 3: SpjaldJB ($4.15 in chips) 
Seat 4: HubertusB ($4.10 in chips) 
Seat 5: prochy1909 ($10.62 in chips) 
Seat 6: zugunder11 ($4.70 in chips) 
EyeEmmaJedi: posts small blind $0.02
SpjaldJB: posts big blind $0.05
*** HOLE CARDS ***
Dealt to HubertusB [6h 7c]
HubertusB: folds 
prochy1909: folds 
zugunder11: folds 
Erynaur: folds 
EyeEmmaJedi: raises $0.10 to $0.15
SpjaldJB: folds 
Uncalled bet ($0.10) returned to EyeEmmaJedi
EyeEmmaJedi collected $0.10 from pot
EyeEmmaJedi: doesn't show hand 
*** SUMMARY ***
Total pot $0.10 | Rake $0 
Seat 1: Erynaur (button) folded before Flop (didn't bet)
Seat 2: EyeEmmaJedi (small blind) collected ($0.10)
Seat 3: SpjaldJB (big blind) folded before Flop
Seat 4: HubertusB folded before Flop (didn't bet)
Seat 5: prochy1909 folded before Flop (didn't bet)
Seat 6: zugunder11 folded before Flop (didn't bet)



PokerStars Zoom Hand #177967411425:  Hold'em No Limit ($0.02/$0.05) - 2017/11/09 2:10:38 CCT [2017/11/08 13:10:38 ET]
Table 'Donati' 6-max Seat #1 is the button
Seat 1: shibahh ($5.87 in chips) 
Seat 2: DonRazVan18 ($22.87 in chips) 
Seat 3: HubertusB ($4.10 in chips) 
Seat 4: danjmekeru ($5 in chips) 
Seat 5: LamprosA ($7.05 in chips) 
Seat 6: Hxrtxng ($6.31 in chips) 
DonRazVan18: posts small blind $0.02
HubertusB: posts big blind $0.05
*** HOLE CARDS ***
Dealt to HubertusB [9c 3d]
danjmekeru: raises $0.10 to $0.15
LamprosA: folds 
Hxrtxng: calls $0.15
shibahh has timed out while disconnected
shibahh: folds 
DonRazVan18: folds 
HubertusB: folds 
*** FLOP *** [2d Jd Qh]
danjmekeru: bets $0.26
Hxrtxng: folds 
Uncalled bet ($0.26) returned to danjmekeru
danjmekeru collected $0.35 from pot
danjmekeru: doesn't show hand 
*** SUMMARY ***
Total pot $0.37 | Rake $0.02 
Board [2d Jd Qh]
Seat 1: shibahh (button) folded before Flop (didn't bet)
Seat 2: DonRazVan18 (small blind) folded before Flop
Seat 3: HubertusB (big blind) folded before Flop
Seat 4: danjmekeru collected ($0.35)
Seat 5: LamprosA folded before Flop (didn't bet)
Seat 6: Hxrtxng folded on the Flop



PokerStars Zoom Hand #177967418525:  Hold'em No Limit ($0.02/$0.05) - 2017/11/09 2:10:47 CCT [2017/11/08 13:10:47 ET]
Table 'Donati' 6-max Seat #1 is the button
Seat 1: badman time ($7.27 in chips) 
Seat 2: KpokoguJIJI ($4.95 in chips) 
Seat 3: barrgand ($4.65 in chips) 
Seat 4: simple s0o ($5.66 in chips) 
Seat 5: HubertusB ($4.05 in chips) 
Seat 6: platypus681 ($6.31 in chips) 
KpokoguJIJI: posts small blind $0.02
barrgand: posts big blind $0.05
*** HOLE CARDS ***
Dealt to HubertusB [Qc 3c]
simple s0o: folds 
HubertusB: raises $0.05 to $0.10
platypus681: folds 
badman time: folds 
KpokoguJIJI: raises $0.25 to $0.35
barrgand: calls $0.30
HubertusB: folds 
*** FLOP *** [Kh 5h 6d]
KpokoguJIJI: bets $0.50
barrgand: raises $0.89 to $1.39
KpokoguJIJI: folds 
Uncalled bet ($0.89) returned to barrgand
barrgand collected $1.73 from pot
barrgand: doesn't show hand 
*** SUMMARY ***
Total pot $1.80 | Rake $0.07 
Board [Kh 5h 6d]
Seat 1: badman time (button) folded before Flop (didn't bet)
Seat 2: KpokoguJIJI (small blind) folded on the Flop
Seat 3: barrgand (big blind) collected ($1.73)
Seat 4: simple s0o folded before Flop (didn't bet)
Seat 5: HubertusB folded before Flop
Seat 6: platypus681 folded before Flop (didn't bet)



PokerStars Zoom Hand #177967461088:  Hold'em No Limit ($0.02/$0.05) - 2017/11/09 2:11:41 CCT [2017/11/08 13:11:41 ET]
Table 'Donati' 6-max Seat #1 is the button
Seat 1: HubertusB ($3.95 in chips) 
Seat 2: gambler4f ($7.30 in chips) 
Seat 3: Mikaeus ($5.28 in chips) 
Seat 4: Ydjin111 ($6.14 in chips) 
Seat 5: zugy37ru ($4.07 in chips) 
Seat 6: ChrischY9 ($6.75 in chips) 
gambler4f: posts small blind $0.02
Mikaeus: posts big blind $0.05
*** HOLE CARDS ***
Dealt to HubertusB [Tc 6s]
Ydjin111: folds 
zugy37ru: folds 
ChrischY9: folds 
HubertusB: folds 
gambler4f: raises $0.10 to $0.15
Mikaeus: calls $0.10
*** FLOP *** [3h Kh As]
gambler4f: bets $0.15
Mikaeus: calls $0.15
*** TURN *** [3h Kh As] [5s]
gambler4f: bets $7 and is all-in
Mikaeus: folds 
Uncalled bet ($7) returned to gambler4f
gambler4f collected $0.58 from pot
gambler4f: doesn't show hand 
*** SUMMARY ***
Total pot $0.60 | Rake $0.02 
Board [3h Kh As 5s]
Seat 1: HubertusB (button) folded before Flop (didn't bet)
Seat 2: gambler4f (small blind) collected ($0.58)
Seat 3: Mikaeus (big blind) folded on the Turn
Seat 4: Ydjin111 folded before Flop (didn't bet)
Seat 5: zugy37ru folded before Flop (didn't bet)
Seat 6: ChrischY9 folded before Flop (didn't bet)



PokerStars Zoom Hand #177967468183:  Hold'em No Limit ($0.02/$0.05) - 2017/11/09 2:11:50 CCT [2017/11/08 13:11:50 ET]
Table 'Donati' 6-max Seat #1 is the button
Seat 1: Mad-n-Smart ($4.64 in chips) 
Seat 2: ciceron86 ($7.39 in chips) 
Seat 3: Dmialber ($9.28 in chips) 
Seat 4: magabas ($12.44 in chips) 
Seat 5: prochy1909 ($10.47 in chips) 
Seat 6: HubertusB ($3.95 in chips) 
ciceron86: posts small blind $0.02
Dmialber: posts big blind $0.05
*** HOLE CARDS ***
Dealt to HubertusB [6s 6d]
magabas: folds 
prochy1909: raises $0.10 to $0.15
HubertusB: calls $0.15
Mad-n-Smart: folds 
ciceron86: folds 
Dmialber: folds 
*** FLOP *** [Qc 6h 7c]
prochy1909: checks 
HubertusB: bets $0.30
prochy1909: folds 
Uncalled bet ($0.30) returned to HubertusB
HubertusB collected $0.35 from pot
HubertusB: doesn't show hand 
*** SUMMARY ***
Total pot $0.37 | Rake $0.02 
Board [Qc 6h 7c]
Seat 1: Mad-n-Smart (button) folded before Flop (didn't bet)
Seat 2: ciceron86 (small blind) folded before Flop
Seat 3: Dmialber (big blind) folded before Flop
Seat 4: magabas folded before Flop (didn't bet)
Seat 5: prochy1909 folded on the Flop
Seat 6: HubertusB collected ($0.35)



PokerStars Zoom Hand #177967488113:  Hold'em No Limit ($0.02/$0.05) - 2017/11/09 2:12:15 CCT [2017/11/08 13:12:15 ET]
Table 'Donati' 6-max Seat #1 is the button
Seat 1: serg-hw ($5.86 in chips) 
Seat 2: HubertusB ($4.15 in chips) 
Seat 3: ooiaooao ($20.94 in chips) 
Seat 4: EyeEmmaJedi ($10.88 in chips) 
Seat 5: Fearless_men ($5 in chips) 
Seat 6: sebano2 ($5.05 in chips) 
HubertusB: posts small blind $0.02
ooiaooao: posts big blind $0.05
*** HOLE CARDS ***
Dealt to HubertusB [Ts 4h]
EyeEmmaJedi: folds 
Fearless_men: folds 
sebano2: folds 
serg-hw: folds 
HubertusB: folds 
Uncalled bet ($0.03) returned to ooiaooao
ooiaooao collected $0.04 from pot
ooiaooao: doesn't show hand 
*** SUMMARY ***
Total pot $0.04 | Rake $0 
Seat 1: serg-hw (button) folded before Flop (didn't bet)
Seat 2: HubertusB (small blind) folded before Flop
Seat 3: ooiaooao (big blind) collected ($0.04)
Seat 4: EyeEmmaJedi folded before Flop (didn't bet)
Seat 5: Fearless_men folded before Flop (didn't bet)
Seat 6: sebano2 folded before Flop (didn't bet)



PokerStars Zoom Hand #177967492821:  Hold'em No Limit ($0.02/$0.05) - 2017/11/09 2:12:21 CCT [2017/11/08 13:12:21 ET]
Table 'Donati' 6-max Seat #1 is the button
Seat 1: Teariny0rEye ($10.44 in chips) 
Seat 2: JSTAK_PTA ($7.12 in chips) 
Seat 3: XorfenX ($5.78 in chips) 
Seat 4: Dmialber ($5.73 in chips) 
Seat 5: HubertusB ($4.13 in chips) 
Seat 6: crash. xxxx ($1.07 in chips) 
JSTAK_PTA: posts small blind $0.02
XorfenX: posts big blind $0.05
*** HOLE CARDS ***
Dealt to HubertusB [5d 7c]
Dmialber: raises $0.10 to $0.15
HubertusB: folds 
crash. xxxx: folds 
Teariny0rEye: folds 
JSTAK_PTA: folds 
XorfenX: folds 
Uncalled bet ($0.10) returned to Dmialber
Dmialber collected $0.12 from pot
Dmialber: doesn't show hand 
*** SUMMARY ***
Total pot $0.12 | Rake $0 
Seat 1: Teariny0rEye (button) folded before Flop (didn't bet)
Seat 2: JSTAK_PTA (small blind) folded before Flop
Seat 3: XorfenX (big blind) folded before Flop
Seat 4: Dmialber collected ($0.12)
Seat 5: HubertusB folded before Flop (didn't bet)
Seat 6: crash. xxxx folded before Flop (didn't bet)



PokerStars Zoom Hand #177967498189:  Hold'em No Limit ($0.02/$0.05) - 2017/11/09 2:12:28 CCT [2017/11/08 13:12:28 ET]
Table 'Donati' 6-max Seat #1 is the button
Seat 1: HubertusB ($4.13 in chips) 
Seat 2: max_polonez ($4.52 in chips) 
Seat 3: BOOLDOZER767 ($2.59 in chips) 
Seat 4: slick.nov ($6.09 in chips) 
Seat 5: DonRazVan18 ($22.82 in chips) 
Seat 6: dragcom ($2 in chips) 
max_polonez: posts small blind $0.02
BOOLDOZER767: posts big blind $0.05
*** HOLE CARDS ***
Dealt to HubertusB [Ah 7c]
slick.nov: raises $0.07 to $0.12
DonRazVan18: folds 
dragcom: folds 
HubertusB: folds 
max_polonez: folds 
BOOLDOZER767: folds 
Uncalled bet ($0.07) returned to slick.nov
slick.nov collected $0.12 from pot
slick.nov: doesn't show hand 
*** SUMMARY ***
Total pot $0.12 | Rake $0 
Seat 1: HubertusB (button) folded before Flop (didn't bet)
Seat 2: max_polonez (small blind) folded before Flop
Seat 3: BOOLDOZER767 (big blind) folded before Flop
Seat 4: slick.nov collected ($0.12)
Seat 5: DonRazVan18 folded before Flop (didn't bet)
Seat 6: dragcom folded before Flop (didn't bet)



PokerStars Zoom Hand #177967509081:  Hold'em No Limit ($0.02/$0.05) - 2017/11/09 2:12:42 CCT [2017/11/08 13:12:42 ET]
Table 'Donati' 6-max Seat #1 is the button
Seat 1: barrgand ($5.89 in chips) 
Seat 2: asusone3 ($5 in chips) 
Seat 3: HubertusB ($4.13 in chips) 
Seat 4: Luzod ($7.51 in chips) 
Seat 5: mel1in ($6.29 in chips) 
Seat 6: dumpassos ($5 in chips) 
asusone3: posts small blind $0.02
HubertusB: posts big blind $0.05
*** HOLE CARDS ***
Dealt to HubertusB [6h Th]
Luzod: folds 
mel1in: folds 
dumpassos: folds 
barrgand: folds 
asusone3: folds 
Uncalled bet ($0.03) returned to HubertusB
HubertusB collected $0.04 from pot
HubertusB: doesn't show hand 
*** SUMMARY ***
Total pot $0.04 | Rake $0 
Seat 1: barrgand (button) folded before Flop (didn't bet)
Seat 2: asusone3 (small blind) folded before Flop
Seat 3: HubertusB (big blind) collected ($0.04)
Seat 4: Luzod folded before Flop (didn't bet)
Seat 5: mel1in folded before Flop (didn't bet)
Seat 6: dumpassos folded before Flop (didn't bet)



PokerStars Zoom Hand #177967515416:  Hold'em No Limit ($0.02/$0.05) - 2017/11/09 2:12:50 CCT [2017/11/08 13:12:50 ET]
Table 'Donati' 6-max Seat #1 is the button
Seat 1: BOSCOBOT ($9.76 in chips) 
Seat 2: LUTCUS ($13.23 in chips) 
Seat 3: psychowallst ($5.68 in chips) 
Seat 4: HubertusB ($4.15 in chips) 
Seat 5: kopatich52 ($7.77 in chips) 
Seat 6: woocha33 ($5 in chips) 
LUTCUS: posts small blind $0.02
psychowallst: posts big blind $0.05
*** HOLE CARDS ***
Dealt to HubertusB [3d 6s]
HubertusB: folds 
kopatich52: folds 
woocha33: folds 
BOSCOBOT: folds 
LUTCUS: raises $0.08 to $0.13
psychowallst: raises $0.27 to $0.40
LUTCUS: raises $0.45 to $0.85
psychowallst: calls $0.45
*** FLOP *** [9s 2d Ah]
LUTCUS: bets $0.72
psychowallst: folds 
Uncalled bet ($0.72) returned to LUTCUS
LUTCUS collected $1.63 from pot
LUTCUS: doesn't show hand 
*** SUMMARY ***
Total pot $1.70 | Rake $0.07 
Board [9s 2d Ah]
Seat 1: BOSCOBOT (button) folded before Flop (didn't bet)
Seat 2: LUTCUS (small blind) collected ($1.63)
Seat 3: psychowallst (big blind) folded on the Flop
Seat 4: HubertusB folded before Flop (didn't bet)
Seat 5: kopatich52 folded before Flop (didn't bet)
Seat 6: woocha33 folded before Flop (didn't bet)



PokerStars Zoom Hand #177967525708:  Hold'em No Limit ($0.02/$0.05) - 2017/11/09 2:13:03 CCT [2017/11/08 13:13:03 ET]
Table 'Donati' 6-max Seat #1 is the button
Seat 1: HubertusB ($4.13 in chips) 
Seat 2: marianoacha ($7.10 in chips) 
Seat 3: Rep_Nothing ($5.12 in chips) 
Seat 4: coolgrays ($3.33 in chips) 
Seat 5: vitoreh ($5.37 in chips) 
Seat 6: thekingdrogb ($10.27 in chips) 
marianoacha: posts small blind $0.02
Rep_Nothing: posts big blind $0.05
*** HOLE CARDS ***
Dealt to HubertusB [As Kd]
coolgrays: folds 
vitoreh: folds 
thekingdrogb: raises $0.06 to $0.11
HubertusB: raises $0.24 to $0.35
marianoacha: folds 
Rep_Nothing: folds 
thekingdrogb: folds 
Uncalled bet ($0.24) returned to HubertusB
HubertusB collected $0.29 from pot
HubertusB: doesn't show hand 
*** SUMMARY ***
Total pot $0.29 | Rake $0 
Seat 1: HubertusB (button) collected ($0.29)
Seat 2: marianoacha (small blind) folded before Flop
Seat 3: Rep_Nothing (big blind) folded before Flop
Seat 4: coolgrays folded before Flop (didn't bet)
Seat 5: vitoreh folded before Flop (didn't bet)
Seat 6: thekingdrogb folded before Flop



PokerStars Zoom Hand #177967519464:  Hold'em No Limit ($0.02/$0.05) - 2017/11/09 2:12:55 CCT [2017/11/08 13:12:55 ET]
Table 'Donati' 6-max Seat #1 is the button
Seat 1: ChrischY9 ($7.19 in chips) 
Seat 2: HubertusB ($4.15 in chips) 
Seat 3: Rassty1983 ($12.79 in chips) 
Seat 4: Altergeek ($3.85 in chips) 
Seat 5: Holand153 ($5 in chips) 
Seat 6: BOSCOBOT ($5.22 in chips) 
HubertusB: posts small blind $0.02
Rassty1983: posts big blind $0.05
*** HOLE CARDS ***
Dealt to HubertusB [3h As]
Altergeek: calls $0.05
Holand153: raises $0.15 to $0.20
BOSCOBOT: folds 
ChrischY9: folds 
HubertusB: folds 
Rassty1983: folds 
Altergeek: calls $0.15
*** FLOP *** [Jc 6d 9d]
Altergeek: checks 
Holand153: bets $0.22
Altergeek: calls $0.22
*** TURN *** [Jc 6d 9d] [5h]
Altergeek: checks 
Holand153: checks 
*** RIVER *** [Jc 6d 9d 5h] [3s]
Altergeek: checks 
Holand153: checks 
*** SHOW DOWN ***
Altergeek: shows [Ad 9s] (a pair of Nines)
Holand153: mucks hand 
Altergeek collected $0.87 from pot
*** SUMMARY ***
Total pot $0.91 | Rake $0.04 
Board [Jc 6d 9d 5h 3s]
Seat 1: ChrischY9 (button) folded before Flop (didn't bet)
Seat 2: HubertusB (small blind) folded before Flop
Seat 3: Rassty1983 (big blind) folded before Flop
Seat 4: Altergeek showed [Ad 9s] and won ($0.87) with a pair of Nines
Seat 5: Holand153 mucked [Qd Td]
Seat 6: BOSCOBOT folded before Flop (didn't bet)



PokerStars Zoom Hand #177967542815:  Hold'em No Limit ($0.02/$0.05) - 2017/11/09 2:13:25 CCT [2017/11/08 13:13:25 ET]
Table 'Donati' 6-max Seat #1 is the button
Seat 1: kopatich52 ($11.10 in chips) 
Seat 2: hceyms ($5.47 in chips) 
Seat 3: HubertusB ($4.31 in chips) 
Seat 4: prata_uk ($5.40 in chips) 
Seat 5: crazybogman ($9.75 in chips) 
Seat 6: klaverdread ($5.24 in chips) 
hceyms: posts small blind $0.02
HubertusB: posts big blind $0.05
*** HOLE CARDS ***
Dealt to HubertusB [6h 4s]
prata_uk: folds 
crazybogman: folds 
klaverdread: raises $0.07 to $0.12
kopatich52: folds 
hceyms: folds 
HubertusB: folds 
Uncalled bet ($0.07) returned to klaverdread
klaverdread collected $0.12 from pot
klaverdread: doesn't show hand 
*** SUMMARY ***
Total pot $0.12 | Rake $0 
Seat 1: kopatich52 (button) folded before Flop (didn't bet)
Seat 2: hceyms (small blind) folded before Flop
Seat 3: HubertusB (big blind) folded before Flop
Seat 4: prata_uk folded before Flop (didn't bet)
Seat 5: crazybogman folded before Flop (didn't bet)
Seat 6: klaverdread collected ($0.12)



PokerStars Zoom Hand #177967547549:  Hold'em No Limit ($0.02/$0.05) - 2017/11/09 2:13:31 CCT [2017/11/08 13:13:31 ET]
Table 'Donati' 6-max Seat #1 is the button
Seat 1: kotopes24 ($17.12 in chips) 
Seat 2: hceyms ($5.08 in chips) 
Seat 3: williamnik ($4.83 in chips) 
Seat 4: Nomoney099 ($6.41 in chips) 
Seat 5: HubertusB ($4.26 in chips) 
Seat 6: YoungKazimir ($6.45 in chips) 
hceyms: posts small blind $0.02
williamnik: posts big blind $0.05
*** HOLE CARDS ***
Dealt to HubertusB [8c 3h]
Nomoney099: folds 
HubertusB: folds 
YoungKazimir: folds 
kotopes24: folds 
hceyms: folds 
Uncalled bet ($0.03) returned to williamnik
williamnik collected $0.04 from pot
williamnik: doesn't show hand 
*** SUMMARY ***
Total pot $0.04 | Rake $0 
Seat 1: kotopes24 (button) folded before Flop (didn't bet)
Seat 2: hceyms (small blind) folded before Flop
Seat 3: williamnik (big blind) collected ($0.04)
Seat 4: Nomoney099 folded before Flop (didn't bet)
Seat 5: HubertusB folded before Flop (didn't bet)
Seat 6: YoungKazimir folded before Flop (didn't bet)



PokerStars Zoom Hand #177967538194:  Hold'em No Limit ($0.02/$0.05) - 2017/11/09 2:13:19 CCT [2017/11/08 13:13:19 ET]
Table 'Donati' 6-max Seat #1 is the button
Seat 1: Erynaur ($6.62 in chips) 
Seat 2: SpicedGoldie ($7.32 in chips) 
Seat 3: pokersito84 ($12.76 in chips) 
Seat 4: peladonk ($7.62 in chips) 
Seat 5: simple s0o ($6.28 in chips) 
Seat 6: HubertusB ($4.31 in chips) 
SpicedGoldie: posts small blind $0.02
pokersito84: posts big blind $0.05
*** HOLE CARDS ***
Dealt to HubertusB [Kc 8s]
peladonk: raises $0.10 to $0.15
simple s0o: folds 
HubertusB: folds 
Erynaur: folds 
SpicedGoldie: folds 
pokersito84: calls $0.10
*** FLOP *** [9c 3d 3h]
pokersito84: checks 
peladonk: bets $0.16
pokersito84: folds 
Uncalled bet ($0.16) returned to peladonk
peladonk collected $0.31 from pot
peladonk: doesn't show hand 
*** SUMMARY ***
Total pot $0.32 | Rake $0.01 
Board [9c 3d 3h]
Seat 1: Erynaur (button) folded before Flop (didn't bet)
Seat 2: SpicedGoldie (small blind) folded before Flop
Seat 3: pokersito84 (big blind) folded on the Flop
Seat 4: peladonk collected ($0.31)
Seat 5: simple s0o folded before Flop (didn't bet)
Seat 6: HubertusB folded before Flop (didn't bet)



PokerStars Zoom Hand #177967553818:  Hold'em No Limit ($0.02/$0.05) - 2017/11/09 2:13:39 CCT [2017/11/08 13:13:39 ET]
Table 'Donati' 6-max Seat #1 is the button
Seat 1: Fearless_men ($5.14 in chips) 
Seat 2: teoter ($15.43 in chips) 
Seat 3: DmitrySh85 ($6.74 in chips) 
Seat 4: HubertusB ($4.26 in chips) 
Seat 5: KpokoguJIJI ($4.85 in chips) 
Seat 6: gambler4f ($7.56 in chips) 
teoter: posts small blind $0.02
DmitrySh85: posts big blind $0.05
*** HOLE CARDS ***
Dealt to HubertusB [Th 2c]
HubertusB: folds 
KpokoguJIJI: folds 
gambler4f: folds 
Fearless_men: folds 
teoter: folds 
Uncalled bet ($0.03) returned to DmitrySh85
DmitrySh85 collected $0.04 from pot
DmitrySh85: doesn't show hand 
*** SUMMARY ***
Total pot $0.04 | Rake $0 
Seat 1: Fearless_men (button) folded before Flop (didn't bet)
Seat 2: teoter (small blind) folded before Flop
Seat 3: DmitrySh85 (big blind) collected ($0.04)
Seat 4: HubertusB folded before Flop (didn't bet)
Seat 5: KpokoguJIJI folded before Flop (didn't bet)
Seat 6: gambler4f folded before Flop (didn't bet)



PokerStars Zoom Hand #177967558532:  Hold'em No Limit ($0.02/$0.05) - 2017/11/09 2:13:45 CCT [2017/11/08 13:13:45 ET]
Table 'Donati' 6-max Seat #1 is the button
Seat 1: nostlagia ($5.24 in chips) 
Seat 2: 7OstapBender ($5 in chips) 
Seat 3: williamnik ($5.05 in chips) 
Seat 4: HubertusB ($4.26 in chips) 
Seat 5: Kondr-KAV ($4.98 in chips) 
Seat 6: miodibao ($5 in chips) 
7OstapBender: posts small blind $0.02
williamnik: posts big blind $0.05
*** HOLE CARDS ***
Dealt to HubertusB [9d Jd]
HubertusB: raises $0.05 to $0.10
Kondr-KAV: folds 
miodibao: calls $0.10
nostlagia: folds 
7OstapBender: folds 
williamnik: folds 
*** FLOP *** [3d Kc 3c]
HubertusB: bets $0.15
miodibao: folds 
Uncalled bet ($0.15) returned to HubertusB
HubertusB collected $0.26 from pot
HubertusB: doesn't show hand 
*** SUMMARY ***
Total pot $0.27 | Rake $0.01 
Board [3d Kc 3c]
Seat 1: nostlagia (button) folded before Flop (didn't bet)
Seat 2: 7OstapBender (small blind) folded before Flop
Seat 3: williamnik (big blind) folded before Flop
Seat 4: HubertusB collected ($0.26)
Seat 5: Kondr-KAV folded before Flop (didn't bet)
Seat 6: miodibao folded on the Flop



PokerStars Zoom Hand #177967573484:  Hold'em No Limit ($0.02/$0.05) - 2017/11/09 2:14:04 CCT [2017/11/08 13:14:04 ET]
Table 'Donati' 6-max Seat #1 is the button
Seat 1: Elchaza_1989 ($5.02 in chips) 
Seat 2: MaaadHatter ($2.84 in chips) 
Seat 3: Nomoney099 ($6.63 in chips) 
Seat 4: Hxrtxng ($6.23 in chips) 
Seat 5: Smeja21 ($5.50 in chips) 
Seat 6: HubertusB ($4.42 in chips) 
MaaadHatter: posts small blind $0.02
Nomoney099: posts big blind $0.05
*** HOLE CARDS ***
Dealt to HubertusB [Jd Ac]
Hxrtxng: folds 
Smeja21: folds 
HubertusB: raises $0.05 to $0.10
Elchaza_1989: folds 
MaaadHatter: calls $0.08
Nomoney099: folds 
*** FLOP *** [3d Kh 9c]
MaaadHatter: bets $0.10
HubertusB: calls $0.10
*** TURN *** [3d Kh 9c] [8c]
MaaadHatter: bets $0.20
HubertusB: raises $0.45 to $0.65
MaaadHatter: folds 
Uncalled bet ($0.45) returned to HubertusB
HubertusB collected $0.81 from pot
HubertusB: doesn't show hand 
*** SUMMARY ***
Total pot $0.85 | Rake $0.04 
Board [3d Kh 9c 8c]
Seat 1: Elchaza_1989 (button) folded before Flop (didn't bet)
Seat 2: MaaadHatter (small blind) folded on the Turn
Seat 3: Nomoney099 (big blind) folded before Flop
Seat 4: Hxrtxng folded before Flop (didn't bet)
Seat 5: Smeja21 folded before Flop (didn't bet)
Seat 6: HubertusB collected ($0.81)



PokerStars Zoom Hand #177967615945:  Hold'em No Limit ($0.02/$0.05) - 2017/11/09 2:14:58 CCT [2017/11/08 13:14:58 ET]
Table 'Donati' 6-max Seat #1 is the button
Seat 1: 6runogn ($8.05 in chips) 
Seat 2: HubertusB ($4.83 in chips) 
Seat 3: zisis83 ($4.71 in chips) 
Seat 4: PaRaNoYa01 ($6.20 in chips) 
Seat 5: fat@l_err0r ($10.90 in chips) 
Seat 6: balbes weva ($5.02 in chips) 
HubertusB: posts small blind $0.02
zisis83: posts big blind $0.05
*** HOLE CARDS ***
Dealt to HubertusB [Kh Js]
PaRaNoYa01: folds 
fat@l_err0r: folds 
balbes weva: folds 
6runogn: folds 
HubertusB: raises $0.05 to $0.10
zisis83: calls $0.05
*** FLOP *** [Td Th Qh]
HubertusB: bets $0.10
zisis83: calls $0.10
*** TURN *** [Td Th Qh] [Ks]
HubertusB: checks 
zisis83: bets $0.20
HubertusB: calls $0.20
*** RIVER *** [Td Th Qh Ks] [7c]
HubertusB: checks 
zisis83: checks 
*** SHOW DOWN ***
HubertusB: shows [Kh Js] (two pair, Kings and Tens)
zisis83: mucks hand 
HubertusB collected $0.77 from pot
*** SUMMARY ***
Total pot $0.80 | Rake $0.03 
Board [Td Th Qh Ks 7c]
Seat 1: 6runogn (button) folded before Flop (didn't bet)
Seat 2: HubertusB (small blind) showed [Kh Js] and won ($0.77) with two pair, Kings and Tens
Seat 3: zisis83 (big blind) mucked [9s Qs]
Seat 4: PaRaNoYa01 folded before Flop (didn't bet)
Seat 5: fat@l_err0r folded before Flop (didn't bet)
Seat 6: balbes weva folded before Flop (didn't bet)



PokerStars Zoom Hand #177967665873:  Hold'em No Limit ($0.02/$0.05) - 2017/11/09 2:16:01 CCT [2017/11/08 13:16:01 ET]
Table 'Donati' 6-max Seat #1 is the button
Seat 1: HubertusB ($5.20 in chips) 
Seat 2: BOSCOBOT ($9.95 in chips) 
Seat 3: Neftot ($5.20 in chips) 
Seat 4: Unstoppabble ($5.17 in chips) 
Seat 5: dumpassos ($6.91 in chips) 
Seat 6: sanux_poker ($9.07 in chips) 
BOSCOBOT: posts small blind $0.02
Neftot: posts big blind $0.05
*** HOLE CARDS ***
Dealt to HubertusB [9d 6c]
Unstoppabble: folds 
dumpassos: folds 
sanux_poker: folds 
HubertusB: raises $0.05 to $0.10
BOSCOBOT: folds 
Neftot: folds 
Uncalled bet ($0.05) returned to HubertusB
HubertusB collected $0.12 from pot
HubertusB: doesn't show hand 
*** SUMMARY ***
Total pot $0.12 | Rake $0 
Seat 1: HubertusB (button) collected ($0.12)
Seat 2: BOSCOBOT (small blind) folded before Flop
Seat 3: Neftot (big blind) folded before Flop
Seat 4: Unstoppabble folded before Flop (didn't bet)
Seat 5: dumpassos folded before Flop (didn't bet)
Seat 6: sanux_poker folded before Flop (didn't bet)



PokerStars Zoom Hand #177967685818:  Hold'em No Limit ($0.02/$0.05) - 2017/11/09 2:16:26 CCT [2017/11/08 13:16:26 ET]
Table 'Donati' 6-max Seat #1 is the button
Seat 1: N0$tradamu$ ($4.97 in chips) 
Seat 2: UruGabo ($27.96 in chips) 
Seat 3: HubertusB ($5.27 in chips) 
Seat 4: Shinoda89 ($22.39 in chips) 
Seat 5: 216NL ($5.31 in chips) 
Seat 6: 1Cart ($5.33 in chips) 
UruGabo: posts small blind $0.02
HubertusB: posts big blind $0.05
*** HOLE CARDS ***
Dealt to HubertusB [5h 3d]
Shinoda89: folds 
216NL: folds 
1Cart: raises $0.10 to $0.15
N0$tradamu$: folds 
UruGabo: folds 
HubertusB: folds 
Uncalled bet ($0.10) returned to 1Cart
1Cart collected $0.12 from pot
1Cart: doesn't show hand 
*** SUMMARY ***
Total pot $0.12 | Rake $0 
Seat 1: N0$tradamu$ (button) folded before Flop (didn't bet)
Seat 2: UruGabo (small blind) folded before Flop
Seat 3: HubertusB (big blind) folded before Flop
Seat 4: Shinoda89 folded before Flop (didn't bet)
Seat 5: 216NL folded before Flop (didn't bet)
Seat 6: 1Cart collected ($0.12)



PokerStars Zoom Hand #177967679414:  Hold'em No Limit ($0.02/$0.05) - 2017/11/09 2:16:18 CCT [2017/11/08 13:16:18 ET]
Table 'Donati' 6-max Seat #1 is the button
Seat 1: coolgrays ($6.64 in chips) 
Seat 2: sakurai1 ($10.79 in chips) 
Seat 3: KpokoguJIJI ($5 in chips) 
Seat 4: and_67rus ($5 in chips) 
Seat 5: HubertusB ($5.27 in chips) 
Seat 6: zsmoala ($5.24 in chips) 
sakurai1: posts small blind $0.02
KpokoguJIJI: posts big blind $0.05
*** HOLE CARDS ***
Dealt to HubertusB [Qh 5c]
and_67rus: raises $0.10 to $0.15
HubertusB: folds 
zsmoala: folds 
coolgrays: folds 
sakurai1: folds 
KpokoguJIJI: calls $0.10
*** FLOP *** [5s 9d Ks]
KpokoguJIJI: checks 
and_67rus: checks 
*** TURN *** [5s 9d Ks] [5d]
KpokoguJIJI: bets $0.20
and_67rus: folds 
Uncalled bet ($0.20) returned to KpokoguJIJI
KpokoguJIJI collected $0.31 from pot
KpokoguJIJI: doesn't show hand 
*** SUMMARY ***
Total pot $0.32 | Rake $0.01 
Board [5s 9d Ks 5d]
Seat 1: coolgrays (button) folded before Flop (didn't bet)
Seat 2: sakurai1 (small blind) folded before Flop
Seat 3: KpokoguJIJI (big blind) collected ($0.31)
Seat 4: and_67rus folded on the Turn
Seat 5: HubertusB folded before Flop (didn't bet)
Seat 6: zsmoala folded before Flop (didn't bet)



PokerStars Zoom Hand #177967695114:  Hold'em No Limit ($0.02/$0.05) - 2017/11/09 2:16:38 CCT [2017/11/08 13:16:38 ET]
Table 'Donati' 6-max Seat #1 is the button
Seat 1: Rassty1983 ($4.01 in chips) 
Seat 2: Thiefain ($9.60 in chips) 
Seat 3: moozeev ($5.30 in chips) 
Seat 4: yesss!!!92 ($7.45 in chips) 
Seat 5: Pro100PaPaN ($5.36 in chips) 
Seat 6: HubertusB ($5.22 in chips) 
Thiefain: posts small blind $0.02
moozeev: posts big blind $0.05
*** HOLE CARDS ***
Dealt to HubertusB [8c Kh]
yesss!!!92: folds 
Pro100PaPaN: folds 
HubertusB: raises $0.05 to $0.10
Rassty1983: folds 
Thiefain: folds 
moozeev: calls $0.05
*** FLOP *** [2h 2c 6h]
moozeev: checks 
HubertusB: bets $0.12
moozeev: folds 
Uncalled bet ($0.12) returned to HubertusB
HubertusB collected $0.21 from pot
HubertusB: doesn't show hand 
*** SUMMARY ***
Total pot $0.22 | Rake $0.01 
Board [2h 2c 6h]
Seat 1: Rassty1983 (button) folded before Flop (didn't bet)
Seat 2: Thiefain (small blind) folded before Flop
Seat 3: moozeev (big blind) folded on the Flop
Seat 4: yesss!!!92 folded before Flop (didn't bet)
Seat 5: Pro100PaPaN folded before Flop (didn't bet)
Seat 6: HubertusB collected ($0.21)



PokerStars Zoom Hand #177967711991:  Hold'em No Limit ($0.02/$0.05) - 2017/11/09 2:16:59 CCT [2017/11/08 13:16:59 ET]
Table 'Donati' 6-max Seat #1 is the button
Seat 1: csokmei98 ($3.60 in chips) 
Seat 2: Rassty1983 ($19.41 in chips) 
Seat 3: fenix321 ($4.13 in chips) 
Seat 4: O0r4nga ($6.25 in chips) 
Seat 5: HubertusB ($5.33 in chips) 
Seat 6: petr 131313 ($4.61 in chips) 
Rassty1983: posts small blind $0.02
fenix321: posts big blind $0.05
*** HOLE CARDS ***
Dealt to HubertusB [8h 3c]
O0r4nga: folds 
HubertusB: folds 
petr 131313: folds 
csokmei98: raises $3.55 to $3.60 and is all-in
Rassty1983: folds 
fenix321: folds 
Uncalled bet ($3.55) returned to csokmei98
csokmei98 collected $0.12 from pot
csokmei98: doesn't show hand 
*** SUMMARY ***
Total pot $0.12 | Rake $0 
Seat 1: csokmei98 (button) collected ($0.12)
Seat 2: Rassty1983 (small blind) folded before Flop
Seat 3: fenix321 (big blind) folded before Flop
Seat 4: O0r4nga folded before Flop (didn't bet)
Seat 5: HubertusB folded before Flop (didn't bet)
Seat 6: petr 131313 folded before Flop (didn't bet)



PokerStars Zoom Hand #177967717540:  Hold'em No Limit ($0.02/$0.05) - 2017/11/09 2:17:06 CCT [2017/11/08 13:17:06 ET]
Table 'Donati' 6-max Seat #1 is the button
Seat 1: iqorrrrr ($6.08 in chips) 
Seat 2: HubertusB ($5.33 in chips) 
Seat 3: IuDeX_777 ($4.88 in chips) 
Seat 4: Ymnica15 ($5.07 in chips) 
Seat 5: miodibao ($5.26 in chips) 
Seat 6: smartymind ($5 in chips) 
HubertusB: posts small blind $0.02
IuDeX_777: posts big blind $0.05
*** HOLE CARDS ***
Dealt to HubertusB [3s 7c]
Ymnica15: folds 
miodibao: folds 
smartymind: raises $0.12 to $0.17
iqorrrrr: folds 
HubertusB: folds 
IuDeX_777: folds 
Uncalled bet ($0.12) returned to smartymind
smartymind collected $0.12 from pot
smartymind: doesn't show hand 
*** SUMMARY ***
Total pot $0.12 | Rake $0 
Seat 1: iqorrrrr (button) folded before Flop (didn't bet)
Seat 2: HubertusB (small blind) folded before Flop
Seat 3: IuDeX_777 (big blind) folded before Flop
Seat 4: Ymnica15 folded before Flop (didn't bet)
Seat 5: miodibao folded before Flop (didn't bet)
Seat 6: smartymind collected ($0.12)



PokerStars Zoom Hand #177967726823:  Hold'em No Limit ($0.02/$0.05) - 2017/11/09 2:17:18 CCT [2017/11/08 13:17:18 ET]
Table 'Donati' 6-max Seat #1 is the button
Seat 1: Dmialber ($9.11 in chips) 
Seat 2: IIIYCTPULO ($6.74 in chips) 
Seat 3: Whizar ($4.31 in chips) 
Seat 4: HubertusB ($5.31 in chips) 
Seat 5: DmitrySh85 ($7.10 in chips) 
Seat 6: Sarmatrus79 ($5 in chips) 
IIIYCTPULO: posts small blind $0.02
Whizar: posts big blind $0.05
*** HOLE CARDS ***
Dealt to HubertusB [Qh Ad]
HubertusB: raises $0.05 to $0.10
DmitrySh85: folds 
Sarmatrus79: folds 
Dmialber: raises $1.15 to $1.25
IIIYCTPULO: folds 
Whizar: folds 
HubertusB: folds 
Uncalled bet ($1.15) returned to Dmialber
Dmialber collected $0.27 from pot
Dmialber: doesn't show hand 
*** SUMMARY ***
Total pot $0.27 | Rake $0 
Seat 1: Dmialber (button) collected ($0.27)
Seat 2: IIIYCTPULO (small blind) folded before Flop
Seat 3: Whizar (big blind) folded before Flop
Seat 4: HubertusB folded before Flop
Seat 5: DmitrySh85 folded before Flop (didn't bet)
Seat 6: Sarmatrus79 folded before Flop (didn't bet)



PokerStars Zoom Hand #177967745942:  Hold'em No Limit ($0.02/$0.05) - 2017/11/09 2:17:42 CCT [2017/11/08 13:17:42 ET]
Table 'Donati' 6-max Seat #1 is the button
Seat 1: Luzod ($5 in chips) 
Seat 2: maliniak75 ($3 in chips) 
Seat 3: HubertusB ($5.21 in chips) 
Seat 4: 3rikBernard ($6.94 in chips) 
Seat 5: ATTAKON ($12.35 in chips) 
Seat 6: mirtes10 ($2.83 in chips) 
maliniak75: posts small blind $0.02
HubertusB: posts big blind $0.05
*** HOLE CARDS ***
Dealt to HubertusB [Kh 5d]
3rikBernard: folds 
ATTAKON: folds 
mirtes10: folds 
Luzod: raises $0.07 to $0.12
maliniak75: folds 
HubertusB: folds 
Uncalled bet ($0.07) returned to Luzod
Luzod collected $0.12 from pot
Luzod: doesn't show hand 
*** SUMMARY ***
Total pot $0.12 | Rake $0 
Seat 1: Luzod (button) collected ($0.12)
Seat 2: maliniak75 (small blind) folded before Flop
Seat 3: HubertusB (big blind) folded before Flop
Seat 4: 3rikBernard folded before Flop (didn't bet)
Seat 5: ATTAKON folded before Flop (didn't bet)
Seat 6: mirtes10 folded before Flop (didn't bet)



PokerStars Zoom Hand #177967756313:  Hold'em No Limit ($0.02/$0.05) - 2017/11/09 2:17:55 CCT [2017/11/08 13:17:55 ET]
Table 'Donati' 6-max Seat #1 is the button
Seat 1: BOOLDOZER767 ($2.40 in chips) 
Seat 2: kotopes24 ($18.21 in chips) 
Seat 3: Volke!n kz ($15.56 in chips) 
Seat 4: HubertusB ($5.16 in chips) 
Seat 5: prochy1909 ($7.71 in chips) 
Seat 6: tursows ($5.18 in chips) 
kotopes24: posts small blind $0.02
Volke!n kz: posts big blind $0.05
*** HOLE CARDS ***
Dealt to HubertusB [5h 9h]
HubertusB: raises $0.05 to $0.10
prochy1909: folds 
tursows: folds 
BOOLDOZER767: folds 
kotopes24: folds 
Volke!n kz: folds 
Uncalled bet ($0.05) returned to HubertusB
HubertusB collected $0.12 from pot
HubertusB: doesn't show hand 
*** SUMMARY ***
Total pot $0.12 | Rake $0 
Seat 1: BOOLDOZER767 (button) folded before Flop (didn't bet)
Seat 2: kotopes24 (small blind) folded before Flop
Seat 3: Volke!n kz (big blind) folded before Flop
Seat 4: HubertusB collected ($0.12)
Seat 5: prochy1909 folded before Flop (didn't bet)
Seat 6: tursows folded before Flop (didn't bet)



PokerStars Zoom Hand #177967765022:  Hold'em No Limit ($0.02/$0.05) - 2017/11/09 2:18:06 CCT [2017/11/08 13:18:06 ET]
Table 'Donati' 6-max Seat #1 is the button
Seat 1: HubertusB ($5.23 in chips) 
Seat 2: donn1987 ($6.11 in chips) 
Seat 3: XorfenX ($4.97 in chips) 
Seat 4: MiCkYKrS ($5 in chips) 
Seat 5: sorokin21 ($5 in chips) 
Seat 6: nestorhunter ($5.12 in chips) 
donn1987: posts small blind $0.02
XorfenX: posts big blind $0.05
*** HOLE CARDS ***
Dealt to HubertusB [7s 8h]
MiCkYKrS: raises $0.10 to $0.15
sorokin21: calls $0.15
nestorhunter: folds 
HubertusB: raises $0.40 to $0.55
donn1987: folds 
XorfenX: folds 
MiCkYKrS: folds 
sorokin21: calls $0.40
*** FLOP *** [Js Jd 8c]
sorokin21: checks 
HubertusB: bets $0.55
sorokin21: folds 
Uncalled bet ($0.55) returned to HubertusB
HubertusB collected $1.27 from pot
HubertusB: doesn't show hand 
*** SUMMARY ***
Total pot $1.32 | Rake $0.05 
Board [Js Jd 8c]
Seat 1: HubertusB (button) collected ($1.27)
Seat 2: donn1987 (small blind) folded before Flop
Seat 3: XorfenX (big blind) folded before Flop
Seat 4: MiCkYKrS folded before Flop
Seat 5: sorokin21 folded on the Flop
Seat 6: nestorhunter folded before Flop (didn't bet)



PokerStars Zoom Hand #177967790553:  Hold'em No Limit ($0.02/$0.05) - 2017/11/09 2:18:38 CCT [2017/11/08 13:18:38 ET]
Table 'Donati' 6-max Seat #1 is the button
Seat 1: ATTAKON ($9.89 in chips) 
Seat 2: Ignite13 ($9.57 in chips) 
Seat 3: Alfie Bear ($5.07 in chips) 
Seat 4: AndreasAU79 ($8.34 in chips) 
Seat 5: ivan777242 ($3.79 in chips) 
Seat 6: HubertusB ($5.93 in chips) 
Ignite13: posts small blind $0.02
Alfie Bear: posts big blind $0.05
*** HOLE CARDS ***
Dealt to HubertusB [Ac Ts]
AndreasAU79: folds 
ivan777242: calls $0.05
HubertusB: raises $0.15 to $0.20
ATTAKON: folds 
Ignite13: folds 
Alfie Bear: folds 
ivan777242: folds 
Uncalled bet ($0.15) returned to HubertusB
HubertusB collected $0.17 from pot
HubertusB: doesn't show hand 
*** SUMMARY ***
Total pot $0.17 | Rake $0 
Seat 1: ATTAKON (button) folded before Flop (didn't bet)
Seat 2: Ignite13 (small blind) folded before Flop
Seat 3: Alfie Bear (big blind) folded before Flop
Seat 4: AndreasAU79 folded before Flop (didn't bet)
Seat 5: ivan777242 folded before Flop
Seat 6: HubertusB collected ($0.17)



PokerStars Zoom Hand #177967785698:  Hold'em No Limit ($0.02/$0.05) - 2017/11/09 2:18:32 CCT [2017/11/08 13:18:32 ET]
Table 'Donati' 6-max Seat #1 is the button
Seat 1: borntamer ($5 in chips) 
Seat 2: HubertusB ($5.95 in chips) 
Seat 3: Badger4515 ($5 in chips) 
Seat 4: bjorkwow504 ($5 in chips) 
Seat 5: Einherjer91 ($5.33 in chips) 
Seat 6: Farfan77rus ($2.43 in chips) 
HubertusB: posts small blind $0.02
Badger4515: posts big blind $0.05
*** HOLE CARDS ***
Dealt to HubertusB [9c 2h]
bjorkwow504: raises $0.10 to $0.15
Einherjer91: folds 
Farfan77rus: calls $0.15
borntamer: folds 
HubertusB: folds 
Badger4515: folds 
*** FLOP *** [4s 7h 3c]
bjorkwow504: checks 
Farfan77rus: checks 
*** TURN *** [4s 7h 3c] [9d]
bjorkwow504: checks 
Farfan77rus: checks 
*** RIVER *** [4s 7h 3c 9d] [8s]
bjorkwow504: checks 
Farfan77rus: checks 
*** SHOW DOWN ***
bjorkwow504: shows [Qc Kc] (high card King)
Farfan77rus: shows [6h 6d] (a pair of Sixes)
Farfan77rus collected $0.35 from pot
*** SUMMARY ***
Total pot $0.37 | Rake $0.02 
Board [4s 7h 3c 9d 8s]
Seat 1: borntamer (button) folded before Flop (didn't bet)
Seat 2: HubertusB (small blind) folded before Flop
Seat 3: Badger4515 (big blind) folded before Flop
Seat 4: bjorkwow504 showed [Qc Kc] and lost with high card King
Seat 5: Einherjer91 folded before Flop (didn't bet)
Seat 6: Farfan77rus showed [6h 6d] and won ($0.35) with a pair of Sixes



PokerStars Zoom Hand #177967803367:  Hold'em No Limit ($0.02/$0.05) - 2017/11/09 2:18:54 CCT [2017/11/08 13:18:54 ET]
Table 'Donati' 6-max Seat #1 is the button
Seat 1: BOSCOBOT ($8.70 in chips) 
Seat 2: plazawolf ($6.30 in chips) 
Seat 3: HubertusB ($6.05 in chips) 
Seat 4: awekisa ($6.13 in chips) 
Seat 5: LuckyIldar ($12.18 in chips) 
Seat 6: Sarmatrus79 ($5.64 in chips) 
plazawolf: posts small blind $0.02
HubertusB: posts big blind $0.05
*** HOLE CARDS ***
Dealt to HubertusB [Ac 9h]
awekisa: raises $0.10 to $0.15
LuckyIldar: folds 
Sarmatrus79: folds 
BOSCOBOT: folds 
plazawolf: folds 
HubertusB: folds 
Uncalled bet ($0.10) returned to awekisa
awekisa collected $0.12 from pot
awekisa: doesn't show hand 
*** SUMMARY ***
Total pot $0.12 | Rake $0 
Seat 1: BOSCOBOT (button) folded before Flop (didn't bet)
Seat 2: plazawolf (small blind) folded before Flop
Seat 3: HubertusB (big blind) folded before Flop
Seat 4: awekisa collected ($0.12)
Seat 5: LuckyIldar folded before Flop (didn't bet)
Seat 6: Sarmatrus79 folded before Flop (didn't bet)



PokerStars Zoom Hand #177967813684:  Hold'em No Limit ($0.02/$0.05) - 2017/11/09 2:19:07 CCT [2017/11/08 13:19:07 ET]
Table 'Donati' 6-max Seat #1 is the button
Seat 1: DonRazVan18 ($8.59 in chips) 
Seat 2: O0r4nga ($6.20 in chips) 
Seat 3: Andrey171410 ($5 in chips) 
Seat 4: peladonk ($11.80 in chips) 
Seat 5: HubertusB ($6 in chips) 
Seat 6: DINHOZP ($2.50 in chips) 
O0r4nga: posts small blind $0.02
Andrey171410: posts big blind $0.05
*** HOLE CARDS ***
Dealt to HubertusB [4c Qd]
peladonk: folds 
HubertusB: folds 
DINHOZP: folds 
DonRazVan18: raises $0.05 to $0.10
O0r4nga: folds 
Andrey171410: folds 
Uncalled bet ($0.05) returned to DonRazVan18
DonRazVan18 collected $0.12 from pot
DonRazVan18: doesn't show hand 
*** SUMMARY ***
Total pot $0.12 | Rake $0 
Seat 1: DonRazVan18 (button) collected ($0.12)
Seat 2: O0r4nga (small blind) folded before Flop
Seat 3: Andrey171410 (big blind) folded before Flop
Seat 4: peladonk folded before Flop (didn't bet)
Seat 5: HubertusB folded before Flop (didn't bet)
Seat 6: DINHOZP folded before Flop (didn't bet)



PokerStars Zoom Hand #177967817671:  Hold'em No Limit ($0.02/$0.05) - 2017/11/09 2:19:12 CCT [2017/11/08 13:19:12 ET]
Table 'Donati' 6-max Seat #1 is the button
Seat 1: HubertusB ($6 in chips) 
Seat 2: woocha33 ($3.84 in chips) 
Seat 3: aodwntm ($7.10 in chips) 
Seat 4: DINHOZP ($2.50 in chips) 
Seat 5: I´m Grinder ($4.03 in chips) 
Seat 6: Ydjin111 ($2.77 in chips) 
woocha33: posts small blind $0.02
aodwntm: posts big blind $0.05
*** HOLE CARDS ***
Dealt to HubertusB [9c Ah]
DINHOZP: folds 
I´m Grinder: folds 
Ydjin111: raises $0.05 to $0.10
HubertusB: raises $0.20 to $0.30
woocha33: raises $0.75 to $1.05
aodwntm: folds 
Ydjin111: folds 
HubertusB: folds 
Uncalled bet ($0.75) returned to woocha33
woocha33 collected $0.75 from pot
woocha33: doesn't show hand 
*** SUMMARY ***
Total pot $0.75 | Rake $0 
Seat 1: HubertusB (button) folded before Flop
Seat 2: woocha33 (small blind) collected ($0.75)
Seat 3: aodwntm (big blind) folded before Flop
Seat 4: DINHOZP folded before Flop (didn't bet)
Seat 5: I´m Grinder folded before Flop (didn't bet)
Seat 6: Ydjin111 folded before Flop



PokerStars Zoom Hand #177967844063:  Hold'em No Limit ($0.02/$0.05) - 2017/11/09 2:19:45 CCT [2017/11/08 13:19:45 ET]
Table 'Donati' 6-max Seat #1 is the button
Seat 1: pokeforeverr ($3.01 in chips) 
Seat 2: magabas ($11.98 in chips) 
Seat 3: yumi2003 ($4.75 in chips) 
Seat 4: BOOLDOZER767 ($2.34 in chips) 
Seat 5: SpjaldJB ($5.08 in chips) 
Seat 6: HubertusB ($5.70 in chips) 
magabas: posts small blind $0.02
yumi2003: posts big blind $0.05
*** HOLE CARDS ***
Dealt to HubertusB [9h Qc]
BOOLDOZER767: folds 
SpjaldJB: folds 
HubertusB: raises $0.05 to $0.10
pokeforeverr: folds 
magabas: folds 
yumi2003: calls $0.05
*** FLOP *** [Ks 5h 5c]
yumi2003: checks 
HubertusB: checks 
*** TURN *** [Ks 5h 5c] [3h]
yumi2003: bets $0.14
HubertusB: calls $0.14
*** RIVER *** [Ks 5h 5c 3h] [7s]
yumi2003: checks 
HubertusB: bets $0.35
yumi2003: folds 
Uncalled bet ($0.35) returned to HubertusB
HubertusB collected $0.48 from pot
HubertusB: doesn't show hand 
*** SUMMARY ***
Total pot $0.50 | Rake $0.02 
Board [Ks 5h 5c 3h 7s]
Seat 1: pokeforeverr (button) folded before Flop (didn't bet)
Seat 2: magabas (small blind) folded before Flop
Seat 3: yumi2003 (big blind) folded on the River
Seat 4: BOOLDOZER767 folded before Flop (didn't bet)
Seat 5: SpjaldJB folded before Flop (didn't bet)
Seat 6: HubertusB collected ($0.48)



PokerStars Zoom Hand #177967871172:  Hold'em No Limit ($0.02/$0.05) - 2017/11/09 2:20:19 CCT [2017/11/08 13:20:19 ET]
Table 'Donati' 6-max Seat #1 is the button
Seat 1: WisherBG ($5.98 in chips) 
Seat 2: alexm883 ($5.16 in chips) 
Seat 3: BOSCOBOT ($9.20 in chips) 
Seat 4: HubertusB ($5.94 in chips) 
Seat 5: Thiefain ($5.10 in chips) 
Seat 6: kvito4ka88 ($5.13 in chips) 
alexm883: posts small blind $0.02
BOSCOBOT: posts big blind $0.05
*** HOLE CARDS ***
Dealt to HubertusB [3d Kh]
HubertusB: folds 
Thiefain: folds 
kvito4ka88: folds 
WisherBG: raises $0.05 to $0.10
alexm883: folds 
BOSCOBOT: folds 
Uncalled bet ($0.05) returned to WisherBG
WisherBG collected $0.12 from pot
WisherBG: doesn't show hand 
*** SUMMARY ***
Total pot $0.12 | Rake $0 
Seat 1: WisherBG (button) collected ($0.12)
Seat 2: alexm883 (small blind) folded before Flop
Seat 3: BOSCOBOT (big blind) folded before Flop
Seat 4: HubertusB folded before Flop (didn't bet)
Seat 5: Thiefain folded before Flop (didn't bet)
Seat 6: kvito4ka88 folded before Flop (didn't bet)



PokerStars Zoom Hand #177967875215:  Hold'em No Limit ($0.02/$0.05) - 2017/11/09 2:20:24 CCT [2017/11/08 13:20:24 ET]
Table 'Donati' 6-max Seat #1 is the button
Seat 1: zsmoala ($4.86 in chips) 
Seat 2: HubertusB ($5.94 in chips) 
Seat 3: Aleksandrpby ($5 in chips) 
Seat 4: O0r4nga ($12.59 in chips) 
Seat 5: Smeja21 ($9.05 in chips) 
Seat 6: VoVaN4o 14 ($5.46 in chips) 
HubertusB: posts small blind $0.02
Aleksandrpby: posts big blind $0.05
*** HOLE CARDS ***
Dealt to HubertusB [3h 3d]
O0r4nga: folds 
Smeja21: folds 
VoVaN4o 14: raises $0.10 to $0.15
zsmoala: folds 
HubertusB: calls $0.13
Aleksandrpby: folds 
*** FLOP *** [As 4d 2h]
HubertusB: checks 
VoVaN4o 14: checks 
*** TURN *** [As 4d 2h] [8s]
HubertusB: bets $0.20
VoVaN4o 14: folds 
Uncalled bet ($0.20) returned to HubertusB
HubertusB collected $0.34 from pot
HubertusB: doesn't show hand 
*** SUMMARY ***
Total pot $0.35 | Rake $0.01 
Board [As 4d 2h 8s]
Seat 1: zsmoala (button) folded before Flop (didn't bet)
Seat 2: HubertusB (small blind) collected ($0.34)
Seat 3: Aleksandrpby (big blind) folded before Flop
Seat 4: O0r4nga folded before Flop (didn't bet)
Seat 5: Smeja21 folded before Flop (didn't bet)
Seat 6: VoVaN4o 14 folded on the Turn



PokerStars Zoom Hand #177967891213:  Hold'em No Limit ($0.02/$0.05) - 2017/11/09 2:20:44 CCT [2017/11/08 13:20:44 ET]
Table 'Donati' 6-max Seat #1 is the button
Seat 1: HubertusB ($6.13 in chips) 
Seat 2: Valerik18 ($5 in chips) 
Seat 3: masha_dza ($3.67 in chips) 
Seat 4: tursows ($5.62 in chips) 
Seat 5: HH-hour ($5.71 in chips) 
Seat 6: DonRazVan18 ($24.66 in chips) 
Valerik18: posts small blind $0.02
masha_dza: posts big blind $0.05
*** HOLE CARDS ***
Dealt to HubertusB [6s 3c]
tursows: raises $0.12 to $0.17
HH-hour: folds 
DonRazVan18: folds 
HubertusB: folds 
Valerik18: folds 
masha_dza: folds 
Uncalled bet ($0.12) returned to tursows
tursows collected $0.12 from pot
tursows: doesn't show hand 
*** SUMMARY ***
Total pot $0.12 | Rake $0 
Seat 1: HubertusB (button) folded before Flop (didn't bet)
Seat 2: Valerik18 (small blind) folded before Flop
Seat 3: masha_dza (big blind) folded before Flop
Seat 4: tursows collected ($0.12)
Seat 5: HH-hour folded before Flop (didn't bet)
Seat 6: DonRazVan18 folded before Flop (didn't bet)



PokerStars Zoom Hand #177967896769:  Hold'em No Limit ($0.02/$0.05) - 2017/11/09 2:20:51 CCT [2017/11/08 13:20:51 ET]
Table 'Donati' 6-max Seat #1 is the button
Seat 1: lv3t3chn0 ($4.46 in chips) 
Seat 2: Tautietis852 ($7.36 in chips) 
Seat 3: HubertusB ($6.13 in chips) 
Seat 4: nicob32 ($2.66 in chips) 
Seat 5: Shurik389 ($5.09 in chips) 
Seat 6: yamadaman ($2.17 in chips) 
Tautietis852: posts small blind $0.02
HubertusB: posts big blind $0.05
*** HOLE CARDS ***
Dealt to HubertusB [Qd Qs]
nicob32: raises $0.10 to $0.15
Shurik389: folds 
yamadaman: folds 
lv3t3chn0: folds 
Tautietis852: folds 
HubertusB: raises $0.45 to $0.60
nicob32: calls $0.45
*** FLOP *** [6d 7h 9s]
HubertusB: bets $0.65
nicob32: calls $0.65
*** TURN *** [6d 7h 9s] [6c]
HubertusB: bets $4.88 and is all-in
nicob32: folds 
Uncalled bet ($4.88) returned to HubertusB
HubertusB collected $2.42 from pot
HubertusB: doesn't show hand 
*** SUMMARY ***
Total pot $2.52 | Rake $0.10 
Board [6d 7h 9s 6c]
Seat 1: lv3t3chn0 (button) folded before Flop (didn't bet)
Seat 2: Tautietis852 (small blind) folded before Flop
Seat 3: HubertusB (big blind) collected ($2.42)
Seat 4: nicob32 folded on the Turn
Seat 5: Shurik389 folded before Flop (didn't bet)
Seat 6: yamadaman folded before Flop (didn't bet)



PokerStars Zoom Hand #177967932537:  Hold'em No Limit ($0.02/$0.05) - 2017/11/09 2:21:36 CCT [2017/11/08 13:21:36 ET]
Table 'Donati' 6-max Seat #1 is the button
Seat 1: PaRaNoYa01 ($5.02 in chips) 
Seat 2: evgenij2125 ($5.07 in chips) 
Seat 3: Mikaeus ($5.34 in chips) 
Seat 4: simple s0o ($8.97 in chips) 
Seat 5: HubertusB ($7.30 in chips) 
Seat 6: hceyms ($5.08 in chips) 
evgenij2125: posts small blind $0.02
Mikaeus: posts big blind $0.05
*** HOLE CARDS ***
Dealt to HubertusB [4s 7s]
simple s0o: folds 
HubertusB: raises $0.05 to $0.10
hceyms: folds 
PaRaNoYa01: folds 
evgenij2125: folds 
Mikaeus: folds 
Uncalled bet ($0.05) returned to HubertusB
HubertusB collected $0.12 from pot
HubertusB: doesn't show hand 
*** SUMMARY ***
Total pot $0.12 | Rake $0 
Seat 1: PaRaNoYa01 (button) folded before Flop (didn't bet)
Seat 2: evgenij2125 (small blind) folded before Flop
Seat 3: Mikaeus (big blind) folded before Flop
Seat 4: simple s0o folded before Flop (didn't bet)
Seat 5: HubertusB collected ($0.12)
Seat 6: hceyms folded before Flop (didn't bet)



PokerStars Zoom Hand #177967954073:  Hold'em No Limit ($0.02/$0.05) - 2017/11/09 2:22:03 CCT [2017/11/08 13:22:03 ET]
Table 'Donati' 6-max Seat #1 is the button
Seat 1: Einherjer91 ($5.27 in chips) 
Seat 2: Lago Madjore ($5 in chips) 
Seat 3: coolgrays ($6.23 in chips) 
Seat 4: HubertusB ($7.37 in chips) 
Seat 5: zmss ($5.16 in chips) 
Seat 6: sanux_poker ($5.08 in chips) 
Lago Madjore: posts small blind $0.02
coolgrays: posts big blind $0.05
*** HOLE CARDS ***
Dealt to HubertusB [Qd 5h]
HubertusB: folds 
zmss: folds 
sanux_poker: folds 
Einherjer91: raises $0.10 to $0.15
Lago Madjore: folds 
coolgrays: folds 
Uncalled bet ($0.10) returned to Einherjer91
Einherjer91 collected $0.12 from pot
Einherjer91: doesn't show hand 
*** SUMMARY ***
Total pot $0.12 | Rake $0 
Seat 1: Einherjer91 (button) collected ($0.12)
Seat 2: Lago Madjore (small blind) folded before Flop
Seat 3: coolgrays (big blind) folded before Flop
Seat 4: HubertusB folded before Flop (didn't bet)
Seat 5: zmss folded before Flop (didn't bet)
Seat 6: sanux_poker folded before Flop (didn't bet)



PokerStars Zoom Hand #177967965923:  Hold'em No Limit ($0.02/$0.05) - 2017/11/09 2:22:18 CCT [2017/11/08 13:22:18 ET]
Table 'Donati' 6-max Seat #1 is the button
Seat 1: Andrey171410 ($5.72 in chips) 
Seat 2: HubertusB ($7.37 in chips) 
Seat 3: Execute Them ($5.58 in chips) 
Seat 4: cl05rrr ($20.52 in chips) 
Seat 5: kvito4ka88 ($5.34 in chips) 
Seat 6: BOSCOBOT ($7.71 in chips) 
HubertusB: posts small blind $0.02
Execute Them: posts big blind $0.05
*** HOLE CARDS ***
Dealt to HubertusB [6c Td]
cl05rrr: folds 
kvito4ka88: folds 
BOSCOBOT: folds 
Andrey171410: raises $0.07 to $0.12
HubertusB: folds 
Execute Them: raises $0.33 to $0.45
Andrey171410: folds 
Uncalled bet ($0.33) returned to Execute Them
Execute Them collected $0.26 from pot
Execute Them: doesn't show hand 
*** SUMMARY ***
Total pot $0.26 | Rake $0 
Seat 1: Andrey171410 (button) folded before Flop
Seat 2: HubertusB (small blind) folded before Flop
Seat 3: Execute Them (big blind) collected ($0.26)
Seat 4: cl05rrr folded before Flop (didn't bet)
Seat 5: kvito4ka88 folded before Flop (didn't bet)
Seat 6: BOSCOBOT folded before Flop (didn't bet)



PokerStars Zoom Hand #177967959715:  Hold'em No Limit ($0.02/$0.05) - 2017/11/09 2:22:10 CCT [2017/11/08 13:22:10 ET]
Table 'Donati' 6-max Seat #1 is the button
Seat 1: HubertusB ($7.37 in chips) 
Seat 2: ooiaooao ($20.41 in chips) 
Seat 3: tom1994lewis ($4.93 in chips) 
Seat 4: Shurik389 ($4.94 in chips) 
Seat 5: AvagK ($4.44 in chips) 
Seat 6: prata_uk ($5 in chips) 
ooiaooao: posts small blind $0.02
tom1994lewis: posts big blind $0.05
*** HOLE CARDS ***
Dealt to HubertusB [Qh 7d]
Shurik389: raises $0.10 to $0.15
AvagK: folds 
prata_uk: folds 
HubertusB: folds 
ooiaooao: folds 
tom1994lewis: calls $0.10
*** FLOP *** [Qd Ks 8c]
tom1994lewis: checks 
Shurik389: bets $0.17
tom1994lewis: calls $0.17
*** TURN *** [Qd Ks 8c] [5h]
tom1994lewis: bets $0.30
Shurik389: folds 
Uncalled bet ($0.30) returned to tom1994lewis
tom1994lewis collected $0.63 from pot
tom1994lewis: doesn't show hand 
*** SUMMARY ***
Total pot $0.66 | Rake $0.03 
Board [Qd Ks 8c 5h]
Seat 1: HubertusB (button) folded before Flop (didn't bet)
Seat 2: ooiaooao (small blind) folded before Flop
Seat 3: tom1994lewis (big blind) collected ($0.63)
Seat 4: Shurik389 folded on the Turn
Seat 5: AvagK folded before Flop (didn't bet)
Seat 6: prata_uk folded before Flop (didn't bet)



PokerStars Zoom Hand #177967973801:  Hold'em No Limit ($0.02/$0.05) - 2017/11/09 2:22:28 CCT [2017/11/08 13:22:28 ET]
Table 'Donati' 6-max Seat #1 is the button
Seat 1: Saarland58 ($4.78 in chips) 
Seat 2: asusone3 ($10.76 in chips) 
Seat 3: zisis83 ($3.67 in chips) 
Seat 4: Lago Madjore ($5.80 in chips) 
Seat 5: prochy1909 ($17.70 in chips) 
Seat 6: HubertusB ($7.35 in chips) 
asusone3: posts small blind $0.02
zisis83: posts big blind $0.05
*** HOLE CARDS ***
Dealt to HubertusB [8d Jc]
Lago Madjore: raises $0.10 to $0.15
prochy1909: folds 
HubertusB: folds 
Saarland58: calls $0.15
asusone3: calls $0.13
zisis83: folds 
*** FLOP *** [Ac Qs Jh]
asusone3: checks 
Lago Madjore: checks 
Saarland58: checks 
*** TURN *** [Ac Qs Jh] [Kd]
asusone3: bets $0.34
Lago Madjore: folds 
Saarland58: folds 
Uncalled bet ($0.34) returned to asusone3
asusone3 collected $0.48 from pot
asusone3: doesn't show hand 
*** SUMMARY ***
Total pot $0.50 | Rake $0.02 
Board [Ac Qs Jh Kd]
Seat 1: Saarland58 (button) folded on the Turn
Seat 2: asusone3 (small blind) collected ($0.48)
Seat 3: zisis83 (big blind) folded before Flop
Seat 4: Lago Madjore folded on the Turn
Seat 5: prochy1909 folded before Flop (didn't bet)
Seat 6: HubertusB folded before Flop (didn't bet)



PokerStars Zoom Hand #177967996784:  Hold'em No Limit ($0.02/$0.05) - 2017/11/09 2:22:57 CCT [2017/11/08 13:22:57 ET]
Table 'Donati' 6-max Seat #1 is the button
Seat 1: schaemic ($9.71 in chips) 
Seat 2: max_polonez ($6.38 in chips) 
Seat 3: HubertusB ($7.35 in chips) 
Seat 4: Odvajke1 ($5.34 in chips) 
Seat 5: Unstoppabble ($10.51 in chips) 
Seat 6: VVS2874 ($8.70 in chips) 
max_polonez: posts small blind $0.02
HubertusB: posts big blind $0.05
*** HOLE CARDS ***
Dealt to HubertusB [5d 7c]
Odvajke1: folds 
Unstoppabble: folds 
VVS2874: folds 
schaemic: raises $0.10 to $0.15
max_polonez: folds 
HubertusB: folds 
Uncalled bet ($0.10) returned to schaemic
schaemic collected $0.12 from pot
schaemic: doesn't show hand 
*** SUMMARY ***
Total pot $0.12 | Rake $0 
Seat 1: schaemic (button) collected ($0.12)
Seat 2: max_polonez (small blind) folded before Flop
Seat 3: HubertusB (big blind) folded before Flop
Seat 4: Odvajke1 folded before Flop (didn't bet)
Seat 5: Unstoppabble folded before Flop (didn't bet)
Seat 6: VVS2874 folded before Flop (didn't bet)



PokerStars Zoom Hand #177968017406:  Hold'em No Limit ($0.02/$0.05) - 2017/11/09 2:23:23 CCT [2017/11/08 13:23:23 ET]
Table 'Donati' 6-max Seat #1 is the button
Seat 1: HubertusB ($7.30 in chips) 
Seat 2: platypus681 ($5 in chips) 
Seat 3: hellhippo ($6.56 in chips) 
Seat 4: WEIPEI1 ($5.48 in chips) 
Seat 5: AvagK ($4.57 in chips) 
Seat 6: petr 131313 ($5.21 in chips) 
platypus681: posts small blind $0.02
hellhippo: posts big blind $0.05
*** HOLE CARDS ***
Dealt to HubertusB [7d Qh]
WEIPEI1: folds 
AvagK: folds 
petr 131313: folds 
HubertusB: raises $0.05 to $0.10
platypus681: folds 
hellhippo: folds 
Uncalled bet ($0.05) returned to HubertusB
HubertusB collected $0.12 from pot
HubertusB: doesn't show hand 
*** SUMMARY ***
Total pot $0.12 | Rake $0 
Seat 1: HubertusB (button) collected ($0.12)
Seat 2: platypus681 (small blind) folded before Flop
Seat 3: hellhippo (big blind) folded before Flop
Seat 4: WEIPEI1 folded before Flop (didn't bet)
Seat 5: AvagK folded before Flop (didn't bet)
Seat 6: petr 131313 folded before Flop (didn't bet)



PokerStars Zoom Hand #177967991241:  Hold'em No Limit ($0.02/$0.05) - 2017/11/09 2:22:50 CCT [2017/11/08 13:22:50 ET]
Table 'Donati' 6-max Seat #1 is the button
Seat 1: simple s0o ($5.69 in chips) 
Seat 2: Mikaeus ($10.29 in chips) 
Seat 3: james5555896 ($5 in chips) 
Seat 4: s_academia ($10.97 in chips) 
Seat 5: HubertusB ($7.35 in chips) 
Seat 6: r3x1a ($5 in chips) 
Mikaeus: posts small blind $0.02
james5555896: posts big blind $0.05
*** HOLE CARDS ***
Dealt to HubertusB [3s 7d]
s_academia: raises $0.10 to $0.15
HubertusB: folds 
r3x1a has timed out
r3x1a: folds 
simple s0o: folds 
Mikaeus: folds 
james5555896: raises $0.35 to $0.50
s_academia: calls $0.35
*** FLOP *** [2c 9h 4h]
james5555896: bets $0.55
s_academia: folds 
Uncalled bet ($0.55) returned to james5555896
james5555896 collected $0.98 from pot
james5555896: doesn't show hand 
*** SUMMARY ***
Total pot $1.02 | Rake $0.04 
Board [2c 9h 4h]
Seat 1: simple s0o (button) folded before Flop (didn't bet)
Seat 2: Mikaeus (small blind) folded before Flop
Seat 3: james5555896 (big blind) collected ($0.98)
Seat 4: s_academia folded on the Flop
Seat 5: HubertusB folded before Flop (didn't bet)
Seat 6: r3x1a folded before Flop (didn't bet)



PokerStars Zoom Hand #177968037207:  Hold'em No Limit ($0.02/$0.05) - 2017/11/09 2:23:48 CCT [2017/11/08 13:23:48 ET]
Table 'Donati' 6-max Seat #1 is the button
Seat 1: DonRazVan18 ($8.22 in chips) 
Seat 2: Shinoda89 ($28.91 in chips) 
Seat 3: raffos_star ($5.02 in chips) 
Seat 4: RamberZamber ($5.14 in chips) 
Seat 5: HubertusB ($7.37 in chips) 
Seat 6: JuHorse ($5.16 in chips) 
Shinoda89: posts small blind $0.02
raffos_star: posts big blind $0.05
*** HOLE CARDS ***
Dealt to HubertusB [4c Qs]
RamberZamber: folds 
HubertusB: raises $0.05 to $0.10
JuHorse: raises $0.20 to $0.30
DonRazVan18: folds 
Shinoda89: folds 
raffos_star: folds 
HubertusB: folds 
Uncalled bet ($0.20) returned to JuHorse
JuHorse collected $0.27 from pot
JuHorse: doesn't show hand 
*** SUMMARY ***
Total pot $0.27 | Rake $0 
Seat 1: DonRazVan18 (button) folded before Flop (didn't bet)
Seat 2: Shinoda89 (small blind) folded before Flop
Seat 3: raffos_star (big blind) folded before Flop
Seat 4: RamberZamber folded before Flop (didn't bet)
Seat 5: HubertusB folded before Flop
Seat 6: JuHorse collected ($0.27)



PokerStars Zoom Hand #177968053020:  Hold'em No Limit ($0.02/$0.05) - 2017/11/09 2:24:08 CCT [2017/11/08 13:24:08 ET]
Table 'Donati' 6-max Seat #1 is the button
Seat 1: mel1in ($15.64 in chips) 
Seat 2: HubertusB ($7.22 in chips) 
Seat 3: Odvajke1 ($5 in chips) 
Seat 4: mrissya33 ($2.44 in chips) 
Seat 5: ser313131 ($6.23 in chips) 
Seat 6: HansGunter15 ($5 in chips) 
HubertusB: posts small blind $0.02
Odvajke1: posts big blind $0.05
*** HOLE CARDS ***
Dealt to HubertusB [4s 5h]
mrissya33: folds 
ser313131: folds 
HansGunter15: folds 
mel1in: folds 
HubertusB: folds 
Uncalled bet ($0.03) returned to Odvajke1
Odvajke1 collected $0.04 from pot
Odvajke1: doesn't show hand 
*** SUMMARY ***
Total pot $0.04 | Rake $0 
Seat 1: mel1in (button) folded before Flop (didn't bet)
Seat 2: HubertusB (small blind) folded before Flop
Seat 3: Odvajke1 (big blind) collected ($0.04)
Seat 4: mrissya33 folded before Flop (didn't bet)
Seat 5: ser313131 folded before Flop (didn't bet)
Seat 6: HansGunter15 folded before Flop (didn't bet)



PokerStars Zoom Hand #177968057002:  Hold'em No Limit ($0.02/$0.05) - 2017/11/09 2:24:13 CCT [2017/11/08 13:24:13 ET]
Table 'Donati' 6-max Seat #1 is the button
Seat 1: Shinoda89 ($28.84 in chips) 
Seat 2: zmss ($7.25 in chips) 
Seat 3: phizzle007 ($5.54 in chips) 
Seat 4: smartymind ($9.23 in chips) 
Seat 5: 6runogn ($8.18 in chips) 
Seat 6: HubertusB ($7.20 in chips) 
zmss: posts small blind $0.02
phizzle007: posts big blind $0.05
*** HOLE CARDS ***
Dealt to HubertusB [6h Ac]
smartymind: folds 
6runogn: folds 
HubertusB: raises $0.05 to $0.10
Shinoda89: folds 
zmss: folds 
phizzle007: folds 
Uncalled bet ($0.05) returned to HubertusB
HubertusB collected $0.12 from pot
HubertusB: doesn't show hand 
*** SUMMARY ***
Total pot $0.12 | Rake $0 
Seat 1: Shinoda89 (button) folded before Flop (didn't bet)
Seat 2: zmss (small blind) folded before Flop
Seat 3: phizzle007 (big blind) folded before Flop
Seat 4: smartymind folded before Flop (didn't bet)
Seat 5: 6runogn folded before Flop (didn't bet)
Seat 6: HubertusB collected ($0.12)



PokerStars Zoom Hand #177968046682:  Hold'em No Limit ($0.02/$0.05) - 2017/11/09 2:24:00 CCT [2017/11/08 13:24:00 ET]
Table 'Donati' 6-max Seat #1 is the button
Seat 1: Barbos383 ($5.55 in chips) 
Seat 2: hceyms ($6.79 in chips) 
Seat 3: HubertusB ($7.27 in chips) 
Seat 4: sojuice ($5.32 in chips) 
Seat 5: Rep_Nothing ($5.07 in chips) 
Seat 6: Tautietis852 ($5.93 in chips) 
hceyms: posts small blind $0.02
HubertusB: posts big blind $0.05
*** HOLE CARDS ***
Dealt to HubertusB [4d 8h]
sojuice: raises $0.10 to $0.15
Rep_Nothing: folds 
Tautietis852: folds 
Barbos383: calls $0.15
hceyms: raises $0.45 to $0.60
HubertusB: folds 
sojuice: folds 
Barbos383: calls $0.45
*** FLOP *** [6s 8c 2c]
hceyms: bets $0.75
Barbos383: folds 
Uncalled bet ($0.75) returned to hceyms
hceyms collected $1.34 from pot
hceyms: doesn't show hand 
*** SUMMARY ***
Total pot $1.40 | Rake $0.06 
Board [6s 8c 2c]
Seat 1: Barbos383 (button) folded on the Flop
Seat 2: hceyms (small blind) collected ($1.34)
Seat 3: HubertusB (big blind) folded before Flop
Seat 4: sojuice folded before Flop
Seat 5: Rep_Nothing folded before Flop (didn't bet)
Seat 6: Tautietis852 folded before Flop (didn't bet)



PokerStars Zoom Hand #177968066605:  Hold'em No Limit ($0.02/$0.05) - 2017/11/09 2:24:25 CCT [2017/11/08 13:24:25 ET]
Table 'Donati' 6-max Seat #1 is the button
Seat 1: KpokoguJIJI ($10.86 in chips) 
Seat 2: sebano2 ($5 in chips) 
Seat 3: zsmoala ($4.96 in chips) 
Seat 4: HubertusB ($7.27 in chips) 
Seat 5: Nerpa911 ($5.68 in chips) 
Seat 6: yayito0924 ($5 in chips) 
sebano2: posts small blind $0.02
zsmoala: posts big blind $0.05
*** HOLE CARDS ***
Dealt to HubertusB [9d Qs]
HubertusB: folds 
Nerpa911: raises $0.10 to $0.15
yayito0924: folds 
KpokoguJIJI: folds 
sebano2: folds 
zsmoala: folds 
Uncalled bet ($0.10) returned to Nerpa911
Nerpa911 collected $0.12 from pot
Nerpa911: doesn't show hand 
*** SUMMARY ***
Total pot $0.12 | Rake $0 
Seat 1: KpokoguJIJI (button) folded before Flop (didn't bet)
Seat 2: sebano2 (small blind) folded before Flop
Seat 3: zsmoala (big blind) folded before Flop
Seat 4: HubertusB folded before Flop (didn't bet)
Seat 5: Nerpa911 collected ($0.12)
Seat 6: yayito0924 folded before Flop (didn't bet)



PokerStars Zoom Hand #177968071377:  Hold'em No Limit ($0.02/$0.05) - 2017/11/09 2:24:31 CCT [2017/11/08 13:24:31 ET]
Table 'Donati' 6-max Seat #1 is the button
Seat 1: sebano2 ($5 in chips) 
Seat 2: Daylor570 ($5.17 in chips) 
Seat 3: domitorii ($5.31 in chips) 
Seat 4: HubertusB ($7.27 in chips) 
Seat 5: sojuice ($11.40 in chips) 
Seat 6: Thiefain ($6.38 in chips) 
Daylor570: posts small blind $0.02
domitorii: posts big blind $0.05
*** HOLE CARDS ***
Dealt to HubertusB [2h 8h]
HubertusB: raises $0.05 to $0.10
sojuice: calls $0.10
Thiefain: folds 
sebano2: folds 
Daylor570: folds 
domitorii: folds 
*** FLOP *** [9c 2s 8d]
HubertusB: bets $0.20
sojuice: raises $0.40 to $0.60
HubertusB: raises $1.50 to $2.10
sojuice: calls $1.50
*** TURN *** [9c 2s 8d] [Ad]
HubertusB: bets $5.07 and is all-in
sojuice: calls $5.07
*** RIVER *** [9c 2s 8d Ad] [Jd]
*** SHOW DOWN ***
HubertusB: shows [2h 8h] (two pair, Eights and Deuces)
sojuice: shows [9d 9h] (three of a kind, Nines)
sojuice collected $14 from pot
*** SUMMARY ***
Total pot $14.61 | Rake $0.61 
Board [9c 2s 8d Ad Jd]
Seat 1: sebano2 (button) folded before Flop (didn't bet)
Seat 2: Daylor570 (small blind) folded before Flop
Seat 3: domitorii (big blind) folded before Flop
Seat 4: HubertusB showed [2h 8h] and lost with two pair, Eights and Deuces
Seat 5: sojuice showed [9d 9h] and won ($14) with three of a kind, Nines
Seat 6: Thiefain folded before Flop (didn't bet)



PokerStars Zoom Hand #177968116829:  Hold'em No Limit ($0.02/$0.05) - 2017/11/09 2:25:28 CCT [2017/11/08 13:25:28 ET]
Table 'Donati' 6-max Seat #1 is the button
Seat 1: HubertusB ($5 in chips) 
Seat 2: Vindictive69 ($10.82 in chips) 
Seat 3: swesda21 ($5.54 in chips) 
Seat 4: Charlie44333 ($5.19 in chips) 
Seat 5: ivan777242 ($2.65 in chips) 
Seat 6: O0r4nga ($6.10 in chips) 
Vindictive69: posts small blind $0.02
swesda21: posts big blind $0.05
*** HOLE CARDS ***
Dealt to HubertusB [4d Qc]
Charlie44333: folds 
ivan777242: folds 
O0r4nga: folds 
HubertusB: raises $0.05 to $0.10
Vindictive69: folds 
swesda21: folds 
Uncalled bet ($0.05) returned to HubertusB
HubertusB collected $0.12 from pot
HubertusB: doesn't show hand 
*** SUMMARY ***
Total pot $0.12 | Rake $0 
Seat 1: HubertusB (button) collected ($0.12)
Seat 2: Vindictive69 (small blind) folded before Flop
Seat 3: swesda21 (big blind) folded before Flop
Seat 4: Charlie44333 folded before Flop (didn't bet)
Seat 5: ivan777242 folded before Flop (didn't bet)
Seat 6: O0r4nga folded before Flop (didn't bet)



PokerStars Zoom Hand #177968128040:  Hold'em No Limit ($0.02/$0.05) - 2017/11/09 2:25:42 CCT [2017/11/08 13:25:42 ET]
Table 'Donati' 6-max Seat #1 is the button
Seat 1: Execute Them ($6.31 in chips) 
Seat 2: DonRazVan18 ($25.21 in chips) 
Seat 3: Badger4515 ($5 in chips) 
Seat 4: Einherjer91 ($6.05 in chips) 
Seat 5: Mad-n-Smart ($4.41 in chips) 
Seat 6: HubertusB ($5.07 in chips) 
DonRazVan18: posts small blind $0.02
Badger4515: posts big blind $0.05
*** HOLE CARDS ***
Dealt to HubertusB [8s Jh]
Einherjer91: folds 
Mad-n-Smart: folds 
HubertusB: raises $0.05 to $0.10
Execute Them: calls $0.10
DonRazVan18: folds 
Badger4515: raises $0.50 to $0.60
HubertusB: folds 
Execute Them: folds 
Uncalled bet ($0.50) returned to Badger4515
Badger4515 collected $0.32 from pot
Badger4515: doesn't show hand 
*** SUMMARY ***
Total pot $0.32 | Rake $0 
Seat 1: Execute Them (button) folded before Flop
Seat 2: DonRazVan18 (small blind) folded before Flop
Seat 3: Badger4515 (big blind) collected ($0.32)
Seat 4: Einherjer91 folded before Flop (didn't bet)
Seat 5: Mad-n-Smart folded before Flop (didn't bet)
Seat 6: HubertusB folded before Flop



PokerStars Zoom Hand #177968142241:  Hold'em No Limit ($0.02/$0.05) - 2017/11/09 2:26:00 CCT [2017/11/08 13:26:00 ET]
Table 'Donati' 6-max Seat #1 is the button
Seat 1: sojuice ($11.90 in chips) 
Seat 2: HubertusB ($4.97 in chips) 
Seat 3: ztrombitas ($5.14 in chips) 
Seat 4: nfnfh83 ($3.36 in chips) 
Seat 5: Sarmatrus79 ($5 in chips) 
Seat 6: aodwntm ($6.31 in chips) 
HubertusB: posts small blind $0.02
ztrombitas: posts big blind $0.05
*** HOLE CARDS ***
Dealt to HubertusB [4s 2c]
nfnfh83: raises $0.10 to $0.15
Sarmatrus79: folds 
aodwntm: folds 
sojuice: folds 
HubertusB: folds 
ztrombitas: folds 
Uncalled bet ($0.10) returned to nfnfh83
nfnfh83 collected $0.12 from pot
nfnfh83: doesn't show hand 
*** SUMMARY ***
Total pot $0.12 | Rake $0 
Seat 1: sojuice (button) folded before Flop (didn't bet)
Seat 2: HubertusB (small blind) folded before Flop
Seat 3: ztrombitas (big blind) folded before Flop
Seat 4: nfnfh83 collected ($0.12)
Seat 5: Sarmatrus79 folded before Flop (didn't bet)
Seat 6: aodwntm folded before Flop (didn't bet)



PokerStars Zoom Hand #177968154952:  Hold'em No Limit ($0.02/$0.05) - 2017/11/09 2:26:16 CCT [2017/11/08 13:26:16 ET]
Table 'Donati' 6-max Seat #1 is the button
Seat 1: charlesws25 ($20.71 in chips) 
Seat 2: navy463 ($5.37 in chips) 
Seat 3: MedChrize ($13.26 in chips) 
Seat 4: HubertusB ($4.90 in chips) 
Seat 5: LamprosA ($6.30 in chips) 
Seat 6: AAs only ($5.28 in chips) 
navy463: posts small blind $0.02
MedChrize: posts big blind $0.05
*** HOLE CARDS ***
Dealt to HubertusB [Qc Kh]
HubertusB: raises $0.05 to $0.10
LamprosA: calls $0.10
AAs only: folds 
charlesws25: folds 
navy463: calls $0.08
MedChrize: folds 
*** FLOP *** [5s 4d Kd]
navy463: checks 
HubertusB: bets $0.25
LamprosA: folds 
navy463: folds 
Uncalled bet ($0.25) returned to HubertusB
HubertusB collected $0.34 from pot
HubertusB: doesn't show hand 
*** SUMMARY ***
Total pot $0.35 | Rake $0.01 
Board [5s 4d Kd]
Seat 1: charlesws25 (button) folded before Flop (didn't bet)
Seat 2: navy463 (small blind) folded on the Flop
Seat 3: MedChrize (big blind) folded before Flop
Seat 4: HubertusB collected ($0.34)
Seat 5: LamprosA folded on the Flop
Seat 6: AAs only folded before Flop (didn't bet)



PokerStars Zoom Hand #177968147756:  Hold'em No Limit ($0.02/$0.05) - 2017/11/09 2:26:07 CCT [2017/11/08 13:26:07 ET]
Table 'Donati' 6-max Seat #1 is the button
Seat 1: Volke!n kz ($5 in chips) 
Seat 2: kraakie73 ($2.18 in chips) 
Seat 3: HubertusB ($4.95 in chips) 
Seat 4: viktoria13s ($28.72 in chips) 
Seat 5: SpjaldJB ($4.61 in chips) 
Seat 6: hceyms ($6.75 in chips) 
kraakie73: posts small blind $0.02
HubertusB: posts big blind $0.05
*** HOLE CARDS ***
Dealt to HubertusB [8c Kd]
viktoria13s: raises $0.12 to $0.17
SpjaldJB: folds 
hceyms: folds 
Volke!n kz: folds 
kraakie73: raises $0.18 to $0.35
HubertusB: folds 
viktoria13s: calls $0.18
*** FLOP *** [Ah 3h 3d]
kraakie73: bets $0.30
viktoria13s: calls $0.30
*** TURN *** [Ah 3h 3d] [7h]
kraakie73: checks 
viktoria13s: checks 
*** RIVER *** [Ah 3h 3d 7h] [2c]
kraakie73: checks 
viktoria13s: bets $28.07 and is all-in
kraakie73: folds 
Uncalled bet ($28.07) returned to viktoria13s
viktoria13s collected $1.29 from pot
viktoria13s: doesn't show hand 
*** SUMMARY ***
Total pot $1.35 | Rake $0.06 
Board [Ah 3h 3d 7h 2c]
Seat 1: Volke!n kz (button) folded before Flop (didn't bet)
Seat 2: kraakie73 (small blind) folded on the River
Seat 3: HubertusB (big blind) folded before Flop
Seat 4: viktoria13s collected ($1.29)
Seat 5: SpjaldJB folded before Flop (didn't bet)
Seat 6: hceyms folded before Flop (didn't bet)



PokerStars Zoom Hand #177968181223:  Hold'em No Limit ($0.02/$0.05) - 2017/11/09 2:26:49 CCT [2017/11/08 13:26:49 ET]
Table 'Donati' 6-max Seat #1 is the button
Seat 1: Volke!n kz ($11.67 in chips) 
Seat 2: Aleksandrpby ($5.67 in chips) 
Seat 3: wolnyjac ($5 in chips) 
Seat 4: s_academia ($9.39 in chips) 
Seat 5: HubertusB ($5.14 in chips) 
Seat 6: Hobbotun174 ($5.79 in chips) 
Aleksandrpby: posts small blind $0.02
wolnyjac: posts big blind $0.05
*** HOLE CARDS ***
Dealt to HubertusB [Js 7d]
s_academia: folds 
HubertusB: folds 
Hobbotun174: raises $0.10 to $0.15
Volke!n kz: folds 
Aleksandrpby: folds 
wolnyjac: folds 
Uncalled bet ($0.10) returned to Hobbotun174
Hobbotun174 collected $0.12 from pot
Hobbotun174: doesn't show hand 
*** SUMMARY ***
Total pot $0.12 | Rake $0 
Seat 1: Volke!n kz (button) folded before Flop (didn't bet)
Seat 2: Aleksandrpby (small blind) folded before Flop
Seat 3: wolnyjac (big blind) folded before Flop
Seat 4: s_academia folded before Flop (didn't bet)
Seat 5: HubertusB folded before Flop (didn't bet)
Seat 6: Hobbotun174 collected ($0.12)



PokerStars Zoom Hand #177968200274:  Hold'em No Limit ($0.02/$0.05) - 2017/11/09 2:27:13 CCT [2017/11/08 13:27:13 ET]
Table 'Donati' 6-max Seat #1 is the button
Seat 1: Zarec ($8.74 in chips) 
Seat 2: evgenij2125 ($6.24 in chips) 
Seat 3: Barra West ($7.29 in chips) 
Seat 4: singel01 ($6.30 in chips) 
Seat 5: Aleksandrpby ($4.94 in chips) 
Seat 6: HubertusB ($5.14 in chips) 
evgenij2125: posts small blind $0.02
Barra West: posts big blind $0.05
*** HOLE CARDS ***
Dealt to HubertusB [5d Jc]
singel01: folds 
Aleksandrpby: folds 
HubertusB: folds 
Zarec: folds 
evgenij2125: folds 
Uncalled bet ($0.03) returned to Barra West
Barra West collected $0.04 from pot
Barra West: doesn't show hand 
*** SUMMARY ***
Total pot $0.04 | Rake $0 
Seat 1: Zarec (button) folded before Flop (didn't bet)
Seat 2: evgenij2125 (small blind) folded before Flop
Seat 3: Barra West (big blind) collected ($0.04)
Seat 4: singel01 folded before Flop (didn't bet)
Seat 5: Aleksandrpby folded before Flop (didn't bet)
Seat 6: HubertusB folded before Flop (didn't bet)



PokerStars Zoom Hand #177968204912:  Hold'em No Limit ($0.02/$0.05) - 2017/11/09 2:27:19 CCT [2017/11/08 13:27:19 ET]
Table 'Donati' 6-max Seat #1 is the button
Seat 1: EyeEmmaJedi ($15.47 in chips) 
Seat 2: bzm73 ($8.80 in chips) 
Seat 3: HubertusB ($5.14 in chips) 
Seat 4: Andrey171410 ($5 in chips) 
Seat 5: prochy1909 ($20.35 in chips) 
Seat 6: wuphfdotcom ($7.22 in chips) 
bzm73: posts small blind $0.02
HubertusB: posts big blind $0.05
*** HOLE CARDS ***
Dealt to HubertusB [5s 7s]
Andrey171410: folds 
prochy1909: folds 
wuphfdotcom: folds 
EyeEmmaJedi: raises $0.07 to $0.12
bzm73: folds 
HubertusB: calls $0.07
*** FLOP *** [6c Ac 2h]
HubertusB: checks 
EyeEmmaJedi: bets $0.13
HubertusB: raises $0.32 to $0.45
EyeEmmaJedi: folds 
Uncalled bet ($0.32) returned to HubertusB
HubertusB collected $0.50 from pot
HubertusB: doesn't show hand 
*** SUMMARY ***
Total pot $0.52 | Rake $0.02 
Board [6c Ac 2h]
Seat 1: EyeEmmaJedi (button) folded on the Flop
Seat 2: bzm73 (small blind) folded before Flop
Seat 3: HubertusB (big blind) collected ($0.50)
Seat 4: Andrey171410 folded before Flop (didn't bet)
Seat 5: prochy1909 folded before Flop (didn't bet)
Seat 6: wuphfdotcom folded before Flop (didn't bet)



PokerStars Zoom Hand #177968188310:  Hold'em No Limit ($0.02/$0.05) - 2017/11/09 2:26:58 CCT [2017/11/08 13:26:58 ET]
Table 'Donati' 6-max Seat #1 is the button
Seat 1: HubertusB ($5.14 in chips) 
Seat 2: Rassty1983 ($5.47 in chips) 
Seat 3: navy463 ($7.59 in chips) 
Seat 4: Tigran336 ($5.02 in chips) 
Seat 5: ole73789 ($10.02 in chips) 
Seat 6: smartymind ($7.89 in chips) 
Rassty1983: posts small blind $0.02
navy463: posts big blind $0.05
*** HOLE CARDS ***
Dealt to HubertusB [9s Jd]
Tigran336: raises $0.10 to $0.15
ole73789: raises $0.10 to $0.25
smartymind: folds 
HubertusB: folds 
Rassty1983: folds 
navy463: folds 
Tigran336: calls $0.10
*** FLOP *** [4c 3h 5d]
Tigran336: checks 
ole73789: checks 
*** TURN *** [4c 3h 5d] [Kc]
Tigran336: checks 
ole73789: checks 
*** RIVER *** [4c 3h 5d Kc] [7c]
Tigran336: checks 
ole73789: bets $0.20
Tigran336: folds 
Uncalled bet ($0.20) returned to ole73789
ole73789 collected $0.55 from pot
ole73789: doesn't show hand 
*** SUMMARY ***
Total pot $0.57 | Rake $0.02 
Board [4c 3h 5d Kc 7c]
Seat 1: HubertusB (button) folded before Flop (didn't bet)
Seat 2: Rassty1983 (small blind) folded before Flop
Seat 3: navy463 (big blind) folded before Flop
Seat 4: Tigran336 folded on the River
Seat 5: ole73789 collected ($0.55)
Seat 6: smartymind folded before Flop (didn't bet)



PokerStars Zoom Hand #177968232878:  Hold'em No Limit ($0.02/$0.05) - 2017/11/09 2:27:54 CCT [2017/11/08 13:27:54 ET]
Table 'Donati' 6-max Seat #1 is the button
Seat 1: Gaston323 ($5.27 in chips) 
Seat 2: Kondr-KAV ($4.98 in chips) 
Seat 3: Lago Madjore ($5.16 in chips) 
Seat 4: KOBRA7777 ($4.98 in chips) 
Seat 5: HubertusB ($5.37 in chips) 
Seat 6: 216NL ($13.35 in chips) 
Kondr-KAV: posts small blind $0.02
Lago Madjore: posts big blind $0.05
*** HOLE CARDS ***
Dealt to HubertusB [7c 2h]
KOBRA7777: folds 
HubertusB: folds 
216NL: folds 
Gaston323: folds 
Kondr-KAV: raises $0.10 to $0.15
Lago Madjore: folds 
Uncalled bet ($0.10) returned to Kondr-KAV
Kondr-KAV collected $0.10 from pot
Kondr-KAV: doesn't show hand 
*** SUMMARY ***
Total pot $0.10 | Rake $0 
Seat 1: Gaston323 (button) folded before Flop (didn't bet)
Seat 2: Kondr-KAV (small blind) collected ($0.10)
Seat 3: Lago Madjore (big blind) folded before Flop
Seat 4: KOBRA7777 folded before Flop (didn't bet)
Seat 5: HubertusB folded before Flop (didn't bet)
Seat 6: 216NL folded before Flop (didn't bet)



PokerStars Zoom Hand #177968225703:  Hold'em No Limit ($0.02/$0.05) - 2017/11/09 2:27:45 CCT [2017/11/08 13:27:45 ET]
Table 'Donati' 6-max Seat #1 is the button
Seat 1: XHerrTUMNUSX ($13.55 in chips) 
Seat 2: HubertusB ($5.39 in chips) 
Seat 3: kotopes24 ($20.06 in chips) 
Seat 4: AAs only ($5.18 in chips) 
Seat 5: Whizar ($4.47 in chips) 
Seat 6: ATTAKON ($8.57 in chips) 
HubertusB: posts small blind $0.02
kotopes24: posts big blind $0.05
*** HOLE CARDS ***
Dealt to HubertusB [7s 4d]
AAs only: folds 
Whizar: calls $0.05
ATTAKON: folds 
XHerrTUMNUSX: folds 
HubertusB: folds 
kotopes24: checks 
*** FLOP *** [3s Qc As]
kotopes24: bets $0.09
Whizar: calls $0.09
*** TURN *** [3s Qc As] [9s]
kotopes24: bets $0.26
Whizar: calls $0.26
*** RIVER *** [3s Qc As 9s] [4c]
kotopes24: checks 
Whizar: bets $0.20
kotopes24: folds 
Uncalled bet ($0.20) returned to Whizar
Whizar collected $0.79 from pot
Whizar: doesn't show hand 
*** SUMMARY ***
Total pot $0.82 | Rake $0.03 
Board [3s Qc As 9s 4c]
Seat 1: XHerrTUMNUSX (button) folded before Flop (didn't bet)
Seat 2: HubertusB (small blind) folded before Flop
Seat 3: kotopes24 (big blind) folded on the River
Seat 4: AAs only folded before Flop (didn't bet)
Seat 5: Whizar collected ($0.79)
Seat 6: ATTAKON folded before Flop (didn't bet)



PokerStars Zoom Hand #177968237751:  Hold'em No Limit ($0.02/$0.05) - 2017/11/09 2:28:00 CCT [2017/11/08 13:28:00 ET]
Table 'Donati' 6-max Seat #1 is the button
Seat 1: Dmialber ($5.74 in chips) 
Seat 2: SevastyanovM ($15.64 in chips) 
Seat 3: O0r4nga ($12.29 in chips) 
Seat 4: Shinoda89 ($13.18 in chips) 
Seat 5: HubertusB ($5.37 in chips) 
Seat 6: firebolt1984 ($7.26 in chips) 
SevastyanovM: posts small blind $0.02
O0r4nga: posts big blind $0.05
*** HOLE CARDS ***
Dealt to HubertusB [Js 5s]
Shinoda89: raises $0.10 to $0.15
HubertusB: raises $0.30 to $0.45
firebolt1984: folds 
Dmialber: folds 
SevastyanovM: calls $0.43
O0r4nga: folds 
Shinoda89: calls $0.30
*** FLOP *** [4h As 2c]
SevastyanovM: checks 
Shinoda89: checks 
HubertusB: bets $0.75
SevastyanovM: folds 
Shinoda89: folds 
Uncalled bet ($0.75) returned to HubertusB
HubertusB collected $1.34 from pot
HubertusB: doesn't show hand 
*** SUMMARY ***
Total pot $1.40 | Rake $0.06 
Board [4h As 2c]
Seat 1: Dmialber (button) folded before Flop (didn't bet)
Seat 2: SevastyanovM (small blind) folded on the Flop
Seat 3: O0r4nga (big blind) folded before Flop
Seat 4: Shinoda89 folded on the Flop
Seat 5: HubertusB collected ($1.34)
Seat 6: firebolt1984 folded before Flop (didn't bet)



PokerStars Zoom Hand #177968295363:  Hold'em No Limit ($0.02/$0.05) - 2017/11/09 2:29:12 CCT [2017/11/08 13:29:12 ET]
Table 'Donati' 6-max Seat #1 is the button
Seat 1: HubertusB ($6.26 in chips) 
Seat 2: Gaston323 ($5.97 in chips) 
Seat 3: Besfairdgemp ($6.88 in chips) 
Seat 4: A.Kavetskyi ($10.91 in chips) 
Seat 5: nonsensever ($8.35 in chips) 
Seat 6: moneybek ($6.59 in chips) 
Gaston323: posts small blind $0.02
Besfairdgemp: posts big blind $0.05
*** HOLE CARDS ***
Dealt to HubertusB [Qh Td]
A.Kavetskyi: folds 
nonsensever: folds 
moneybek: folds 
HubertusB: raises $0.05 to $0.10
Gaston323: folds 
Besfairdgemp: folds 
Uncalled bet ($0.05) returned to HubertusB
HubertusB collected $0.12 from pot
HubertusB: doesn't show hand 
*** SUMMARY ***
Total pot $0.12 | Rake $0 
Seat 1: HubertusB (button) collected ($0.12)
Seat 2: Gaston323 (small blind) folded before Flop
Seat 3: Besfairdgemp (big blind) folded before Flop
Seat 4: A.Kavetskyi folded before Flop (didn't bet)
Seat 5: nonsensever folded before Flop (didn't bet)
Seat 6: moneybek folded before Flop (didn't bet)



PokerStars Zoom Hand #177968303319:  Hold'em No Limit ($0.02/$0.05) - 2017/11/09 2:29:22 CCT [2017/11/08 13:29:22 ET]
Table 'Donati' 6-max Seat #1 is the button
Seat 1: asusone3 ($5.77 in chips) 
Seat 2: HubertusB ($6.33 in chips) 
Seat 3: Fearless_men ($5.04 in chips) 
Seat 4: falcao991 ($4.98 in chips) 
Seat 5: swesda21 ($30.08 in chips) 
Seat 6: taboliklol ($6.12 in chips) 
HubertusB: posts small blind $0.02
Fearless_men: posts big blind $0.05
*** HOLE CARDS ***
Dealt to HubertusB [3s 2s]
falcao991: folds 
swesda21: folds 
taboliklol: folds 
asusone3: raises $0.10 to $0.15
HubertusB: folds 
Fearless_men: folds 
Uncalled bet ($0.10) returned to asusone3
asusone3 collected $0.12 from pot
asusone3: doesn't show hand 
*** SUMMARY ***
Total pot $0.12 | Rake $0 
Seat 1: asusone3 (button) collected ($0.12)
Seat 2: HubertusB (small blind) folded before Flop
Seat 3: Fearless_men (big blind) folded before Flop
Seat 4: falcao991 folded before Flop (didn't bet)
Seat 5: swesda21 folded before Flop (didn't bet)
Seat 6: taboliklol folded before Flop (didn't bet)



PokerStars Zoom Hand #177968307199:  Hold'em No Limit ($0.02/$0.05) - 2017/11/09 2:29:27 CCT [2017/11/08 13:29:27 ET]
Table 'Donati' 6-max Seat #1 is the button
Seat 1: Einherjer91 ($5.17 in chips) 
Seat 2: The_Craic114 ($4.75 in chips) 
Seat 3: HubertusB ($6.31 in chips) 
Seat 4: XHerrTUMNUSX ($12.62 in chips) 
Seat 5: SCAMMER12345 ($5 in chips) 
Seat 6: t_k_b__lol__ ($2.14 in chips) 
The_Craic114: posts small blind $0.02
HubertusB: posts big blind $0.05
*** HOLE CARDS ***
Dealt to HubertusB [Jd Kh]
XHerrTUMNUSX: folds 
SCAMMER12345: raises $0.10 to $0.15
t_k_b__lol__: folds 
Einherjer91: folds 
The_Craic114: folds 
HubertusB: folds 
Uncalled bet ($0.10) returned to SCAMMER12345
SCAMMER12345 collected $0.12 from pot
SCAMMER12345: doesn't show hand 
*** SUMMARY ***
Total pot $0.12 | Rake $0 
Seat 1: Einherjer91 (button) folded before Flop (didn't bet)
Seat 2: The_Craic114 (small blind) folded before Flop
Seat 3: HubertusB (big blind) folded before Flop
Seat 4: XHerrTUMNUSX folded before Flop (didn't bet)
Seat 5: SCAMMER12345 collected ($0.12)
Seat 6: t_k_b__lol__ folded before Flop (didn't bet)



PokerStars Zoom Hand #177968290491:  Hold'em No Limit ($0.02/$0.05) - 2017/11/09 2:29:06 CCT [2017/11/08 13:29:06 ET]
Table 'Donati' 6-max Seat #1 is the button
Seat 1: House 221b ($17.84 in chips) 
Seat 2: alexm883 ($8.28 in chips) 
Seat 3: Love7822 ($2.44 in chips) 
Seat 4: HubertusB ($6.26 in chips) 
Seat 5: lR0G3Rl ($6.94 in chips) 
Seat 6: Charlie44333 ($5.12 in chips) 
alexm883: posts small blind $0.02
Love7822: posts big blind $0.05
*** HOLE CARDS ***
Dealt to HubertusB [5h 4c]
HubertusB: folds 
lR0G3Rl: raises $0.10 to $0.15
Charlie44333: folds 
House 221b: folds 
alexm883: raises $0.25 to $0.40
Love7822: folds 
lR0G3Rl: calls $0.25
*** FLOP *** [Js 2d 4s]
alexm883: bets $0.41
lR0G3Rl: folds 
Uncalled bet ($0.41) returned to alexm883
alexm883 collected $0.81 from pot
alexm883: doesn't show hand 
*** SUMMARY ***
Total pot $0.85 | Rake $0.04 
Board [Js 2d 4s]
Seat 1: House 221b (button) folded before Flop (didn't bet)
Seat 2: alexm883 (small blind) collected ($0.81)
Seat 3: Love7822 (big blind) folded before Flop
Seat 4: HubertusB folded before Flop (didn't bet)
Seat 5: lR0G3Rl folded on the Flop
Seat 6: Charlie44333 folded before Flop (didn't bet)



PokerStars Zoom Hand #177968314336:  Hold'em No Limit ($0.02/$0.05) - 2017/11/09 2:29:36 CCT [2017/11/08 13:29:36 ET]
Table 'Donati' 6-max Seat #1 is the button
Seat 1: AAs only ($6.83 in chips) 
Seat 2: Valerik18 ($6.45 in chips) 
Seat 3: LUIZ_NANINI1 ($13.01 in chips) 
Seat 4: sokolik81 ($9.26 in chips) 
Seat 5: zxmgp99 ($4.64 in chips) 
Seat 6: HubertusB ($6.26 in chips) 
Valerik18: posts small blind $0.02
LUIZ_NANINI1: posts big blind $0.05
*** HOLE CARDS ***
Dealt to HubertusB [5s Ad]
sokolik81: folds 
zxmgp99: folds 
HubertusB: raises $0.05 to $0.10
AAs only: raises $0.27 to $0.37
Valerik18: folds 
LUIZ_NANINI1: folds 
HubertusB: folds 
Uncalled bet ($0.27) returned to AAs only
AAs only collected $0.27 from pot
AAs only: doesn't show hand 
*** SUMMARY ***
Total pot $0.27 | Rake $0 
Seat 1: AAs only (button) collected ($0.27)
Seat 2: Valerik18 (small blind) folded before Flop
Seat 3: LUIZ_NANINI1 (big blind) folded before Flop
Seat 4: sokolik81 folded before Flop (didn't bet)
Seat 5: zxmgp99 folded before Flop (didn't bet)
Seat 6: HubertusB folded before Flop



PokerStars Zoom Hand #177968325536:  Hold'em No Limit ($0.02/$0.05) - 2017/11/09 2:29:50 CCT [2017/11/08 13:29:50 ET]
Table 'Donati' 6-max Seat #1 is the button
Seat 1: Vindictive69 ($11.75 in chips) 
Seat 2: ooiaooao ($14.37 in chips) 
Seat 3: devianin96 ($5.32 in chips) 
Seat 4: HubertusB ($6.16 in chips) 
Seat 5: LamprosA ($7.28 in chips) 
Seat 6: ztrombitas ($5.41 in chips) 
ooiaooao: posts small blind $0.02
devianin96: posts big blind $0.05
*** HOLE CARDS ***
Dealt to HubertusB [4c 3c]
HubertusB: raises $0.05 to $0.10
LamprosA: folds 
ztrombitas: folds 
Vindictive69: folds 
ooiaooao: folds 
devianin96: folds 
Uncalled bet ($0.05) returned to HubertusB
HubertusB collected $0.12 from pot
HubertusB: doesn't show hand 
*** SUMMARY ***
Total pot $0.12 | Rake $0 
Seat 1: Vindictive69 (button) folded before Flop (didn't bet)
Seat 2: ooiaooao (small blind) folded before Flop
Seat 3: devianin96 (big blind) folded before Flop
Seat 4: HubertusB collected ($0.12)
Seat 5: LamprosA folded before Flop (didn't bet)
Seat 6: ztrombitas folded before Flop (didn't bet)



PokerStars Zoom Hand #177968334303:  Hold'em No Limit ($0.02/$0.05) - 2017/11/09 2:30:01 CCT [2017/11/08 13:30:01 ET]
Table 'Donati' 6-max Seat #1 is the button
Seat 1: HubertusB ($6.23 in chips) 
Seat 2: Moskvich951 ($12.46 in chips) 
Seat 3: SpjaldJB ($7.99 in chips) 
Seat 4: DoubleCoffe ($14.64 in chips) 
Seat 5: tursows ($5.33 in chips) 
Seat 6: barrgand ($4.31 in chips) 
Moskvich951: posts small blind $0.02
SpjaldJB: posts big blind $0.05
*** HOLE CARDS ***
Dealt to HubertusB [Js Ts]
DoubleCoffe: folds 
tursows: folds 
barrgand: folds 
HubertusB: raises $0.05 to $0.10
Moskvich951: calls $0.08
SpjaldJB: folds 
*** FLOP *** [2d 8c Qc]
Moskvich951: checks 
HubertusB: bets $0.15
Moskvich951: calls $0.15
*** TURN *** [2d 8c Qc] [Jh]
Moskvich951: checks 
HubertusB: checks 
*** RIVER *** [2d 8c Qc Jh] [9c]
Moskvich951: bets $0.35
HubertusB: calls $0.35
*** SHOW DOWN ***
Moskvich951: shows [Jc Tc] (a straight flush, Eight to Queen)
HubertusB: mucks hand 
Moskvich951 collected $1.20 from pot
*** SUMMARY ***
Total pot $1.25 | Rake $0.05 
Board [2d 8c Qc Jh 9c]
Seat 1: HubertusB (button) mucked [Js Ts]
Seat 2: Moskvich951 (small blind) showed [Jc Tc] and won ($1.20) with a straight flush, Eight to Queen
Seat 3: SpjaldJB (big blind) folded before Flop
Seat 4: DoubleCoffe folded before Flop (didn't bet)
Seat 5: tursows folded before Flop (didn't bet)
Seat 6: barrgand folded before Flop (didn't bet)



PokerStars Zoom Hand #177968377302:  Hold'em No Limit ($0.02/$0.05) - 2017/11/09 2:30:55 CCT [2017/11/08 13:30:55 ET]
Table 'Donati' 6-max Seat #1 is the button
Seat 1: devianin96 ($5.55 in chips) 
Seat 2: viktoria13s ($29.64 in chips) 
Seat 3: Barbos383 ($2.50 in chips) 
Seat 4: The_Craic114 ($2.77 in chips) 
Seat 5: taboliklol ($6.10 in chips) 
Seat 6: HubertusB ($5.63 in chips) 
viktoria13s: posts small blind $0.02
Barbos383: posts big blind $0.05
*** HOLE CARDS ***
Dealt to HubertusB [3s Tc]
The_Craic114: raises $0.07 to $0.12
taboliklol: folds 
HubertusB: folds 
devianin96: folds 
viktoria13s: folds 
Barbos383: folds 
Uncalled bet ($0.07) returned to The_Craic114
The_Craic114 collected $0.12 from pot
The_Craic114: doesn't show hand 
*** SUMMARY ***
Total pot $0.12 | Rake $0 
Seat 1: devianin96 (button) folded before Flop (didn't bet)
Seat 2: viktoria13s (small blind) folded before Flop
Seat 3: Barbos383 (big blind) folded before Flop
Seat 4: The_Craic114 collected ($0.12)
Seat 5: taboliklol folded before Flop (didn't bet)
Seat 6: HubertusB folded before Flop (didn't bet)



PokerStars Zoom Hand #177968382899:  Hold'em No Limit ($0.02/$0.05) - 2017/11/09 2:31:02 CCT [2017/11/08 13:31:02 ET]
Table 'Donati' 6-max Seat #1 is the button
Seat 1: dumpassos ($8.19 in chips) 
Seat 2: Miktor1 ($7.82 in chips) 
Seat 3: wuphfdotcom ($3.89 in chips) 
Seat 4: simple s0o ($5 in chips) 
Seat 5: HubertusB ($5.63 in chips) 
Seat 6: holandietis3 ($3.86 in chips) 
Miktor1: posts small blind $0.02
wuphfdotcom: posts big blind $0.05
*** HOLE CARDS ***
Dealt to HubertusB [9c 7c]
simple s0o: folds 
HubertusB: raises $0.05 to $0.10
holandietis3: folds 
dumpassos: folds 
Miktor1: raises $0.35 to $0.45
wuphfdotcom: folds 
HubertusB: folds 
Uncalled bet ($0.35) returned to Miktor1
Miktor1 collected $0.25 from pot
Miktor1: doesn't show hand 
*** SUMMARY ***
Total pot $0.25 | Rake $0 
Seat 1: dumpassos (button) folded before Flop (didn't bet)
Seat 2: Miktor1 (small blind) collected ($0.25)
Seat 3: wuphfdotcom (big blind) folded before Flop
Seat 4: simple s0o folded before Flop (didn't bet)
Seat 5: HubertusB folded before Flop
Seat 6: holandietis3 folded before Flop (didn't bet)



PokerStars Zoom Hand #177968394280:  Hold'em No Limit ($0.02/$0.05) - 2017/11/09 2:31:16 CCT [2017/11/08 13:31:16 ET]
Table 'Donati' 6-max Seat #1 is the button
Seat 1: Aleks3215275 ($5.33 in chips) 
Seat 2: firebolt1984 ($5 in chips) 
Seat 3: HubertusB ($5.53 in chips) 
Seat 4: ztrombitas ($5 in chips) 
Seat 5: lukasamace ($1.96 in chips) 
Seat 6: babaluba33 ($3.84 in chips) 
firebolt1984: posts small blind $0.02
HubertusB: posts big blind $0.05
*** HOLE CARDS ***
Dealt to HubertusB [9h Jd]
ztrombitas: folds 
lukasamace: raises $0.10 to $0.15
babaluba33: folds 
Aleks3215275: folds 
firebolt1984: folds 
HubertusB: folds 
Uncalled bet ($0.10) returned to lukasamace
lukasamace collected $0.12 from pot
lukasamace: doesn't show hand 
*** SUMMARY ***
Total pot $0.12 | Rake $0 
Seat 1: Aleks3215275 (button) folded before Flop (didn't bet)
Seat 2: firebolt1984 (small blind) folded before Flop
Seat 3: HubertusB (big blind) folded before Flop
Seat 4: ztrombitas folded before Flop (didn't bet)
Seat 5: lukasamace collected ($0.12)
Seat 6: babaluba33 folded before Flop (didn't bet)



PokerStars Zoom Hand #177968410943:  Hold'em No Limit ($0.02/$0.05) - 2017/11/09 2:31:37 CCT [2017/11/08 13:31:37 ET]
Table 'Donati' 6-max Seat #1 is the button
Seat 1: HubertusB ($5.46 in chips) 
Seat 2: bigolsen428 ($2.30 in chips) 
Seat 3: KZabolotskii ($6.34 in chips) 
Seat 4: selivan ($5.58 in chips) 
Seat 5: falcao991 ($5.38 in chips) 
Seat 6: MC Durak ($3.07 in chips) 
bigolsen428: posts small blind $0.02
KZabolotskii: posts big blind $0.05
*** HOLE CARDS ***
Dealt to HubertusB [8d 6s]
selivan: folds 
falcao991: folds 
MC Durak: folds 
HubertusB: raises $0.05 to $0.10
bigolsen428: folds 
KZabolotskii: calls $0.05
*** FLOP *** [Kh Js 5s]
KZabolotskii: bets $0.11
HubertusB: folds 
Uncalled bet ($0.11) returned to KZabolotskii
KZabolotskii collected $0.21 from pot
KZabolotskii: doesn't show hand 
*** SUMMARY ***
Total pot $0.22 | Rake $0.01 
Board [Kh Js 5s]
Seat 1: HubertusB (button) folded on the Flop
Seat 2: bigolsen428 (small blind) folded before Flop
Seat 3: KZabolotskii (big blind) collected ($0.21)
Seat 4: selivan folded before Flop (didn't bet)
Seat 5: falcao991 folded before Flop (didn't bet)
Seat 6: MC Durak folded before Flop (didn't bet)



PokerStars Zoom Hand #177968405441:  Hold'em No Limit ($0.02/$0.05) - 2017/11/09 2:31:30 CCT [2017/11/08 13:31:30 ET]
Table 'Donati' 6-max Seat #1 is the button
Seat 1: Ruslan1111s ($11.95 in chips) 
Seat 2: HubertusB ($5.48 in chips) 
Seat 3: iampokerdaft ($5.26 in chips) 
Seat 4: Pokurov ($2.50 in chips) 
Seat 5: Aleksandrpby ($4.02 in chips) 
Seat 6: 216NL ($12.96 in chips) 
HubertusB: posts small blind $0.02
iampokerdaft: posts big blind $0.05
*** HOLE CARDS ***
Dealt to HubertusB [4d Jc]
Pokurov: folds 
Aleksandrpby: folds 
216NL: folds 
Ruslan1111s: calls $0.05
HubertusB: folds 
iampokerdaft: checks 
*** FLOP *** [Ah Ts 9h]
iampokerdaft: checks 
Ruslan1111s: bets $0.05
iampokerdaft: folds 
Uncalled bet ($0.05) returned to Ruslan1111s
Ruslan1111s collected $0.12 from pot
Ruslan1111s: doesn't show hand 
*** SUMMARY ***
Total pot $0.12 | Rake $0 
Board [Ah Ts 9h]
Seat 1: Ruslan1111s (button) collected ($0.12)
Seat 2: HubertusB (small blind) folded before Flop
Seat 3: iampokerdaft (big blind) folded on the Flop
Seat 4: Pokurov folded before Flop (didn't bet)
Seat 5: Aleksandrpby folded before Flop (didn't bet)
Seat 6: 216NL folded before Flop (didn't bet)



PokerStars Zoom Hand #177968423099:  Hold'em No Limit ($0.02/$0.05) - 2017/11/09 2:31:52 CCT [2017/11/08 13:31:52 ET]
Table 'Donati' 6-max Seat #1 is the button
Seat 1: swesda21 ($6.55 in chips) 
Seat 2: SCAMMER12345 ($5 in chips) 
Seat 3: Andrey171410 ($5.04 in chips) 
Seat 4: balabir ($14.65 in chips) 
Seat 5: Yahan588 ($5.62 in chips) 
Seat 6: HubertusB ($5.36 in chips) 
SCAMMER12345: posts small blind $0.02
Andrey171410: posts big blind $0.05
*** HOLE CARDS ***
Dealt to HubertusB [6d 6c]
balabir: folds 
Yahan588: folds 
HubertusB: raises $0.05 to $0.10
swesda21: raises $0.25 to $0.35
SCAMMER12345: folds 
Andrey171410: folds 
HubertusB: folds 
Uncalled bet ($0.25) returned to swesda21
swesda21 collected $0.27 from pot
swesda21: doesn't show hand 
*** SUMMARY ***
Total pot $0.27 | Rake $0 
Seat 1: swesda21 (button) collected ($0.27)
Seat 2: SCAMMER12345 (small blind) folded before Flop
Seat 3: Andrey171410 (big blind) folded before Flop
Seat 4: balabir folded before Flop (didn't bet)
Seat 5: Yahan588 folded before Flop (didn't bet)
Seat 6: HubertusB folded before Flop



PokerStars Zoom Hand #177968436699:  Hold'em No Limit ($0.02/$0.05) - 2017/11/09 2:32:09 CCT [2017/11/08 13:32:09 ET]
Table 'Donati' 6-max Seat #1 is the button
Seat 1: sojuice ($7.56 in chips) 
Seat 2: N0$tradamu$ ($2.69 in chips) 
Seat 3: prochy1909 ($21.24 in chips) 
Seat 4: HubertusB ($5.26 in chips) 
Seat 5: O0r4nga ($12.26 in chips) 
Seat 6: HH-hour ($6.03 in chips) 
N0$tradamu$: posts small blind $0.02
prochy1909: posts big blind $0.05
*** HOLE CARDS ***
Dealt to HubertusB [Qs Th]
HubertusB: folds 
O0r4nga: folds 
HH-hour: raises $0.10 to $0.15
sojuice: folds 
N0$tradamu$: folds 
prochy1909: folds 
Uncalled bet ($0.10) returned to HH-hour
HH-hour collected $0.12 from pot
HH-hour: doesn't show hand 
*** SUMMARY ***
Total pot $0.12 | Rake $0 
Seat 1: sojuice (button) folded before Flop (didn't bet)
Seat 2: N0$tradamu$ (small blind) folded before Flop
Seat 3: prochy1909 (big blind) folded before Flop
Seat 4: HubertusB folded before Flop (didn't bet)
Seat 5: O0r4nga folded before Flop (didn't bet)
Seat 6: HH-hour collected ($0.12)



PokerStars Zoom Hand #177968441384:  Hold'em No Limit ($0.02/$0.05) - 2017/11/09 2:32:15 CCT [2017/11/08 13:32:15 ET]
Table 'Donati' 6-max Seat #1 is the button
Seat 1: sebano2 ($5 in chips) 
Seat 2: HubertusB ($5.26 in chips) 
Seat 3: Zarec ($7.28 in chips) 
Seat 4: ZMLucker ($11.79 in chips) 
Seat 5: domitorii ($5.62 in chips) 
Seat 6: and_67rus ($5.18 in chips) 
HubertusB: posts small blind $0.02
Zarec: posts big blind $0.05
*** HOLE CARDS ***
Dealt to HubertusB [Tc 2h]
ZMLucker: raises $0.10 to $0.15
domitorii: folds 
and_67rus: folds 
sebano2: folds 
HubertusB: folds 
Zarec: folds 
Uncalled bet ($0.10) returned to ZMLucker
ZMLucker collected $0.12 from pot
ZMLucker: doesn't show hand 
*** SUMMARY ***
Total pot $0.12 | Rake $0 
Seat 1: sebano2 (button) folded before Flop (didn't bet)
Seat 2: HubertusB (small blind) folded before Flop
Seat 3: Zarec (big blind) folded before Flop
Seat 4: ZMLucker collected ($0.12)
Seat 5: domitorii folded before Flop (didn't bet)
Seat 6: and_67rus folded before Flop (didn't bet)



PokerStars Zoom Hand #177968454852:  Hold'em No Limit ($0.02/$0.05) - 2017/11/09 2:32:32 CCT [2017/11/08 13:32:32 ET]
Table 'Donati' 6-max Seat #1 is the button
Seat 1: HubertusB ($5.19 in chips) 
Seat 2: Hobbotun174 ($5.02 in chips) 
Seat 3: gosen333 ($2.74 in chips) 
Seat 4: pIay2kiLL ($5 in chips) 
Seat 5: Pro100PaPaN ($9.09 in chips) 
Seat 6: haozhang ($2.77 in chips) 
Hobbotun174: posts small blind $0.02
gosen333: posts big blind $0.05
*** HOLE CARDS ***
Dealt to HubertusB [6d 6h]
pIay2kiLL: folds 
Pro100PaPaN: folds 
haozhang: folds 
HubertusB: raises $0.05 to $0.10
Hobbotun174: folds 
gosen333: folds 
Uncalled bet ($0.05) returned to HubertusB
HubertusB collected $0.12 from pot
HubertusB: doesn't show hand 
*** SUMMARY ***
Total pot $0.12 | Rake $0 
Seat 1: HubertusB (button) collected ($0.12)
Seat 2: Hobbotun174 (small blind) folded before Flop
Seat 3: gosen333 (big blind) folded before Flop
Seat 4: pIay2kiLL folded before Flop (didn't bet)
Seat 5: Pro100PaPaN folded before Flop (didn't bet)
Seat 6: haozhang folded before Flop (didn't bet)



PokerStars Zoom Hand #177968445340:  Hold'em No Limit ($0.02/$0.05) - 2017/11/09 2:32:20 CCT [2017/11/08 13:32:20 ET]
Table 'Donati' 6-max Seat #1 is the button
Seat 1: viktoria13s ($30.04 in chips) 
Seat 2: Supamaggie ($6.89 in chips) 
Seat 3: HubertusB ($5.24 in chips) 
Seat 4: MedChrize ($8.82 in chips) 
Seat 5: UruGabo ($30.23 in chips) 
Seat 6: MaximAstra ($6.27 in chips) 
Supamaggie: posts small blind $0.02
HubertusB: posts big blind $0.05
*** HOLE CARDS ***
Dealt to HubertusB [Kd 6c]
MedChrize: folds 
UruGabo: raises $0.10 to $0.15
MaximAstra: folds 
viktoria13s: calls $0.15
Supamaggie: folds 
HubertusB: folds 
*** FLOP *** [Ks Qd Ad]
UruGabo: checks 
viktoria13s: checks 
*** TURN *** [Ks Qd Ad] [Ah]
UruGabo: bets $0.23
viktoria13s: calls $0.23
*** RIVER *** [Ks Qd Ad Ah] [3d]
UruGabo: checks 
viktoria13s: bets $0.80
UruGabo: calls $0.80
*** SHOW DOWN ***
viktoria13s: shows [Jd 8d] (a flush, Ace high)
UruGabo: mucks hand 
viktoria13s collected $2.33 from pot
*** SUMMARY ***
Total pot $2.43 | Rake $0.10 
Board [Ks Qd Ad Ah 3d]
Seat 1: viktoria13s (button) showed [Jd 8d] and won ($2.33) with a flush, Ace high
Seat 2: Supamaggie (small blind) folded before Flop
Seat 3: HubertusB (big blind) folded before Flop
Seat 4: MedChrize folded before Flop (didn't bet)
Seat 5: UruGabo mucked [Ts Qc]
Seat 6: MaximAstra folded before Flop (didn't bet)



PokerStars Zoom Hand #177968470717:  Hold'em No Limit ($0.02/$0.05) - 2017/11/09 2:32:52 CCT [2017/11/08 13:32:52 ET]
Table 'Donati' 6-max Seat #1 is the button
Seat 1: chillboy666 ($7.52 in chips) 
Seat 2: 7OstapBender ($7.77 in chips) 
Seat 3: Volke!n kz ($5 in chips) 
Seat 4: hceyms ($5.71 in chips) 
Seat 5: Yahan588 ($5 in chips) 
Seat 6: HubertusB ($5.26 in chips) 
7OstapBender: posts small blind $0.02
Volke!n kz: posts big blind $0.05
*** HOLE CARDS ***
Dealt to HubertusB [4s Kc]
hceyms: folds 
Yahan588: folds 
HubertusB: raises $0.05 to $0.10
chillboy666: folds 
7OstapBender: folds 
Volke!n kz: folds 
Uncalled bet ($0.05) returned to HubertusB
HubertusB collected $0.12 from pot
HubertusB: doesn't show hand 
*** SUMMARY ***
Total pot $0.12 | Rake $0 
Seat 1: chillboy666 (button) folded before Flop (didn't bet)
Seat 2: 7OstapBender (small blind) folded before Flop
Seat 3: Volke!n kz (big blind) folded before Flop
Seat 4: hceyms folded before Flop (didn't bet)
Seat 5: Yahan588 folded before Flop (didn't bet)
Seat 6: HubertusB collected ($0.12)



PokerStars Zoom Hand #177968481187:  Hold'em No Limit ($0.02/$0.05) - 2017/11/09 2:33:05 CCT [2017/11/08 13:33:05 ET]
Table 'Donati' 6-max Seat #1 is the button
Seat 1: Tigran336 ($4.52 in chips) 
Seat 2: Nomoney099 ($5.61 in chips) 
Seat 3: NeRoboV47 ($4.94 in chips) 
Seat 4: T0M5T3R ($5.45 in chips) 
Seat 5: HubertusB ($5.33 in chips) 
Seat 6: Lago Madjore ($5.37 in chips) 
Nomoney099: posts small blind $0.02
NeRoboV47: posts big blind $0.05
*** HOLE CARDS ***
Dealt to HubertusB [4h Kd]
T0M5T3R: folds 
HubertusB: folds 
Lago Madjore: folds 
Tigran336: folds 
Nomoney099: raises $0.10 to $0.15
NeRoboV47: folds 
Uncalled bet ($0.10) returned to Nomoney099
Nomoney099 collected $0.10 from pot
Nomoney099: doesn't show hand 
*** SUMMARY ***
Total pot $0.10 | Rake $0 
Seat 1: Tigran336 (button) folded before Flop (didn't bet)
Seat 2: Nomoney099 (small blind) collected ($0.10)
Seat 3: NeRoboV47 (big blind) folded before Flop
Seat 4: T0M5T3R folded before Flop (didn't bet)
Seat 5: HubertusB folded before Flop (didn't bet)
Seat 6: Lago Madjore folded before Flop (didn't bet)



PokerStars Zoom Hand #177968485244:  Hold'em No Limit ($0.02/$0.05) - 2017/11/09 2:33:10 CCT [2017/11/08 13:33:10 ET]
Table 'Donati' 6-max Seat #1 is the button
Seat 1: LeXPSU ($6.46 in chips) 
Seat 2: KpokoguJIJI ($11.59 in chips) 
Seat 3: pokersito84 ($7.62 in chips) 
Seat 4: zmss ($5.43 in chips) 
Seat 5: HubertusB ($5.33 in chips) 
Seat 6: sanux_poker ($14.41 in chips) 
KpokoguJIJI: posts small blind $0.02
pokersito84: posts big blind $0.05
*** HOLE CARDS ***
Dealt to HubertusB [8c 9c]
zmss: folds 
HubertusB: raises $0.05 to $0.10
sanux_poker: folds 
LeXPSU: folds 
KpokoguJIJI: folds 
pokersito84: folds 
Uncalled bet ($0.05) returned to HubertusB
HubertusB collected $0.12 from pot
HubertusB: doesn't show hand 
*** SUMMARY ***
Total pot $0.12 | Rake $0 
Seat 1: LeXPSU (button) folded before Flop (didn't bet)
Seat 2: KpokoguJIJI (small blind) folded before Flop
Seat 3: pokersito84 (big blind) folded before Flop
Seat 4: zmss folded before Flop (didn't bet)
Seat 5: HubertusB collected ($0.12)
Seat 6: sanux_poker folded before Flop (didn't bet)



PokerStars Zoom Hand #177968498020:  Hold'em No Limit ($0.02/$0.05) - 2017/11/09 2:33:26 CCT [2017/11/08 13:33:26 ET]
Table 'Donati' 6-max Seat #1 is the button
Seat 1: Poker in DNA ($2.97 in chips) 
Seat 2: Kreg Heg ($4.19 in chips) 
Seat 3: m.roman23 ($6.87 in chips) 
Seat 4: max_polonez ($2.50 in chips) 
Seat 5: HubertusB ($5.40 in chips) 
Seat 6: Sarmatrus79 ($5.24 in chips) 
Kreg Heg: posts small blind $0.02
m.roman23: posts big blind $0.05
*** HOLE CARDS ***
Dealt to HubertusB [5c 6d]
max_polonez: folds 
HubertusB: folds 
Sarmatrus79: folds 
Poker in DNA: folds 
Kreg Heg: folds 
Uncalled bet ($0.03) returned to m.roman23
m.roman23 collected $0.04 from pot
m.roman23: doesn't show hand 
*** SUMMARY ***
Total pot $0.04 | Rake $0 
Seat 1: Poker in DNA (button) folded before Flop (didn't bet)
Seat 2: Kreg Heg (small blind) folded before Flop
Seat 3: m.roman23 (big blind) collected ($0.04)
Seat 4: max_polonez folded before Flop (didn't bet)
Seat 5: HubertusB folded before Flop (didn't bet)
Seat 6: Sarmatrus79 folded before Flop (didn't bet)



PokerStars Zoom Hand #177968507452:  Hold'em No Limit ($0.02/$0.05) - 2017/11/09 2:33:38 CCT [2017/11/08 13:33:38 ET]
Table 'Donati' 6-max Seat #1 is the button
Seat 1: babaluba33 ($4.09 in chips) 
Seat 2: SpjaldJB ($9.87 in chips) 
Seat 3: HubertusB ($5.38 in chips) 
Seat 4: Ba!aganov ($11.90 in chips) 
Seat 5: serg-hw ($6.05 in chips) 
Seat 6: viktoria13s ($31.40 in chips) 
SpjaldJB: posts small blind $0.02
HubertusB: posts big blind $0.05
*** HOLE CARDS ***
Dealt to HubertusB [4h 6s]
Ba!aganov: raises $0.05 to $0.10
serg-hw: folds 
viktoria13s: folds 
babaluba33: folds 
SpjaldJB: folds 
HubertusB: folds 
Uncalled bet ($0.05) returned to Ba!aganov
Ba!aganov collected $0.12 from pot
Ba!aganov: doesn't show hand 
*** SUMMARY ***
Total pot $0.12 | Rake $0 
Seat 1: babaluba33 (button) folded before Flop (didn't bet)
Seat 2: SpjaldJB (small blind) folded before Flop
Seat 3: HubertusB (big blind) folded before Flop
Seat 4: Ba!aganov collected ($0.12)
Seat 5: serg-hw folded before Flop (didn't bet)
Seat 6: viktoria13s folded before Flop (didn't bet)



PokerStars Zoom Hand #177968513095:  Hold'em No Limit ($0.02/$0.05) - 2017/11/09 2:33:45 CCT [2017/11/08 13:33:45 ET]
Table 'Donati' 6-max Seat #1 is the button
Seat 1: HubertusB ($5.33 in chips) 
Seat 2: House 221b ($18.34 in chips) 
Seat 3: KpokoguJIJI ($6.16 in chips) 
Seat 4: LeXPSU ($6.31 in chips) 
Seat 5: laiha ($16.06 in chips) 
Seat 6: Erynaur ($6.04 in chips) 
House 221b: posts small blind $0.02
KpokoguJIJI: posts big blind $0.05
*** HOLE CARDS ***
Dealt to HubertusB [3s 5h]
LeXPSU: folds 
laiha: folds 
Erynaur: folds 
HubertusB: folds 
House 221b: folds 
Uncalled bet ($0.03) returned to KpokoguJIJI
KpokoguJIJI collected $0.04 from pot
KpokoguJIJI: doesn't show hand 
*** SUMMARY ***
Total pot $0.04 | Rake $0 
Seat 1: HubertusB (button) folded before Flop (didn't bet)
Seat 2: House 221b (small blind) folded before Flop
Seat 3: KpokoguJIJI (big blind) collected ($0.04)
Seat 4: LeXPSU folded before Flop (didn't bet)
Seat 5: laiha folded before Flop (didn't bet)
Seat 6: Erynaur folded before Flop (didn't bet)



PokerStars Zoom Hand #177968502690:  Hold'em No Limit ($0.02/$0.05) - 2017/11/09 2:33:32 CCT [2017/11/08 13:33:32 ET]
Table 'Donati' 6-max Seat #1 is the button
Seat 1: kopatich52 ($8.28 in chips) 
Seat 2: HubertusB ($5.40 in chips) 
Seat 3: MarishaR63 ($5.63 in chips) 
Seat 4: xAndrzej-K ($5.32 in chips) 
Seat 5: bzm73 ($9.21 in chips) 
Seat 6: prata_uk ($5.77 in chips) 
HubertusB: posts small blind $0.02
MarishaR63: posts big blind $0.05
*** HOLE CARDS ***
Dealt to HubertusB [5d 3c]
xAndrzej-K: calls $0.05
bzm73: folds 
prata_uk: folds 
kopatich52: folds 
HubertusB: folds 
MarishaR63: checks 
*** FLOP *** [4c 6c Ah]
MarishaR63: checks 
xAndrzej-K: checks 
*** TURN *** [4c 6c Ah] [Ad]
MarishaR63: checks 
xAndrzej-K: checks 
*** RIVER *** [4c 6c Ah Ad] [8h]
MarishaR63: bets $0.08
xAndrzej-K: folds 
Uncalled bet ($0.08) returned to MarishaR63
MarishaR63 collected $0.12 from pot
MarishaR63: doesn't show hand 
*** SUMMARY ***
Total pot $0.12 | Rake $0 
Board [4c 6c Ah Ad 8h]
Seat 1: kopatich52 (button) folded before Flop (didn't bet)
Seat 2: HubertusB (small blind) folded before Flop
Seat 3: MarishaR63 (big blind) collected ($0.12)
Seat 4: xAndrzej-K folded on the River
Seat 5: bzm73 folded before Flop (didn't bet)
Seat 6: prata_uk folded before Flop (didn't bet)



PokerStars Zoom Hand #177968518754:  Hold'em No Limit ($0.02/$0.05) - 2017/11/09 2:33:52 CCT [2017/11/08 13:33:52 ET]
Table 'Donati' 6-max Seat #1 is the button
Seat 1: Ymnica15 ($5.06 in chips) 
Seat 2: VVTCH ($7.42 in chips) 
Seat 3: Kreg Heg ($4.17 in chips) 
Seat 4: kotopes24 ($9.36 in chips) 
Seat 5: SCAMMER12345 ($5.13 in chips) 
Seat 6: HubertusB ($5.33 in chips) 
VVTCH: posts small blind $0.02
Kreg Heg: posts big blind $0.05
*** HOLE CARDS ***
Dealt to HubertusB [5c 2d]
kotopes24: folds 
SCAMMER12345: folds 
HubertusB: folds 
Ymnica15: folds 
VVTCH: folds 
Uncalled bet ($0.03) returned to Kreg Heg
Kreg Heg collected $0.04 from pot
Kreg Heg: doesn't show hand 
*** SUMMARY ***
Total pot $0.04 | Rake $0 
Seat 1: Ymnica15 (button) folded before Flop (didn't bet)
Seat 2: VVTCH (small blind) folded before Flop
Seat 3: Kreg Heg (big blind) collected ($0.04)
Seat 4: kotopes24 folded before Flop (didn't bet)
Seat 5: SCAMMER12345 folded before Flop (didn't bet)
Seat 6: HubertusB folded before Flop (didn't bet)



PokerStars Zoom Hand #177968526837:  Hold'em No Limit ($0.02/$0.05) - 2017/11/09 2:34:02 CCT [2017/11/08 13:34:02 ET]
Table 'Donati' 6-max Seat #1 is the button
Seat 1: UruGabo ($11.20 in chips) 
Seat 2: zmss ($5 in chips) 
Seat 3: jaynesjs ($5.65 in chips) 
Seat 4: HubertusB ($5.33 in chips) 
Seat 5: VVS2874 ($5.56 in chips) 
Seat 6: Aleksandrpby ($4.94 in chips) 
zmss: posts small blind $0.02
jaynesjs: posts big blind $0.05
*** HOLE CARDS ***
Dealt to HubertusB [9d Ks]
HubertusB: folds 
VVS2874: folds 
Aleksandrpby: raises $0.10 to $0.15
UruGabo: folds 
zmss: folds 
jaynesjs: folds 
Uncalled bet ($0.10) returned to Aleksandrpby
Aleksandrpby collected $0.12 from pot
Aleksandrpby: doesn't show hand 
*** SUMMARY ***
Total pot $0.12 | Rake $0 
Seat 1: UruGabo (button) folded before Flop (didn't bet)
Seat 2: zmss (small blind) folded before Flop
Seat 3: jaynesjs (big blind) folded before Flop
Seat 4: HubertusB folded before Flop (didn't bet)
Seat 5: VVS2874 folded before Flop (didn't bet)
Seat 6: Aleksandrpby collected ($0.12)



PokerStars Zoom Hand #177968533211:  Hold'em No Limit ($0.02/$0.05) - 2017/11/09 2:34:10 CCT [2017/11/08 13:34:10 ET]
Table 'Donati' 6-max Seat #1 is the button
Seat 1: Kreg Heg ($6.07 in chips) 
Seat 2: HubertusB ($5.33 in chips) 
Seat 3: hceyms ($10.19 in chips) 
Seat 4: Elchaza_1989 ($11.38 in chips) 
Seat 5: bzm73 ($11.89 in chips) 
Seat 6: doobik80 ($3.26 in chips) 
HubertusB: posts small blind $0.02
hceyms: posts big blind $0.05
*** HOLE CARDS ***
Dealt to HubertusB [Js Ad]
Elchaza_1989: raises $0.10 to $0.15
bzm73: folds 
doobik80: folds 
Kreg Heg: folds 
HubertusB: folds 
hceyms: folds 
Uncalled bet ($0.10) returned to Elchaza_1989
Elchaza_1989 collected $0.12 from pot
Elchaza_1989: doesn't show hand 
*** SUMMARY ***
Total pot $0.12 | Rake $0 
Seat 1: Kreg Heg (button) folded before Flop (didn't bet)
Seat 2: HubertusB (small blind) folded before Flop
Seat 3: hceyms (big blind) folded before Flop
Seat 4: Elchaza_1989 collected ($0.12)
Seat 5: bzm73 folded before Flop (didn't bet)
Seat 6: doobik80 folded before Flop (didn't bet)



PokerStars Zoom Hand #177968522856:  Hold'em No Limit ($0.02/$0.05) - 2017/11/09 2:33:57 CCT [2017/11/08 13:33:57 ET]
Table 'Donati' 6-max Seat #1 is the button
Seat 1: HH-hour ($6.96 in chips) 
Seat 2: barrgand ($9.87 in chips) 
Seat 3: Fearless_men ($5.11 in chips) 
Seat 4: HubertusB ($5.33 in chips) 
Seat 5: sanux_poker ($6.18 in chips) 
Seat 6: bjorkwow504 ($5.15 in chips) 
barrgand: posts small blind $0.02
Fearless_men: posts big blind $0.05
*** HOLE CARDS ***
Dealt to HubertusB [9s 2s]
HubertusB: folds 
sanux_poker: folds 
bjorkwow504: raises $0.10 to $0.15
HH-hour: folds 
barrgand: calls $0.13
Fearless_men: folds 
*** FLOP *** [Js 7s Kc]
barrgand: checks 
bjorkwow504: bets $0.15
barrgand: folds 
Uncalled bet ($0.15) returned to bjorkwow504
bjorkwow504 collected $0.34 from pot
bjorkwow504: doesn't show hand 
*** SUMMARY ***
Total pot $0.35 | Rake $0.01 
Board [Js 7s Kc]
Seat 1: HH-hour (button) folded before Flop (didn't bet)
Seat 2: barrgand (small blind) folded on the Flop
Seat 3: Fearless_men (big blind) folded before Flop
Seat 4: HubertusB folded before Flop (didn't bet)
Seat 5: sanux_poker folded before Flop (didn't bet)
Seat 6: bjorkwow504 collected ($0.34)



PokerStars Zoom Hand #177968549944:  Hold'em No Limit ($0.02/$0.05) - 2017/11/09 2:34:31 CCT [2017/11/08 13:34:31 ET]
Table 'Donati' 6-max Seat #1 is the button
Seat 1: HubertusB ($5.26 in chips) 
Seat 2: iampokerdaft ($15.81 in chips) 
Seat 3: pokersito84 ($23.74 in chips) 
Seat 4: hellhippo ($9.50 in chips) 
Seat 5: SCAMMER12345 ($5.86 in chips) 
Seat 6: Ignite13 ($10.33 in chips) 
iampokerdaft: posts small blind $0.02
pokersito84: posts big blind $0.05
*** HOLE CARDS ***
Dealt to HubertusB [3s 6d]
hellhippo: folds 
SCAMMER12345: folds 
Ignite13: raises $0.10 to $0.15
HubertusB: folds 
iampokerdaft: raises $0.35 to $0.50
pokersito84: folds 
Ignite13: raises $1.25 to $1.75
iampokerdaft: folds 
Uncalled bet ($1.25) returned to Ignite13
Ignite13 collected $1.05 from pot
Ignite13: doesn't show hand 
*** SUMMARY ***
Total pot $1.05 | Rake $0 
Seat 1: HubertusB (button) folded before Flop (didn't bet)
Seat 2: iampokerdaft (small blind) folded before Flop
Seat 3: pokersito84 (big blind) folded before Flop
Seat 4: hellhippo folded before Flop (didn't bet)
Seat 5: SCAMMER12345 folded before Flop (didn't bet)
Seat 6: Ignite13 collected ($1.05)



PokerStars Zoom Hand #177968541070:  Hold'em No Limit ($0.02/$0.05) - 2017/11/09 2:34:20 CCT [2017/11/08 13:34:20 ET]
Table 'Donati' 6-max Seat #1 is the button
Seat 1: LeXPSU ($7.18 in chips) 
Seat 2: hceyms ($10.14 in chips) 
Seat 3: HubertusB ($5.31 in chips) 
Seat 4: pIay2kiLL ($5 in chips) 
Seat 5: LamprosA ($8.75 in chips) 
Seat 6: 6runogn ($10.36 in chips) 
hceyms: posts small blind $0.02
HubertusB: posts big blind $0.05
*** HOLE CARDS ***
Dealt to HubertusB [8c 3c]
pIay2kiLL: raises $0.07 to $0.12
LamprosA: folds 
6runogn: folds 
LeXPSU: calls $0.12
hceyms: raises $0.38 to $0.50
HubertusB: folds 
pIay2kiLL: calls $0.38
LeXPSU: calls $0.38
*** FLOP *** [Ad 4s 2c]
hceyms: checks 
pIay2kiLL: checks 
LeXPSU: checks 
*** TURN *** [Ad 4s 2c] [Qs]
hceyms: bets $1.12
pIay2kiLL: calls $1.12
LeXPSU: folds 
*** RIVER *** [Ad 4s 2c Qs] [5s]
hceyms: bets $6.25
pIay2kiLL: calls $3.38 and is all-in
Uncalled bet ($2.87) returned to hceyms
*** SHOW DOWN ***
hceyms: shows [Qc Ac] (two pair, Aces and Queens)
pIay2kiLL: shows [4d 4c] (three of a kind, Fours)
pIay2kiLL collected $10.11 from pot
*** SUMMARY ***
Total pot $10.55 | Rake $0.44 
Board [Ad 4s 2c Qs 5s]
Seat 1: LeXPSU (button) folded on the Turn
Seat 2: hceyms (small blind) showed [Qc Ac] and lost with two pair, Aces and Queens
Seat 3: HubertusB (big blind) folded before Flop
Seat 4: pIay2kiLL showed [4d 4c] and won ($10.11) with three of a kind, Fours
Seat 5: LamprosA folded before Flop (didn't bet)
Seat 6: 6runogn folded before Flop (didn't bet)



PokerStars Zoom Hand #177968553999:  Hold'em No Limit ($0.02/$0.05) - 2017/11/09 2:34:36 CCT [2017/11/08 13:34:36 ET]
Table 'Donati' 6-max Seat #1 is the button
Seat 1: falcao991 ($5.16 in chips) 
Seat 2: JN46 ($2.28 in chips) 
Seat 3: simple s0o ($7.92 in chips) 
Seat 4: arlequím ($8.56 in chips) 
Seat 5: FAYA0902 ($4.95 in chips) 
Seat 6: HubertusB ($5.26 in chips) 
JN46: posts small blind $0.02
simple s0o: posts big blind $0.05
*** HOLE CARDS ***
Dealt to HubertusB [As 8c]
arlequím: folds 
FAYA0902: folds 
HubertusB: raises $0.05 to $0.10
falcao991: folds 
JN46: calls $0.08
simple s0o: folds 
*** FLOP *** [Ad 7d Js]
JN46: checks 
HubertusB: checks 
*** TURN *** [Ad 7d Js] [Jd]
JN46: checks 
HubertusB: bets $0.15
JN46: folds 
Uncalled bet ($0.15) returned to HubertusB
HubertusB collected $0.24 from pot
HubertusB: doesn't show hand 
*** SUMMARY ***
Total pot $0.25 | Rake $0.01 
Board [Ad 7d Js Jd]
Seat 1: falcao991 (button) folded before Flop (didn't bet)
Seat 2: JN46 (small blind) folded on the Turn
Seat 3: simple s0o (big blind) folded before Flop
Seat 4: arlequím folded before Flop (didn't bet)
Seat 5: FAYA0902 folded before Flop (didn't bet)
Seat 6: HubertusB collected ($0.24)



PokerStars Zoom Hand #177968584557:  Hold'em No Limit ($0.02/$0.05) - 2017/11/09 2:35:14 CCT [2017/11/08 13:35:14 ET]
Table 'Donati' 6-max Seat #1 is the button
Seat 1: hceyms ($8.43 in chips) 
Seat 2: Barbos383 ($6.14 in chips) 
Seat 3: EikeS ($7.33 in chips) 
Seat 4: Farfan77rus ($2.41 in chips) 
Seat 5: HubertusB ($5.40 in chips) 
Seat 6: rnjsdbsrb ($7.58 in chips) 
Barbos383: posts small blind $0.02
EikeS: posts big blind $0.05
*** HOLE CARDS ***
Dealt to HubertusB [Qd 4h]
Farfan77rus: folds 
HubertusB: folds 
rnjsdbsrb: folds 
hceyms: folds 
Barbos383: folds 
Uncalled bet ($0.03) returned to EikeS
EikeS collected $0.04 from pot
EikeS: doesn't show hand 
*** SUMMARY ***
Total pot $0.04 | Rake $0 
Seat 1: hceyms (button) folded before Flop (didn't bet)
Seat 2: Barbos383 (small blind) folded before Flop
Seat 3: EikeS (big blind) collected ($0.04)
Seat 4: Farfan77rus folded before Flop (didn't bet)
Seat 5: HubertusB folded before Flop (didn't bet)
Seat 6: rnjsdbsrb folded before Flop (didn't bet)



PokerStars Zoom Hand #177968594812:  Hold'em No Limit ($0.02/$0.05) - 2017/11/09 2:35:27 CCT [2017/11/08 13:35:27 ET]
Table 'Donati' 6-max Seat #1 is the button
Seat 1: Clamfish0 ($5.18 in chips) 
Seat 2: HubertusB ($5.40 in chips) 
Seat 3: GaaMaster95 ($5.07 in chips) 
Seat 4: 1nTeresT ($2.58 in chips) 
Seat 5: bery91 ($2.96 in chips) 
Seat 6: Rassty1983 ($5.40 in chips) 
HubertusB: posts small blind $0.02
GaaMaster95: posts big blind $0.05
*** HOLE CARDS ***
Dealt to HubertusB [3h Ah]
1nTeresT: folds 
bery91: folds 
Rassty1983: folds 
Clamfish0: folds 
HubertusB: raises $0.05 to $0.10
GaaMaster95: folds 
Uncalled bet ($0.05) returned to HubertusB
HubertusB collected $0.10 from pot
HubertusB: doesn't show hand 
*** SUMMARY ***
Total pot $0.10 | Rake $0 
Seat 1: Clamfish0 (button) folded before Flop (didn't bet)
Seat 2: HubertusB (small blind) collected ($0.10)
Seat 3: GaaMaster95 (big blind) folded before Flop
Seat 4: 1nTeresT folded before Flop (didn't bet)
Seat 5: bery91 folded before Flop (didn't bet)
Seat 6: Rassty1983 folded before Flop (didn't bet)



PokerStars Zoom Hand #177968590882:  Hold'em No Limit ($0.02/$0.05) - 2017/11/09 2:35:22 CCT [2017/11/08 13:35:22 ET]
Table 'Donati' 6-max Seat #1 is the button
Seat 1: MyTrips70 ($4.84 in chips) 
Seat 2: mnv123 ($4.84 in chips) 
Seat 3: opie62 ($4.93 in chips) 
Seat 4: HubertusB ($5.40 in chips) 
Seat 5: Einherjer91 ($5.13 in chips) 
Seat 6: coolgrays ($2.60 in chips) 
mnv123: posts small blind $0.02
opie62: posts big blind $0.05
*** HOLE CARDS ***
Dealt to HubertusB [4h 6s]
HubertusB: folds 
Einherjer91: folds 
coolgrays: folds 
MyTrips70: folds 
mnv123: calls $0.03
opie62: raises $0.15 to $0.20
mnv123: calls $0.15
*** FLOP *** [Kh 3c 3s]
mnv123: bets $0.19
opie62: raises $0.31 to $0.50
mnv123: folds 
Uncalled bet ($0.31) returned to opie62
opie62 collected $0.75 from pot
opie62: doesn't show hand 
*** SUMMARY ***
Total pot $0.78 | Rake $0.03 
Board [Kh 3c 3s]
Seat 1: MyTrips70 (button) folded before Flop (didn't bet)
Seat 2: mnv123 (small blind) folded on the Flop
Seat 3: opie62 (big blind) collected ($0.75)
Seat 4: HubertusB folded before Flop (didn't bet)
Seat 5: Einherjer91 folded before Flop (didn't bet)
Seat 6: coolgrays folded before Flop (didn't bet)



PokerStars Zoom Hand #177968606947:  Hold'em No Limit ($0.02/$0.05) - 2017/11/09 2:35:42 CCT [2017/11/08 13:35:42 ET]
Table 'Donati' 6-max Seat #1 is the button
Seat 1: royal jascha ($8.96 in chips) 
Seat 2: taboliklol ($5.02 in chips) 
Seat 3: HubertusB ($5.45 in chips) 
Seat 4: BigEarn86 ($18.74 in chips) 
Seat 5: lR0G3Rl ($5 in chips) 
Seat 6: DallaBillya ($3.62 in chips) 
taboliklol: posts small blind $0.02
HubertusB: posts big blind $0.05
*** HOLE CARDS ***
Dealt to HubertusB [Qh Kd]
BigEarn86: folds 
lR0G3Rl: folds 
DallaBillya: calls $0.05
royal jascha: folds 
taboliklol: folds 
HubertusB: raises $0.15 to $0.20
DallaBillya: calls $0.15
*** FLOP *** [7h 2s Td]
HubertusB: bets $0.25
DallaBillya: folds 
Uncalled bet ($0.25) returned to HubertusB
HubertusB collected $0.40 from pot
HubertusB: doesn't show hand 
*** SUMMARY ***
Total pot $0.42 | Rake $0.02 
Board [7h 2s Td]
Seat 1: royal jascha (button) folded before Flop (didn't bet)
Seat 2: taboliklol (small blind) folded before Flop
Seat 3: HubertusB (big blind) collected ($0.40)
Seat 4: BigEarn86 folded before Flop (didn't bet)
Seat 5: lR0G3Rl folded before Flop (didn't bet)
Seat 6: DallaBillya folded on the Flop



PokerStars Zoom Hand #177968631007:  Hold'em No Limit ($0.02/$0.05) - 2017/11/09 2:36:12 CCT [2017/11/08 13:36:12 ET]
Table 'Donati' 6-max Seat #1 is the button
Seat 1: HubertusB ($5.65 in chips) 
Seat 2: founder9 ($5.51 in chips) 
Seat 3: dumpassos ($5.34 in chips) 
Seat 4: Supamaggie ($5.06 in chips) 
Seat 5: SuperNazario ($5.09 in chips) 
Seat 6: Gaston323 ($5.13 in chips) 
founder9: posts small blind $0.02
dumpassos: posts big blind $0.05
*** HOLE CARDS ***
Dealt to HubertusB [Jh 9d]
Supamaggie: folds 
SuperNazario: folds 
Gaston323: folds 
HubertusB: folds 
founder9: folds 
Uncalled bet ($0.03) returned to dumpassos
dumpassos collected $0.04 from pot
dumpassos: doesn't show hand 
*** SUMMARY ***
Total pot $0.04 | Rake $0 
Seat 1: HubertusB (button) folded before Flop (didn't bet)
Seat 2: founder9 (small blind) folded before Flop
Seat 3: dumpassos (big blind) collected ($0.04)
Seat 4: Supamaggie folded before Flop (didn't bet)
Seat 5: SuperNazario folded before Flop (didn't bet)
Seat 6: Gaston323 folded before Flop (didn't bet)



PokerStars Zoom Hand #177968635827:  Hold'em No Limit ($0.02/$0.05) - 2017/11/09 2:36:18 CCT [2017/11/08 13:36:18 ET]
Table 'Donati' 6-max Seat #1 is the button
Seat 1: Rassty1983 ($15 in chips) 
Seat 2: MarishaR63 ($5.62 in chips) 
Seat 3: t_k_b__lol__ ($2.10 in chips) 
Seat 4: Erynaur ($5.89 in chips) 
Seat 5: Machestr ($8.65 in chips) 
Seat 6: HubertusB ($5.65 in chips) 
MarishaR63: posts small blind $0.02
t_k_b__lol__: posts big blind $0.05
*** HOLE CARDS ***
Dealt to HubertusB [3h Ks]
Erynaur: folds 
Machestr: folds 
HubertusB: raises $0.05 to $0.10
Rassty1983: folds 
MarishaR63: raises $0.28 to $0.38
t_k_b__lol__: folds 
HubertusB: folds 
Uncalled bet ($0.28) returned to MarishaR63
MarishaR63 collected $0.25 from pot
MarishaR63: doesn't show hand 
*** SUMMARY ***
Total pot $0.25 | Rake $0 
Seat 1: Rassty1983 (button) folded before Flop (didn't bet)
Seat 2: MarishaR63 (small blind) collected ($0.25)
Seat 3: t_k_b__lol__ (big blind) folded before Flop
Seat 4: Erynaur folded before Flop (didn't bet)
Seat 5: Machestr folded before Flop (didn't bet)
Seat 6: HubertusB folded before Flop



PokerStars Zoom Hand #177968648715:  Hold'em No Limit ($0.02/$0.05) - 2017/11/09 2:36:34 CCT [2017/11/08 13:36:34 ET]
Table 'Donati' 6-max Seat #1 is the button
Seat 1: ImChrissyyyy ($5.34 in chips) 
Seat 2: SpjaldJB ($5.02 in chips) 
Seat 3: Ignite13 ($10.99 in chips) 
Seat 4: GaaMaster95 ($5.24 in chips) 
Seat 5: HubertusB ($5.55 in chips) 
Seat 6: kcyxa ($2.19 in chips) 
SpjaldJB: posts small blind $0.02
Ignite13: posts big blind $0.05
*** HOLE CARDS ***
Dealt to HubertusB [Jd As]
GaaMaster95: folds 
HubertusB: raises $0.05 to $0.10
kcyxa: raises $0.20 to $0.30
ImChrissyyyy: folds 
SpjaldJB: folds 
Ignite13: folds 
HubertusB: calls $0.20
*** FLOP *** [Kd Ah 6h]
HubertusB: checks 
kcyxa: bets $0.40
HubertusB: calls $0.40
*** TURN *** [Kd Ah 6h] [4d]
HubertusB: checks 
kcyxa: bets $1.49 and is all-in
HubertusB: calls $1.49
*** RIVER *** [Kd Ah 6h 4d] [8c]
*** SHOW DOWN ***
HubertusB: shows [Jd As] (a pair of Aces)
kcyxa: shows [Ac Qc] (a pair of Aces - King+Queen kicker)
kcyxa collected $4.27 from pot
*** SUMMARY ***
Total pot $4.45 | Rake $0.18 
Board [Kd Ah 6h 4d 8c]
Seat 1: ImChrissyyyy (button) folded before Flop (didn't bet)
Seat 2: SpjaldJB (small blind) folded before Flop
Seat 3: Ignite13 (big blind) folded before Flop
Seat 4: GaaMaster95 folded before Flop (didn't bet)
Seat 5: HubertusB showed [Jd As] and lost with a pair of Aces
Seat 6: kcyxa showed [Ac Qc] and won ($4.27) with a pair of Aces



PokerStars Zoom Hand #177968689424:  Hold'em No Limit ($0.02/$0.05) - 2017/11/09 2:37:25 CCT [2017/11/08 13:37:25 ET]
Table 'Donati' 6-max Seat #1 is the button
Seat 1: Skort_0 ($8.26 in chips) 
Seat 2: vitoreh ($6.07 in chips) 
Seat 3: HubertusB ($3.34 in chips) 
Seat 4: Daylor570 ($9.53 in chips) 
Seat 5: robbson77 ($1.97 in chips) 
Seat 6: A.Kavetskyi ($6.03 in chips) 
vitoreh: posts small blind $0.02
HubertusB: posts big blind $0.05
*** HOLE CARDS ***
Dealt to HubertusB [Ts 5h]
Daylor570: raises $0.05 to $0.10
robbson77: folds 
A.Kavetskyi: folds 
Skort_0: folds 
vitoreh: folds 
HubertusB: folds 
Uncalled bet ($0.05) returned to Daylor570
Daylor570 collected $0.12 from pot
Daylor570: doesn't show hand 
*** SUMMARY ***
Total pot $0.12 | Rake $0 
Seat 1: Skort_0 (button) folded before Flop (didn't bet)
Seat 2: vitoreh (small blind) folded before Flop
Seat 3: HubertusB (big blind) folded before Flop
Seat 4: Daylor570 collected ($0.12)
Seat 5: robbson77 folded before Flop (didn't bet)
Seat 6: A.Kavetskyi folded before Flop (didn't bet)



PokerStars Zoom Hand #177968685481:  Hold'em No Limit ($0.02/$0.05) - 2017/11/09 2:37:20 CCT [2017/11/08 13:37:20 ET]
Table 'Donati' 6-max Seat #1 is the button
Seat 1: nonsensever ($7.65 in chips) 
Seat 2: HubertusB ($3.36 in chips) 
Seat 3: coolgrays ($9.65 in chips) 
Seat 4: Lago Madjore ($5 in chips) 
Seat 5: gcz94 ($5.82 in chips) 
Seat 6: navy463 ($5.45 in chips) 
HubertusB: posts small blind $0.02
coolgrays: posts big blind $0.05
*** HOLE CARDS ***
Dealt to HubertusB [7s 3c]
Lago Madjore: raises $0.10 to $0.15
gcz94: folds 
navy463: folds 
nonsensever has timed out
nonsensever: folds 
HubertusB: folds 
coolgrays: folds 
Uncalled bet ($0.10) returned to Lago Madjore
Lago Madjore collected $0.12 from pot
Lago Madjore: doesn't show hand 
*** SUMMARY ***
Total pot $0.12 | Rake $0 
Seat 1: nonsensever (button) folded before Flop (didn't bet)
Seat 2: HubertusB (small blind) folded before Flop
Seat 3: coolgrays (big blind) folded before Flop
Seat 4: Lago Madjore collected ($0.12)
Seat 5: gcz94 folded before Flop (didn't bet)
Seat 6: navy463 folded before Flop (didn't bet)



PokerStars Zoom Hand #177968694222:  Hold'em No Limit ($0.02/$0.05) - 2017/11/09 2:37:31 CCT [2017/11/08 13:37:31 ET]
Table 'Donati' 6-max Seat #1 is the button
Seat 1: HubertusB ($3.29 in chips) 
Seat 2: Promotoresp ($9.41 in chips) 
Seat 3: laiha ($15.54 in chips) 
Seat 4: MstrJJ ($11.96 in chips) 
Seat 5: masha_dza ($7.49 in chips) 
Seat 6: AngryGumby ($5.20 in chips) 
Promotoresp: posts small blind $0.02
laiha: posts big blind $0.05
*** HOLE CARDS ***
Dealt to HubertusB [Tc 8s]
MstrJJ: folds 
masha_dza: folds 
AngryGumby: folds 
HubertusB: raises $0.05 to $0.10
Promotoresp: folds 
laiha: calls $0.05
*** FLOP *** [5d 7d Kd]
laiha: checks 
HubertusB: bets $0.15
laiha: folds 
Uncalled bet ($0.15) returned to HubertusB
HubertusB collected $0.21 from pot
HubertusB: doesn't show hand 
*** SUMMARY ***
Total pot $0.22 | Rake $0.01 
Board [5d 7d Kd]
Seat 1: HubertusB (button) collected ($0.21)
Seat 2: Promotoresp (small blind) folded before Flop
Seat 3: laiha (big blind) folded on the Flop
Seat 4: MstrJJ folded before Flop (didn't bet)
Seat 5: masha_dza folded before Flop (didn't bet)
Seat 6: AngryGumby folded before Flop (didn't bet)



PokerStars Zoom Hand #177968717455:  Hold'em No Limit ($0.02/$0.05) - 2017/11/09 2:38:00 CCT [2017/11/08 13:38:00 ET]
Table 'Donati' 6-max Seat #1 is the button
Seat 1: royal jascha ($8.75 in chips) 
Seat 2: SCAMMER12345 ($5 in chips) 
Seat 3: MyTrips70 ($5 in chips) 
Seat 4: HubertusB ($3.40 in chips) 
Seat 5: Ydjin111 ($2.97 in chips) 
Seat 6: devianin96 ($6.28 in chips) 
SCAMMER12345: posts small blind $0.02
MyTrips70: posts big blind $0.05
*** HOLE CARDS ***
Dealt to HubertusB [Th Kc]
HubertusB: raises $0.05 to $0.10
Ydjin111: folds 
devianin96: folds 
royal jascha: folds 
SCAMMER12345: calls $0.08
MyTrips70: folds 
*** FLOP *** [8d Ah Ad]
SCAMMER12345: checks 
HubertusB: bets $0.15
SCAMMER12345: calls $0.15
*** TURN *** [8d Ah Ad] [6s]
SCAMMER12345: checks 
HubertusB: checks 
*** RIVER *** [8d Ah Ad 6s] [5h]
SCAMMER12345: bets $0.53
HubertusB: folds 
Uncalled bet ($0.53) returned to SCAMMER12345
SCAMMER12345 collected $0.53 from pot
SCAMMER12345: doesn't show hand 
*** SUMMARY ***
Total pot $0.55 | Rake $0.02 
Board [8d Ah Ad 6s 5h]
Seat 1: royal jascha (button) folded before Flop (didn't bet)
Seat 2: SCAMMER12345 (small blind) collected ($0.53)
Seat 3: MyTrips70 (big blind) folded before Flop
Seat 4: HubertusB folded on the River
Seat 5: Ydjin111 folded before Flop (didn't bet)
Seat 6: devianin96 folded before Flop (didn't bet)



PokerStars Zoom Hand #177968753548:  Hold'em No Limit ($0.02/$0.05) - 2017/11/09 2:38:45 CCT [2017/11/08 13:38:45 ET]
Table 'Donati' 6-max Seat #1 is the button
Seat 1: $KeyRanger$ ($4.70 in chips) 
Seat 2: Ignite13 ($12.42 in chips) 
Seat 3: ooiaooao ($6.31 in chips) 
Seat 4: debeli999 ($3.48 in chips) 
Seat 5: kcyxa ($4.44 in chips) 
Seat 6: HubertusB ($3.15 in chips) 
Ignite13: posts small blind $0.02
ooiaooao: posts big blind $0.05
*** HOLE CARDS ***
Dealt to HubertusB [Kc 5c]
debeli999: raises $0.15 to $0.20
kcyxa: folds 
HubertusB: folds 
$KeyRanger$: folds 
Ignite13: folds 
ooiaooao: folds 
Uncalled bet ($0.15) returned to debeli999
debeli999 collected $0.12 from pot
debeli999: doesn't show hand 
*** SUMMARY ***
Total pot $0.12 | Rake $0 
Seat 1: $KeyRanger$ (button) folded before Flop (didn't bet)
Seat 2: Ignite13 (small blind) folded before Flop
Seat 3: ooiaooao (big blind) folded before Flop
Seat 4: debeli999 collected ($0.12)
Seat 5: kcyxa folded before Flop (didn't bet)
Seat 6: HubertusB folded before Flop (didn't bet)



PokerStars Zoom Hand #177968760845:  Hold'em No Limit ($0.02/$0.05) - 2017/11/09 2:38:54 CCT [2017/11/08 13:38:54 ET]
Table 'Donati' 6-max Seat #1 is the button
Seat 1: Friisbak ($19.42 in chips) 
Seat 2: HubertusB ($3.15 in chips) 
Seat 3: sokolik81 ($7.82 in chips) 
Seat 4: ZMLucker ($5 in chips) 
Seat 5: SuperNazario ($5.34 in chips) 
Seat 6: Alfie Bear ($5.12 in chips) 
HubertusB: posts small blind $0.02
sokolik81: posts big blind $0.05
*** HOLE CARDS ***
Dealt to HubertusB [5h Js]
ZMLucker: folds 
SuperNazario: folds 
Alfie Bear: folds 
Friisbak: folds 
HubertusB: folds 
Uncalled bet ($0.03) returned to sokolik81
sokolik81 collected $0.04 from pot
sokolik81: doesn't show hand 
*** SUMMARY ***
Total pot $0.04 | Rake $0 
Seat 1: Friisbak (button) folded before Flop (didn't bet)
Seat 2: HubertusB (small blind) folded before Flop
Seat 3: sokolik81 (big blind) collected ($0.04)
Seat 4: ZMLucker folded before Flop (didn't bet)
Seat 5: SuperNazario folded before Flop (didn't bet)
Seat 6: Alfie Bear folded before Flop (didn't bet)



PokerStars Zoom Hand #177968772177:  Hold'em No Limit ($0.02/$0.05) - 2017/11/09 2:39:08 CCT [2017/11/08 13:39:08 ET]
Table 'Donati' 6-max Seat #1 is the button
Seat 1: Clamfish0 ($7.59 in chips) 
Seat 2: Kondr-KAV ($4.43 in chips) 
Seat 3: HubertusB ($3.13 in chips) 
Seat 4: moneybek ($9.41 in chips) 
Seat 5: zloy_dik ($4.29 in chips) 
Seat 6: MaMi82 ($5.08 in chips) 
Kondr-KAV: posts small blind $0.02
HubertusB: posts big blind $0.05
*** HOLE CARDS ***
Dealt to HubertusB [Qc 2h]
moneybek: folds 
zloy_dik: folds 
MaMi82: raises $0.10 to $0.15
Clamfish0: folds 
Kondr-KAV: folds 
HubertusB: folds 
Uncalled bet ($0.10) returned to MaMi82
MaMi82 collected $0.12 from pot
MaMi82: doesn't show hand 
*** SUMMARY ***
Total pot $0.12 | Rake $0 
Seat 1: Clamfish0 (button) folded before Flop (didn't bet)
Seat 2: Kondr-KAV (small blind) folded before Flop
Seat 3: HubertusB (big blind) folded before Flop
Seat 4: moneybek folded before Flop (didn't bet)
Seat 5: zloy_dik folded before Flop (didn't bet)
Seat 6: MaMi82 collected ($0.12)



PokerStars Zoom Hand #177968795324:  Hold'em No Limit ($0.02/$0.05) - 2017/11/09 2:39:37 CCT [2017/11/08 13:39:37 ET]
Table 'Donati' 6-max Seat #1 is the button
Seat 1: Huaen ($5.64 in chips) 
Seat 2: urrrrdddd ($7.04 in chips) 
Seat 3: Clamfish0 ($7.45 in chips) 
Seat 4: Kmosh ($5.12 in chips) 
Seat 5: HubertusB ($3.08 in chips) 
Seat 6: 72odonkey ($5.25 in chips) 
urrrrdddd: posts small blind $0.02
Clamfish0: posts big blind $0.05
*** HOLE CARDS ***
Dealt to HubertusB [4h Jc]
Kmosh: raises $0.10 to $0.15
HubertusB: folds 
72odonkey: folds 
Huaen: folds 
urrrrdddd: folds 
Clamfish0: folds 
Uncalled bet ($0.10) returned to Kmosh
Kmosh collected $0.12 from pot
Kmosh: doesn't show hand 
*** SUMMARY ***
Total pot $0.12 | Rake $0 
Seat 1: Huaen (button) folded before Flop (didn't bet)
Seat 2: urrrrdddd (small blind) folded before Flop
Seat 3: Clamfish0 (big blind) folded before Flop
Seat 4: Kmosh collected ($0.12)
Seat 5: HubertusB folded before Flop (didn't bet)
Seat 6: 72odonkey folded before Flop (didn't bet)



PokerStars Zoom Hand #177968801597:  Hold'em No Limit ($0.02/$0.05) - 2017/11/09 2:39:45 CCT [2017/11/08 13:39:45 ET]
Table 'Donati' 6-max Seat #1 is the button
Seat 1: R.Serhii ($2.77 in chips) 
Seat 2: Odvajke1 ($5.02 in chips) 
Seat 3: 72odonkey ($7.82 in chips) 
Seat 4: HubertusB ($3.08 in chips) 
Seat 5: jullikka25 ($7.29 in chips) 
Seat 6: nfnfh83 ($3.94 in chips) 
Odvajke1: posts small blind $0.02
72odonkey: posts big blind $0.05
*** HOLE CARDS ***
Dealt to HubertusB [9s 2s]
HubertusB: raises $0.05 to $0.10
jullikka25: folds 
nfnfh83: folds 
R.Serhii: folds 
Odvajke1: folds 
72odonkey: folds 
Uncalled bet ($0.05) returned to HubertusB
HubertusB collected $0.12 from pot
HubertusB: doesn't show hand 
*** SUMMARY ***
Total pot $0.12 | Rake $0 
Seat 1: R.Serhii (button) folded before Flop (didn't bet)
Seat 2: Odvajke1 (small blind) folded before Flop
Seat 3: 72odonkey (big blind) folded before Flop
Seat 4: HubertusB collected ($0.12)
Seat 5: jullikka25 folded before Flop (didn't bet)
Seat 6: nfnfh83 folded before Flop (didn't bet)



PokerStars Zoom Hand #177968779297:  Hold'em No Limit ($0.02/$0.05) - 2017/11/09 2:39:17 CCT [2017/11/08 13:39:17 ET]
Table 'Donati' 6-max Seat #1 is the button
Seat 1: HubertusB ($3.08 in chips) 
Seat 2: Ravaas ($1.73 in chips) 
Seat 3: uwanttobeeme ($5.66 in chips) 
Seat 4: Bunnytrickz7 ($3.99 in chips) 
Seat 5: ady101987 ($5.05 in chips) 
Seat 6: WINDTOY ($5.30 in chips) 
Ravaas: posts small blind $0.02
uwanttobeeme: posts big blind $0.05
*** HOLE CARDS ***
Dealt to HubertusB [4c 8h]
Bunnytrickz7: folds 
ady101987: calls $0.05
WINDTOY: raises $0.20 to $0.25
HubertusB: folds 
Ravaas: folds 
uwanttobeeme: folds 
ady101987: calls $0.20
*** FLOP *** [Ah 7h Qd]
ady101987: checks 
WINDTOY: bets $0.25
ady101987: folds 
Uncalled bet ($0.25) returned to WINDTOY
WINDTOY collected $0.55 from pot
WINDTOY: doesn't show hand 
*** SUMMARY ***
Total pot $0.57 | Rake $0.02 
Board [Ah 7h Qd]
Seat 1: HubertusB (button) folded before Flop (didn't bet)
Seat 2: Ravaas (small blind) folded before Flop
Seat 3: uwanttobeeme (big blind) folded before Flop
Seat 4: Bunnytrickz7 folded before Flop (didn't bet)
Seat 5: ady101987 folded on the Flop
Seat 6: WINDTOY collected ($0.55)



PokerStars Zoom Hand #177968813689:  Hold'em No Limit ($0.02/$0.05) - 2017/11/09 2:40:00 CCT [2017/11/08 13:40:00 ET]
Table 'Donati' 6-max Seat #1 is the button
Seat 1: coolgrays ($3.14 in chips) 
Seat 2: Clamfish0 ($7.40 in chips) 
Seat 3: House 221b ($5 in chips) 
Seat 4: moneybek ($5.02 in chips) 
Seat 5: uwanttobeeme ($5.66 in chips) 
Seat 6: HubertusB ($3.15 in chips) 
Clamfish0: posts small blind $0.02
House 221b: posts big blind $0.05
*** HOLE CARDS ***
Dealt to HubertusB [6d Jh]
moneybek: folds 
uwanttobeeme: folds 
HubertusB: raises $0.05 to $0.10
coolgrays: folds 
Clamfish0: raises $0.24 to $0.34
House 221b: folds 
HubertusB: raises $0.51 to $0.85
Clamfish0: folds 
Uncalled bet ($0.51) returned to HubertusB
HubertusB collected $0.73 from pot
HubertusB: doesn't show hand 
*** SUMMARY ***
Total pot $0.73 | Rake $0 
Seat 1: coolgrays (button) folded before Flop (didn't bet)
Seat 2: Clamfish0 (small blind) folded before Flop
Seat 3: House 221b (big blind) folded before Flop
Seat 4: moneybek folded before Flop (didn't bet)
Seat 5: uwanttobeeme folded before Flop (didn't bet)
Seat 6: HubertusB collected ($0.73)



PokerStars Zoom Hand #177968834280:  Hold'em No Limit ($0.02/$0.05) - 2017/11/09 2:40:26 CCT [2017/11/08 13:40:26 ET]
Table 'Donati' 6-max Seat #1 is the button
Seat 1: Charlie44333 ($5 in chips) 
Seat 2: HubertusB ($3.54 in chips) 
Seat 3: Friisbak ($18.16 in chips) 
Seat 4: hiller1980 ($5.37 in chips) 
Seat 5: needluck89 ($5.05 in chips) 
Seat 6: Mongolica ($8 in chips) 
HubertusB: posts small blind $0.02
Friisbak: posts big blind $0.05
*** HOLE CARDS ***
Dealt to HubertusB [9h 9s]
hiller1980: calls $0.05
needluck89: folds 
Mongolica: folds 
Charlie44333: folds 
HubertusB: calls $0.03
Friisbak: checks 
*** FLOP *** [Qc Jc 8d]
HubertusB: bets $0.10
Friisbak: raises $0.15 to $0.25
hiller1980: calls $0.25
HubertusB: folds 
*** TURN *** [Qc Jc 8d] [2c]
Friisbak: checks 
hiller1980: bets $0.40
Friisbak: folds 
Uncalled bet ($0.40) returned to hiller1980
hiller1980 collected $0.72 from pot
hiller1980: doesn't show hand 
*** SUMMARY ***
Total pot $0.75 | Rake $0.03 
Board [Qc Jc 8d 2c]
Seat 1: Charlie44333 (button) folded before Flop (didn't bet)
Seat 2: HubertusB (small blind) folded on the Flop
Seat 3: Friisbak (big blind) folded on the Turn
Seat 4: hiller1980 collected ($0.72)
Seat 5: needluck89 folded before Flop (didn't bet)
Seat 6: Mongolica folded before Flop (didn't bet)



PokerStars Zoom Hand #177968877417:  Hold'em No Limit ($0.02/$0.05) - 2017/11/09 2:41:20 CCT [2017/11/08 13:41:20 ET]
Table 'Donati' 6-max Seat #1 is the button
Seat 1: Hxrtxng ($9.63 in chips) 
Seat 2: balabir ($11.61 in chips) 
Seat 3: HubertusB ($3.39 in chips) 
Seat 4: begze ($4.91 in chips) 
Seat 5: lukasamace ($6.75 in chips) 
Seat 6: rnjsdbsrb ($8.32 in chips) 
balabir: posts small blind $0.02
HubertusB: posts big blind $0.05
*** HOLE CARDS ***
Dealt to HubertusB [9s 3s]
begze: folds 
lukasamace: raises $0.10 to $0.15
rnjsdbsrb: folds 
Hxrtxng: folds 
balabir: folds 
HubertusB: folds 
Uncalled bet ($0.10) returned to lukasamace
lukasamace collected $0.12 from pot
lukasamace: doesn't show hand 
*** SUMMARY ***
Total pot $0.12 | Rake $0 
Seat 1: Hxrtxng (button) folded before Flop (didn't bet)
Seat 2: balabir (small blind) folded before Flop
Seat 3: HubertusB (big blind) folded before Flop
Seat 4: begze folded before Flop (didn't bet)
Seat 5: lukasamace collected ($0.12)
Seat 6: rnjsdbsrb folded before Flop (didn't bet)



PokerStars Zoom Hand #177968872743:  Hold'em No Limit ($0.02/$0.05) - 2017/11/09 2:41:14 CCT [2017/11/08 13:41:14 ET]
Table 'Donati' 6-max Seat #1 is the button
Seat 1: KKKKypros ($4.75 in chips) 
Seat 2: Sarmatrus79 ($5.26 in chips) 
Seat 3: Post64 ($8.26 in chips) 
Seat 4: 216NL ($31.19 in chips) 
Seat 5: HubertusB ($3.39 in chips) 
Seat 6: crappyquads ($5.89 in chips) 
Sarmatrus79: posts small blind $0.02
Post64: posts big blind $0.05
*** HOLE CARDS ***
Dealt to HubertusB [6d 4c]
216NL: raises $0.07 to $0.12
HubertusB: folds 
crappyquads: calls $0.12
KKKKypros: folds 
Sarmatrus79: folds 
Post64: folds 
*** FLOP *** [Qc 9c 2s]
216NL: bets $0.23
crappyquads: folds 
Uncalled bet ($0.23) returned to 216NL
216NL collected $0.30 from pot
216NL: doesn't show hand 
*** SUMMARY ***
Total pot $0.31 | Rake $0.01 
Board [Qc 9c 2s]
Seat 1: KKKKypros (button) folded before Flop (didn't bet)
Seat 2: Sarmatrus79 (small blind) folded before Flop
Seat 3: Post64 (big blind) folded before Flop
Seat 4: 216NL collected ($0.30)
Seat 5: HubertusB folded before Flop (didn't bet)
Seat 6: crappyquads folded on the Flop



PokerStars Zoom Hand #177968887006:  Hold'em No Limit ($0.02/$0.05) - 2017/11/09 2:41:32 CCT [2017/11/08 13:41:32 ET]
Table 'Donati' 6-max Seat #1 is the button
Seat 1: zloy_dik ($3.91 in chips) 
Seat 2: aodwntm ($8.19 in chips) 
Seat 3: moozeev ($4.85 in chips) 
Seat 4: HubertusB ($3.34 in chips) 
Seat 5: bery91 ($4.82 in chips) 
Seat 6: Hxrtxng ($6.70 in chips) 
aodwntm: posts small blind $0.02
moozeev: posts big blind $0.05
*** HOLE CARDS ***
Dealt to HubertusB [Ks As]
HubertusB: raises $0.05 to $0.10
bery91: folds 
Hxrtxng: folds 
zloy_dik: folds 
aodwntm: calls $0.08
moozeev: folds 
*** FLOP *** [6d 5s Qs]
aodwntm: checks 
HubertusB: bets $0.15
aodwntm: folds 
Uncalled bet ($0.15) returned to HubertusB
HubertusB collected $0.24 from pot
HubertusB: doesn't show hand 
*** SUMMARY ***
Total pot $0.25 | Rake $0.01 
Board [6d 5s Qs]
Seat 1: zloy_dik (button) folded before Flop (didn't bet)
Seat 2: aodwntm (small blind) folded on the Flop
Seat 3: moozeev (big blind) folded before Flop
Seat 4: HubertusB collected ($0.24)
Seat 5: bery91 folded before Flop (didn't bet)
Seat 6: Hxrtxng folded before Flop (didn't bet)



PokerStars Zoom Hand #177968918190:  Hold'em No Limit ($0.02/$0.05) - 2017/11/09 2:42:11 CCT [2017/11/08 13:42:11 ET]
Table 'Donati' 6-max Seat #1 is the button
Seat 1: ooiaooao ($10.23 in chips) 
Seat 2: balabir ($11.61 in chips) 
Seat 3: CykuHKOT ($2.63 in chips) 
Seat 4: WisherBG ($5.57 in chips) 
Seat 5: domitorii ($6.23 in chips) 
Seat 6: HubertusB ($3.48 in chips) 
balabir: posts small blind $0.02
CykuHKOT: posts big blind $0.05
*** HOLE CARDS ***
Dealt to HubertusB [9d Js]
WisherBG: folds 
domitorii: folds 
HubertusB: raises $0.05 to $0.10
ooiaooao: folds 
balabir: folds 
CykuHKOT: folds 
Uncalled bet ($0.05) returned to HubertusB
HubertusB collected $0.12 from pot
HubertusB: doesn't show hand 
*** SUMMARY ***
Total pot $0.12 | Rake $0 
Seat 1: ooiaooao (button) folded before Flop (didn't bet)
Seat 2: balabir (small blind) folded before Flop
Seat 3: CykuHKOT (big blind) folded before Flop
Seat 4: WisherBG folded before Flop (didn't bet)
Seat 5: domitorii folded before Flop (didn't bet)
Seat 6: HubertusB collected ($0.12)



PokerStars Zoom Hand #177968928424:  Hold'em No Limit ($0.02/$0.05) - 2017/11/09 2:42:24 CCT [2017/11/08 13:42:24 ET]
Table 'Donati' 6-max Seat #1 is the button
Seat 1: max_polonez ($2.65 in chips) 
Seat 2: kopatich52 ($8.51 in chips) 
Seat 3: Bashiroff43 ($4.93 in chips) 
Seat 4: Volke!n kz ($13.04 in chips) 
Seat 5: HubertusB ($3.55 in chips) 
Seat 6: veryfatjedi ($4.69 in chips) 
kopatich52: posts small blind $0.02
Bashiroff43: posts big blind $0.05
*** HOLE CARDS ***
Dealt to HubertusB [4s 8s]
Volke!n kz: folds 
HubertusB: raises $0.05 to $0.10
veryfatjedi: folds 
max_polonez: folds 
kopatich52: folds 
Bashiroff43: folds 
Uncalled bet ($0.05) returned to HubertusB
HubertusB collected $0.12 from pot
HubertusB: doesn't show hand 
*** SUMMARY ***
Total pot $0.12 | Rake $0 
Seat 1: max_polonez (button) folded before Flop (didn't bet)
Seat 2: kopatich52 (small blind) folded before Flop
Seat 3: Bashiroff43 (big blind) folded before Flop
Seat 4: Volke!n kz folded before Flop (didn't bet)
Seat 5: HubertusB collected ($0.12)
Seat 6: veryfatjedi folded before Flop (didn't bet)



PokerStars Zoom Hand #177968911074:  Hold'em No Limit ($0.02/$0.05) - 2017/11/09 2:42:02 CCT [2017/11/08 13:42:02 ET]
Table 'Donati' 6-max Seat #1 is the button
Seat 1: HubertusB ($3.48 in chips) 
Seat 2: rrrmmpp ($8.38 in chips) 
Seat 3: bobcarpy ($1.84 in chips) 
Seat 4: and_67rus ($4.84 in chips) 
Seat 5: mel1in ($19.81 in chips) 
Seat 6: kongor331977 ($9.81 in chips) 
rrrmmpp: posts small blind $0.02
bobcarpy: posts big blind $0.05
*** HOLE CARDS ***
Dealt to HubertusB [7c Td]
and_67rus: raises $0.10 to $0.15
mel1in: folds 
kongor331977: folds 
HubertusB: folds 
rrrmmpp: calls $0.13
bobcarpy: folds 
*** FLOP *** [8c 7s 2h]
rrrmmpp: checks 
and_67rus: bets $0.30
rrrmmpp: folds 
Uncalled bet ($0.30) returned to and_67rus
and_67rus collected $0.34 from pot
and_67rus: doesn't show hand 
*** SUMMARY ***
Total pot $0.35 | Rake $0.01 
Board [8c 7s 2h]
Seat 1: HubertusB (button) folded before Flop (didn't bet)
Seat 2: rrrmmpp (small blind) folded on the Flop
Seat 3: bobcarpy (big blind) folded before Flop
Seat 4: and_67rus collected ($0.34)
Seat 5: mel1in folded before Flop (didn't bet)
Seat 6: kongor331977 folded before Flop (didn't bet)



PokerStars Zoom Hand #177968938905:  Hold'em No Limit ($0.02/$0.05) - 2017/11/09 2:42:37 CCT [2017/11/08 13:42:37 ET]
Table 'Donati' 6-max Seat #1 is the button
Seat 1: HubertusB ($3.62 in chips) 
Seat 2: 4betkenny ($22.90 in chips) 
Seat 3: fibonacci000 ($11.40 in chips) 
Seat 4: royal jascha ($9 in chips) 
Seat 5: WEIPEI1 ($7.05 in chips) 
Seat 6: SuperNazario ($5.57 in chips) 
4betkenny: posts small blind $0.02
fibonacci000: posts big blind $0.05
*** HOLE CARDS ***
Dealt to HubertusB [2s 5s]
royal jascha: folds 
WEIPEI1: raises $0.10 to $0.15
SuperNazario: folds 
HubertusB: folds 
4betkenny: folds 
fibonacci000: folds 
Uncalled bet ($0.10) returned to WEIPEI1
WEIPEI1 collected $0.12 from pot
WEIPEI1: doesn't show hand 
*** SUMMARY ***
Total pot $0.12 | Rake $0 
Seat 1: HubertusB (button) folded before Flop (didn't bet)
Seat 2: 4betkenny (small blind) folded before Flop
Seat 3: fibonacci000 (big blind) folded before Flop
Seat 4: royal jascha folded before Flop (didn't bet)
Seat 5: WEIPEI1 collected ($0.12)
Seat 6: SuperNazario folded before Flop (didn't bet)



PokerStars Zoom Hand #177968947675:  Hold'em No Limit ($0.02/$0.05) - 2017/11/09 2:42:48 CCT [2017/11/08 13:42:48 ET]
Table 'Donati' 6-max Seat #1 is the button
Seat 1: BOSCOBOT ($5 in chips) 
Seat 2: Lago Madjore ($5 in chips) 
Seat 3: HubertusB ($3.62 in chips) 
Seat 4: KOBRA7777 ($5.81 in chips) 
Seat 5: needluck89 ($5 in chips) 
Seat 6: uwanttobeeme ($7.02 in chips) 
Lago Madjore: posts small blind $0.02
HubertusB: posts big blind $0.05
*** HOLE CARDS ***
Dealt to HubertusB [7d 2c]
KOBRA7777: folds 
needluck89: folds 
uwanttobeeme: folds 
BOSCOBOT: folds 
Lago Madjore: folds 
Uncalled bet ($0.03) returned to HubertusB
HubertusB collected $0.04 from pot
HubertusB: doesn't show hand 
*** SUMMARY ***
Total pot $0.04 | Rake $0 
Seat 1: BOSCOBOT (button) folded before Flop (didn't bet)
Seat 2: Lago Madjore (small blind) folded before Flop
Seat 3: HubertusB (big blind) collected ($0.04)
Seat 4: KOBRA7777 folded before Flop (didn't bet)
Seat 5: needluck89 folded before Flop (didn't bet)
Seat 6: uwanttobeeme folded before Flop (didn't bet)



PokerStars Zoom Hand #177968956497:  Hold'em No Limit ($0.02/$0.05) - 2017/11/09 2:42:59 CCT [2017/11/08 13:42:59 ET]
Table 'Donati' 6-max Seat #1 is the button
Seat 1: HansGunter15 ($6.04 in chips) 
Seat 2: taboliklol ($5.60 in chips) 
Seat 3: Les Paul 987 ($5.51 in chips) 
Seat 4: HubertusB ($3.64 in chips) 
Seat 5: Einherjer91 ($5.65 in chips) 
Seat 6: Promotoresp ($10.48 in chips) 
taboliklol: posts small blind $0.02
Les Paul 987: posts big blind $0.05
*** HOLE CARDS ***
Dealt to HubertusB [8d Ks]
HubertusB: folds 
Einherjer91: folds 
Promotoresp: folds 
HansGunter15: raises $0.10 to $0.15
taboliklol: folds 
Les Paul 987: folds 
Uncalled bet ($0.10) returned to HansGunter15
HansGunter15 collected $0.12 from pot
HansGunter15: doesn't show hand 
*** SUMMARY ***
Total pot $0.12 | Rake $0 
Seat 1: HansGunter15 (button) collected ($0.12)
Seat 2: taboliklol (small blind) folded before Flop
Seat 3: Les Paul 987 (big blind) folded before Flop
Seat 4: HubertusB folded before Flop (didn't bet)
Seat 5: Einherjer91 folded before Flop (didn't bet)
Seat 6: Promotoresp folded before Flop (didn't bet)



PokerStars Zoom Hand #177968975799:  Hold'em No Limit ($0.02/$0.05) - 2017/11/09 2:43:23 CCT [2017/11/08 13:43:23 ET]
Table 'Donati' 6-max Seat #1 is the button
Seat 1: blade_knops ($6.90 in chips) 
Seat 2: Danilloo93 ($5 in chips) 
Seat 3: Nazaretter ($4.88 in chips) 
Seat 4: Les Paul 987 ($4.14 in chips) 
Seat 5: HubertusB ($3.62 in chips) 
Seat 6: Odvajke1 ($5.02 in chips) 
Danilloo93: posts small blind $0.02
Nazaretter: posts big blind $0.05
*** HOLE CARDS ***
Dealt to HubertusB [2h 5c]
Les Paul 987: folds 
HubertusB: folds 
Odvajke1: raises $0.07 to $0.12
blade_knops: folds 
Danilloo93: folds 
Nazaretter: folds 
Uncalled bet ($0.07) returned to Odvajke1
Odvajke1 collected $0.12 from pot
Odvajke1: doesn't show hand 
*** SUMMARY ***
Total pot $0.12 | Rake $0 
Seat 1: blade_knops (button) folded before Flop (didn't bet)
Seat 2: Danilloo93 (small blind) folded before Flop
Seat 3: Nazaretter (big blind) folded before Flop
Seat 4: Les Paul 987 folded before Flop (didn't bet)
Seat 5: HubertusB folded before Flop (didn't bet)
Seat 6: Odvajke1 collected ($0.12)



PokerStars Zoom Hand #177968984562:  Hold'em No Limit ($0.02/$0.05) - 2017/11/09 2:43:34 CCT [2017/11/08 13:43:34 ET]
Table 'Donati' 6-max Seat #1 is the button
Seat 1: Ymnica15 ($10.96 in chips) 
Seat 2: Yahan588 ($5 in chips) 
Seat 3: ooiaooao ($13.39 in chips) 
Seat 4: HubertusB ($3.62 in chips) 
Seat 5: prata_uk ($6.12 in chips) 
Seat 6: Pro100PaPaN ($7.29 in chips) 
Yahan588: posts small blind $0.02
ooiaooao: posts big blind $0.05
*** HOLE CARDS ***
Dealt to HubertusB [3d Ts]
HubertusB: folds 
prata_uk: folds 
Pro100PaPaN: folds 
Ymnica15: folds 
Yahan588: folds 
Uncalled bet ($0.03) returned to ooiaooao
ooiaooao collected $0.04 from pot
ooiaooao: doesn't show hand 
*** SUMMARY ***
Total pot $0.04 | Rake $0 
Seat 1: Ymnica15 (button) folded before Flop (didn't bet)
Seat 2: Yahan588 (small blind) folded before Flop
Seat 3: ooiaooao (big blind) collected ($0.04)
Seat 4: HubertusB folded before Flop (didn't bet)
Seat 5: prata_uk folded before Flop (didn't bet)
Seat 6: Pro100PaPaN folded before Flop (didn't bet)



PokerStars Zoom Hand #177968988609:  Hold'em No Limit ($0.02/$0.05) - 2017/11/09 2:43:39 CCT [2017/11/08 13:43:39 ET]
Table 'Donati' 6-max Seat #1 is the button
Seat 1: House 221b ($6.51 in chips) 
Seat 2: SCAMMER12345 ($5 in chips) 
Seat 3: HubertusB ($3.62 in chips) 
Seat 4: MedChrize ($13.35 in chips) 
Seat 5: StasoN445 ($9.74 in chips) 
Seat 6: Ymnica15 ($5.02 in chips) 
SCAMMER12345: posts small blind $0.02
HubertusB: posts big blind $0.05
*** HOLE CARDS ***
Dealt to HubertusB [Jc Ah]
MedChrize: folds 
StasoN445: folds 
Ymnica15: folds 
House 221b: folds 
SCAMMER12345: folds 
Uncalled bet ($0.03) returned to HubertusB
HubertusB collected $0.04 from pot
HubertusB: doesn't show hand 
*** SUMMARY ***
Total pot $0.04 | Rake $0 
Seat 1: House 221b (button) folded before Flop (didn't bet)
Seat 2: SCAMMER12345 (small blind) folded before Flop
Seat 3: HubertusB (big blind) collected ($0.04)
Seat 4: MedChrize folded before Flop (didn't bet)
Seat 5: StasoN445 folded before Flop (didn't bet)
Seat 6: Ymnica15 folded before Flop (didn't bet)



PokerStars Zoom Hand #177968979006:  Hold'em No Limit ($0.02/$0.05) - 2017/11/09 2:43:27 CCT [2017/11/08 13:43:27 ET]
Table 'Donati' 6-max Seat #1 is the button
Seat 1: bilosama ($11.12 in chips) 
Seat 2: Dudugalo1313 ($7.69 in chips) 
Seat 3: quaackk ($5 in chips) 
Seat 4: Maroshi99 ($12.64 in chips) 
Seat 5: Rassty1983 ($6.06 in chips) 
Seat 6: HubertusB ($3.62 in chips) 
Dudugalo1313: posts small blind $0.02
quaackk: posts big blind $0.05
*** HOLE CARDS ***
Dealt to HubertusB [Th Kh]
Maroshi99: raises $0.10 to $0.15
Rassty1983: folds 
HubertusB: folds 
bilosama: folds 
Dudugalo1313: folds 
quaackk has timed out while disconnected
quaackk: folds 
Uncalled bet ($0.10) returned to Maroshi99
Maroshi99 collected $0.12 from pot
Maroshi99: doesn't show hand 
*** SUMMARY ***
Total pot $0.12 | Rake $0 
Seat 1: bilosama (button) folded before Flop (didn't bet)
Seat 2: Dudugalo1313 (small blind) folded before Flop
Seat 3: quaackk (big blind) folded before Flop
Seat 4: Maroshi99 collected ($0.12)
Seat 5: Rassty1983 folded before Flop (didn't bet)
Seat 6: HubertusB folded before Flop (didn't bet)



PokerStars Zoom Hand #177968995053:  Hold'em No Limit ($0.02/$0.05) - 2017/11/09 2:43:47 CCT [2017/11/08 13:43:47 ET]
Table 'Donati' 6-max Seat #1 is the button
Seat 1: jabbyjay ($5 in chips) 
Seat 2: HubertusB ($3.64 in chips) 
Seat 3: WEIPEI1 ($5.14 in chips) 
Seat 4: aForrester ($5 in chips) 
Seat 5: Machestr ($7.25 in chips) 
Seat 6: zmss ($6 in chips) 
HubertusB: posts small blind $0.02
WEIPEI1: posts big blind $0.05
*** HOLE CARDS ***
Dealt to HubertusB [Jd 9s]
aForrester: folds 
Machestr: folds 
zmss: folds 
jabbyjay: folds 
HubertusB: folds 
Uncalled bet ($0.03) returned to WEIPEI1
WEIPEI1 collected $0.04 from pot
WEIPEI1: doesn't show hand 
*** SUMMARY ***
Total pot $0.04 | Rake $0 
Seat 1: jabbyjay (button) folded before Flop (didn't bet)
Seat 2: HubertusB (small blind) folded before Flop
Seat 3: WEIPEI1 (big blind) collected ($0.04)
Seat 4: aForrester folded before Flop (didn't bet)
Seat 5: Machestr folded before Flop (didn't bet)
Seat 6: zmss folded before Flop (didn't bet)



PokerStars Zoom Hand #177968959717:  Hold'em No Limit ($0.02/$0.05) - 2017/11/09 2:43:03 CCT [2017/11/08 13:43:03 ET]
Table 'Donati' 6-max Seat #1 is the button
Seat 1: serg-hw ($5 in chips) 
Seat 2: HubertusB ($3.64 in chips) 
Seat 3: kapsidis420 ($5.27 in chips) 
Seat 4: Shurik389 ($4.55 in chips) 
Seat 5: CykuHKOT ($2.86 in chips) 
Seat 6: VignettenMan ($4.93 in chips) 
HubertusB: posts small blind $0.02
kapsidis420: posts big blind $0.05
*** HOLE CARDS ***
Dealt to HubertusB [8c 9c]
Shurik389: folds 
CykuHKOT: folds 
VignettenMan: folds 
serg-hw: raises $0.08 to $0.13
HubertusB: folds 
kapsidis420: calls $0.08
*** FLOP *** [5c 6c 7h]
kapsidis420: checks 
serg-hw: checks 
*** TURN *** [5c 6c 7h] [5s]
kapsidis420: checks 
serg-hw: checks 
*** RIVER *** [5c 6c 7h 5s] [3h]
kapsidis420: bets $0.25
serg-hw: folds 
Uncalled bet ($0.25) returned to kapsidis420
kapsidis420 collected $0.27 from pot
kapsidis420: doesn't show hand 
*** SUMMARY ***
Total pot $0.28 | Rake $0.01 
Board [5c 6c 7h 5s 3h]
Seat 1: serg-hw (button) folded on the River
Seat 2: HubertusB (small blind) folded before Flop
Seat 3: kapsidis420 (big blind) collected ($0.27)
Seat 4: Shurik389 folded before Flop (didn't bet)
Seat 5: CykuHKOT folded before Flop (didn't bet)
Seat 6: VignettenMan folded before Flop (didn't bet)



PokerStars Zoom Hand #177968999015:  Hold'em No Limit ($0.02/$0.05) - 2017/11/09 2:43:52 CCT [2017/11/08 13:43:52 ET]
Table 'Donati' 6-max Seat #1 is the button
Seat 1: HubertusB ($3.62 in chips) 
Seat 2: Yahan588 ($5 in chips) 
Seat 3: magabas ($10.58 in chips) 
Seat 4: WisherBG ($5.27 in chips) 
Seat 5: robbson77 ($1.40 in chips) 
Seat 6: slick.nov ($4.85 in chips) 
Yahan588: posts small blind $0.02
magabas: posts big blind $0.05
*** HOLE CARDS ***
Dealt to HubertusB [3c 3d]
WisherBG: folds 
robbson77: folds 
slick.nov: raises $0.10 to $0.15
HubertusB: folds 
Yahan588: folds 
magabas: folds 
Uncalled bet ($0.10) returned to slick.nov
slick.nov collected $0.12 from pot
slick.nov: doesn't show hand 
*** SUMMARY ***
Total pot $0.12 | Rake $0 
Seat 1: HubertusB (button) folded before Flop (didn't bet)
Seat 2: Yahan588 (small blind) folded before Flop
Seat 3: magabas (big blind) folded before Flop
Seat 4: WisherBG folded before Flop (didn't bet)
Seat 5: robbson77 folded before Flop (didn't bet)
Seat 6: slick.nov collected ($0.12)



PokerStars Zoom Hand #177969007873:  Hold'em No Limit ($0.02/$0.05) - 2017/11/09 2:44:03 CCT [2017/11/08 13:44:03 ET]
Table 'Donati' 6-max Seat #1 is the button
Seat 1: Rassty1983 ($5.99 in chips) 
Seat 2: needluck89 ($6.32 in chips) 
Seat 3: NrgSobol ($5.68 in chips) 
Seat 4: GeorgSL1 ($4.95 in chips) 
Seat 5: Ignite13 ($13.35 in chips) 
Seat 6: HubertusB ($3.62 in chips) 
needluck89: posts small blind $0.02
NrgSobol: posts big blind $0.05
*** HOLE CARDS ***
Dealt to HubertusB [Ks 5d]
GeorgSL1: folds 
Ignite13: folds 
HubertusB: folds 
Rassty1983: folds 
needluck89: folds 
Uncalled bet ($0.03) returned to NrgSobol
NrgSobol collected $0.04 from pot
NrgSobol: doesn't show hand 
*** SUMMARY ***
Total pot $0.04 | Rake $0 
Seat 1: Rassty1983 (button) folded before Flop (didn't bet)
Seat 2: needluck89 (small blind) folded before Flop
Seat 3: NrgSobol (big blind) collected ($0.04)
Seat 4: GeorgSL1 folded before Flop (didn't bet)
Seat 5: Ignite13 folded before Flop (didn't bet)
Seat 6: HubertusB folded before Flop (didn't bet)



PokerStars Zoom Hand #177969012784:  Hold'em No Limit ($0.02/$0.05) - 2017/11/09 2:44:09 CCT [2017/11/08 13:44:09 ET]
Table 'Donati' 6-max Seat #1 is the button
Seat 1: nonsensever ($6.68 in chips) 
Seat 2: IVANbI484 ($2.79 in chips) 
Seat 3: simple s0o ($6.53 in chips) 
Seat 4: HubertusB ($3.62 in chips) 
Seat 5: stormmindAAA ($8.52 in chips) 
Seat 6: Sonic.lg777 ($4.93 in chips) 
IVANbI484: posts small blind $0.02
simple s0o: posts big blind $0.05
*** HOLE CARDS ***
Dealt to HubertusB [Qs 6s]
HubertusB: folds 
stormmindAAA: folds 
Sonic.lg777: folds 
nonsensever: folds 
IVANbI484: raises $0.10 to $0.15
simple s0o: folds 
Uncalled bet ($0.10) returned to IVANbI484
IVANbI484 collected $0.10 from pot
IVANbI484: doesn't show hand 
*** SUMMARY ***
Total pot $0.10 | Rake $0 
Seat 1: nonsensever (button) folded before Flop (didn't bet)
Seat 2: IVANbI484 (small blind) collected ($0.10)
Seat 3: simple s0o (big blind) folded before Flop
Seat 4: HubertusB folded before Flop (didn't bet)
Seat 5: stormmindAAA folded before Flop (didn't bet)
Seat 6: Sonic.lg777 folded before Flop (didn't bet)



PokerStars Zoom Hand #177969017428:  Hold'em No Limit ($0.02/$0.05) - 2017/11/09 2:44:15 CCT [2017/11/08 13:44:15 ET]
Table 'Donati' 6-max Seat #1 is the button
Seat 1: astra1206 ($2.01 in chips) 
Seat 2: taraxako$ ($6.68 in chips) 
Seat 3: MyTrips70 ($5.93 in chips) 
Seat 4: pussd ($6.58 in chips) 
Seat 5: HubertusB ($3.62 in chips) 
Seat 6: ivan19921 ($5.30 in chips) 
taraxako$: posts small blind $0.02
MyTrips70: posts big blind $0.05
*** HOLE CARDS ***
Dealt to HubertusB [3c Qd]
pussd: folds 
HubertusB: folds 
ivan19921: folds 
astra1206: folds 
taraxako$: folds 
Uncalled bet ($0.03) returned to MyTrips70
MyTrips70 collected $0.04 from pot
MyTrips70: doesn't show hand 
*** SUMMARY ***
Total pot $0.04 | Rake $0 
Seat 1: astra1206 (button) folded before Flop (didn't bet)
Seat 2: taraxako$ (small blind) folded before Flop
Seat 3: MyTrips70 (big blind) collected ($0.04)
Seat 4: pussd folded before Flop (didn't bet)
Seat 5: HubertusB folded before Flop (didn't bet)
Seat 6: ivan19921 folded before Flop (didn't bet)



PokerStars Zoom Hand #177969022184:  Hold'em No Limit ($0.02/$0.05) - 2017/11/09 2:44:21 CCT [2017/11/08 13:44:21 ET]
Table 'Donati' 6-max Seat #1 is the button
Seat 1: magonzalez ($2.83 in chips) 
Seat 2: founder9 ($6.67 in chips) 
Seat 3: HubertusB ($3.62 in chips) 
Seat 4: magabas ($10.51 in chips) 
Seat 5: quaackk ($5 in chips) 
Seat 6: VignettenMan ($4.58 in chips) 
founder9: posts small blind $0.02
HubertusB: posts big blind $0.05
*** HOLE CARDS ***
Dealt to HubertusB [7h 7d]
magabas: folds 
quaackk: folds 
VignettenMan: folds 
magonzalez: folds 
founder9: folds 
Uncalled bet ($0.03) returned to HubertusB
HubertusB collected $0.04 from pot
HubertusB: doesn't show hand 
*** SUMMARY ***
Total pot $0.04 | Rake $0 
Seat 1: magonzalez (button) folded before Flop (didn't bet)
Seat 2: founder9 (small blind) folded before Flop
Seat 3: HubertusB (big blind) collected ($0.04)
Seat 4: magabas folded before Flop (didn't bet)
Seat 5: quaackk folded before Flop (didn't bet)
Seat 6: VignettenMan folded before Flop (didn't bet)



PokerStars Zoom Hand #177969033507:  Hold'em No Limit ($0.02/$0.05) - 2017/11/09 2:44:35 CCT [2017/11/08 13:44:35 ET]
Table 'Donati' 6-max Seat #1 is the button
Seat 1: HubertusB ($3.64 in chips) 
Seat 2: Lago Madjore ($6.10 in chips) 
Seat 3: Kreg Heg ($5.80 in chips) 
Seat 4: IVANbI484 ($2.84 in chips) 
Seat 5: devianin96 ($5.94 in chips) 
Seat 6: buboTN ($5.59 in chips) 
Lago Madjore: posts small blind $0.02
Kreg Heg: posts big blind $0.05
*** HOLE CARDS ***
Dealt to HubertusB [4d 3c]
IVANbI484: folds 
devianin96: folds 
buboTN: raises $0.10 to $0.15
HubertusB: folds 
Lago Madjore: folds 
Kreg Heg: folds 
Uncalled bet ($0.10) returned to buboTN
buboTN collected $0.12 from pot
buboTN: doesn't show hand 
*** SUMMARY ***
Total pot $0.12 | Rake $0 
Seat 1: HubertusB (button) folded before Flop (didn't bet)
Seat 2: Lago Madjore (small blind) folded before Flop
Seat 3: Kreg Heg (big blind) folded before Flop
Seat 4: IVANbI484 folded before Flop (didn't bet)
Seat 5: devianin96 folded before Flop (didn't bet)
Seat 6: buboTN collected ($0.12)



PokerStars Zoom Hand #177969041506:  Hold'em No Limit ($0.02/$0.05) - 2017/11/09 2:44:45 CCT [2017/11/08 13:44:45 ET]
Table 'Donati' 6-max Seat #1 is the button
Seat 1: Dudugalo1313 ($5.36 in chips) 
Seat 2: HubertusB ($3.64 in chips) 
Seat 3: Casady282 ($6.25 in chips) 
Seat 4: petokrcmar ($4.47 in chips) 
Seat 5: sojuice ($14.80 in chips) 
Seat 6: yourtsu ($2.20 in chips) 
HubertusB: posts small blind $0.02
Casady282: posts big blind $0.05
*** HOLE CARDS ***
Dealt to HubertusB [4s Tc]
petokrcmar: folds 
sojuice: folds 
yourtsu: folds 
Dudugalo1313: folds 
HubertusB: folds 
Uncalled bet ($0.03) returned to Casady282
Casady282 collected $0.04 from pot
Casady282: doesn't show hand 
*** SUMMARY ***
Total pot $0.04 | Rake $0 
Seat 1: Dudugalo1313 (button) folded before Flop (didn't bet)
Seat 2: HubertusB (small blind) folded before Flop
Seat 3: Casady282 (big blind) collected ($0.04)
Seat 4: petokrcmar folded before Flop (didn't bet)
Seat 5: sojuice folded before Flop (didn't bet)
Seat 6: yourtsu folded before Flop (didn't bet)



PokerStars Zoom Hand #177969054257:  Hold'em No Limit ($0.02/$0.05) - 2017/11/09 2:45:01 CCT [2017/11/08 13:45:01 ET]
Table 'Donati' 6-max Seat #1 is the button
Seat 1: HubertusB ($3.62 in chips) 
Seat 2: Smeja21 ($9.11 in chips) 
Seat 3: 34Wolf89 ($5.15 in chips) 
Seat 4: simple s0o ($5 in chips) 
Seat 5: Hobbotun174 ($6.73 in chips) 
Seat 6: woocha33 ($6.04 in chips) 
Smeja21: posts small blind $0.02
34Wolf89: posts big blind $0.05
*** HOLE CARDS ***
Dealt to HubertusB [Js 6d]
simple s0o: folds 
Hobbotun174: folds 
woocha33: folds 
HubertusB: raises $0.05 to $0.10
Smeja21: folds 
34Wolf89: folds 
Uncalled bet ($0.05) returned to HubertusB
HubertusB collected $0.12 from pot
HubertusB: doesn't show hand 
*** SUMMARY ***
Total pot $0.12 | Rake $0 
Seat 1: HubertusB (button) collected ($0.12)
Seat 2: Smeja21 (small blind) folded before Flop
Seat 3: 34Wolf89 (big blind) folded before Flop
Seat 4: simple s0o folded before Flop (didn't bet)
Seat 5: Hobbotun174 folded before Flop (didn't bet)
Seat 6: woocha33 folded before Flop (didn't bet)



PokerStars Zoom Hand #177969049578:  Hold'em No Limit ($0.02/$0.05) - 2017/11/09 2:44:55 CCT [2017/11/08 13:44:55 ET]
Table 'Donati' 6-max Seat #1 is the button
Seat 1: Hxrtxng ($7.08 in chips) 
Seat 2: dumpassos ($12.35 in chips) 
Seat 3: RamaKK ($5.58 in chips) 
Seat 4: HubertusB ($3.62 in chips) 
Seat 5: StasoN445 ($9.86 in chips) 
Seat 6: gcz94 ($6.93 in chips) 
dumpassos: posts small blind $0.02
RamaKK: posts big blind $0.05
*** HOLE CARDS ***
Dealt to HubertusB [Qd 8h]
HubertusB: folds 
StasoN445: folds 
gcz94: folds 
Hxrtxng: folds 
dumpassos: raises $0.10 to $0.15
RamaKK: calls $0.10
*** FLOP *** [3s Td 5h]
dumpassos: bets $0.19
RamaKK: folds 
Uncalled bet ($0.19) returned to dumpassos
dumpassos collected $0.29 from pot
dumpassos: doesn't show hand 
*** SUMMARY ***
Total pot $0.30 | Rake $0.01 
Board [3s Td 5h]
Seat 1: Hxrtxng (button) folded before Flop (didn't bet)
Seat 2: dumpassos (small blind) collected ($0.29)
Seat 3: RamaKK (big blind) folded on the Flop
Seat 4: HubertusB folded before Flop (didn't bet)
Seat 5: StasoN445 folded before Flop (didn't bet)
Seat 6: gcz94 folded before Flop (didn't bet)



PokerStars Zoom Hand #177969067085:  Hold'em No Limit ($0.02/$0.05) - 2017/11/09 2:45:17 CCT [2017/11/08 13:45:17 ET]
Table 'Donati' 6-max Seat #1 is the button
Seat 1: Elchaza_1989 ($8.67 in chips) 
Seat 2: prochy1909 ($18.39 in chips) 
Seat 3: HubertusB ($3.69 in chips) 
Seat 4: Bunnytrickz7 ($3.49 in chips) 
Seat 5: D-TeamPro ($23.35 in chips) 
Seat 6: LamprosA ($9.49 in chips) 
prochy1909: posts small blind $0.02
HubertusB: posts big blind $0.05
*** HOLE CARDS ***
Dealt to HubertusB [5c As]
Bunnytrickz7: folds 
D-TeamPro: folds 
LamprosA: folds 
Elchaza_1989: raises $0.10 to $0.15
prochy1909: folds 
HubertusB: folds 
Uncalled bet ($0.10) returned to Elchaza_1989
Elchaza_1989 collected $0.12 from pot
Elchaza_1989: doesn't show hand 
*** SUMMARY ***
Total pot $0.12 | Rake $0 
Seat 1: Elchaza_1989 (button) collected ($0.12)
Seat 2: prochy1909 (small blind) folded before Flop
Seat 3: HubertusB (big blind) folded before Flop
Seat 4: Bunnytrickz7 folded before Flop (didn't bet)
Seat 5: D-TeamPro folded before Flop (didn't bet)
Seat 6: LamprosA folded before Flop (didn't bet)



PokerStars Zoom Hand #177969045544:  Hold'em No Limit ($0.02/$0.05) - 2017/11/09 2:44:50 CCT [2017/11/08 13:44:50 ET]
Table 'Donati' 6-max Seat #1 is the button
Seat 1: Aleksandrpby ($2.23 in chips) 
Seat 2: devianin96 ($5.89 in chips) 
Seat 3: VVTCH ($5 in chips) 
Seat 4: Planck88 ($5.14 in chips) 
Seat 5: LanSCrab ($5.17 in chips) 
Seat 6: HubertusB ($3.62 in chips) 
devianin96: posts small blind $0.02
VVTCH: posts big blind $0.05
*** HOLE CARDS ***
Dealt to HubertusB [Ts 7c]
Planck88: raises $0.09 to $0.14
LanSCrab: folds 
HubertusB: folds 
Aleksandrpby: folds 
devianin96: calls $0.12
VVTCH: folds 
*** FLOP *** [5s 4d 6s]
devianin96: checks 
Planck88: checks 
*** TURN *** [5s 4d 6s] [Td]
devianin96: bets $0.16
Planck88: folds 
Uncalled bet ($0.16) returned to devianin96
devianin96 collected $0.32 from pot
devianin96: doesn't show hand 
*** SUMMARY ***
Total pot $0.33 | Rake $0.01 
Board [5s 4d 6s Td]
Seat 1: Aleksandrpby (button) folded before Flop (didn't bet)
Seat 2: devianin96 (small blind) collected ($0.32)
Seat 3: VVTCH (big blind) folded before Flop
Seat 4: Planck88 folded on the Turn
Seat 5: LanSCrab folded before Flop (didn't bet)
Seat 6: HubertusB folded before Flop (didn't bet)



PokerStars Zoom Hand #177969077355:  Hold'em No Limit ($0.02/$0.05) - 2017/11/09 2:45:30 CCT [2017/11/08 13:45:30 ET]
Table 'Donati' 6-max Seat #1 is the button
Seat 1: Tosha550 ($6.76 in chips) 
Seat 2: timugin12 ($44.32 in chips) 
Seat 3: uwanttobeeme ($6.58 in chips) 
Seat 4: Kondr-KAV ($4.18 in chips) 
Seat 5: vickolay ($5 in chips) 
Seat 6: HubertusB ($3.62 in chips) 
timugin12: posts small blind $0.02
uwanttobeeme: posts big blind $0.05
*** HOLE CARDS ***
Dealt to HubertusB [4s Jh]
Kondr-KAV: folds 
vickolay: folds 
HubertusB: folds 
Tosha550: folds 
timugin12: folds 
Uncalled bet ($0.03) returned to uwanttobeeme
uwanttobeeme collected $0.04 from pot
uwanttobeeme: doesn't show hand 
*** SUMMARY ***
Total pot $0.04 | Rake $0 
Seat 1: Tosha550 (button) folded before Flop (didn't bet)
Seat 2: timugin12 (small blind) folded before Flop
Seat 3: uwanttobeeme (big blind) collected ($0.04)
Seat 4: Kondr-KAV folded before Flop (didn't bet)
Seat 5: vickolay folded before Flop (didn't bet)
Seat 6: HubertusB folded before Flop (didn't bet)



PokerStars Zoom Hand #177969081322:  Hold'em No Limit ($0.02/$0.05) - 2017/11/09 2:45:35 CCT [2017/11/08 13:45:35 ET]
Table 'Donati' 6-max Seat #1 is the button
Seat 1: EikeS ($5.07 in chips) 
Seat 2: SuperNazario ($4.27 in chips) 
Seat 3: Danilloo93 ($5.26 in chips) 
Seat 4: gcz94 ($6.86 in chips) 
Seat 5: HubertusB ($3.62 in chips) 
Seat 6: rrrmmpp ($7.44 in chips) 
SuperNazario: posts small blind $0.02
Danilloo93: posts big blind $0.05
*** HOLE CARDS ***
Dealt to HubertusB [4d Qs]
gcz94: raises $0.10 to $0.15
HubertusB: folds 
rrrmmpp: folds 
EikeS: folds 
SuperNazario: folds 
Danilloo93: folds 
Uncalled bet ($0.10) returned to gcz94
gcz94 collected $0.12 from pot
gcz94: doesn't show hand 
*** SUMMARY ***
Total pot $0.12 | Rake $0 
Seat 1: EikeS (button) folded before Flop (didn't bet)
Seat 2: SuperNazario (small blind) folded before Flop
Seat 3: Danilloo93 (big blind) folded before Flop
Seat 4: gcz94 collected ($0.12)
Seat 5: HubertusB folded before Flop (didn't bet)
Seat 6: rrrmmpp folded before Flop (didn't bet)



PokerStars Zoom Hand #177969089301:  Hold'em No Limit ($0.02/$0.05) - 2017/11/09 2:45:45 CCT [2017/11/08 13:45:45 ET]
Table 'Donati' 6-max Seat #1 is the button
Seat 1: zmss ($6.19 in chips) 
Seat 2: thekingdrogb ($5 in chips) 
Seat 3: kopatich52 ($4.34 in chips) 
Seat 4: Nomoney099 ($6.07 in chips) 
Seat 5: just_OTEZ ($5.91 in chips) 
Seat 6: HubertusB ($3.60 in chips) 
thekingdrogb: posts small blind $0.02
kopatich52: posts big blind $0.05
*** HOLE CARDS ***
Dealt to HubertusB [Kd 4s]
Nomoney099: folds 
just_OTEZ: raises $0.09 to $0.14
HubertusB: folds 
zmss: folds 
thekingdrogb: folds 
kopatich52: folds 
Uncalled bet ($0.09) returned to just_OTEZ
just_OTEZ collected $0.12 from pot
just_OTEZ: doesn't show hand 
*** SUMMARY ***
Total pot $0.12 | Rake $0 
Seat 1: zmss (button) folded before Flop (didn't bet)
Seat 2: thekingdrogb (small blind) folded before Flop
Seat 3: kopatich52 (big blind) folded before Flop
Seat 4: Nomoney099 folded before Flop (didn't bet)
Seat 5: just_OTEZ collected ($0.12)
Seat 6: HubertusB folded before Flop (didn't bet)



PokerStars Zoom Hand #177969085319:  Hold'em No Limit ($0.02/$0.05) - 2017/11/09 2:45:40 CCT [2017/11/08 13:45:40 ET]
Table 'Donati' 6-max Seat #1 is the button
Seat 1: misu2k ($4.92 in chips) 
Seat 2: HubertusB ($3.62 in chips) 
Seat 3: O0r4nga ($5.28 in chips) 
Seat 4: LumpyBadbeat ($7.47 in chips) 
Seat 5: mel1in ($5.54 in chips) 
Seat 6: wolnyjac ($5 in chips) 
HubertusB: posts small blind $0.02
O0r4nga: posts big blind $0.05
*** HOLE CARDS ***
Dealt to HubertusB [4h 8c]
LumpyBadbeat: raises $0.10 to $0.15
mel1in: folds 
wolnyjac: folds 
misu2k: folds 
HubertusB: folds 
O0r4nga has timed out
O0r4nga: folds 
Uncalled bet ($0.10) returned to LumpyBadbeat
LumpyBadbeat collected $0.12 from pot
LumpyBadbeat: doesn't show hand 
*** SUMMARY ***
Total pot $0.12 | Rake $0 
Seat 1: misu2k (button) folded before Flop (didn't bet)
Seat 2: HubertusB (small blind) folded before Flop
Seat 3: O0r4nga (big blind) folded before Flop
Seat 4: LumpyBadbeat collected ($0.12)
Seat 5: mel1in folded before Flop (didn't bet)
Seat 6: wolnyjac folded before Flop (didn't bet)



PokerStars Zoom Hand #177969072599:  Hold'em No Limit ($0.02/$0.05) - 2017/11/09 2:45:24 CCT [2017/11/08 13:45:24 ET]
Table 'Donati' 6-max Seat #1 is the button
Seat 1: GaaMaster95 ($5 in chips) 
Seat 2: HubertusB ($3.64 in chips) 
Seat 3: Sergei Mihn. ($11.23 in chips) 
Seat 4: awekisa ($6.10 in chips) 
Seat 5: Bashiroff43 ($5.39 in chips) 
Seat 6: CykuHKOT ($2.50 in chips) 
HubertusB: posts small blind $0.02
Sergei Mihn.: posts big blind $0.05
*** HOLE CARDS ***
Dealt to HubertusB [7h 8s]
awekisa: raises $0.10 to $0.15
Bashiroff43: folds 
CykuHKOT: folds 
GaaMaster95: folds 
HubertusB: folds 
Sergei Mihn.: calls $0.10
*** FLOP *** [3s 7c 6c]
Sergei Mihn.: checks 
awekisa: bets $0.16
Sergei Mihn.: calls $0.16
*** TURN *** [3s 7c 6c] [Ts]
Sergei Mihn.: checks 
awekisa: bets $0.31
Sergei Mihn.: calls $0.31
*** RIVER *** [3s 7c 6c Ts] [4d]
Sergei Mihn.: checks 
awekisa: checks 
*** SHOW DOWN ***
Sergei Mihn.: shows [9d 9c] (a pair of Nines)
awekisa: shows [Jc Js] (a pair of Jacks)
awekisa collected $1.21 from pot
*** SUMMARY ***
Total pot $1.26 | Rake $0.05 
Board [3s 7c 6c Ts 4d]
Seat 1: GaaMaster95 (button) folded before Flop (didn't bet)
Seat 2: HubertusB (small blind) folded before Flop
Seat 3: Sergei Mihn. (big blind) showed [9d 9c] and lost with a pair of Nines
Seat 4: awekisa showed [Jc Js] and won ($1.21) with a pair of Jacks
Seat 5: Bashiroff43 folded before Flop (didn't bet)
Seat 6: CykuHKOT folded before Flop (didn't bet)



PokerStars Zoom Hand #177969100506:  Hold'em No Limit ($0.02/$0.05) - 2017/11/09 2:45:59 CCT [2017/11/08 13:45:59 ET]
Table 'Donati' 6-max Seat #1 is the button
Seat 1: hceyms ($9.50 in chips) 
Seat 2: aodwntm ($7.95 in chips) 
Seat 3: HubertusB ($3.60 in chips) 
Seat 4: gurugeorge03 ($5.77 in chips) 
Seat 5: stormmindAAA ($9.32 in chips) 
Seat 6: max_polonez ($3.57 in chips) 
aodwntm: posts small blind $0.02
HubertusB: posts big blind $0.05
*** HOLE CARDS ***
Dealt to HubertusB [Ks 5h]
gurugeorge03: folds 
stormmindAAA: raises $0.10 to $0.15
max_polonez: folds 
hceyms: folds 
aodwntm: folds 
HubertusB: folds 
Uncalled bet ($0.10) returned to stormmindAAA
stormmindAAA collected $0.12 from pot
stormmindAAA: doesn't show hand 
*** SUMMARY ***
Total pot $0.12 | Rake $0 
Seat 1: hceyms (button) folded before Flop (didn't bet)
Seat 2: aodwntm (small blind) folded before Flop
Seat 3: HubertusB (big blind) folded before Flop
Seat 4: gurugeorge03 folded before Flop (didn't bet)
Seat 5: stormmindAAA collected ($0.12)
Seat 6: max_polonez folded before Flop (didn't bet)



PokerStars Zoom Hand #177969063141:  Hold'em No Limit ($0.02/$0.05) - 2017/11/09 2:45:12 CCT [2017/11/08 13:45:12 ET]
Table 'Donati' 6-max Seat #1 is the button
Seat 1: Fearless_men ($7.43 in chips) 
Seat 2: Whizar ($2.75 in chips) 
Seat 3: WINDTOY ($6.23 in chips) 
Seat 4: WEIPEI1 ($5 in chips) 
Seat 5: HubertusB ($3.69 in chips) 
Seat 6: needluck89 ($6.41 in chips) 
Whizar: posts small blind $0.02
WINDTOY: posts big blind $0.05
*** HOLE CARDS ***
Dealt to HubertusB [7c 5d]
WEIPEI1: folds 
HubertusB: folds 
needluck89: folds 
Fearless_men: raises $0.10 to $0.15
Whizar: folds 
WINDTOY: calls $0.10
*** FLOP *** [5s Tc 7s]
WINDTOY: checks 
Fearless_men: bets $0.19
WINDTOY: calls $0.19
*** TURN *** [5s Tc 7s] [Jh]
WINDTOY: checks 
Fearless_men: bets $0.40
WINDTOY: calls $0.40
*** RIVER *** [5s Tc 7s Jh] [Jd]
WINDTOY: checks 
Fearless_men: bets $0.86
WINDTOY: calls $0.86
*** SHOW DOWN ***
Fearless_men: shows [Js Qc] (three of a kind, Jacks)
WINDTOY: mucks hand 
Fearless_men collected $3.09 from pot
*** SUMMARY ***
Total pot $3.22 | Rake $0.13 
Board [5s Tc 7s Jh Jd]
Seat 1: Fearless_men (button) showed [Js Qc] and won ($3.09) with three of a kind, Jacks
Seat 2: Whizar (small blind) folded before Flop
Seat 3: WINDTOY (big blind) mucked [As Th]
Seat 4: WEIPEI1 folded before Flop (didn't bet)
Seat 5: HubertusB folded before Flop (didn't bet)
Seat 6: needluck89 folded before Flop (didn't bet)



PokerStars Zoom Hand #177969106118:  Hold'em No Limit ($0.02/$0.05) - 2017/11/09 2:46:06 CCT [2017/11/08 13:46:06 ET]
Table 'Donati' 6-max Seat #1 is the button
Seat 1: danjmekeru ($5 in chips) 
Seat 2: Badger4515 ($5.12 in chips) 
Seat 3: lisenok97 ($2.66 in chips) 
Seat 4: HubertusB ($3.55 in chips) 
Seat 5: deanAKQ ($3.16 in chips) 
Seat 6: woocha33 ($6.17 in chips) 
Badger4515: posts small blind $0.02
lisenok97: posts big blind $0.05
*** HOLE CARDS ***
Dealt to HubertusB [7h Kh]
HubertusB: raises $0.05 to $0.10
deanAKQ: folds 
woocha33: folds 
danjmekeru: folds 
Badger4515: folds 
lisenok97: folds 
Uncalled bet ($0.05) returned to HubertusB
HubertusB collected $0.12 from pot
HubertusB: doesn't show hand 
*** SUMMARY ***
Total pot $0.12 | Rake $0 
Seat 1: danjmekeru (button) folded before Flop (didn't bet)
Seat 2: Badger4515 (small blind) folded before Flop
Seat 3: lisenok97 (big blind) folded before Flop
Seat 4: HubertusB collected ($0.12)
Seat 5: deanAKQ folded before Flop (didn't bet)
Seat 6: woocha33 folded before Flop (didn't bet)



PokerStars Zoom Hand #177969119020:  Hold'em No Limit ($0.02/$0.05) - 2017/11/09 2:46:22 CCT [2017/11/08 13:46:22 ET]
Table 'Donati' 6-max Seat #1 is the button
Seat 1: yan moura ($2.23 in chips) 
Seat 2: DiegoRhcp13 ($7.25 in chips) 
Seat 3: IuDeX_777 ($4.92 in chips) 
Seat 4: VVTCH ($5.12 in chips) 
Seat 5: HubertusB ($3.62 in chips) 
Seat 6: Victor18gs ($2.28 in chips) 
DiegoRhcp13: posts small blind $0.02
IuDeX_777: posts big blind $0.05
*** HOLE CARDS ***
Dealt to HubertusB [6s Kc]
VVTCH: folds 
HubertusB: folds 
Victor18gs: folds 
yan moura: folds 
DiegoRhcp13: raises $0.10 to $0.15
IuDeX_777: folds 
Uncalled bet ($0.10) returned to DiegoRhcp13
DiegoRhcp13 collected $0.10 from pot
DiegoRhcp13: doesn't show hand 
*** SUMMARY ***
Total pot $0.10 | Rake $0 
Seat 1: yan moura (button) folded before Flop (didn't bet)
Seat 2: DiegoRhcp13 (small blind) collected ($0.10)
Seat 3: IuDeX_777 (big blind) folded before Flop
Seat 4: VVTCH folded before Flop (didn't bet)
Seat 5: HubertusB folded before Flop (didn't bet)
Seat 6: Victor18gs folded before Flop (didn't bet)



PokerStars Zoom Hand #177969096483:  Hold'em No Limit ($0.02/$0.05) - 2017/11/09 2:45:54 CCT [2017/11/08 13:45:54 ET]
Table 'Donati' 6-max Seat #1 is the button
Seat 1: HubertusB ($3.60 in chips) 
Seat 2: xroidsx ($3.89 in chips) 
Seat 3: sojuice ($4.14 in chips) 
Seat 4: sprinter1999 ($2.46 in chips) 
Seat 5: wuHomiePkr ($5.09 in chips) 
Seat 6: KOBRA7777 ($2.42 in chips) 
xroidsx: posts small blind $0.02
sojuice: posts big blind $0.05
*** HOLE CARDS ***
Dealt to HubertusB [Ts 6h]
sprinter1999: raises $0.12 to $0.17
wuHomiePkr: folds 
KOBRA7777: folds 
HubertusB: folds 
xroidsx: calls $0.15
sojuice: raises $0.53 to $0.70
sprinter1999: calls $0.53
xroidsx: calls $0.53
*** FLOP *** [7s Js 3s]
xroidsx: checks 
sojuice: checks 
sprinter1999: bets $0.05
xroidsx: raises $2.10 to $2.15
sojuice: folds 
sprinter1999: calls $1.71 and is all-in
Uncalled bet ($0.39) returned to xroidsx
*** TURN *** [7s Js 3s] [9d]
*** RIVER *** [7s Js 3s 9d] [Ah]
*** SHOW DOWN ***
xroidsx: shows [Qs 9s] (a flush, Queen high)
sprinter1999: shows [Ks 6s] (a flush, King high)
sprinter1999 collected $5.39 from pot
*** SUMMARY ***
Total pot $5.62 | Rake $0.23 
Board [7s Js 3s 9d Ah]
Seat 1: HubertusB (button) folded before Flop (didn't bet)
Seat 2: xroidsx (small blind) showed [Qs 9s] and lost with a flush, Queen high
Seat 3: sojuice (big blind) folded on the Flop
Seat 4: sprinter1999 showed [Ks 6s] and won ($5.39) with a flush, King high
Seat 5: wuHomiePkr folded before Flop (didn't bet)
Seat 6: KOBRA7777 folded before Flop (didn't bet)



PokerStars Zoom Hand #177969133366:  Hold'em No Limit ($0.02/$0.05) - 2017/11/09 2:46:40 CCT [2017/11/08 13:46:40 ET]
Table 'Donati' 6-max Seat #1 is the button
Seat 1: AlaNacho ($2.59 in chips) 
Seat 2: HubertusB ($3.62 in chips) 
Seat 3: DonRazVan18 ($16.68 in chips) 
Seat 4: arlequím ($7.60 in chips) 
Seat 5: veryfatjedi ($2.53 in chips) 
Seat 6: lisenok97 ($2.54 in chips) 
HubertusB: posts small blind $0.02
DonRazVan18: posts big blind $0.05
*** HOLE CARDS ***
Dealt to HubertusB [6d 7h]
arlequím: folds 
veryfatjedi: raises $0.10 to $0.15
lisenok97: folds 
AlaNacho: folds 
HubertusB: folds 
DonRazVan18: folds 
Uncalled bet ($0.10) returned to veryfatjedi
veryfatjedi collected $0.12 from pot
veryfatjedi: doesn't show hand 
*** SUMMARY ***
Total pot $0.12 | Rake $0 
Seat 1: AlaNacho (button) folded before Flop (didn't bet)
Seat 2: HubertusB (small blind) folded before Flop
Seat 3: DonRazVan18 (big blind) folded before Flop
Seat 4: arlequím folded before Flop (didn't bet)
Seat 5: veryfatjedi collected ($0.12)
Seat 6: lisenok97 folded before Flop (didn't bet)



PokerStars Zoom Hand #177969123822:  Hold'em No Limit ($0.02/$0.05) - 2017/11/09 2:46:28 CCT [2017/11/08 13:46:28 ET]
Table 'Donati' 6-max Seat #1 is the button
Seat 1: HubertusB ($3.62 in chips) 
Seat 2: thekingdrogb ($6.47 in chips) 
Seat 3: Elchaza_1989 ($8.81 in chips) 
Seat 4: lisenok97 ($2.59 in chips) 
Seat 5: sojuice ($4.85 in chips) 
Seat 6: XHerrTUMNUSX ($11.09 in chips) 
thekingdrogb: posts small blind $0.02
Elchaza_1989: posts big blind $0.05
*** HOLE CARDS ***
Dealt to HubertusB [6h 7s]
lisenok97: folds 
sojuice: folds 
XHerrTUMNUSX: raises $0.10 to $0.15
HubertusB: folds 
thekingdrogb: folds 
Elchaza_1989: calls $0.10
*** FLOP *** [Kd 3d Td]
Elchaza_1989: checks 
XHerrTUMNUSX: checks 
*** TURN *** [Kd 3d Td] [3c]
Elchaza_1989: checks 
XHerrTUMNUSX: checks 
*** RIVER *** [Kd 3d Td 3c] [2d]
Elchaza_1989: checks 
XHerrTUMNUSX: bets $0.16
Elchaza_1989: folds 
Uncalled bet ($0.16) returned to XHerrTUMNUSX
XHerrTUMNUSX collected $0.31 from pot
XHerrTUMNUSX: doesn't show hand 
*** SUMMARY ***
Total pot $0.32 | Rake $0.01 
Board [Kd 3d Td 3c 2d]
Seat 1: HubertusB (button) folded before Flop (didn't bet)
Seat 2: thekingdrogb (small blind) folded before Flop
Seat 3: Elchaza_1989 (big blind) folded on the River
Seat 4: lisenok97 folded before Flop (didn't bet)
Seat 5: sojuice folded before Flop (didn't bet)
Seat 6: XHerrTUMNUSX collected ($0.31)



PokerStars Zoom Hand #177969143013:  Hold'em No Limit ($0.02/$0.05) - 2017/11/09 2:46:52 CCT [2017/11/08 13:46:52 ET]
Table 'Donati' 6-max Seat #1 is the button
Seat 1: xamerrr ($5.47 in chips) 
Seat 2: zloy_dik ($6.83 in chips) 
Seat 3: hceyms ($9.55 in chips) 
Seat 4: HubertusB ($3.60 in chips) 
Seat 5: slick.nov ($4.68 in chips) 
Seat 6: KKKKypros ($4.93 in chips) 
zloy_dik: posts small blind $0.02
hceyms: posts big blind $0.05
*** HOLE CARDS ***
Dealt to HubertusB [As 3d]
HubertusB: folds 
slick.nov: raises $0.07 to $0.12
KKKKypros: folds 
xamerrr: folds 
zloy_dik: folds 
hceyms: folds 
Uncalled bet ($0.07) returned to slick.nov
slick.nov collected $0.12 from pot
slick.nov: doesn't show hand 
*** SUMMARY ***
Total pot $0.12 | Rake $0 
Seat 1: xamerrr (button) folded before Flop (didn't bet)
Seat 2: zloy_dik (small blind) folded before Flop
Seat 3: hceyms (big blind) folded before Flop
Seat 4: HubertusB folded before Flop (didn't bet)
Seat 5: slick.nov collected ($0.12)
Seat 6: KKKKypros folded before Flop (didn't bet)



PokerStars Zoom Hand #177969149438:  Hold'em No Limit ($0.02/$0.05) - 2017/11/09 2:47:00 CCT [2017/11/08 13:47:00 ET]
Table 'Donati' 6-max Seat #1 is the button
Seat 1: Odvajke1 ($5 in chips) 
Seat 2: Besfairdgemp ($9.88 in chips) 
Seat 3: HubertusB ($3.60 in chips) 
Seat 4: DAVIDOFF351 ($11.71 in chips) 
Seat 5: Tosha550 ($6.33 in chips) 
Seat 6: buboTN ($5.32 in chips) 
Besfairdgemp: posts small blind $0.02
HubertusB: posts big blind $0.05
*** HOLE CARDS ***
Dealt to HubertusB [Js 8d]
DAVIDOFF351: folds 
Tosha550: folds 
buboTN: raises $0.10 to $0.15
Odvajke1: raises $0.30 to $0.45
Besfairdgemp: folds 
HubertusB: folds 
buboTN: folds 
Uncalled bet ($0.30) returned to Odvajke1
Odvajke1 collected $0.37 from pot
Odvajke1: doesn't show hand 
*** SUMMARY ***
Total pot $0.37 | Rake $0 
Seat 1: Odvajke1 (button) collected ($0.37)
Seat 2: Besfairdgemp (small blind) folded before Flop
Seat 3: HubertusB (big blind) folded before Flop
Seat 4: DAVIDOFF351 folded before Flop (didn't bet)
Seat 5: Tosha550 folded before Flop (didn't bet)
Seat 6: buboTN folded before Flop



PokerStars Zoom Hand #177969157376:  Hold'em No Limit ($0.02/$0.05) - 2017/11/09 2:47:10 CCT [2017/11/08 13:47:10 ET]
Table 'Donati' 6-max Seat #1 is the button
Seat 1: kongor331977 ($7.73 in chips) 
Seat 2: Sarmatrus79 ($5.35 in chips) 
Seat 3: Whizar ($1.70 in chips) 
Seat 4: HubertusB ($3.55 in chips) 
Seat 5: AvagK ($3.71 in chips) 
Seat 6: AAs only ($9.48 in chips) 
Sarmatrus79: posts small blind $0.02
Whizar: posts big blind $0.05
*** HOLE CARDS ***
Dealt to HubertusB [Td 9h]
HubertusB: folds 
AvagK: raises $0.10 to $0.15
AAs only: folds 
kongor331977: folds 
Sarmatrus79: raises $0.15 to $0.30
Whizar: folds 
AvagK: calls $0.15
*** FLOP *** [Qc Qd Ts]
Sarmatrus79: checks 
AvagK: checks 
*** TURN *** [Qc Qd Ts] [6h]
Sarmatrus79: bets $0.50
AvagK: folds 
Uncalled bet ($0.50) returned to Sarmatrus79
Sarmatrus79 collected $0.62 from pot
Sarmatrus79: doesn't show hand 
*** SUMMARY ***
Total pot $0.65 | Rake $0.03 
Board [Qc Qd Ts 6h]
Seat 1: kongor331977 (button) folded before Flop (didn't bet)
Seat 2: Sarmatrus79 (small blind) collected ($0.62)
Seat 3: Whizar (big blind) folded before Flop
Seat 4: HubertusB folded before Flop (didn't bet)
Seat 5: AvagK folded on the Turn
Seat 6: AAs only folded before Flop (didn't bet)



PokerStars Zoom Hand #177969171824:  Hold'em No Limit ($0.02/$0.05) - 2017/11/09 2:47:28 CCT [2017/11/08 13:47:28 ET]
Table 'Donati' 6-max Seat #1 is the button
Seat 1: HubertusB ($3.55 in chips) 
Seat 2: bery91 ($3.55 in chips) 
Seat 3: crash. xxxx ($1.32 in chips) 
Seat 4: max_polonez ($4.33 in chips) 
Seat 5: begze ($9.62 in chips) 
Seat 6: SpecialForMe ($4.72 in chips) 
bery91: posts small blind $0.02
crash. xxxx: posts big blind $0.05
*** HOLE CARDS ***
Dealt to HubertusB [Qc 6d]
max_polonez: folds 
begze: folds 
SpecialForMe: folds 
HubertusB: raises $0.05 to $0.10
bery91: folds 
crash. xxxx: calls $0.05
*** FLOP *** [5c 3c As]
crash. xxxx: bets $0.05
HubertusB: raises $0.10 to $0.15
crash. xxxx: folds 
Uncalled bet ($0.10) returned to HubertusB
HubertusB collected $0.31 from pot
HubertusB: doesn't show hand 
*** SUMMARY ***
Total pot $0.32 | Rake $0.01 
Board [5c 3c As]
Seat 1: HubertusB (button) collected ($0.31)
Seat 2: bery91 (small blind) folded before Flop
Seat 3: crash. xxxx (big blind) folded on the Flop
Seat 4: max_polonez folded before Flop (didn't bet)
Seat 5: begze folded before Flop (didn't bet)
Seat 6: SpecialForMe folded before Flop (didn't bet)



PokerStars Zoom Hand #177969190995:  Hold'em No Limit ($0.02/$0.05) - 2017/11/09 2:47:52 CCT [2017/11/08 13:47:52 ET]
Table 'Donati' 6-max Seat #1 is the button
Seat 1: igorok198851 ($2.35 in chips) 
Seat 2: HubertusB ($3.71 in chips) 
Seat 3: CykuHKOT ($3.37 in chips) 
Seat 4: nfnfh83 ($3.72 in chips) 
Seat 5: taraxako$ ($2.90 in chips) 
Seat 6: CPUrul0r ($7.58 in chips) 
HubertusB: posts small blind $0.02
CykuHKOT: posts big blind $0.05
*** HOLE CARDS ***
Dealt to HubertusB [7s 8c]
nfnfh83: folds 
taraxako$: raises $0.10 to $0.15
CPUrul0r: folds 
igorok198851: folds 
HubertusB: folds 
CykuHKOT: folds 
Uncalled bet ($0.10) returned to taraxako$
taraxako$ collected $0.12 from pot
taraxako$: doesn't show hand 
*** SUMMARY ***
Total pot $0.12 | Rake $0 
Seat 1: igorok198851 (button) folded before Flop (didn't bet)
Seat 2: HubertusB (small blind) folded before Flop
Seat 3: CykuHKOT (big blind) folded before Flop
Seat 4: nfnfh83 folded before Flop (didn't bet)
Seat 5: taraxako$ collected ($0.12)
Seat 6: CPUrul0r folded before Flop (didn't bet)



PokerStars Zoom Hand #177969166888:  Hold'em No Limit ($0.02/$0.05) - 2017/11/09 2:47:22 CCT [2017/11/08 13:47:22 ET]
Table 'Donati' 6-max Seat #1 is the button
Seat 1: begze ($9.62 in chips) 
Seat 2: unpeuplus ($5.81 in chips) 
Seat 3: 216NL ($34.39 in chips) 
Seat 4: Gaston323 ($16.41 in chips) 
Seat 5: HubertusB ($3.55 in chips) 
Seat 6: hceyms ($7.20 in chips) 
unpeuplus: posts small blind $0.02
216NL: posts big blind $0.05
*** HOLE CARDS ***
Dealt to HubertusB [Qc 5d]
Gaston323: folds 
HubertusB: folds 
hceyms: raises $0.07 to $0.12
begze: folds 
unpeuplus: raises $0.17 to $0.29
216NL: folds 
hceyms: calls $0.17
*** FLOP *** [8d 6s Kd]
unpeuplus: checks 
hceyms: checks 
*** TURN *** [8d 6s Kd] [9h]
unpeuplus: checks 
hceyms: bets $0.45
unpeuplus: calls $0.45
*** RIVER *** [8d 6s Kd 9h] [Jd]
unpeuplus: checks 
hceyms: bets $0.97
unpeuplus: folds 
Uncalled bet ($0.97) returned to hceyms
hceyms collected $1.47 from pot
hceyms: doesn't show hand 
*** SUMMARY ***
Total pot $1.53 | Rake $0.06 
Board [8d 6s Kd 9h Jd]
Seat 1: begze (button) folded before Flop (didn't bet)
Seat 2: unpeuplus (small blind) folded on the River
Seat 3: 216NL (big blind) folded before Flop
Seat 4: Gaston323 folded before Flop (didn't bet)
Seat 5: HubertusB folded before Flop (didn't bet)
Seat 6: hceyms collected ($1.47)



PokerStars Zoom Hand #177969162862:  Hold'em No Limit ($0.02/$0.05) - 2017/11/09 2:47:17 CCT [2017/11/08 13:47:17 ET]
Table 'Donati' 6-max Seat #1 is the button
Seat 1: Tosha550 ($6.60 in chips) 
Seat 2: 25deluxe ($2.94 in chips) 
Seat 3: crossino ($5.38 in chips) 
Seat 4: zmss ($6.03 in chips) 
Seat 5: SikaTrx ($5.62 in chips) 
Seat 6: HubertusB ($3.55 in chips) 
25deluxe: posts small blind $0.02
crossino: posts big blind $0.05
*** HOLE CARDS ***
Dealt to HubertusB [4d 5c]
zmss: folds 
SikaTrx: raises $0.10 to $0.15
HubertusB: folds 
Tosha550: calls $0.15
25deluxe: folds 
crossino: calls $0.10
*** FLOP *** [Qh 5h Kd]
crossino: checks 
SikaTrx: checks 
Tosha550: checks 
*** TURN *** [Qh 5h Kd] [Ah]
crossino: bets $0.23
SikaTrx: folds 
Tosha550: folds 
Uncalled bet ($0.23) returned to crossino
crossino collected $0.45 from pot
crossino: doesn't show hand 
*** SUMMARY ***
Total pot $0.47 | Rake $0.02 
Board [Qh 5h Kd Ah]
Seat 1: Tosha550 (button) folded on the Turn
Seat 2: 25deluxe (small blind) folded before Flop
Seat 3: crossino (big blind) collected ($0.45)
Seat 4: zmss folded before Flop (didn't bet)
Seat 5: SikaTrx folded on the Turn
Seat 6: HubertusB folded before Flop (didn't bet)



PokerStars Zoom Hand #177969195811:  Hold'em No Limit ($0.02/$0.05) - 2017/11/09 2:47:58 CCT [2017/11/08 13:47:58 ET]
Table 'Donati' 6-max Seat #1 is the button
Seat 1: t$unami cr ($5.57 in chips) 
Seat 2: mps109 ($3.38 in chips) 
Seat 3: HubertusB ($3.69 in chips) 
Seat 4: 7OstapBender ($9.05 in chips) 
Seat 5: hellhippo ($7.96 in chips) 
Seat 6: BigBadPalm ($10.04 in chips) 
mps109: posts small blind $0.02
HubertusB: posts big blind $0.05
*** HOLE CARDS ***
Dealt to HubertusB [2h Tc]
7OstapBender: folds 
hellhippo: folds 
BigBadPalm: folds 
t$unami cr: folds 
mps109: folds 
Uncalled bet ($0.03) returned to HubertusB
HubertusB collected $0.04 from pot
HubertusB: doesn't show hand 
*** SUMMARY ***
Total pot $0.04 | Rake $0 
Seat 1: t$unami cr (button) folded before Flop (didn't bet)
Seat 2: mps109 (small blind) folded before Flop
Seat 3: HubertusB (big blind) collected ($0.04)
Seat 4: 7OstapBender folded before Flop (didn't bet)
Seat 5: hellhippo folded before Flop (didn't bet)
Seat 6: BigBadPalm folded before Flop (didn't bet)



PokerStars Zoom Hand #177969203866:  Hold'em No Limit ($0.02/$0.05) - 2017/11/09 2:48:08 CCT [2017/11/08 13:48:08 ET]
Table 'Donati' 6-max Seat #1 is the button
Seat 1: HubertusB ($3.71 in chips) 
Seat 2: ruba4ok555 ($5.64 in chips) 
Seat 3: LUIZ_NANINI1 ($15.67 in chips) 
Seat 4: veryfatjedi ($5.07 in chips) 
Seat 5: MaMi82 ($6.25 in chips) 
Seat 6: digi940 ($3.74 in chips) 
ruba4ok555: posts small blind $0.02
LUIZ_NANINI1: posts big blind $0.05
*** HOLE CARDS ***
Dealt to HubertusB [8d Jd]
veryfatjedi: folds 
MaMi82: raises $0.10 to $0.15
digi940: folds 
HubertusB: folds 
ruba4ok555: calls $0.13
LUIZ_NANINI1: folds 
*** FLOP *** [6d 9c 5s]
ruba4ok555: checks 
MaMi82: checks 
*** TURN *** [6d 9c 5s] [2d]
ruba4ok555: bets $0.20
MaMi82: folds 
Uncalled bet ($0.20) returned to ruba4ok555
ruba4ok555 collected $0.34 from pot
ruba4ok555: doesn't show hand 
*** SUMMARY ***
Total pot $0.35 | Rake $0.01 
Board [6d 9c 5s 2d]
Seat 1: HubertusB (button) folded before Flop (didn't bet)
Seat 2: ruba4ok555 (small blind) collected ($0.34)
Seat 3: LUIZ_NANINI1 (big blind) folded before Flop
Seat 4: veryfatjedi folded before Flop (didn't bet)
Seat 5: MaMi82 folded on the Turn
Seat 6: digi940 folded before Flop (didn't bet)



PokerStars Zoom Hand #177969209393:  Hold'em No Limit ($0.02/$0.05) - 2017/11/09 2:48:15 CCT [2017/11/08 13:48:15 ET]
Table 'Donati' 6-max Seat #1 is the button
Seat 1: sigsauer555 ($20.79 in chips) 
Seat 2: ooiaooao ($5 in chips) 
Seat 3: Daylor570 ($5.07 in chips) 
Seat 4: Kreg Heg ($8.48 in chips) 
Seat 5: navy463 ($8.51 in chips) 
Seat 6: HubertusB ($3.71 in chips) 
ooiaooao: posts small blind $0.02
Daylor570: posts big blind $0.05
*** HOLE CARDS ***
Dealt to HubertusB [Td Jd]
Kreg Heg: folds 
navy463: folds 
HubertusB: raises $0.08 to $0.13
sigsauer555: calls $0.13
ooiaooao: folds 
Daylor570: raises $0.32 to $0.45
HubertusB: calls $0.32
sigsauer555: calls $0.32
*** FLOP *** [7s Qs 8s]
Daylor570: checks 
HubertusB: checks 
sigsauer555: bets $4
Daylor570: folds 
HubertusB: folds 
Uncalled bet ($4) returned to sigsauer555
sigsauer555 collected $1.31 from pot
sigsauer555: doesn't show hand 
*** SUMMARY ***
Total pot $1.37 | Rake $0.06 
Board [7s Qs 8s]
Seat 1: sigsauer555 (button) collected ($1.31)
Seat 2: ooiaooao (small blind) folded before Flop
Seat 3: Daylor570 (big blind) folded on the Flop
Seat 4: Kreg Heg folded before Flop (didn't bet)
Seat 5: navy463 folded before Flop (didn't bet)
Seat 6: HubertusB folded on the Flop



PokerStars Zoom Hand #177969245392:  Hold'em No Limit ($0.02/$0.05) - 2017/11/09 2:49:00 CCT [2017/11/08 13:49:00 ET]
Table 'Donati' 6-max Seat #1 is the button
Seat 1: Yahan588 ($6.71 in chips) 
Seat 2: DAVIDOFF351 ($6.41 in chips) 
Seat 3: yayito0924 ($5 in chips) 
Seat 4: sojuice ($5.24 in chips) 
Seat 5: Sonic.lg777 ($3.29 in chips) 
Seat 6: HubertusB ($3.26 in chips) 
DAVIDOFF351: posts small blind $0.02
yayito0924: posts big blind $0.05
*** HOLE CARDS ***
Dealt to HubertusB [7c 3h]
sojuice: folds 
Sonic.lg777: folds 
HubertusB: folds 
Yahan588: raises $0.07 to $0.12
DAVIDOFF351: folds 
yayito0924: folds 
Uncalled bet ($0.07) returned to Yahan588
Yahan588 collected $0.12 from pot
Yahan588: doesn't show hand 
*** SUMMARY ***
Total pot $0.12 | Rake $0 
Seat 1: Yahan588 (button) collected ($0.12)
Seat 2: DAVIDOFF351 (small blind) folded before Flop
Seat 3: yayito0924 (big blind) folded before Flop
Seat 4: sojuice folded before Flop (didn't bet)
Seat 5: Sonic.lg777 folded before Flop (didn't bet)
Seat 6: HubertusB folded before Flop (didn't bet)



PokerStars Zoom Hand #177969259008:  Hold'em No Limit ($0.02/$0.05) - 2017/11/09 2:49:17 CCT [2017/11/08 13:49:17 ET]
Table 'Donati' 6-max Seat #1 is the button
Seat 1: gkougkou ($2.85 in chips) 
Seat 2: 216NL ($19.47 in chips) 
Seat 3: HubertusB ($3.26 in chips) 
Seat 4: Ignite13 ($12.84 in chips) 
Seat 5: kllons ($4.93 in chips) 
Seat 6: schaemic ($13.83 in chips) 
216NL: posts small blind $0.02
HubertusB: posts big blind $0.05
*** HOLE CARDS ***
Dealt to HubertusB [Kd 6h]
Ignite13: folds 
kllons: folds 
schaemic: folds 
gkougkou: folds 
216NL: raises $0.05 to $0.10
HubertusB: folds 
Uncalled bet ($0.05) returned to 216NL
216NL collected $0.10 from pot
216NL: doesn't show hand 
*** SUMMARY ***
Total pot $0.10 | Rake $0 
Seat 1: gkougkou (button) folded before Flop (didn't bet)
Seat 2: 216NL (small blind) collected ($0.10)
Seat 3: HubertusB (big blind) folded before Flop
Seat 4: Ignite13 folded before Flop (didn't bet)
Seat 5: kllons folded before Flop (didn't bet)
Seat 6: schaemic folded before Flop (didn't bet)



PokerStars Zoom Hand #177969270973:  Hold'em No Limit ($0.02/$0.05) - 2017/11/09 2:49:32 CCT [2017/11/08 13:49:32 ET]
Table 'Donati' 6-max Seat #1 is the button
Seat 1: prochy1909 ($7.87 in chips) 
Seat 2: HubertusB ($3.21 in chips) 
Seat 3: Vindictive69 ($14.29 in chips) 
Seat 4: Doctuss ($5.99 in chips) 
Seat 5: Geopgiy ($2.22 in chips) 
Seat 6: Odvajke1 ($5 in chips) 
HubertusB: posts small blind $0.02
Vindictive69: posts big blind $0.05
*** HOLE CARDS ***
Dealt to HubertusB [Ah As]
Doctuss: folds 
Geopgiy: calls $0.05
Odvajke1: folds 
prochy1909: folds 
HubertusB: raises $0.25 to $0.30
Vindictive69: folds 
Geopgiy: calls $0.25
*** FLOP *** [6h 4c 7h]
HubertusB: bets $0.34
Geopgiy: folds 
Uncalled bet ($0.34) returned to HubertusB
HubertusB collected $0.62 from pot
HubertusB: doesn't show hand 
*** SUMMARY ***
Total pot $0.65 | Rake $0.03 
Board [6h 4c 7h]
Seat 1: prochy1909 (button) folded before Flop (didn't bet)
Seat 2: HubertusB (small blind) collected ($0.62)
Seat 3: Vindictive69 (big blind) folded before Flop
Seat 4: Doctuss folded before Flop (didn't bet)
Seat 5: Geopgiy folded on the Flop
Seat 6: Odvajke1 folded before Flop (didn't bet)



PokerStars Zoom Hand #177969255047:  Hold'em No Limit ($0.02/$0.05) - 2017/11/09 2:49:12 CCT [2017/11/08 13:49:12 ET]
Table 'Donati' 6-max Seat #1 is the button
Seat 1: quaackk ($5.85 in chips) 
Seat 2: crappyquads ($5 in chips) 
Seat 3: witto666 ($5 in chips) 
Seat 4: HubertusB ($3.26 in chips) 
Seat 5: jabbyjay ($5.56 in chips) 
Seat 6: fibonacci000 ($5.37 in chips) 
crappyquads: posts small blind $0.02
witto666: posts big blind $0.05
*** HOLE CARDS ***
Dealt to HubertusB [5d Ts]
HubertusB: folds 
jabbyjay: folds 
fibonacci000: raises $0.10 to $0.15
quaackk: folds 
crappyquads: folds 
witto666: calls $0.10
*** FLOP *** [3d Jc Qc]
witto666: bets $0.05
fibonacci000: calls $0.05
*** TURN *** [3d Jc Qc] [6h]
witto666: bets $0.40
fibonacci000: folds 
Uncalled bet ($0.40) returned to witto666
witto666 collected $0.40 from pot
witto666: doesn't show hand 
*** SUMMARY ***
Total pot $0.42 | Rake $0.02 
Board [3d Jc Qc 6h]
Seat 1: quaackk (button) folded before Flop (didn't bet)
Seat 2: crappyquads (small blind) folded before Flop
Seat 3: witto666 (big blind) collected ($0.40)
Seat 4: HubertusB folded before Flop (didn't bet)
Seat 5: jabbyjay folded before Flop (didn't bet)
Seat 6: fibonacci000 folded on the Turn



PokerStars Zoom Hand #177969290094:  Hold'em No Limit ($0.02/$0.05) - 2017/11/09 2:49:56 CCT [2017/11/08 13:49:56 ET]
Table 'Donati' 6-max Seat #1 is the button
Seat 1: Martinbá ($9.85 in chips) 
Seat 2: moozeev ($8.06 in chips) 
Seat 3: prochy1909 ($7.38 in chips) 
Seat 4: awekisa ($8.23 in chips) 
Seat 5: HubertusB ($3.53 in chips) 
Seat 6: rrrmmpp ($4.80 in chips) 
moozeev: posts small blind $0.02
prochy1909: posts big blind $0.05
*** HOLE CARDS ***
Dealt to HubertusB [5d Kd]
awekisa: folds 
HubertusB: folds 
rrrmmpp: raises $0.10 to $0.15
Martinbá: folds 
moozeev: folds 
prochy1909: folds 
Uncalled bet ($0.10) returned to rrrmmpp
rrrmmpp collected $0.12 from pot
rrrmmpp: doesn't show hand 
*** SUMMARY ***
Total pot $0.12 | Rake $0 
Seat 1: Martinbá (button) folded before Flop (didn't bet)
Seat 2: moozeev (small blind) folded before Flop
Seat 3: prochy1909 (big blind) folded before Flop
Seat 4: awekisa folded before Flop (didn't bet)
Seat 5: HubertusB folded before Flop (didn't bet)
Seat 6: rrrmmpp collected ($0.12)



PokerStars Zoom Hand #177969295667:  Hold'em No Limit ($0.02/$0.05) - 2017/11/09 2:50:03 CCT [2017/11/08 13:50:03 ET]
Table 'Donati' 6-max Seat #1 is the button
Seat 1: xBankie ($6.52 in chips) 
Seat 2: 1Cart ($5.20 in chips) 
Seat 3: oleg777886 ($5 in chips) 
Seat 4: HubertusB ($3.53 in chips) 
Seat 5: quaackk ($5.69 in chips) 
Seat 6: MarishaR63 ($5.48 in chips) 
1Cart: posts small blind $0.02
oleg777886: posts big blind $0.05
*** HOLE CARDS ***
Dealt to HubertusB [2d Ad]
HubertusB: raises $0.05 to $0.10
quaackk: folds 
MarishaR63: folds 
xBankie: folds 
1Cart: folds 
oleg777886: folds 
Uncalled bet ($0.05) returned to HubertusB
HubertusB collected $0.12 from pot
HubertusB: doesn't show hand 
*** SUMMARY ***
Total pot $0.12 | Rake $0 
Seat 1: xBankie (button) folded before Flop (didn't bet)
Seat 2: 1Cart (small blind) folded before Flop
Seat 3: oleg777886 (big blind) folded before Flop
Seat 4: HubertusB collected ($0.12)
Seat 5: quaackk folded before Flop (didn't bet)
Seat 6: MarishaR63 folded before Flop (didn't bet)



PokerStars Zoom Hand #177969309852:  Hold'em No Limit ($0.02/$0.05) - 2017/11/09 2:50:21 CCT [2017/11/08 13:50:21 ET]
Table 'Donati' 6-max Seat #1 is the button
Seat 1: navy463 ($6.53 in chips) 
Seat 2: Roxstar_81 ($5.29 in chips) 
Seat 3: SikaTrx ($8.79 in chips) 
Seat 4: sanja2007789 ($8.40 in chips) 
Seat 5: HubertusB ($3.60 in chips) 
Seat 6: Yahan588 ($6.10 in chips) 
Roxstar_81: posts small blind $0.02
SikaTrx: posts big blind $0.05
*** HOLE CARDS ***
Dealt to HubertusB [9h 8c]
sanja2007789: folds 
HubertusB: folds 
Yahan588: folds 
navy463: folds 
Roxstar_81: raises $0.10 to $0.15
SikaTrx: folds 
Uncalled bet ($0.10) returned to Roxstar_81
Roxstar_81 collected $0.10 from pot
Roxstar_81: doesn't show hand 
*** SUMMARY ***
Total pot $0.10 | Rake $0 
Seat 1: navy463 (button) folded before Flop (didn't bet)
Seat 2: Roxstar_81 (small blind) collected ($0.10)
Seat 3: SikaTrx (big blind) folded before Flop
Seat 4: sanja2007789 folded before Flop (didn't bet)
Seat 5: HubertusB folded before Flop (didn't bet)
Seat 6: Yahan588 folded before Flop (didn't bet)



PokerStars Zoom Hand #177969323339:  Hold'em No Limit ($0.02/$0.05) - 2017/11/09 2:50:38 CCT [2017/11/08 13:50:38 ET]
Table 'Donati' 6-max Seat #1 is the button
Seat 1: slick.nov ($5.25 in chips) 
Seat 2: Smeja21 ($7.11 in chips) 
Seat 3: HubertusB ($3.58 in chips) 
Seat 4: D-TeamPro ($23.36 in chips) 
Seat 5: t$unami cr ($7.48 in chips) 
Seat 6: Zarec ($10.51 in chips) 
Smeja21: posts small blind $0.02
HubertusB: posts big blind $0.05
*** HOLE CARDS ***
Dealt to HubertusB [Jh Kh]
D-TeamPro: folds 
t$unami cr: folds 
Zarec: folds 
slick.nov: folds 
Smeja21: folds 
Uncalled bet ($0.03) returned to HubertusB
HubertusB collected $0.04 from pot
HubertusB: doesn't show hand 
*** SUMMARY ***
Total pot $0.04 | Rake $0 
Seat 1: slick.nov (button) folded before Flop (didn't bet)
Seat 2: Smeja21 (small blind) folded before Flop
Seat 3: HubertusB (big blind) collected ($0.04)
Seat 4: D-TeamPro folded before Flop (didn't bet)
Seat 5: t$unami cr folded before Flop (didn't bet)
Seat 6: Zarec folded before Flop (didn't bet)



PokerStars Zoom Hand #177969315450:  Hold'em No Limit ($0.02/$0.05) - 2017/11/09 2:50:28 CCT [2017/11/08 13:50:28 ET]
Table 'Donati' 6-max Seat #1 is the button
Seat 1: Andrey171410 ($5 in chips) 
Seat 2: HubertusB ($3.60 in chips) 
Seat 3: ritual11 ($5 in chips) 
Seat 4: O0r4nga ($14.26 in chips) 
Seat 5: CrawlForSun ($5.95 in chips) 
Seat 6: dysteven ($5.28 in chips) 
HubertusB: posts small blind $0.02
ritual11: posts big blind $0.05
*** HOLE CARDS ***
Dealt to HubertusB [2h Th]
O0r4nga: folds 
CrawlForSun: folds 
dysteven: folds 
Andrey171410: raises $0.07 to $0.12
HubertusB: folds 
ritual11: calls $0.07
*** FLOP *** [Ks 7h Qh]
ritual11: bets $0.15
Andrey171410: folds 
Uncalled bet ($0.15) returned to ritual11
ritual11 collected $0.25 from pot
ritual11: doesn't show hand 
*** SUMMARY ***
Total pot $0.26 | Rake $0.01 
Board [Ks 7h Qh]
Seat 1: Andrey171410 (button) folded on the Flop
Seat 2: HubertusB (small blind) folded before Flop
Seat 3: ritual11 (big blind) collected ($0.25)
Seat 4: O0r4nga folded before Flop (didn't bet)
Seat 5: CrawlForSun folded before Flop (didn't bet)
Seat 6: dysteven folded before Flop (didn't bet)



PokerStars Zoom Hand #177969333585:  Hold'em No Limit ($0.02/$0.05) - 2017/11/09 2:50:51 CCT [2017/11/08 13:50:51 ET]
Table 'Donati' 6-max Seat #1 is the button
Seat 1: HubertusB ($3.60 in chips) 
Seat 2: O0r4nga ($10.28 in chips) 
Seat 3: crazybogman ($6.98 in chips) 
Seat 4: Smeja21 ($5.50 in chips) 
Seat 5: Huaen ($7.64 in chips) 
Seat 6: yayito0924 ($5.05 in chips) 
O0r4nga: posts small blind $0.02
crazybogman: posts big blind $0.05
*** HOLE CARDS ***
Dealt to HubertusB [8s 2s]
Smeja21: folds 
Huaen: folds 
yayito0924: raises $0.07 to $0.12
HubertusB: folds 
O0r4nga: folds 
crazybogman: folds 
Uncalled bet ($0.07) returned to yayito0924
yayito0924 collected $0.12 from pot
yayito0924: doesn't show hand 
*** SUMMARY ***
Total pot $0.12 | Rake $0 
Seat 1: HubertusB (button) folded before Flop (didn't bet)
Seat 2: O0r4nga (small blind) folded before Flop
Seat 3: crazybogman (big blind) folded before Flop
Seat 4: Smeja21 folded before Flop (didn't bet)
Seat 5: Huaen folded before Flop (didn't bet)
Seat 6: yayito0924 collected ($0.12)



PokerStars Zoom Hand #177969338441:  Hold'em No Limit ($0.02/$0.05) - 2017/11/09 2:50:57 CCT [2017/11/08 13:50:57 ET]
Table 'Donati' 6-max Seat #1 is the button
Seat 1: HubertusB ($3.60 in chips) 
Seat 2: chiomar ($10.06 in chips) 
Seat 3: Migellx ($5.95 in chips) 
Seat 4: Dudugalo1313 ($7.42 in chips) 
Seat 5: oleg777886 ($5.14 in chips) 
Seat 6: fraudster405 ($6.03 in chips) 
chiomar: posts small blind $0.02
Migellx: posts big blind $0.05
*** HOLE CARDS ***
Dealt to HubertusB [6h 9h]
Dudugalo1313: folds 
oleg777886: folds 
fraudster405: folds 
HubertusB: raises $0.05 to $0.10
chiomar: folds 
Migellx: raises $0.28 to $0.38
HubertusB: folds 
Uncalled bet ($0.28) returned to Migellx
Migellx collected $0.22 from pot
Migellx: doesn't show hand 
*** SUMMARY ***
Total pot $0.22 | Rake $0 
Seat 1: HubertusB (button) folded before Flop
Seat 2: chiomar (small blind) folded before Flop
Seat 3: Migellx (big blind) collected ($0.22)
Seat 4: Dudugalo1313 folded before Flop (didn't bet)
Seat 5: oleg777886 folded before Flop (didn't bet)
Seat 6: fraudster405 folded before Flop (didn't bet)



PokerStars Zoom Hand #177969352752:  Hold'em No Limit ($0.02/$0.05) - 2017/11/09 2:51:15 CCT [2017/11/08 13:51:15 ET]
Table 'Donati' 6-max Seat #1 is the button
Seat 1: KOBRA7777 ($5.35 in chips) 
Seat 2: AlaNacho ($2.67 in chips) 
Seat 3: Aleksandrpby ($3.98 in chips) 
Seat 4: knorrr ($4.50 in chips) 
Seat 5: hceyms ($5.13 in chips) 
Seat 6: HubertusB ($3.50 in chips) 
AlaNacho: posts small blind $0.02
Aleksandrpby: posts big blind $0.05
*** HOLE CARDS ***
Dealt to HubertusB [Ac 4h]
knorrr: folds 
hceyms: raises $0.07 to $0.12
HubertusB: folds 
KOBRA7777: folds 
AlaNacho: folds 
Aleksandrpby: folds 
Uncalled bet ($0.07) returned to hceyms
hceyms collected $0.12 from pot
hceyms: doesn't show hand 
*** SUMMARY ***
Total pot $0.12 | Rake $0 
Seat 1: KOBRA7777 (button) folded before Flop (didn't bet)
Seat 2: AlaNacho (small blind) folded before Flop
Seat 3: Aleksandrpby (big blind) folded before Flop
Seat 4: knorrr folded before Flop (didn't bet)
Seat 5: hceyms collected ($0.12)
Seat 6: HubertusB folded before Flop (didn't bet)



PokerStars Zoom Hand #177969359154:  Hold'em No Limit ($0.02/$0.05) - 2017/11/09 2:51:23 CCT [2017/11/08 13:51:23 ET]
Table 'Donati' 6-max Seat #1 is the button
Seat 1: Aleks3215275 ($5.57 in chips) 
Seat 2: yayito0924 ($5.19 in chips) 
Seat 3: EikeS ($8.94 in chips) 
Seat 4: thekingdrogb ($5.19 in chips) 
Seat 5: bobcarpy ($1.14 in chips) 
Seat 6: HubertusB ($3.50 in chips) 
yayito0924: posts small blind $0.02
EikeS: posts big blind $0.05
*** HOLE CARDS ***
Dealt to HubertusB [Ac 2d]
thekingdrogb: folds 
bobcarpy: raises $1.09 to $1.14 and is all-in
HubertusB: folds 
Aleks3215275: folds 
yayito0924: folds 
EikeS: folds 
Uncalled bet ($1.09) returned to bobcarpy
bobcarpy collected $0.12 from pot
bobcarpy: doesn't show hand 
*** SUMMARY ***
Total pot $0.12 | Rake $0 
Seat 1: Aleks3215275 (button) folded before Flop (didn't bet)
Seat 2: yayito0924 (small blind) folded before Flop
Seat 3: EikeS (big blind) folded before Flop
Seat 4: thekingdrogb folded before Flop (didn't bet)
Seat 5: bobcarpy collected ($0.12)
Seat 6: HubertusB folded before Flop (didn't bet)



PokerStars Zoom Hand #177969363078:  Hold'em No Limit ($0.02/$0.05) - 2017/11/09 2:51:28 CCT [2017/11/08 13:51:28 ET]
Table 'Donati' 6-max Seat #1 is the button
Seat 1: charrua71 ($8.07 in chips) 
Seat 2: HubertusB ($3.50 in chips) 
Seat 3: Mr_Green1109 ($5.95 in chips) 
Seat 4: gcz94 ($11.50 in chips) 
Seat 5: sanja2007789 ($8.31 in chips) 
Seat 6: Fedex1976 ($3.58 in chips) 
HubertusB: posts small blind $0.02
Mr_Green1109: posts big blind $0.05
*** HOLE CARDS ***
Dealt to HubertusB [Js Ad]
gcz94: folds 
sanja2007789: folds 
Fedex1976: folds 
charrua71: folds 
HubertusB: raises $0.05 to $0.10
Mr_Green1109: folds 
Uncalled bet ($0.05) returned to HubertusB
HubertusB collected $0.10 from pot
HubertusB: doesn't show hand 
*** SUMMARY ***
Total pot $0.10 | Rake $0 
Seat 1: charrua71 (button) folded before Flop (didn't bet)
Seat 2: HubertusB (small blind) collected ($0.10)
Seat 3: Mr_Green1109 (big blind) folded before Flop
Seat 4: gcz94 folded before Flop (didn't bet)
Seat 5: sanja2007789 folded before Flop (didn't bet)
Seat 6: Fedex1976 folded before Flop (didn't bet)



PokerStars Zoom Hand #177969379274:  Hold'em No Limit ($0.02/$0.05) - 2017/11/09 2:51:48 CCT [2017/11/08 13:51:48 ET]
Table 'Donati' 6-max Seat #1 is the button
Seat 1: rikc7 ($5 in chips) 
Seat 2: PatriarhPk ($5 in chips) 
Seat 3: HubertusB ($3.55 in chips) 
Seat 4: mothership92 ($7.52 in chips) 
Seat 5: MOROZ056 ($9.11 in chips) 
Seat 6: SpjaldJB ($10.86 in chips) 
PatriarhPk: posts small blind $0.02
HubertusB: posts big blind $0.05
*** HOLE CARDS ***
Dealt to HubertusB [2h Kd]
mothership92: folds 
MOROZ056: folds 
SpjaldJB: folds 
rikc7: folds 
PatriarhPk: folds 
Uncalled bet ($0.03) returned to HubertusB
HubertusB collected $0.04 from pot
HubertusB: doesn't show hand 
*** SUMMARY ***
Total pot $0.04 | Rake $0 
Seat 1: rikc7 (button) folded before Flop (didn't bet)
Seat 2: PatriarhPk (small blind) folded before Flop
Seat 3: HubertusB (big blind) collected ($0.04)
Seat 4: mothership92 folded before Flop (didn't bet)
Seat 5: MOROZ056 folded before Flop (didn't bet)
Seat 6: SpjaldJB folded before Flop (didn't bet)



PokerStars Zoom Hand #177969385634:  Hold'em No Limit ($0.02/$0.05) - 2017/11/09 2:51:56 CCT [2017/11/08 13:51:56 ET]
Table 'Donati' 6-max Seat #1 is the button
Seat 1: aodwntm ($8.37 in chips) 
Seat 2: ooiaooao ($12.93 in chips) 
Seat 3: teluaa ($4.61 in chips) 
Seat 4: HubertusB ($3.57 in chips) 
Seat 5: hceyms ($8.40 in chips) 
Seat 6: lekayak ($4.93 in chips) 
ooiaooao: posts small blind $0.02
teluaa: posts big blind $0.05
*** HOLE CARDS ***
Dealt to HubertusB [3c Jd]
HubertusB: folds 
hceyms: raises $0.07 to $0.12
lekayak: folds 
aodwntm: folds 
ooiaooao: folds 
teluaa: folds 
Uncalled bet ($0.07) returned to hceyms
hceyms collected $0.12 from pot
hceyms: doesn't show hand 
*** SUMMARY ***
Total pot $0.12 | Rake $0 
Seat 1: aodwntm (button) folded before Flop (didn't bet)
Seat 2: ooiaooao (small blind) folded before Flop
Seat 3: teluaa (big blind) folded before Flop
Seat 4: HubertusB folded before Flop (didn't bet)
Seat 5: hceyms collected ($0.12)
Seat 6: lekayak folded before Flop (didn't bet)



PokerStars Zoom Hand #177969373573:  Hold'em No Limit ($0.02/$0.05) - 2017/11/09 2:51:41 CCT [2017/11/08 13:51:41 ET]
Table 'Donati' 6-max Seat #1 is the button
Seat 1: AAs only ($5.04 in chips) 
Seat 2: Rollex11 ($17.80 in chips) 
Seat 3: MaKyyyXaA ($7.59 in chips) 
Seat 4: Supamaggie ($8.12 in chips) 
Seat 5: HubertusB ($3.55 in chips) 
Seat 6: Zarec ($10.32 in chips) 
Rollex11: posts small blind $0.02
MaKyyyXaA: posts big blind $0.05
*** HOLE CARDS ***
Dealt to HubertusB [9c 6c]
Supamaggie: raises $0.07 to $0.12
HubertusB: folds 
Zarec: folds 
AAs only: calls $0.12
Rollex11: folds 
MaKyyyXaA: calls $0.07
*** FLOP *** [5c 2s 2h]
MaKyyyXaA: checks 
Supamaggie: checks 
AAs only: checks 
*** TURN *** [5c 2s 2h] [Js]
MaKyyyXaA: checks 
Supamaggie: checks 
AAs only: bets $0.18
MaKyyyXaA: folds 
Supamaggie: folds 
Uncalled bet ($0.18) returned to AAs only
AAs only collected $0.36 from pot
AAs only: doesn't show hand 
*** SUMMARY ***
Total pot $0.38 | Rake $0.02 
Board [5c 2s 2h Js]
Seat 1: AAs only (button) collected ($0.36)
Seat 2: Rollex11 (small blind) folded before Flop
Seat 3: MaKyyyXaA (big blind) folded on the Turn
Seat 4: Supamaggie folded on the Turn
Seat 5: HubertusB folded before Flop (didn't bet)
Seat 6: Zarec folded before Flop (didn't bet)



PokerStars Zoom Hand #177969389597:  Hold'em No Limit ($0.02/$0.05) - 2017/11/09 2:52:01 CCT [2017/11/08 13:52:01 ET]
Table 'Donati' 6-max Seat #1 is the button
Seat 1: HubertusB ($3.57 in chips) 
Seat 2: Tosha550 ($5.90 in chips) 
Seat 3: 216NL ($19.26 in chips) 
Seat 4: woocha33 ($4.79 in chips) 
Seat 5: melaphonefx ($2.64 in chips) 
Seat 6: BOSCOBOT ($5 in chips) 
Tosha550: posts small blind $0.02
216NL: posts big blind $0.05
*** HOLE CARDS ***
Dealt to HubertusB [Js Ks]
woocha33: folds 
melaphonefx: folds 
BOSCOBOT: folds 
HubertusB: raises $0.05 to $0.10
Tosha550: raises $0.29 to $0.39
216NL: folds 
HubertusB: calls $0.29
*** FLOP *** [8c 6s Kc]
Tosha550: bets $0.44
HubertusB: calls $0.44
*** TURN *** [8c 6s Kc] [6c]
Tosha550: bets $0.90
HubertusB: calls $0.90
*** RIVER *** [8c 6s Kc 6c] [3h]
Tosha550: checks 
HubertusB: checks 
*** SHOW DOWN ***
Tosha550: shows [Jh Jc] (two pair, Jacks and Sixes)
HubertusB: shows [Js Ks] (two pair, Kings and Sixes)
HubertusB collected $3.36 from pot
*** SUMMARY ***
Total pot $3.51 | Rake $0.15 
Board [8c 6s Kc 6c 3h]
Seat 1: HubertusB (button) showed [Js Ks] and won ($3.36) with two pair, Kings and Sixes
Seat 2: Tosha550 (small blind) showed [Jh Jc] and lost with two pair, Jacks and Sixes
Seat 3: 216NL (big blind) folded before Flop
Seat 4: woocha33 folded before Flop (didn't bet)
Seat 5: melaphonefx folded before Flop (didn't bet)
Seat 6: BOSCOBOT folded before Flop (didn't bet)



PokerStars Zoom Hand #177969457194:  Hold'em No Limit ($0.02/$0.05) - 2017/11/09 2:53:25 CCT [2017/11/08 13:53:25 ET]
Table 'Donati' 6-max Seat #1 is the button
Seat 1: 216NL ($19.14 in chips) 
Seat 2: lukasamace ($2.28 in chips) 
Seat 3: KKKKypros ($4.91 in chips) 
Seat 4: HubertusB ($5.18 in chips) 
Seat 5: A.Kavetskyi ($8.98 in chips) 
Seat 6: D-TeamPro ($9.40 in chips) 
lukasamace: posts small blind $0.02
KKKKypros: posts big blind $0.05
*** HOLE CARDS ***
Dealt to HubertusB [Ts 2d]
HubertusB: folds 
A.Kavetskyi: folds 
D-TeamPro: raises $0.10 to $0.15
216NL: folds 
lukasamace: folds 
KKKKypros: folds 
Uncalled bet ($0.10) returned to D-TeamPro
D-TeamPro collected $0.12 from pot
D-TeamPro: doesn't show hand 
*** SUMMARY ***
Total pot $0.12 | Rake $0 
Seat 1: 216NL (button) folded before Flop (didn't bet)
Seat 2: lukasamace (small blind) folded before Flop
Seat 3: KKKKypros (big blind) folded before Flop
Seat 4: HubertusB folded before Flop (didn't bet)
Seat 5: A.Kavetskyi folded before Flop (didn't bet)
Seat 6: D-TeamPro collected ($0.12)



PokerStars Zoom Hand #177969461300:  Hold'em No Limit ($0.02/$0.05) - 2017/11/09 2:53:30 CCT [2017/11/08 13:53:30 ET]
Table 'Donati' 6-max Seat #1 is the button
Seat 1: begze ($4.83 in chips) 
Seat 2: Hobbotun174 ($8.44 in chips) 
Seat 3: HubertusB ($5.18 in chips) 
Seat 4: buboTN ($6.36 in chips) 
Seat 5: Migellx ($5.53 in chips) 
Seat 6: GeorgSL1 ($7.51 in chips) 
Hobbotun174: posts small blind $0.02
HubertusB: posts big blind $0.05
*** HOLE CARDS ***
Dealt to HubertusB [Kh 6s]
buboTN: raises $0.10 to $0.15
Migellx: folds 
GeorgSL1: folds 
begze: folds 
Hobbotun174: folds 
HubertusB: folds 
Uncalled bet ($0.10) returned to buboTN
buboTN collected $0.12 from pot
buboTN: doesn't show hand 
*** SUMMARY ***
Total pot $0.12 | Rake $0 
Seat 1: begze (button) folded before Flop (didn't bet)
Seat 2: Hobbotun174 (small blind) folded before Flop
Seat 3: HubertusB (big blind) folded before Flop
Seat 4: buboTN collected ($0.12)
Seat 5: Migellx folded before Flop (didn't bet)
Seat 6: GeorgSL1 folded before Flop (didn't bet)



PokerStars Zoom Hand #177969452409:  Hold'em No Limit ($0.02/$0.05) - 2017/11/09 2:53:19 CCT [2017/11/08 13:53:19 ET]
Table 'Donati' 6-max Seat #1 is the button
Seat 1: barmaley_889 ($2.86 in chips) 
Seat 2: HubertusB ($5.20 in chips) 
Seat 3: Volke!n kz ($5.76 in chips) 
Seat 4: rrrmmpp ($6.29 in chips) 
Seat 5: Kreg Heg ($5.47 in chips) 
Seat 6: Dudugalo1313 ($7.48 in chips) 
HubertusB: posts small blind $0.02
Volke!n kz: posts big blind $0.05
*** HOLE CARDS ***
Dealt to HubertusB [Qh 7d]
rrrmmpp: raises $0.10 to $0.15
Kreg Heg has timed out
Kreg Heg: folds 
Dudugalo1313: folds 
barmaley_889: folds 
HubertusB: folds 
Volke!n kz: folds 
Uncalled bet ($0.10) returned to rrrmmpp
rrrmmpp collected $0.12 from pot
rrrmmpp: doesn't show hand 
*** SUMMARY ***
Total pot $0.12 | Rake $0 
Seat 1: barmaley_889 (button) folded before Flop (didn't bet)
Seat 2: HubertusB (small blind) folded before Flop
Seat 3: Volke!n kz (big blind) folded before Flop
Seat 4: rrrmmpp collected ($0.12)
Seat 5: Kreg Heg folded before Flop (didn't bet)
Seat 6: Dudugalo1313 folded before Flop (didn't bet)



PokerStars Zoom Hand #177969465448:  Hold'em No Limit ($0.02/$0.05) - 2017/11/09 2:53:35 CCT [2017/11/08 13:53:35 ET]
Table 'Donati' 6-max Seat #1 is the button
Seat 1: HubertusB ($5.13 in chips) 
Seat 2: melaphonefx ($4.65 in chips) 
Seat 3: dysteven ($4.48 in chips) 
Seat 4: MaKyyyXaA ($7.46 in chips) 
Seat 5: artem1103072 ($4.84 in chips) 
Seat 6: Dmialber ($5.02 in chips) 
melaphonefx: posts small blind $0.02
dysteven: posts big blind $0.05
*** HOLE CARDS ***
Dealt to HubertusB [Qd Jd]
MaKyyyXaA: folds 
artem1103072: folds 
Dmialber: folds 
HubertusB: raises $0.06 to $0.11
melaphonefx: calls $0.09
dysteven: folds 
*** FLOP *** [Js 2c 5c]
melaphonefx: bets $0.15
HubertusB: calls $0.15
*** TURN *** [Js 2c 5c] [6d]
melaphonefx: checks 
HubertusB: bets $0.23
melaphonefx: calls $0.23
*** RIVER *** [Js 2c 5c 6d] [9h]
melaphonefx: checks 
HubertusB: bets $0.10
melaphonefx: calls $0.10
*** SHOW DOWN ***
HubertusB: shows [Qd Jd] (a pair of Jacks)
melaphonefx: mucks hand 
HubertusB collected $1.18 from pot
*** SUMMARY ***
Total pot $1.23 | Rake $0.05 
Board [Js 2c 5c 6d 9h]
Seat 1: HubertusB (button) showed [Qd Jd] and won ($1.18) with a pair of Jacks
Seat 2: melaphonefx (small blind) mucked [5h 7h]
Seat 3: dysteven (big blind) folded before Flop
Seat 4: MaKyyyXaA folded before Flop (didn't bet)
Seat 5: artem1103072 folded before Flop (didn't bet)
Seat 6: Dmialber folded before Flop (didn't bet)



PokerStars Zoom Hand #177969495300:  Hold'em No Limit ($0.02/$0.05) - 2017/11/09 2:54:12 CCT [2017/11/08 13:54:12 ET]
Table 'Donati' 6-max Seat #1 is the button
Seat 1: HansGunter15 ($8.61 in chips) 
Seat 2: RagnarRebane ($8.55 in chips) 
Seat 3: Ignite13 ($10.29 in chips) 
Seat 4: petr 131313 ($6.95 in chips) 
Seat 5: domitorii ($5 in chips) 
Seat 6: HubertusB ($5.72 in chips) 
RagnarRebane: posts small blind $0.02
Ignite13: posts big blind $0.05
*** HOLE CARDS ***
Dealt to HubertusB [Ad Th]
petr 131313: raises $0.10 to $0.15
domitorii: folds 
HubertusB: folds 
HansGunter15: folds 
RagnarRebane: folds 
Ignite13: folds 
Uncalled bet ($0.10) returned to petr 131313
petr 131313 collected $0.12 from pot
petr 131313: doesn't show hand 
*** SUMMARY ***
Total pot $0.12 | Rake $0 
Seat 1: HansGunter15 (button) folded before Flop (didn't bet)
Seat 2: RagnarRebane (small blind) folded before Flop
Seat 3: Ignite13 (big blind) folded before Flop
Seat 4: petr 131313 collected ($0.12)
Seat 5: domitorii folded before Flop (didn't bet)
Seat 6: HubertusB folded before Flop (didn't bet)



PokerStars Zoom Hand #177969250233:  Hold'em No Limit ($0.02/$0.05) - 2017/11/09 2:49:06 CCT [2017/11/08 13:49:06 ET]
Table 'Donati' 6-max Seat #1 is the button
Seat 1: fafapk ($4.14 in chips) 
Seat 2: vinnikovplus ($5.30 in chips) 
Seat 3: CykuHKOT ($3.10 in chips) 
Seat 4: WINDTOY ($5.37 in chips) 
Seat 5: HubertusB ($3.26 in chips) 
Seat 6: mel1in ($6.67 in chips) 
vinnikovplus: posts small blind $0.02
CykuHKOT: posts big blind $0.05
*** HOLE CARDS ***
Dealt to HubertusB [Ts 2c]
WINDTOY: raises $0.10 to $0.15
HubertusB: folds 
mel1in: folds 
fafapk: calls $0.15
vinnikovplus: calls $0.13
CykuHKOT: folds 
*** FLOP *** [Jh 8h 4h]
vinnikovplus: bets $0.20
WINDTOY: calls $0.20
fafapk: raises $0.30 to $0.50
vinnikovplus: raises $0.50 to $1
WINDTOY: calls $0.80
fafapk: raises $1 to $2
vinnikovplus: raises $3.15 to $5.15 and is all-in
WINDTOY is disconnected 
WINDTOY is connected 
WINDTOY: folds 
fafapk: calls $1.99 and is all-in
Uncalled bet ($1.16) returned to vinnikovplus
*** TURN *** [Jh 8h 4h] [2s]
*** RIVER *** [Jh 8h 4h 2s] [7d]
*** SHOW DOWN ***
vinnikovplus: shows [3h 5h] (a flush, Jack high)
fafapk: shows [Ah 6h] (a flush, Ace high)
fafapk collected $9.09 from pot
*** SUMMARY ***
Total pot $9.48 | Rake $0.39 
Board [Jh 8h 4h 2s 7d]
Seat 1: fafapk (button) showed [Ah 6h] and won ($9.09) with a flush, Ace high
Seat 2: vinnikovplus (small blind) showed [3h 5h] and lost with a flush, Jack high
Seat 3: CykuHKOT (big blind) folded before Flop
Seat 4: WINDTOY folded on the Flop
Seat 5: HubertusB folded before Flop (didn't bet)
Seat 6: mel1in folded before Flop (didn't bet)



PokerStars Zoom Hand #177969501016:  Hold'em No Limit ($0.02/$0.05) - 2017/11/09 2:54:19 CCT [2017/11/08 13:54:19 ET]
Table 'Donati' 6-max Seat #1 is the button
Seat 1: Pro100PaPaN ($8.33 in chips) 
Seat 2: milimuki ($10.20 in chips) 
Seat 3: Ignite13 ($10.55 in chips) 
Seat 4: DmitrySh85 ($4.86 in chips) 
Seat 5: HubertusB ($5.72 in chips) 
Seat 6: williamnik ($4.78 in chips) 
milimuki: posts small blind $0.02
Ignite13: posts big blind $0.05
*** HOLE CARDS ***
Dealt to HubertusB [Kd 2s]
DmitrySh85: folds 
HubertusB: folds 
williamnik: folds 
Pro100PaPaN: raises $0.10 to $0.15
milimuki: folds 
Ignite13: calls $0.10
*** FLOP *** [Ah 8c 6h]
Ignite13: checks 
Pro100PaPaN: bets $0.20
Ignite13: folds 
Uncalled bet ($0.20) returned to Pro100PaPaN
Pro100PaPaN collected $0.31 from pot
Pro100PaPaN: doesn't show hand 
*** SUMMARY ***
Total pot $0.32 | Rake $0.01 
Board [Ah 8c 6h]
Seat 1: Pro100PaPaN (button) collected ($0.31)
Seat 2: milimuki (small blind) folded before Flop
Seat 3: Ignite13 (big blind) folded on the Flop
Seat 4: DmitrySh85 folded before Flop (didn't bet)
Seat 5: HubertusB folded before Flop (didn't bet)
Seat 6: williamnik folded before Flop (didn't bet)



PokerStars Zoom Hand #177969505872:  Hold'em No Limit ($0.02/$0.05) - 2017/11/09 2:54:25 CCT [2017/11/08 13:54:25 ET]
Table 'Donati' 6-max Seat #1 is the button
Seat 1: ilpan85 ($6.58 in chips) 
Seat 2: Danilloo93 ($5.78 in chips) 
Seat 3: MedChrize ($12.65 in chips) 
Seat 4: Badger4515 ($5.07 in chips) 
Seat 5: oleg667733d ($3.38 in chips) 
Seat 6: HubertusB ($5.72 in chips) 
Danilloo93: posts small blind $0.02
MedChrize: posts big blind $0.05
*** HOLE CARDS ***
Dealt to HubertusB [7h Qh]
Badger4515: folds 
oleg667733d: folds 
HubertusB: raises $0.05 to $0.10
ilpan85: folds 
Danilloo93: folds 
MedChrize: folds 
Uncalled bet ($0.05) returned to HubertusB
HubertusB collected $0.12 from pot
HubertusB: doesn't show hand 
*** SUMMARY ***
Total pot $0.12 | Rake $0 
Seat 1: ilpan85 (button) folded before Flop (didn't bet)
Seat 2: Danilloo93 (small blind) folded before Flop
Seat 3: MedChrize (big blind) folded before Flop
Seat 4: Badger4515 folded before Flop (didn't bet)
Seat 5: oleg667733d folded before Flop (didn't bet)
Seat 6: HubertusB collected ($0.12)



PokerStars Zoom Hand #177969528500:  Hold'em No Limit ($0.02/$0.05) - 2017/11/09 2:54:53 CCT [2017/11/08 13:54:53 ET]
Table 'Donati' 6-max Seat #1 is the button
Seat 1: korona14 ($5.15 in chips) 
Seat 2: hceyms ($5.68 in chips) 
Seat 3: HubertusB ($5.79 in chips) 
Seat 4: begze ($4.73 in chips) 
Seat 5: AAs only ($5.17 in chips) 
Seat 6: apoel89 ($4.77 in chips) 
hceyms: posts small blind $0.02
HubertusB: posts big blind $0.05
*** HOLE CARDS ***
Dealt to HubertusB [Jd 8s]
begze: folds 
AAs only: raises $0.12 to $0.17
apoel89: folds 
korona14: folds 
hceyms: folds 
HubertusB: folds 
Uncalled bet ($0.12) returned to AAs only
AAs only collected $0.12 from pot
AAs only: doesn't show hand 
*** SUMMARY ***
Total pot $0.12 | Rake $0 
Seat 1: korona14 (button) folded before Flop (didn't bet)
Seat 2: hceyms (small blind) folded before Flop
Seat 3: HubertusB (big blind) folded before Flop
Seat 4: begze folded before Flop (didn't bet)
Seat 5: AAs only collected ($0.12)
Seat 6: apoel89 folded before Flop (didn't bet)



PokerStars Zoom Hand #177969535686:  Hold'em No Limit ($0.02/$0.05) - 2017/11/09 2:55:02 CCT [2017/11/08 13:55:02 ET]
Table 'Donati' 6-max Seat #1 is the button
Seat 1: Fedex1976 ($5.09 in chips) 
Seat 2: astra1206 ($3.42 in chips) 
Seat 3: SartyBallz ($6.87 in chips) 
Seat 4: HubertusB ($5.74 in chips) 
Seat 5: paranoia235 ($5.72 in chips) 
Seat 6: stormmindAAA ($6.38 in chips) 
astra1206: posts small blind $0.02
SartyBallz: posts big blind $0.05
*** HOLE CARDS ***
Dealt to HubertusB [Js Qc]
HubertusB: raises $0.06 to $0.11
paranoia235: folds 
stormmindAAA: folds 
Fedex1976: folds 
astra1206: folds 
SartyBallz: calls $0.06
*** FLOP *** [8c 4h 9d]
SartyBallz: checks 
HubertusB: bets $0.10
SartyBallz: folds 
Uncalled bet ($0.10) returned to HubertusB
HubertusB collected $0.23 from pot
HubertusB: doesn't show hand 
*** SUMMARY ***
Total pot $0.24 | Rake $0.01 
Board [8c 4h 9d]
Seat 1: Fedex1976 (button) folded before Flop (didn't bet)
Seat 2: astra1206 (small blind) folded before Flop
Seat 3: SartyBallz (big blind) folded on the Flop
Seat 4: HubertusB collected ($0.23)
Seat 5: paranoia235 folded before Flop (didn't bet)
Seat 6: stormmindAAA folded before Flop (didn't bet)



PokerStars Zoom Hand #177969567503:  Hold'em No Limit ($0.02/$0.05) - 2017/11/09 2:55:48 CCT [2017/11/08 13:55:48 ET]
Table 'Donati' 6-max Seat #1 is the button
Seat 1: Ymnica15 ($10.41 in chips) 
Seat 2: Barra West ($12.86 in chips) 
Seat 3: LUTCUS ($5 in chips) 
Seat 4: HubertusB ($5.82 in chips) 
Seat 5: petr 131313 ($10.75 in chips) 
Seat 6: Danilloo93 ($5.18 in chips) 
Barra West: posts small blind $0.02
LUTCUS: posts big blind $0.05
*** HOLE CARDS ***
Dealt to HubertusB [Kh 3h]
HubertusB: folds 
petr 131313: folds 
Danilloo93: folds 
Ymnica15: folds 
Barra West: raises $0.10 to $0.15
LUTCUS: folds 
Uncalled bet ($0.10) returned to Barra West
Barra West collected $0.10 from pot
Barra West: doesn't show hand 
*** SUMMARY ***
Total pot $0.10 | Rake $0 
Seat 1: Ymnica15 (button) folded before Flop (didn't bet)
Seat 2: Barra West (small blind) collected ($0.10)
Seat 3: LUTCUS (big blind) folded before Flop
Seat 4: HubertusB folded before Flop (didn't bet)
Seat 5: petr 131313 folded before Flop (didn't bet)
Seat 6: Danilloo93 folded before Flop (didn't bet)



PokerStars Zoom Hand #177969563631:  Hold'em No Limit ($0.02/$0.05) - 2017/11/09 2:55:42 CCT [2017/11/08 13:55:42 ET]
Table 'Donati' 6-max Seat #1 is the button
Seat 1: fibonacci000 ($5.98 in chips) 
Seat 2: 1Cart ($5.70 in chips) 
Seat 3: mel1in ($10.26 in chips) 
Seat 4: Jarness II ($5 in chips) 
Seat 5: HubertusB ($5.82 in chips) 
Seat 6: coolgrays ($5.74 in chips) 
1Cart: posts small blind $0.02
mel1in: posts big blind $0.05
*** HOLE CARDS ***
Dealt to HubertusB [Jc Td]
Jarness II: folds 
HubertusB: folds 
coolgrays: raises $0.10 to $0.15
fibonacci000: folds 
1Cart: folds 
mel1in: folds 
Uncalled bet ($0.10) returned to coolgrays
coolgrays collected $0.12 from pot
coolgrays: doesn't show hand 
*** SUMMARY ***
Total pot $0.12 | Rake $0 
Seat 1: fibonacci000 (button) folded before Flop (didn't bet)
Seat 2: 1Cart (small blind) folded before Flop
Seat 3: mel1in (big blind) folded before Flop
Seat 4: Jarness II folded before Flop (didn't bet)
Seat 5: HubertusB folded before Flop (didn't bet)
Seat 6: coolgrays collected ($0.12)



PokerStars Zoom Hand #177969570730:  Hold'em No Limit ($0.02/$0.05) - 2017/11/09 2:55:53 CCT [2017/11/08 13:55:53 ET]
Table 'Donati' 6-max Seat #1 is the button
Seat 1: HubertusB ($5.82 in chips) 
Seat 2: navy463 ($5.84 in chips) 
Seat 3: axeldada ($5.14 in chips) 
Seat 4: Funharti ($4.77 in chips) 
Seat 5: hector-987 ($6.59 in chips) 
Seat 6: pokersito84 ($25.45 in chips) 
navy463: posts small blind $0.02
axeldada: posts big blind $0.05
*** HOLE CARDS ***
Dealt to HubertusB [7c Jc]
Funharti: folds 
hector-987: folds 
pokersito84: folds 
HubertusB: raises $0.05 to $0.10
navy463: folds 
axeldada: folds 
Uncalled bet ($0.05) returned to HubertusB
HubertusB collected $0.12 from pot
HubertusB: doesn't show hand 
*** SUMMARY ***
Total pot $0.12 | Rake $0 
Seat 1: HubertusB (button) collected ($0.12)
Seat 2: navy463 (small blind) folded before Flop
Seat 3: axeldada (big blind) folded before Flop
Seat 4: Funharti folded before Flop (didn't bet)
Seat 5: hector-987 folded before Flop (didn't bet)
Seat 6: pokersito84 folded before Flop (didn't bet)



PokerStars Zoom Hand #177969556509:  Hold'em No Limit ($0.02/$0.05) - 2017/11/09 2:55:31 CCT [2017/11/08 13:55:31 ET]
Table 'Donati' 6-max Seat #1 is the button
Seat 1: CykuHKOT ($2.50 in chips) 
Seat 2: HubertusB ($5.86 in chips) 
Seat 3: simple s0o ($9.95 in chips) 
Seat 4: ¡No pasarán! ($5.48 in chips) 
Seat 5: T0M5T3R ($5.30 in chips) 
Seat 6: KKKKypros ($4.74 in chips) 
HubertusB: posts small blind $0.02
simple s0o: posts big blind $0.05
*** HOLE CARDS ***
Dealt to HubertusB [Ad 7h]
¡No pasarán!: folds 
T0M5T3R: folds 
KKKKypros: folds 
CykuHKOT: raises $0.10 to $0.15
HubertusB: folds 
simple s0o: calls $0.10
*** FLOP *** [Ac 5s 7s]
simple s0o: checks 
CykuHKOT: bets $0.23
simple s0o: calls $0.23
*** TURN *** [Ac 5s 7s] [Kh]
simple s0o: checks 
CykuHKOT: bets $0.56
simple s0o: calls $0.56
*** RIVER *** [Ac 5s 7s Kh] [2h]
simple s0o: checks 
CykuHKOT: bets $1.56 and is all-in
simple s0o: folds 
Uncalled bet ($1.56) returned to CykuHKOT
CykuHKOT collected $1.82 from pot
CykuHKOT: doesn't show hand 
*** SUMMARY ***
Total pot $1.90 | Rake $0.08 
Board [Ac 5s 7s Kh 2h]
Seat 1: CykuHKOT (button) collected ($1.82)
Seat 2: HubertusB (small blind) folded before Flop
Seat 3: simple s0o (big blind) folded on the River
Seat 4: ¡No pasarán! folded before Flop (didn't bet)
Seat 5: T0M5T3R folded before Flop (didn't bet)
Seat 6: KKKKypros folded before Flop (didn't bet)



PokerStars Zoom Hand #177969560421:  Hold'em No Limit ($0.02/$0.05) - 2017/11/09 2:55:37 CCT [2017/11/08 13:55:37 ET]
Table 'Donati' 6-max Seat #1 is the button
Seat 1: Huaen ($10.26 in chips) 
Seat 2: HubertusB ($5.84 in chips) 
Seat 3: VVTCH ($5.24 in chips) 
Seat 4: begze ($5 in chips) 
Seat 5: tmyhands ($4.57 in chips) 
Seat 6: Gaston323 ($5.83 in chips) 
HubertusB: posts small blind $0.02
VVTCH: posts big blind $0.05
*** HOLE CARDS ***
Dealt to HubertusB [2d 6c]
begze: folds 
tmyhands: folds 
Gaston323: folds 
Huaen: raises $0.05 to $0.10
HubertusB: folds 
VVTCH: calls $0.05
*** FLOP *** [7h 3c 5c]
VVTCH: checks 
Huaen: checks 
*** TURN *** [7h 3c 5c] [7c]
VVTCH: bets $0.14
Huaen: calls $0.14
*** RIVER *** [7h 3c 5c 7c] [Js]
VVTCH: bets $0.32
Huaen: folds 
Uncalled bet ($0.32) returned to VVTCH
VVTCH collected $0.48 from pot
VVTCH: doesn't show hand 
*** SUMMARY ***
Total pot $0.50 | Rake $0.02 
Board [7h 3c 5c 7c Js]
Seat 1: Huaen (button) folded on the River
Seat 2: HubertusB (small blind) folded before Flop
Seat 3: VVTCH (big blind) collected ($0.48)
Seat 4: begze folded before Flop (didn't bet)
Seat 5: tmyhands folded before Flop (didn't bet)
Seat 6: Gaston323 folded before Flop (didn't bet)



PokerStars Zoom Hand #177969580330:  Hold'em No Limit ($0.02/$0.05) - 2017/11/09 2:56:08 CCT [2017/11/08 13:56:08 ET]
Table 'Donati' 6-max Seat #1 is the button
Seat 1: stormmindAAA ($6.67 in chips) 
Seat 2: Bratwurst25 ($7.82 in chips) 
Seat 3: HubertusB ($5.89 in chips) 
Seat 4: pokersito84 ($5.02 in chips) 
Seat 5: SpjaldJB ($5.55 in chips) 
Seat 6: xGzusS ($5 in chips) 
Bratwurst25: posts small blind $0.02
HubertusB: posts big blind $0.05
*** HOLE CARDS ***
Dealt to HubertusB [Jh Ks]
pokersito84: folds 
SpjaldJB: folds 
xGzusS: folds 
stormmindAAA: folds 
Bratwurst25: folds 
Uncalled bet ($0.03) returned to HubertusB
HubertusB collected $0.04 from pot
HubertusB: doesn't show hand 
*** SUMMARY ***
Total pot $0.04 | Rake $0 
Seat 1: stormmindAAA (button) folded before Flop (didn't bet)
Seat 2: Bratwurst25 (small blind) folded before Flop
Seat 3: HubertusB (big blind) collected ($0.04)
Seat 4: pokersito84 folded before Flop (didn't bet)
Seat 5: SpjaldJB folded before Flop (didn't bet)
Seat 6: xGzusS folded before Flop (didn't bet)



PokerStars Zoom Hand #177969592577:  Hold'em No Limit ($0.02/$0.05) - 2017/11/09 2:56:27 CCT [2017/11/08 13:56:27 ET]
Table 'Donati' 6-max Seat #1 is the button
Seat 1: HubertusB ($5.91 in chips) 
Seat 2: Jyzze ($10.74 in chips) 
Seat 3: max_polonez ($2.77 in chips) 
Seat 4: quaackk ($5.09 in chips) 
Seat 5: Diokkrau ($7.02 in chips) 
Seat 6: petr 131313 ($6.23 in chips) 
Jyzze: posts small blind $0.02
max_polonez: posts big blind $0.05
*** HOLE CARDS ***
Dealt to HubertusB [3c Tc]
quaackk: folds 
Diokkrau: raises $0.11 to $0.16
petr 131313: folds 
HubertusB: folds 
Jyzze: folds 
max_polonez: folds 
Uncalled bet ($0.11) returned to Diokkrau
Diokkrau collected $0.12 from pot
Diokkrau: doesn't show hand 
*** SUMMARY ***
Total pot $0.12 | Rake $0 
Seat 1: HubertusB (button) folded before Flop (didn't bet)
Seat 2: Jyzze (small blind) folded before Flop
Seat 3: max_polonez (big blind) folded before Flop
Seat 4: quaackk folded before Flop (didn't bet)
Seat 5: Diokkrau collected ($0.12)
Seat 6: petr 131313 folded before Flop (didn't bet)



PokerStars Zoom Hand #177969598402:  Hold'em No Limit ($0.02/$0.05) - 2017/11/09 2:56:36 CCT [2017/11/08 13:56:36 ET]
Table 'Donati' 6-max Seat #1 is the button
Seat 1: Aleksandrpby ($5.31 in chips) 
Seat 2: ritual11 ($4.86 in chips) 
Seat 3: almos548 ($4.63 in chips) 
Seat 4: paranoia235 ($5.38 in chips) 
Seat 5: Kreg Heg ($7.51 in chips) 
Seat 6: HubertusB ($5.91 in chips) 
ritual11: posts small blind $0.02
almos548: posts big blind $0.05
*** HOLE CARDS ***
Dealt to HubertusB [3d 3h]
paranoia235: folds 
Kreg Heg: folds 
HubertusB: raises $0.05 to $0.10
Aleksandrpby: folds 
ritual11: folds 
almos548: calls $0.05
*** FLOP *** [Ts 5h Jc]
almos548: checks 
HubertusB: bets $0.12
almos548: folds 
Uncalled bet ($0.12) returned to HubertusB
HubertusB collected $0.21 from pot
HubertusB: doesn't show hand 
*** SUMMARY ***
Total pot $0.22 | Rake $0.01 
Board [Ts 5h Jc]
Seat 1: Aleksandrpby (button) folded before Flop (didn't bet)
Seat 2: ritual11 (small blind) folded before Flop
Seat 3: almos548 (big blind) folded on the Flop
Seat 4: paranoia235 folded before Flop (didn't bet)
Seat 5: Kreg Heg folded before Flop (didn't bet)
Seat 6: HubertusB collected ($0.21)



PokerStars Zoom Hand #177969617787:  Hold'em No Limit ($0.02/$0.05) - 2017/11/09 2:57:06 CCT [2017/11/08 13:57:06 ET]
Table 'Donati' 6-max Seat #1 is the button
Seat 1: Valerij V.S. ($5.14 in chips) 
Seat 2: HubertusB ($6.02 in chips) 
Seat 3: Gaston323 ($5.97 in chips) 
Seat 4: Vity673 ($3.54 in chips) 
Seat 5: Barba Ruim ($6.25 in chips) 
Seat 6: shuriken95 ($5.17 in chips) 
HubertusB: posts small blind $0.02
Gaston323: posts big blind $0.05
*** HOLE CARDS ***
Dealt to HubertusB [Qd Qc]
Vity673: folds 
Barba Ruim: folds 
shuriken95: folds 
Valerij V.S.: folds 
HubertusB: raises $0.10 to $0.15
Gaston323: folds 
Uncalled bet ($0.10) returned to HubertusB
HubertusB collected $0.10 from pot
HubertusB: doesn't show hand 
*** SUMMARY ***
Total pot $0.10 | Rake $0 
Seat 1: Valerij V.S. (button) folded before Flop (didn't bet)
Seat 2: HubertusB (small blind) collected ($0.10)
Seat 3: Gaston323 (big blind) folded before Flop
Seat 4: Vity673 folded before Flop (didn't bet)
Seat 5: Barba Ruim folded before Flop (didn't bet)
Seat 6: shuriken95 folded before Flop (didn't bet)



PokerStars Zoom Hand #177969629929:  Hold'em No Limit ($0.02/$0.05) - 2017/11/09 2:57:25 CCT [2017/11/08 13:57:25 ET]
Table 'Donati' 6-max Seat #1 is the button
Seat 1: Kmosh ($6.10 in chips) 
Seat 2: Kreg Heg ($5.17 in chips) 
Seat 3: laiha ($13.59 in chips) 
Seat 4: Elchaza_1989 ($9.48 in chips) 
Seat 5: Volke!n kz ($17.87 in chips) 
Seat 6: HubertusB ($6.07 in chips) 
Kreg Heg: posts small blind $0.02
laiha: posts big blind $0.05
*** HOLE CARDS ***
Dealt to HubertusB [Jd Td]
Elchaza_1989: folds 
Volke!n kz: folds 
HubertusB: raises $0.06 to $0.11
Kmosh: calls $0.11
Kreg Heg: folds 
laiha: raises $0.19 to $0.30
HubertusB: calls $0.19
Kmosh: calls $0.19
*** FLOP *** [5c 2d 7c]
laiha: bets $0.45
HubertusB: folds 
Kmosh: calls $0.45
*** TURN *** [5c 2d 7c] [9d]
laiha: bets $1.05
Kmosh: calls $1.05
*** RIVER *** [5c 2d 7c 9d] [Js]
laiha: checks 
Kmosh: checks 
*** SHOW DOWN ***
laiha: shows [Qh Qs] (a pair of Queens)
Kmosh: mucks hand 
laiha collected $3.76 from pot
*** SUMMARY ***
Total pot $3.92 | Rake $0.16 
Board [5c 2d 7c 9d Js]
Seat 1: Kmosh (button) mucked [Ac 6c]
Seat 2: Kreg Heg (small blind) folded before Flop
Seat 3: laiha (big blind) showed [Qh Qs] and won ($3.76) with a pair of Queens
Seat 4: Elchaza_1989 folded before Flop (didn't bet)
Seat 5: Volke!n kz folded before Flop (didn't bet)
Seat 6: HubertusB folded on the Flop



PokerStars Zoom Hand #177969684163:  Hold'em No Limit ($0.02/$0.05) - 2017/11/09 2:58:48 CCT [2017/11/08 13:58:48 ET]
Table 'Donati' 6-max Seat #1 is the button
Seat 1: dewaaa ($5.21 in chips) 
Seat 2: Planck88 ($9.90 in chips) 
Seat 3: HubertusB ($5.77 in chips) 
Seat 4: kopatich52 ($6.70 in chips) 
Seat 5: witto666 ($5.93 in chips) 
Seat 6: Clamfish0 ($5.87 in chips) 
Planck88: posts small blind $0.02
HubertusB: posts big blind $0.05
*** HOLE CARDS ***
Dealt to HubertusB [Ah 2d]
kopatich52: folds 
witto666: folds 
Clamfish0: folds 
dewaaa: folds 
Planck88: folds 
Uncalled bet ($0.03) returned to HubertusB
HubertusB collected $0.04 from pot
HubertusB: doesn't show hand 
*** SUMMARY ***
Total pot $0.04 | Rake $0 
Seat 1: dewaaa (button) folded before Flop (didn't bet)
Seat 2: Planck88 (small blind) folded before Flop
Seat 3: HubertusB (big blind) collected ($0.04)
Seat 4: kopatich52 folded before Flop (didn't bet)
Seat 5: witto666 folded before Flop (didn't bet)
Seat 6: Clamfish0 folded before Flop (didn't bet)



PokerStars Zoom Hand #177969691476:  Hold'em No Limit ($0.02/$0.05) - 2017/11/09 2:58:59 CCT [2017/11/08 13:58:59 ET]
Table 'Donati' 6-max Seat #1 is the button
Seat 1: HubertusB ($5.79 in chips) 
Seat 2: marianoacha ($5 in chips) 
Seat 3: iops88 ($4.86 in chips) 
Seat 4: miniB!Gus ($5.56 in chips) 
Seat 5: Evgesha0400 ($13.06 in chips) 
Seat 6: badman time ($5 in chips) 
marianoacha: posts small blind $0.02
iops88: posts big blind $0.05
*** HOLE CARDS ***
Dealt to HubertusB [6h Tc]
miniB!Gus: folds 
Evgesha0400: calls $0.05
badman time: folds 
HubertusB: raises $0.20 to $0.25
marianoacha: folds 
iops88: folds 
Evgesha0400: calls $0.20
*** FLOP *** [7h 9s Kh]
Evgesha0400: bets $0.28
HubertusB: folds 
Uncalled bet ($0.28) returned to Evgesha0400
Evgesha0400 collected $0.55 from pot
Evgesha0400: doesn't show hand 
*** SUMMARY ***
Total pot $0.57 | Rake $0.02 
Board [7h 9s Kh]
Seat 1: HubertusB (button) folded on the Flop
Seat 2: marianoacha (small blind) folded before Flop
Seat 3: iops88 (big blind) folded before Flop
Seat 4: miniB!Gus folded before Flop (didn't bet)
Seat 5: Evgesha0400 collected ($0.55)
Seat 6: badman time folded before Flop (didn't bet)



PokerStars Zoom Hand #177969705032:  Hold'em No Limit ($0.02/$0.05) - 2017/11/09 2:59:20 CCT [2017/11/08 13:59:20 ET]
Table 'Donati' 6-max Seat #1 is the button
Seat 1: miodibao ($5 in chips) 
Seat 2: begze ($4.95 in chips) 
Seat 3: lapa143 ($14.09 in chips) 
Seat 4: HubertusB ($5.54 in chips) 
Seat 5: Seppel7176 ($8.56 in chips) 
Seat 6: quaackk ($5 in chips) 
begze: posts small blind $0.02
lapa143: posts big blind $0.05
*** HOLE CARDS ***
Dealt to HubertusB [2c 6d]
HubertusB: folds 
Seppel7176: folds 
quaackk: folds 
miodibao: folds 
begze: folds 
Uncalled bet ($0.03) returned to lapa143
lapa143 collected $0.04 from pot
lapa143: doesn't show hand 
*** SUMMARY ***
Total pot $0.04 | Rake $0 
Seat 1: miodibao (button) folded before Flop (didn't bet)
Seat 2: begze (small blind) folded before Flop
Seat 3: lapa143 (big blind) collected ($0.04)
Seat 4: HubertusB folded before Flop (didn't bet)
Seat 5: Seppel7176 folded before Flop (didn't bet)
Seat 6: quaackk folded before Flop (didn't bet)



PokerStars Zoom Hand #177969679598:  Hold'em No Limit ($0.02/$0.05) - 2017/11/09 2:58:41 CCT [2017/11/08 13:58:41 ET]
Table 'Donati' 6-max Seat #1 is the button
Seat 1: axeldada ($5.20 in chips) 
Seat 2: Odvajke1 ($5.02 in chips) 
Seat 3: ElGabatx ($5.02 in chips) 
Seat 4: mel1in ($9.69 in chips) 
Seat 5: HubertusB ($5.77 in chips) 
Seat 6: Migellx ($9.63 in chips) 
Odvajke1: posts small blind $0.02
ElGabatx: posts big blind $0.05
*** HOLE CARDS ***
Dealt to HubertusB [3d 9h]
mel1in: folds 
HubertusB: folds 
Migellx: raises $0.06 to $0.11
axeldada: folds 
Odvajke1: folds 
ElGabatx: calls $0.06
*** FLOP *** [Th 9s Ad]
ElGabatx: checks 
Migellx: checks 
*** TURN *** [Th 9s Ad] [Qc]
ElGabatx: checks 
Migellx: checks 
*** RIVER *** [Th 9s Ad Qc] [5d]
ElGabatx: checks 
Migellx: checks 
*** SHOW DOWN ***
ElGabatx: shows [6d 6h] (a pair of Sixes)
Migellx: shows [Jc Jd] (a pair of Jacks)
Migellx collected $0.23 from pot
*** SUMMARY ***
Total pot $0.24 | Rake $0.01 
Board [Th 9s Ad Qc 5d]
Seat 1: axeldada (button) folded before Flop (didn't bet)
Seat 2: Odvajke1 (small blind) folded before Flop
Seat 3: ElGabatx (big blind) showed [6d 6h] and lost with a pair of Sixes
Seat 4: mel1in folded before Flop (didn't bet)
Seat 5: HubertusB folded before Flop (didn't bet)
Seat 6: Migellx showed [Jc Jd] and won ($0.23) with a pair of Jacks



PokerStars Zoom Hand #177969674981:  Hold'em No Limit ($0.02/$0.05) - 2017/11/09 2:58:34 CCT [2017/11/08 13:58:34 ET]
Table 'Donati' 6-max Seat #1 is the button
Seat 1: SartyBallz ($8.74 in chips) 
Seat 2: DonRazVan18 ($23.39 in chips) 
Seat 3: 55region ($5.10 in chips) 
Seat 4: rokk10 ($6.96 in chips) 
Seat 5: HubertusB ($5.77 in chips) 
Seat 6: DAVIDOFF351 ($15.57 in chips) 
DonRazVan18: posts small blind $0.02
55region: posts big blind $0.05
*** HOLE CARDS ***
Dealt to HubertusB [3c 4c]
rokk10: raises $0.10 to $0.15
HubertusB: folds 
DAVIDOFF351: calls $0.15
SartyBallz: folds 
DonRazVan18: folds 
55region: folds 
*** FLOP *** [Jd 3h 2h]
rokk10: checks 
DAVIDOFF351: bets $0.25
rokk10: raises $0.40 to $0.65
DAVIDOFF351: raises $14.77 to $15.42 and is all-in
rokk10: calls $6.16 and is all-in
Uncalled bet ($8.61) returned to DAVIDOFF351
*** FIRST TURN *** [Jd 3h 2h] [Th]
*** FIRST RIVER *** [Jd 3h 2h Th] [Ad]
*** SECOND TURN *** [Jd 3h 2h] [Ac]
*** SECOND RIVER *** [Jd 3h 2h Ac] [Qs]
*** FIRST SHOW DOWN ***
rokk10: shows [Jh Kh] (a flush, King high)
DAVIDOFF351: shows [2d 2s] (three of a kind, Deuces)
rokk10 collected $6.71 from pot
*** SECOND SHOW DOWN ***
rokk10: shows [Jh Kh] (a pair of Jacks)
DAVIDOFF351: shows [2d 2s] (three of a kind, Deuces)
DAVIDOFF351 collected $6.70 from pot
*** SUMMARY ***
Total pot $13.99 | Rake $0.58 
Hand was run twice
FIRST Board [Jd 3h 2h Th Ad]
SECOND Board [Jd 3h 2h Ac Qs]
Seat 1: SartyBallz (button) folded before Flop (didn't bet)
Seat 2: DonRazVan18 (small blind) folded before Flop
Seat 3: 55region (big blind) folded before Flop
Seat 4: rokk10 showed [Jh Kh] and won ($6.71) with a flush, King high, and lost with a pair of Jacks
Seat 5: HubertusB folded before Flop (didn't bet)
Seat 6: DAVIDOFF351 showed [2d 2s] and lost with three of a kind, Deuces, and won ($6.70) with three of a kind, Deuces



PokerStars Zoom Hand #177969709593:  Hold'em No Limit ($0.02/$0.05) - 2017/11/09 2:59:27 CCT [2017/11/08 13:59:27 ET]
Table 'Donati' 6-max Seat #1 is the button
Seat 1: MLancelot ($6.31 in chips) 
Seat 2: woocha33 ($5.18 in chips) 
Seat 3: danik_man ($3.27 in chips) 
Seat 4: miodibao ($5 in chips) 
Seat 5: ruba4ok555 ($0.48 in chips) 
Seat 6: HubertusB ($5.54 in chips) 
woocha33: posts small blind $0.02
danik_man: posts big blind $0.05
*** HOLE CARDS ***
Dealt to HubertusB [6h 4s]
miodibao: folds 
ruba4ok555: raises $0.43 to $0.48 and is all-in
HubertusB: folds 
MLancelot: folds 
woocha33: folds 
danik_man: calls $0.43
*** FLOP *** [9h Jc Jh]
*** TURN *** [9h Jc Jh] [Tc]
*** RIVER *** [9h Jc Jh Tc] [3c]
*** SHOW DOWN ***
danik_man: shows [8s 7s] (a straight, Seven to Jack)
ruba4ok555: shows [Kc Ks] (two pair, Kings and Jacks)
danik_man collected $0.94 from pot
*** SUMMARY ***
Total pot $0.98 | Rake $0.04 
Board [9h Jc Jh Tc 3c]
Seat 1: MLancelot (button) folded before Flop (didn't bet)
Seat 2: woocha33 (small blind) folded before Flop
Seat 3: danik_man (big blind) showed [8s 7s] and won ($0.94) with a straight, Seven to Jack
Seat 4: miodibao folded before Flop (didn't bet)
Seat 5: ruba4ok555 showed [Kc Ks] and lost with two pair, Kings and Jacks
Seat 6: HubertusB folded before Flop (didn't bet)



PokerStars Zoom Hand #177969712857:  Hold'em No Limit ($0.02/$0.05) - 2017/11/09 2:59:32 CCT [2017/11/08 13:59:32 ET]
Table 'Donati' 6-max Seat #1 is the button
Seat 1: pokersito84 ($25.43 in chips) 
Seat 2: HubertusB ($5.54 in chips) 
Seat 3: veryfatjedi ($5 in chips) 
Seat 4: shuriken95 ($5.75 in chips) 
Seat 5: prochy1909 ($18.95 in chips) 
Seat 6: miniB!Gus ($5.61 in chips) 
HubertusB: posts small blind $0.02
veryfatjedi: posts big blind $0.05
*** HOLE CARDS ***
Dealt to HubertusB [3d 6d]
shuriken95: folds 
prochy1909: folds 
miniB!Gus: raises $0.05 to $0.10
pokersito84: raises $0.25 to $0.35
HubertusB: folds 
veryfatjedi: folds 
miniB!Gus: folds 
Uncalled bet ($0.25) returned to pokersito84
pokersito84 collected $0.27 from pot
pokersito84: doesn't show hand 
*** SUMMARY ***
Total pot $0.27 | Rake $0 
Seat 1: pokersito84 (button) collected ($0.27)
Seat 2: HubertusB (small blind) folded before Flop
Seat 3: veryfatjedi (big blind) folded before Flop
Seat 4: shuriken95 folded before Flop (didn't bet)
Seat 5: prochy1909 folded before Flop (didn't bet)
Seat 6: miniB!Gus folded before Flop



PokerStars Zoom Hand #177969716756:  Hold'em No Limit ($0.02/$0.05) - 2017/11/09 2:59:38 CCT [2017/11/08 13:59:38 ET]
Table 'Donati' 6-max Seat #1 is the button
Seat 1: HubertusB ($5.52 in chips) 
Seat 2: Aidar_EKR ($5.99 in chips) 
Seat 3: Gaston323 ($5.38 in chips) 
Seat 4: SpjaldJB ($5.44 in chips) 
Seat 5: MstrJJ ($5 in chips) 
Seat 6: HALMac990 ($5.77 in chips) 
Aidar_EKR: posts small blind $0.02
Gaston323: posts big blind $0.05
*** HOLE CARDS ***
Dealt to HubertusB [9h Ah]
SpjaldJB: folds 
MstrJJ: folds 
HALMac990: folds 
HubertusB: raises $0.05 to $0.10
Aidar_EKR: folds 
Gaston323: folds 
Uncalled bet ($0.05) returned to HubertusB
HubertusB collected $0.12 from pot
HubertusB: doesn't show hand 
*** SUMMARY ***
Total pot $0.12 | Rake $0 
Seat 1: HubertusB (button) collected ($0.12)
Seat 2: Aidar_EKR (small blind) folded before Flop
Seat 3: Gaston323 (big blind) folded before Flop
Seat 4: SpjaldJB folded before Flop (didn't bet)
Seat 5: MstrJJ folded before Flop (didn't bet)
Seat 6: HALMac990 folded before Flop (didn't bet)



PokerStars Zoom Hand #177969726538:  Hold'em No Limit ($0.02/$0.05) - 2017/11/09 2:59:53 CCT [2017/11/08 13:59:53 ET]
Table 'Donati' 6-max Seat #1 is the button
Seat 1: Andrey171410 ($5 in chips) 
Seat 2: Clamfish0 ($6.82 in chips) 
Seat 3: HubertusB ($5.59 in chips) 
Seat 4: coolgrays ($11.42 in chips) 
Seat 5: RagnarRebane ($5 in chips) 
Seat 6: You_Rule_Now ($6.64 in chips) 
Clamfish0: posts small blind $0.02
HubertusB: posts big blind $0.05
*** HOLE CARDS ***
Dealt to HubertusB [6d Th]
coolgrays: folds 
RagnarRebane: folds 
You_Rule_Now: folds 
Andrey171410: raises $0.07 to $0.12
Clamfish0: raises $0.26 to $0.38
HubertusB: folds 
Andrey171410: folds 
Uncalled bet ($0.26) returned to Clamfish0
Clamfish0 collected $0.29 from pot
Clamfish0: doesn't show hand 
*** SUMMARY ***
Total pot $0.29 | Rake $0 
Seat 1: Andrey171410 (button) folded before Flop
Seat 2: Clamfish0 (small blind) collected ($0.29)
Seat 3: HubertusB (big blind) folded before Flop
Seat 4: coolgrays folded before Flop (didn't bet)
Seat 5: RagnarRebane folded before Flop (didn't bet)
Seat 6: You_Rule_Now folded before Flop (didn't bet)



PokerStars Zoom Hand #177969735944:  Hold'em No Limit ($0.02/$0.05) - 2017/11/09 3:00:07 CCT [2017/11/08 14:00:07 ET]
Table 'Donati' 6-max Seat #1 is the button
Seat 1: begze ($4.93 in chips) 
Seat 2: BigBadPalm ($5 in chips) 
Seat 3: MOROZ056 ($7.61 in chips) 
Seat 4: HubertusB ($5.54 in chips) 
Seat 5: 7OstapBender ($6.21 in chips) 
Seat 6: iops88 ($6.88 in chips) 
BigBadPalm: posts small blind $0.02
MOROZ056: posts big blind $0.05
*** HOLE CARDS ***
Dealt to HubertusB [8d 9c]
HubertusB: folds 
7OstapBender: folds 
iops88: folds 
begze: folds 
BigBadPalm: raises $0.10 to $0.15
MOROZ056: folds 
Uncalled bet ($0.10) returned to BigBadPalm
BigBadPalm collected $0.10 from pot
BigBadPalm: doesn't show hand 
*** SUMMARY ***
Total pot $0.10 | Rake $0 
Seat 1: begze (button) folded before Flop (didn't bet)
Seat 2: BigBadPalm (small blind) collected ($0.10)
Seat 3: MOROZ056 (big blind) folded before Flop
Seat 4: HubertusB folded before Flop (didn't bet)
Seat 5: 7OstapBender folded before Flop (didn't bet)
Seat 6: iops88 folded before Flop (didn't bet)



PokerStars Zoom Hand #177969745812:  Hold'em No Limit ($0.02/$0.05) - 2017/11/09 3:00:21 CCT [2017/11/08 14:00:21 ET]
Table 'Donati' 6-max Seat #1 is the button
Seat 1: MrCöre ($5 in chips) 
Seat 2: Tosha550 ($5.22 in chips) 
Seat 3: andron7879 ($4.90 in chips) 
Seat 4: BOSCOBOT ($5 in chips) 
Seat 5: dimg8 ($1.83 in chips) 
Seat 6: HubertusB ($5.54 in chips) 
Tosha550: posts small blind $0.02
andron7879: posts big blind $0.05
*** HOLE CARDS ***
Dealt to HubertusB [6c Jc]
BOSCOBOT: folds 
dimg8: folds 
HubertusB: raises $0.05 to $0.10
MrCöre: folds 
Tosha550: folds 
andron7879: raises $0.15 to $0.25
HubertusB: folds 
Uncalled bet ($0.15) returned to andron7879
andron7879 collected $0.22 from pot
andron7879: doesn't show hand 
*** SUMMARY ***
Total pot $0.22 | Rake $0 
Seat 1: MrCöre (button) folded before Flop (didn't bet)
Seat 2: Tosha550 (small blind) folded before Flop
Seat 3: andron7879 (big blind) collected ($0.22)
Seat 4: BOSCOBOT folded before Flop (didn't bet)
Seat 5: dimg8 folded before Flop (didn't bet)
Seat 6: HubertusB folded before Flop



PokerStars Zoom Hand #177969765740:  Hold'em No Limit ($0.02/$0.05) - 2017/11/09 3:00:50 CCT [2017/11/08 14:00:50 ET]
Table 'Donati' 6-max Seat #1 is the button
Seat 1: Andrey171410 ($5.02 in chips) 
Seat 2: CykuHKOT ($2.78 in chips) 
Seat 3: marianoacha ($23.38 in chips) 
Seat 4: HubertusB ($5.44 in chips) 
Seat 5: old boys_1 ($4.67 in chips) 
Seat 6: lekayak ($3.98 in chips) 
CykuHKOT: posts small blind $0.02
marianoacha: posts big blind $0.05
*** HOLE CARDS ***
Dealt to HubertusB [Kd Th]
HubertusB: folds 
old boys_1: folds 
lekayak: folds 
Andrey171410: folds 
CykuHKOT: folds 
Uncalled bet ($0.03) returned to marianoacha
marianoacha collected $0.04 from pot
marianoacha: doesn't show hand 
*** SUMMARY ***
Total pot $0.04 | Rake $0 
Seat 1: Andrey171410 (button) folded before Flop (didn't bet)
Seat 2: CykuHKOT (small blind) folded before Flop
Seat 3: marianoacha (big blind) collected ($0.04)
Seat 4: HubertusB folded before Flop (didn't bet)
Seat 5: old boys_1 folded before Flop (didn't bet)
Seat 6: lekayak folded before Flop (didn't bet)



PokerStars Zoom Hand #177969769202:  Hold'em No Limit ($0.02/$0.05) - 2017/11/09 3:00:55 CCT [2017/11/08 14:00:55 ET]
Table 'Donati' 6-max Seat #1 is the button
Seat 1: Ymnica15 ($6.47 in chips) 
Seat 2: HubertusB ($5.44 in chips) 
Seat 3: Jarness II ($7.30 in chips) 
Seat 4: SikaTrx ($4.36 in chips) 
Seat 5: Kondr-KAV ($8.42 in chips) 
Seat 6: DonRazVan18 ($15.03 in chips) 
HubertusB: posts small blind $0.02
Jarness II: posts big blind $0.05
*** HOLE CARDS ***
Dealt to HubertusB [Qh 5d]
SikaTrx: folds 
Kondr-KAV: folds 
DonRazVan18: folds 
Ymnica15: raises $0.10 to $0.15
HubertusB: folds 
Jarness II: folds 
Uncalled bet ($0.10) returned to Ymnica15
Ymnica15 collected $0.12 from pot
Ymnica15: doesn't show hand 
*** SUMMARY ***
Total pot $0.12 | Rake $0 
Seat 1: Ymnica15 (button) collected ($0.12)
Seat 2: HubertusB (small blind) folded before Flop
Seat 3: Jarness II (big blind) folded before Flop
Seat 4: SikaTrx folded before Flop (didn't bet)
Seat 5: Kondr-KAV folded before Flop (didn't bet)
Seat 6: DonRazVan18 folded before Flop (didn't bet)



PokerStars Zoom Hand #177969740350:  Hold'em No Limit ($0.02/$0.05) - 2017/11/09 3:00:13 CCT [2017/11/08 14:00:13 ET]
Table 'Donati' 6-max Seat #1 is the button
Seat 1: bobus solis ($4.68 in chips) 
Seat 2: HALMac990 ($5.72 in chips) 
Seat 3: csokmei98 ($3.83 in chips) 
Seat 4: Hangover_CZ ($4.99 in chips) 
Seat 5: HubertusB ($5.54 in chips) 
Seat 6: Jay_T91 ($3.48 in chips) 
HALMac990: posts small blind $0.02
csokmei98: posts big blind $0.05
*** HOLE CARDS ***
Dealt to HubertusB [Tc 2d]
Hangover_CZ: raises $0.05 to $0.10
HubertusB: folds 
Jay_T91: folds 
bobus solis: calls $0.10
HALMac990: folds 
csokmei98: folds 
*** FLOP *** [8h 2s Th]
Hangover_CZ: bets $0.13
bobus solis: raises $0.17 to $0.30
Hangover_CZ: calls $0.17
*** TURN *** [8h 2s Th] [Jh]
Hangover_CZ: bets $0.42
bobus solis: raises $1.13 to $1.55
Hangover_CZ: calls $1.13
*** RIVER *** [8h 2s Th Jh] [Ts]
Hangover_CZ: bets $3.04 and is all-in
bobus solis: calls $2.73 and is all-in
Uncalled bet ($0.31) returned to Hangover_CZ
*** SHOW DOWN ***
Hangover_CZ: shows [5h Ah] (a flush, Ace high)
bobus solis: shows [Td 9h] (three of a kind, Tens)
Hangover_CZ collected $9.04 from pot
*** SUMMARY ***
Total pot $9.43 | Rake $0.39 
Board [8h 2s Th Jh Ts]
Seat 1: bobus solis (button) showed [Td 9h] and lost with three of a kind, Tens
Seat 2: HALMac990 (small blind) folded before Flop
Seat 3: csokmei98 (big blind) folded before Flop
Seat 4: Hangover_CZ showed [5h Ah] and won ($9.04) with a flush, Ace high
Seat 5: HubertusB folded before Flop (didn't bet)
Seat 6: Jay_T91 folded before Flop (didn't bet)



PokerStars Zoom Hand #177969774127:  Hold'em No Limit ($0.02/$0.05) - 2017/11/09 3:01:02 CCT [2017/11/08 14:01:02 ET]
Table 'Donati' 6-max Seat #1 is the button
Seat 1: nowhiteimp ($2.08 in chips) 
Seat 2: teluaa ($3.74 in chips) 
Seat 3: HubertusB ($5.42 in chips) 
Seat 4: stormmindAAA ($5.72 in chips) 
Seat 5: RagnarRebane ($8.76 in chips) 
Seat 6: almos548 ($4.68 in chips) 
teluaa: posts small blind $0.02
HubertusB: posts big blind $0.05
*** HOLE CARDS ***
Dealt to HubertusB [As 6s]
stormmindAAA: folds 
RagnarRebane: raises $0.10 to $0.15
almos548: folds 
nowhiteimp: folds 
teluaa: calls $0.13
HubertusB: calls $0.10
*** FLOP *** [8c Qc 2c]
teluaa: checks 
HubertusB: checks 
RagnarRebane: checks 
*** TURN *** [8c Qc 2c] [5c]
teluaa: bets $0.43
HubertusB: folds 
RagnarRebane: folds 
Uncalled bet ($0.43) returned to teluaa
teluaa collected $0.43 from pot
teluaa: doesn't show hand 
*** SUMMARY ***
Total pot $0.45 | Rake $0.02 
Board [8c Qc 2c 5c]
Seat 1: nowhiteimp (button) folded before Flop (didn't bet)
Seat 2: teluaa (small blind) collected ($0.43)
Seat 3: HubertusB (big blind) folded on the Turn
Seat 4: stormmindAAA folded before Flop (didn't bet)
Seat 5: RagnarRebane folded on the Turn
Seat 6: almos548 folded before Flop (didn't bet)



PokerStars Zoom Hand #177969792575:  Hold'em No Limit ($0.02/$0.05) - 2017/11/09 3:01:27 CCT [2017/11/08 14:01:27 ET]
Table 'Donati' 6-max Seat #1 is the button
Seat 1: devianin96 ($6.41 in chips) 
Seat 2: DiegoRhcp13 ($7.61 in chips) 
Seat 3: lapa143 ($15.45 in chips) 
Seat 4: HubertusB ($5.27 in chips) 
Seat 5: schaemic ($16.57 in chips) 
Seat 6: ¡No pasarán! ($6.73 in chips) 
DiegoRhcp13: posts small blind $0.02
lapa143: posts big blind $0.05
*** HOLE CARDS ***
Dealt to HubertusB [Jc Ac]
HubertusB: raises $0.05 to $0.10
schaemic: folds 
¡No pasarán!: folds 
devianin96: folds 
DiegoRhcp13: folds 
lapa143: calls $0.05
*** FLOP *** [9s 6h 5s]
lapa143: checks 
HubertusB: bets $0.10
lapa143: folds 
Uncalled bet ($0.10) returned to HubertusB
HubertusB collected $0.21 from pot
HubertusB: doesn't show hand 
*** SUMMARY ***
Total pot $0.22 | Rake $0.01 
Board [9s 6h 5s]
Seat 1: devianin96 (button) folded before Flop (didn't bet)
Seat 2: DiegoRhcp13 (small blind) folded before Flop
Seat 3: lapa143 (big blind) folded on the Flop
Seat 4: HubertusB collected ($0.21)
Seat 5: schaemic folded before Flop (didn't bet)
Seat 6: ¡No pasarán! folded before Flop (didn't bet)



PokerStars Zoom Hand #177969809080:  Hold'em No Limit ($0.02/$0.05) - 2017/11/09 3:01:48 CCT [2017/11/08 14:01:48 ET]
Table 'Donati' 6-max Seat #1 is the button
Seat 1: Alfie Bear ($8.70 in chips) 
Seat 2: Einherjer91 ($5 in chips) 
Seat 3: MaKyyyXaA ($5.14 in chips) 
Seat 4: poliars ($7.83 in chips) 
Seat 5: Barba Ruim ($5.22 in chips) 
Seat 6: HubertusB ($5.38 in chips) 
Einherjer91: posts small blind $0.02
MaKyyyXaA: posts big blind $0.05
*** HOLE CARDS ***
Dealt to HubertusB [Qc Tc]
poliars: raises $0.10 to $0.15
Barba Ruim: calls $0.15
HubertusB: calls $0.15
Alfie Bear: folds 
Einherjer91: folds 
MaKyyyXaA: folds 
*** FLOP *** [8h Jc 7s]
poliars: bets $0.32
Barba Ruim: calls $0.32
HubertusB: calls $0.32
*** TURN *** [8h Jc 7s] [4h]
poliars: checks 
Barba Ruim: bets $1
HubertusB: folds 
poliars: folds 
Uncalled bet ($1) returned to Barba Ruim
Barba Ruim collected $1.42 from pot
Barba Ruim: doesn't show hand 
*** SUMMARY ***
Total pot $1.48 | Rake $0.06 
Board [8h Jc 7s 4h]
Seat 1: Alfie Bear (button) folded before Flop (didn't bet)
Seat 2: Einherjer91 (small blind) folded before Flop
Seat 3: MaKyyyXaA (big blind) folded before Flop
Seat 4: poliars folded on the Turn
Seat 5: Barba Ruim collected ($1.42)
Seat 6: HubertusB folded on the Turn



PokerStars Zoom Hand #177969860881:  Hold'em No Limit ($0.02/$0.05) - 2017/11/09 3:02:54 CCT [2017/11/08 14:02:54 ET]
Table 'Donati' 6-max Seat #1 is the button
Seat 1: HubertusB ($4.91 in chips) 
Seat 2: toddot661 ($2.95 in chips) 
Seat 3: urrrrdddd ($7.12 in chips) 
Seat 4: bery91 ($1.71 in chips) 
Seat 5: tmyhands ($5.85 in chips) 
Seat 6: Kreg Heg ($4.88 in chips) 
toddot661: posts small blind $0.02
urrrrdddd: posts big blind $0.05
*** HOLE CARDS ***
Dealt to HubertusB [5s 5h]
bery91: folds 
tmyhands: folds 
Kreg Heg: folds 
HubertusB: raises $0.07 to $0.12
toddot661: calls $0.10
urrrrdddd: folds 
*** FLOP *** [Ah Ad Kd]
toddot661: checks 
HubertusB: bets $0.05
toddot661: calls $0.05
*** TURN *** [Ah Ad Kd] [Qs]
toddot661: checks 
HubertusB: checks 
*** RIVER *** [Ah Ad Kd Qs] [Ks]
toddot661: checks 
HubertusB: checks 
*** SHOW DOWN ***
toddot661: shows [Jd Qc] (two pair, Aces and Kings)
HubertusB: shows [5s 5h] (two pair, Aces and Kings)
toddot661 collected $0.19 from pot
HubertusB collected $0.18 from pot
*** SUMMARY ***
Total pot $0.39 | Rake $0.02 
Board [Ah Ad Kd Qs Ks]
Seat 1: HubertusB (button) showed [5s 5h] and won ($0.18) with two pair, Aces and Kings
Seat 2: toddot661 (small blind) showed [Jd Qc] and won ($0.19) with two pair, Aces and Kings
Seat 3: urrrrdddd (big blind) folded before Flop
Seat 4: bery91 folded before Flop (didn't bet)
Seat 5: tmyhands folded before Flop (didn't bet)
Seat 6: Kreg Heg folded before Flop (didn't bet)



PokerStars Zoom Hand #177969885282:  Hold'em No Limit ($0.02/$0.05) - 2017/11/09 3:03:25 CCT [2017/11/08 14:03:25 ET]
Table 'Donati' 6-max Seat #1 is the button
Seat 1: VVTCH ($5.19 in chips) 
Seat 2: HubertusB ($4.92 in chips) 
Seat 3: PtheOristKER ($6.24 in chips) 
Seat 4: BigBadPalm ($5.07 in chips) 
Seat 5: quaackk ($9.41 in chips) 
Seat 6: Einherjer91 ($5.94 in chips) 
HubertusB: posts small blind $0.02
PtheOristKER: posts big blind $0.05
*** HOLE CARDS ***
Dealt to HubertusB [Td Ad]
BigBadPalm: folds 
quaackk: folds 
Einherjer91: folds 
VVTCH: folds 
HubertusB: raises $0.05 to $0.10
PtheOristKER: calls $0.05
*** FLOP *** [9s Ts Ah]
HubertusB: bets $0.10
PtheOristKER: calls $0.10
*** TURN *** [9s Ts Ah] [5c]
HubertusB: bets $0.28
PtheOristKER: folds 
Uncalled bet ($0.28) returned to HubertusB
HubertusB collected $0.38 from pot
HubertusB: doesn't show hand 
*** SUMMARY ***
Total pot $0.40 | Rake $0.02 
Board [9s Ts Ah 5c]
Seat 1: VVTCH (button) folded before Flop (didn't bet)
Seat 2: HubertusB (small blind) collected ($0.38)
Seat 3: PtheOristKER (big blind) folded on the Turn
Seat 4: BigBadPalm folded before Flop (didn't bet)
Seat 5: quaackk folded before Flop (didn't bet)
Seat 6: Einherjer91 folded before Flop (didn't bet)



PokerStars Zoom Hand #177969913154:  Hold'em No Limit ($0.02/$0.05) - 2017/11/09 3:03:59 CCT [2017/11/08 14:03:59 ET]
Table 'Donati' 6-max Seat #1 is the button
Seat 1: toddot661 ($2.99 in chips) 
Seat 2: pussd ($7.71 in chips) 
Seat 3: HubertusB ($5.10 in chips) 
Seat 4: arlequím ($5.75 in chips) 
Seat 5: bery91 ($1.55 in chips) 
Seat 6: vy021 ($5 in chips) 
pussd: posts small blind $0.02
HubertusB: posts big blind $0.05
*** HOLE CARDS ***
Dealt to HubertusB [8s 9d]
arlequím: folds 
bery91: folds 
vy021: raises $0.07 to $0.12
toddot661: calls $0.12
pussd: folds 
HubertusB: folds 
*** FLOP *** [Ac 9h 6h]
vy021: bets $0.20
toddot661: folds 
Uncalled bet ($0.20) returned to vy021
vy021 collected $0.30 from pot
vy021: doesn't show hand 
*** SUMMARY ***
Total pot $0.31 | Rake $0.01 
Board [Ac 9h 6h]
Seat 1: toddot661 (button) folded on the Flop
Seat 2: pussd (small blind) folded before Flop
Seat 3: HubertusB (big blind) folded before Flop
Seat 4: arlequím folded before Flop (didn't bet)
Seat 5: bery91 folded before Flop (didn't bet)
Seat 6: vy021 collected ($0.30)



PokerStars Zoom Hand #177969924483:  Hold'em No Limit ($0.02/$0.05) - 2017/11/09 3:04:13 CCT [2017/11/08 14:04:13 ET]
Table 'Donati' 6-max Seat #1 is the button
Seat 1: Volke!n kz ($5.42 in chips) 
Seat 2: xBankie ($13.79 in chips) 
Seat 3: lapa143 ($15.67 in chips) 
Seat 4: ballyblue ($5.68 in chips) 
Seat 5: HubertusB ($5.05 in chips) 
Seat 6: kopatich52 ($10.10 in chips) 
xBankie: posts small blind $0.02
lapa143: posts big blind $0.05
*** HOLE CARDS ***
Dealt to HubertusB [5s Ts]
ballyblue: folds 
HubertusB: folds 
kopatich52: folds 
Volke!n kz: folds 
xBankie: raises $0.09 to $0.14
lapa143: folds 
Uncalled bet ($0.09) returned to xBankie
xBankie collected $0.10 from pot
xBankie: doesn't show hand 
*** SUMMARY ***
Total pot $0.10 | Rake $0 
Seat 1: Volke!n kz (button) folded before Flop (didn't bet)
Seat 2: xBankie (small blind) collected ($0.10)
Seat 3: lapa143 (big blind) folded before Flop
Seat 4: ballyblue folded before Flop (didn't bet)
Seat 5: HubertusB folded before Flop (didn't bet)
Seat 6: kopatich52 folded before Flop (didn't bet)



PokerStars Zoom Hand #177969929309:  Hold'em No Limit ($0.02/$0.05) - 2017/11/09 3:04:19 CCT [2017/11/08 14:04:19 ET]
Table 'Donati' 6-max Seat #1 is the button
Seat 1: maziKilla ($4.80 in chips) 
Seat 2: urka55 ($2.73 in chips) 
Seat 3: Jarness II ($7.27 in chips) 
Seat 4: HubertusB ($5.05 in chips) 
Seat 5: woocha33 ($4.26 in chips) 
Seat 6: pokersito84 ($10.65 in chips) 
urka55: posts small blind $0.02
Jarness II: posts big blind $0.05
*** HOLE CARDS ***
Dealt to HubertusB [7h Js]
HubertusB: folds 
woocha33: folds 
pokersito84: folds 
maziKilla: raises $0.10 to $0.15
urka55: folds 
Jarness II: folds 
Uncalled bet ($0.10) returned to maziKilla
maziKilla collected $0.12 from pot
maziKilla: doesn't show hand 
*** SUMMARY ***
Total pot $0.12 | Rake $0 
Seat 1: maziKilla (button) collected ($0.12)
Seat 2: urka55 (small blind) folded before Flop
Seat 3: Jarness II (big blind) folded before Flop
Seat 4: HubertusB folded before Flop (didn't bet)
Seat 5: woocha33 folded before Flop (didn't bet)
Seat 6: pokersito84 folded before Flop (didn't bet)



PokerStars Zoom Hand #177969935040:  Hold'em No Limit ($0.02/$0.05) - 2017/11/09 3:04:26 CCT [2017/11/08 14:04:26 ET]
Table 'Donati' 6-max Seat #1 is the button
Seat 1: HubertusB ($5.05 in chips) 
Seat 2: xAndrzej-K ($6.70 in chips) 
Seat 3: KKKKypros ($6.19 in chips) 
Seat 4: zhenabalasha ($4.98 in chips) 
Seat 5: DmitrySh85 ($3.62 in chips) 
Seat 6: Fr13ndAG ($6.38 in chips) 
xAndrzej-K: posts small blind $0.02
KKKKypros: posts big blind $0.05
*** HOLE CARDS ***
Dealt to HubertusB [2s 3h]
zhenabalasha: folds 
DmitrySh85: folds 
Fr13ndAG: folds 
HubertusB: raises $0.05 to $0.10
xAndrzej-K: calls $0.08
KKKKypros: folds 
*** FLOP *** [6h 7h Th]
xAndrzej-K: bets $0.05
HubertusB: raises $0.15 to $0.20
xAndrzej-K: folds 
Uncalled bet ($0.15) returned to HubertusB
HubertusB collected $0.34 from pot
HubertusB: doesn't show hand 
*** SUMMARY ***
Total pot $0.35 | Rake $0.01 
Board [6h 7h Th]
Seat 1: HubertusB (button) collected ($0.34)
Seat 2: xAndrzej-K (small blind) folded on the Flop
Seat 3: KKKKypros (big blind) folded before Flop
Seat 4: zhenabalasha folded before Flop (didn't bet)
Seat 5: DmitrySh85 folded before Flop (didn't bet)
Seat 6: Fr13ndAG folded before Flop (didn't bet)



PokerStars Zoom Hand #177969952057:  Hold'em No Limit ($0.02/$0.05) - 2017/11/09 3:04:47 CCT [2017/11/08 14:04:47 ET]
Table 'Donati' 6-max Seat #1 is the button
Seat 1: axeldada ($5 in chips) 
Seat 2: xGzusS ($6.07 in chips) 
Seat 3: marcus 53 ($3.53 in chips) 
Seat 4: magonzalez ($2.95 in chips) 
Seat 5: xiaowu85 ($11.45 in chips) 
Seat 6: HubertusB ($5.24 in chips) 
xGzusS: posts small blind $0.02
marcus 53: posts big blind $0.05
*** HOLE CARDS ***
Dealt to HubertusB [Ac Ah]
magonzalez: folds 
xiaowu85: folds 
HubertusB: raises $0.07 to $0.12
axeldada: folds 
xGzusS: folds 
marcus 53: calls $0.07
*** FLOP *** [3d 3h 4c]
marcus 53: checks 
HubertusB: bets $0.15
marcus 53: calls $0.15
*** TURN *** [3d 3h 4c] [7c]
marcus 53: checks 
HubertusB: bets $0.39
marcus 53: folds 
Uncalled bet ($0.39) returned to HubertusB
HubertusB collected $0.54 from pot
HubertusB: doesn't show hand 
*** SUMMARY ***
Total pot $0.56 | Rake $0.02 
Board [3d 3h 4c 7c]
Seat 1: axeldada (button) folded before Flop (didn't bet)
Seat 2: xGzusS (small blind) folded before Flop
Seat 3: marcus 53 (big blind) folded on the Turn
Seat 4: magonzalez folded before Flop (didn't bet)
Seat 5: xiaowu85 folded before Flop (didn't bet)
Seat 6: HubertusB collected ($0.54)



PokerStars Zoom Hand #177969977060:  Hold'em No Limit ($0.02/$0.05) - 2017/11/09 3:05:17 CCT [2017/11/08 14:05:17 ET]
Table 'Donati' 6-max Seat #1 is the button
Seat 1: cristian87 ($5 in chips) 
Seat 2: HubertusB ($5.51 in chips) 
Seat 3: tursows ($5 in chips) 
Seat 4: iops88 ($4.98 in chips) 
Seat 5: MaKyyyXaA ($5.02 in chips) 
Seat 6: aodwntm ($11.75 in chips) 
HubertusB: posts small blind $0.02
tursows: posts big blind $0.05
*** HOLE CARDS ***
Dealt to HubertusB [Ad 5c]
iops88: folds 
MaKyyyXaA: folds 
aodwntm: folds 
cristian87: raises $0.05 to $0.10
HubertusB: folds 
tursows: folds 
Uncalled bet ($0.05) returned to cristian87
cristian87 collected $0.12 from pot
cristian87: doesn't show hand 
*** SUMMARY ***
Total pot $0.12 | Rake $0 
Seat 1: cristian87 (button) collected ($0.12)
Seat 2: HubertusB (small blind) folded before Flop
Seat 3: tursows (big blind) folded before Flop
Seat 4: iops88 folded before Flop (didn't bet)
Seat 5: MaKyyyXaA folded before Flop (didn't bet)
Seat 6: aodwntm folded before Flop (didn't bet)



PokerStars Zoom Hand #177969985295:  Hold'em No Limit ($0.02/$0.05) - 2017/11/09 3:05:27 CCT [2017/11/08 14:05:27 ET]
Table 'Donati' 6-max Seat #1 is the button
Seat 1: k535ru ($5.06 in chips) 
Seat 2: EikeS ($4.98 in chips) 
Seat 3: HubertusB ($5.49 in chips) 
Seat 4: KOBRA7777 ($4.46 in chips) 
Seat 5: Jarness II ($9.21 in chips) 
Seat 6: burila18 ($5.02 in chips) 
EikeS: posts small blind $0.02
HubertusB: posts big blind $0.05
*** HOLE CARDS ***
Dealt to HubertusB [6c 7s]
KOBRA7777: folds 
Jarness II: folds 
burila18: raises $0.07 to $0.12
k535ru: folds 
EikeS: folds 
HubertusB: folds 
Uncalled bet ($0.07) returned to burila18
burila18 collected $0.12 from pot
burila18: doesn't show hand 
*** SUMMARY ***
Total pot $0.12 | Rake $0 
Seat 1: k535ru (button) folded before Flop (didn't bet)
Seat 2: EikeS (small blind) folded before Flop
Seat 3: HubertusB (big blind) folded before Flop
Seat 4: KOBRA7777 folded before Flop (didn't bet)
Seat 5: Jarness II folded before Flop (didn't bet)
Seat 6: burila18 collected ($0.12)



PokerStars Zoom Hand #177969981278:  Hold'em No Limit ($0.02/$0.05) - 2017/11/09 3:05:22 CCT [2017/11/08 14:05:22 ET]
Table 'Donati' 6-max Seat #1 is the button
Seat 1: HubertusB ($5.49 in chips) 
Seat 2: MyTrips70 ($5.14 in chips) 
Seat 3: Rassty1983 ($5.43 in chips) 
Seat 4: Kreg Heg ($5.29 in chips) 
Seat 5: jrb180 ($5.07 in chips) 
Seat 6: genei0 ($11.13 in chips) 
MyTrips70: posts small blind $0.02
Rassty1983: posts big blind $0.05
*** HOLE CARDS ***
Dealt to HubertusB [Td 8c]
Kreg Heg: folds 
jrb180: folds 
genei0: folds 
HubertusB: folds 
MyTrips70: raises $0.10 to $0.15
Rassty1983: calls $0.10
*** FLOP *** [3h 6h 3s]
MyTrips70: checks 
Rassty1983: checks 
*** TURN *** [3h 6h 3s] [Jh]
MyTrips70: checks 
Rassty1983: bets $0.29
MyTrips70: folds 
Uncalled bet ($0.29) returned to Rassty1983
Rassty1983 collected $0.29 from pot
Rassty1983: doesn't show hand 
*** SUMMARY ***
Total pot $0.30 | Rake $0.01 
Board [3h 6h 3s Jh]
Seat 1: HubertusB (button) folded before Flop (didn't bet)
Seat 2: MyTrips70 (small blind) folded on the Turn
Seat 3: Rassty1983 (big blind) collected ($0.29)
Seat 4: Kreg Heg folded before Flop (didn't bet)
Seat 5: jrb180 folded before Flop (didn't bet)
Seat 6: genei0 folded before Flop (didn't bet)



PokerStars Zoom Hand #177970001619:  Hold'em No Limit ($0.02/$0.05) - 2017/11/09 3:05:47 CCT [2017/11/08 14:05:47 ET]
Table 'Donati' 6-max Seat #1 is the button
Seat 1: orongo__997 ($1.52 in chips) 
Seat 2: fibonacci000 ($5 in chips) 
Seat 3: Nerpa911 ($3.20 in chips) 
Seat 4: Clamfish0 ($6.17 in chips) 
Seat 5: HubertusB ($5.44 in chips) 
Seat 6: xGzusS ($5.02 in chips) 
fibonacci000: posts small blind $0.02
Nerpa911: posts big blind $0.05
*** HOLE CARDS ***
Dealt to HubertusB [4s Tc]
Clamfish0: folds 
HubertusB: folds 
xGzusS: folds 
orongo__997: raises $0.05 to $0.10
fibonacci000: raises $0.40 to $0.50
Nerpa911: calls $0.45
orongo__997: folds 
*** FLOP *** [Jh 7h Ks]
fibonacci000: checks 
Nerpa911: checks 
*** TURN *** [Jh 7h Ks] [5h]
fibonacci000: bets $0.51
Nerpa911: folds 
Uncalled bet ($0.51) returned to fibonacci000
fibonacci000 collected $1.05 from pot
fibonacci000: doesn't show hand 
*** SUMMARY ***
Total pot $1.10 | Rake $0.05 
Board [Jh 7h Ks 5h]
Seat 1: orongo__997 (button) folded before Flop
Seat 2: fibonacci000 (small blind) collected ($1.05)
Seat 3: Nerpa911 (big blind) folded on the Turn
Seat 4: Clamfish0 folded before Flop (didn't bet)
Seat 5: HubertusB folded before Flop (didn't bet)
Seat 6: xGzusS folded before Flop (didn't bet)



PokerStars Zoom Hand #177970005664:  Hold'em No Limit ($0.02/$0.05) - 2017/11/09 3:05:52 CCT [2017/11/08 14:05:52 ET]
Table 'Donati' 6-max Seat #1 is the button
Seat 1: pussd ($7.40 in chips) 
Seat 2: moneybek ($5.28 in chips) 
Seat 3: firebolt1984 ($5.19 in chips) 
Seat 4: vy021 ($4.93 in chips) 
Seat 5: HubertusB ($5.44 in chips) 
Seat 6: 321-MEINS100 ($8.14 in chips) 
moneybek: posts small blind $0.02
firebolt1984: posts big blind $0.05
*** HOLE CARDS ***
Dealt to HubertusB [9d 4d]
vy021: folds 
HubertusB: calls $0.05
321-MEINS100: folds 
pussd: folds 
moneybek: folds 
firebolt1984: checks 
*** FLOP *** [Ad 3d 5d]
firebolt1984: bets $0.05
HubertusB: raises $0.05 to $0.10
firebolt1984: calls $0.05
*** TURN *** [Ad 3d 5d] [Ks]
firebolt1984: checks 
HubertusB: bets $0.17
firebolt1984: calls $0.17
*** RIVER *** [Ad 3d 5d Ks] [4s]
firebolt1984: checks 
HubertusB: bets $1
firebolt1984: folds 
Uncalled bet ($1) returned to HubertusB
HubertusB collected $0.63 from pot
HubertusB: doesn't show hand 
*** SUMMARY ***
Total pot $0.66 | Rake $0.03 
Board [Ad 3d 5d Ks 4s]
Seat 1: pussd (button) folded before Flop (didn't bet)
Seat 2: moneybek (small blind) folded before Flop
Seat 3: firebolt1984 (big blind) folded on the River
Seat 4: vy021 folded before Flop (didn't bet)
Seat 5: HubertusB collected ($0.63)
Seat 6: 321-MEINS100 folded before Flop (didn't bet)



PokerStars Zoom Hand #177970063994:  Hold'em No Limit ($0.02/$0.05) - 2017/11/09 3:07:03 CCT [2017/11/08 14:07:03 ET]
Table 'Donati' 6-max Seat #1 is the button
Seat 1: hceyms ($5.28 in chips) 
Seat 2: HubertusB ($5.75 in chips) 
Seat 3: Jarness II ($6.08 in chips) 
Seat 4: Kreg Heg ($4.80 in chips) 
Seat 5: maziKilla ($5.30 in chips) 
Seat 6: mel1in ($12.04 in chips) 
HubertusB: posts small blind $0.02
Jarness II: posts big blind $0.05
*** HOLE CARDS ***
Dealt to HubertusB [Ts 8s]
Kreg Heg: folds 
maziKilla: folds 
mel1in: folds 
hceyms: raises $0.07 to $0.12
HubertusB: folds 
Jarness II: folds 
Uncalled bet ($0.07) returned to hceyms
hceyms collected $0.12 from pot
hceyms: doesn't show hand 
*** SUMMARY ***
Total pot $0.12 | Rake $0 
Seat 1: hceyms (button) collected ($0.12)
Seat 2: HubertusB (small blind) folded before Flop
Seat 3: Jarness II (big blind) folded before Flop
Seat 4: Kreg Heg folded before Flop (didn't bet)
Seat 5: maziKilla folded before Flop (didn't bet)
Seat 6: mel1in folded before Flop (didn't bet)



